FID,shape,objectid,statefp10,countyfp10,tractce10,blockgroup,total_pop,hisp_latino,not_hisp_latino,pop_one_race,white_alone,black_africamer_alone,amerind_aknat_alone,asian_alone,nathaw_pacisl_alone,other_race_alone,pop_two_or_more_races,over18_total_pop,over18_hisp_latino,over18_not_hisp_latino,over18_pop_one_race,over18_white_alone,over18_black_africamer_alone,over18_amerind_aknat_alone,over18_asian_alone,over18_nathaw_pacisl_alone,over18_other_race_alone,over18_pop_two_or_more_races,total_housing_units,occupied_housing_units,vacant_housing_units
census_2010_blockgroups_view.fid--2dc29038_13ec899ba8f_-2654,"MULTIPOLYGON (((-82.64984864562378 35.52822622410266, -82.65058164583598 35.527636224057574, -82.6527796464724 35.52586822392241, -82.65351364668469 35.52527922387763, -82.65363364671688 35.52519922387362, -82.6538586467772 35.52505022386632, -82.65400964681135 35.52499122386973, -82.65414464684169 35.52493922387293, -82.65487864700181 35.52469122389761, -82.65524464708164 35.52456722390983, -82.65685164743157 35.524027223964396, -82.65708264748173 35.52395022397239, -82.65781764764174 35.523703223997295, -82.6580236476852 35.52364322400615, -82.65864364781544 35.523466224033605, -82.6588506478589 35.523407224042764, -82.66076064827016 35.52279522411364, -82.66649164950425 35.52096022432652, -82.66722264966145 35.520727224353955, -82.66845864985373 35.52081422449821, -82.66845264986789 35.52071522447736, -82.66844164989973 35.52049522443147, -82.66843664991042 35.52042022441566, -82.66843064992437 35.52032222439507, -82.66843064992521 35.52031722439404, -82.66840764996007 35.52006422434014, -82.66840764996046 35.52006222433967, -82.66837664999237 35.519820224287216, -82.66828565005741 35.519296224171114, -82.66827365006675 35.519222224154824, -82.66825365009132 35.519040224115706, -82.66824565010332 35.518953224097146, -82.6682456501044 35.5189462240957, -82.6682496501438 35.51869322404455, -82.66825165015737 35.51860722402725, -82.66826665020503 35.51831222396865, -82.66828265025457 35.51800622390796, -82.6682886502709 35.51790622388822, -82.66830465030677 35.51768922384564, -82.66833165033862 35.51751022381189, -82.66835065035357 35.5174332237982, -82.66837665037355 35.51733122378, -82.66844365041182 35.51715422375085, -82.66844665041356 35.517146223749464, -82.66849865043852 35.517039223733015, -82.66859065048338 35.51684622370312, -82.66876265056628 35.516492223648605, -82.66886365061166 35.51630522362082, -82.66895365064795 35.51616622360168, -82.66910965070186 35.51598322358036, -82.66911565070417 35.51597522357937, -82.66935065078103 35.515728223553054, -82.66936465078564 35.51571322355143, -82.66940565079939 35.515668223546456, -82.66942065080404 35.515654223545205, -82.6694226508046 35.51565222354495, -82.66955565084743 35.515517223531106, -82.66967565088575 35.51539722351888, -82.6697756509154 35.51531222351178, -82.66989265094661 35.51523522350808, -82.66999365097122 35.51518422350806, -82.6700156509763 35.51517522350842, -82.67012965100169 35.515133223511576, -82.67019865101607 35.51511422351482, -82.67027965103308 35.515091223518354, -82.67032365104203 35.515080223520634, -82.67054265108659 35.51502722353221, -82.6706826511145 35.514997223540455, -82.67070265111842 35.51499322354174, -82.67081465114015 35.514973223549084, -82.67083165114286 35.514973223550825, -82.67095865116521 35.51496522356218, -82.6710736511836 35.514970223574984, -82.67116465119643 35.51498522358738, -82.67121765120332 35.51499822359545, -82.67125965120856 35.515009223602014, -82.67132265121472 35.515037223614115, -82.6713706512171 35.515074223626634, -82.67140965121588 35.51512422364076, -82.67142265121181 35.51516522365047, -82.67142365120503 35.51521022365976, -82.67140065119102 35.51527722367099, -82.67134765116954 35.51535922368232, -82.67128465114708 35.515438223692016, -82.67116765110798 35.515566223706045, -82.67086565101654 35.51583522372994, -82.67084765101099 35.51585222373156, -82.67077065098702 35.515925223738606, -82.67072865097266 35.51597322374409, -82.67069565095939 35.51602422375112, -82.67066665094248 35.51610322376417, -82.67067265093576 35.51615322377499, -82.67067565093143 35.51618522378181, -82.67068165093039 35.516198223785075, -82.67070965092555 35.51626022380063, -82.67075265092487 35.51631122381544, -82.67075765092511 35.51631522381674, -82.67079565092696 35.51634422382651, -82.67081365092795 35.51635722383107, -82.67090165093667 35.51639622384797, -82.6709796509478 35.516408223858406, -82.67110265096889 35.51640422387019, -82.67160765105983 35.51635822391248, -82.67302165131447 35.51623122403136, -82.67314965133632 35.51622722404366, -82.67327965135779 35.51622822405714, -82.67340365137665 35.51624022407233, -82.6735326513945 35.51626322409018, -82.67364265140763 35.516297224108435, -82.67375065141918 35.51633922412797, -82.67402665144029 35.51650122418927, -82.67407465144397 35.516529224199914, -82.67420565145642 35.516590224225716, -82.6743066514675 35.516627224243635, -82.67440765148115 35.51664822425823, -82.67452565149584 35.51668022427683, -82.67480665153442 35.51673322431642, -82.67481665153582 35.516735224317834, -82.67488965154507 35.51675422432917, -82.67489865154602 35.516757224330696, -82.67509965156862 35.516828224365725, -82.67513965157208 35.516849224374084, -82.67521565157857 35.51688922439005, -82.67551865159652 35.51710122446428, -82.67580665161036 35.517323224538956, -82.67629665163413 35.51770022466604, -82.67688465166121 35.51816222482031, -82.67711265167263 35.518335224878925, -82.67742665168619 35.5185872249624, -82.6775426516919 35.51867622499241, -82.67802165171555 35.51904222511606, -82.67812265171948 35.51912622514351, -82.67817765172175 35.5191712251583, -82.6782246517229 35.519214225171886, -82.67823865172329 35.519227225176, -82.67829865172358 35.51929022519498, -82.67840465172098 35.51942222523277, -82.67844965171828 35.51948922525092, -82.67847565171596 35.51953222526242, -82.67854565170983 35.519648225293196, -82.67862865170207 35.51978922533041, -82.67872565169286 35.519954225374, -82.67881165168184 35.520120225416676, -82.67885865167344 35.520226225443096, -82.6789046516649 35.52033122546913, -82.67892165166047 35.52037922548069, -82.67900065163867 35.52060722553524, -82.6790506516161 35.520809225581466, -82.67907165159671 35.52095822561406, -82.67907365159027 35.5210022256232, -82.67907965157895 35.52108322564036, -82.67907165154132 35.521320225687795, -82.67905565151857 35.521451225712845, -82.6789626514187 35.52200222581564, -82.678864651297 35.52269022594588, -82.67883365125694 35.52291822598915, -82.67874765114476 35.52355722611051, -82.67866465104062 35.524146226222165, -82.67861665097973 35.52449222628769, -82.67857565092007 35.52483722635381, -82.67857465089044 35.525029226392874, -82.67858565086779 35.525189226426605, -82.67862165085076 35.52533922646086, -82.6786636508375 35.52547122649208, -82.67870765082957 35.52557122651692, -82.67876365082385 35.52566922654263, -82.67884765082158 35.52577522657285, -82.67890765082177 35.52583922659197, -82.67893265082179 35.52586622660007, -82.67930965083471 35.52619122670489, -82.6793596508374 35.52622822671755, -82.67929265081548 35.52629822672503, -82.67921265078905 35.5263842267343, -82.67910665075617 35.52648322674365, -82.67908465074997 35.526500226744865, -82.67901165072817 35.52656322675026, -82.6789956507235 35.52657622675126, -82.67879765067035 35.52670822675784, -82.67858065061516 35.52683222676089, -82.6784066505731 35.52691822676068, -82.67839465057004 35.52692522676079, -82.67823565053318 35.52699322675844, -82.67812165050763 35.52703622675549, -82.67786065045262 35.52711222674431, -82.67763365040824 35.5271552267298, -82.67714765031194 35.52725622670061, -82.67687465025404 35.527337226689205, -82.67663565020158 35.52742022668163, -82.67639565014638 35.527520226677396, -82.67625365011341 35.527581226675316, -82.67615165008905 35.52762922667465, -82.67595965004064 35.52773722667704, -82.67578064999294 35.52785422668254, -82.67565464995708 35.52795122668943, -82.67553664992356 35.52804222669587, -82.67537164987519 35.52817822670666, -82.67528464984939 35.52825222671289, -82.67516464981354 35.52835622672177, -82.67504064977723 35.52845822672987, -82.67466864966819 35.5287662267545, -82.67454564963197 35.528869226762936, -82.67450664962068 35.52890022676529, -82.67439064958671 35.528996226772946, -82.67435264957552 35.529028226775594, -82.67414164951391 35.529201226789176, -82.6735106493294 35.52972022683037, -82.67330064926776 35.529894226844334, -82.67313564921966 35.53002922685491, -82.67309264920726 35.53006322685751, -82.67262164906951 35.530451226888346, -82.67248364902618 35.530584226901276, -82.67229164896554 35.530771226919775, -82.67215964893991 35.53079522691114, -82.67211764892969 35.53081622691113, -82.6720566489168 35.53083422690851, -82.67200064890474 35.53085222690646, -82.67188864888244 35.53087622689985, -82.67133564877756 35.53096022686037, -82.67132764877594 35.5309622268599, -82.67109464873215 35.53099522684287, -82.67098664871207 35.531009226834584, -82.6706656486516 35.53105522681109, -82.67055864863154 35.53107022680325, -82.6704746486157 35.53108222679707, -82.67022364856817 35.53112022677908, -82.67014064855235 35.53113322677326, -82.67006764853852 35.53114422676798, -82.66995364851464 35.531176226762916, -82.66939864839819 35.53133322673804, -82.6692656483703 35.53137122673218, -82.66923564836307 35.53138622673208, -82.66921864835886 35.531395226732215, -82.66919964835297 35.53141322673391, -82.66916264834396 35.5314312267338, -82.66908564832525 35.53147022673391, -82.66898764829975 35.531530226736045, -82.66893064828471 35.53156622673758, -82.66844464815762 35.53186822674938, -82.6683776481414 35.53190122674916, -82.66821264810129 35.53198422674923, -82.6679886480444 35.532112226752325, -82.66781164800115 35.532202226752574, -82.66764864796194 35.532281226752026, -82.66748664792424 35.532351226749604, -82.66731764788598 35.53241722674579, -82.66715264784969 35.53247522674077, -82.66695964780837 35.532535226733145, -82.66658764773348 35.53262022671244, -82.66652664772104 35.532635226709274, -82.66629164767136 35.532704226699224, -82.66600264761257 35.53277422668385, -82.66596264760459 35.532783226681666, -82.66575764756371 35.53282722666956, -82.66537164749434 35.53286122663699, -82.6651346474535 35.532870226614556, -82.66512764745238 35.532870226613845, -82.66491764741717 35.53287222659269, -82.6647256473851 35.53287322657325, -82.66414964728844 35.532878226515244, -82.6639586472564 35.532880226496104, -82.66373764721938 35.53288222647389, -82.66249664701228 35.53288722634778, -82.66209464694246 35.532906226310494, -82.6617846468889 35.53291922628141, -82.66132464680922 35.53294022623855, -82.66128964680306 35.53294222623538, -82.66110664677024 35.532958226219925, -82.6609476467398 35.5329842262089, -82.66078664670682 35.53302422620063, -82.66062964667103 35.5330882261975, -82.66047464663232 35.533172226198744, -82.66031364658832 35.53328422620511, -82.66018464654812 35.533407226216994, -82.6600696465059 35.53355722623578, -82.65997064645842 35.53376022626698, -82.6598896464112 35.53398022630353, -82.65981664636318 35.53421422634375, -82.65978064633224 35.534377226373316, -82.6597696463114 35.53450122639736, -82.65978164629448 35.53462422642373, -82.65982264627979 35.5347642264564, -82.65987864626737 35.53490622649105, -82.65994764626075 35.53502422652222, -82.66017164624849 35.53534722661097, -82.66024464624067 35.53547722664492, -82.66029264622917 35.5356042266757, -82.66032664621248 35.535750226708906, -82.66034564619343 35.535895226740394, -82.66034564616993 35.53604822677162, -82.66032164613901 35.536224226805, -82.660282646109 35.536377226832165, -82.66021564607009 35.53655822686222, -82.65995964594467 35.53709922694622, -82.65987864590677 35.537258226970295, -82.65983164588441 35.537353226984855, -82.65971464583286 35.53756222701545, -82.65955964576769 35.53781922705195, -82.65925064564702 35.53827122711243, -82.6591406456066 35.53841522713048, -82.65905064557359 35.538533227145315, -82.6588006454865 35.53883022718025, -82.65842164536245 35.53922822722251, -82.65802964523374 35.53964222726672, -82.65779664516022 35.53986922728908, -82.65764664511428 35.54000622730161, -82.65753164508172 35.54009322730758, -82.65748464506869 35.54012722730972, -82.65737864504155 35.540189227311494, -82.65716764499028 35.540295227311454, -82.65626264478396 35.54065922729292, -82.65618764476689 35.54068922729134, -82.65608264474446 35.54072122728706, -82.65583664477141 35.540279227171844, -82.65571964477819 35.540108227124975, -82.65560764477905 35.53998122708763, -82.65547664477404 35.53987122705185, -82.65533064476516 35.53977122701646, -82.65510464474524 35.5396562269699, -82.65484764471564 35.53957022692612, -82.65472764470053 35.53953922690748, -82.6546726446933 35.53952622689914, -82.65407564461502 35.539389226810115, -82.65403464460913 35.539383226804674, -82.65384964458286 35.539354226779764, -82.65361764454889 35.539324226749905, -82.65281064442331 35.53926822665585, -82.65249564437426 35.53924622661906, -82.65232764434809 35.53923522659964, -82.6520486443033 35.53922422656881, -82.65177464425834 35.53922022653986, -82.65149864421086 35.539231226513884, -82.65124764416528 35.539256226493315, -82.6509956441183 35.539289226474175, -82.65075764407227 35.53933122645832, -82.6505106440228 35.53938622644422, -82.65028564397616 35.5394462264334, -82.64980064387251 35.539596226414204, -82.64949464380706 35.53969122640225, -82.6491966437433 35.53978422639068, -82.64802364349167 35.54015322634567, -82.64714364330293 35.540429226311716, -82.6469826432682 35.5404812263059, -82.64681664323268 35.54053322629941, -82.6464536431549 35.54064722628548, -82.64618664309762 35.54073122627526, -82.64588564303297 35.540826226263725, -82.6457126429958 35.54088122625725, -82.64556164296349 35.540928226251296, -82.64524064289476 35.54102822623884, -82.64513064287135 35.54106122623422, -82.64480364280143 35.54116322622155, -82.64469464277792 35.541198226217475, -82.64429264269206 35.54132222620157, -82.64426564268666 35.54132822620002, -82.64402864263809 35.541388226187976, -82.64393764262022 35.5414062261823, -82.64376864258706 35.541439226171704, -82.6435236425406 35.54147622615417, -82.64325964249353 35.54149722613131, -82.64302564245338 35.54150522610905, -82.64293864243872 35.54150622610031, -82.64249164236305 35.54151522605634, -82.64248164236143 35.541515226055274, -82.6419706422754 35.54152222600439, -82.64125364215406 35.54153622593372, -82.63954464186459 35.5415712257658, -82.63927264181707 35.541586225740964, -82.63899364176581 35.54161822571885, -82.6387596417211 35.541656225702596, -82.63846364166149 35.541723225685885, -82.63837864164374 35.54174722568212, -82.63818464160298 35.54180322567366, -82.63792064154352 35.54190422566719, -82.63760864147274 35.54202822566045, -82.6373506414138 35.54213222565521, -82.6370146413356 35.542278225650485, -82.6369016413083 35.54233322565014, -82.63667064125138 35.54245422565113, -82.63649564120576 35.54256222565518, -82.63612564117315 35.54237422557898, -82.63595464115704 35.54229322554491, -82.63560964112605 35.542122225474785, -82.63504064107444 35.54184222535935, -82.63424964100273 35.54145222519888, -82.6329476408845 35.54081222493511, -82.63242064083668 35.54055322482828, -82.63206064080397 35.540376224755384, -82.63236064087305 35.54025122476063, -82.63256364092483 35.54013322475741, -82.63289864101286 35.53992222474875, -82.63318864109638 35.53969222473159, -82.63370064122975 35.539377224719935, -82.63410964134782 35.53905122469545, -82.63455764146892 35.538747224679454, -82.63498164158317 35.538461224664594, -82.6356396417608 35.538016224641375, -82.63775264233091 35.536589224567194, -82.6394966428011 35.53541322450629, -82.64199564347547 35.533724224418265, -82.64278864368946 35.53318822439033, -82.64292364372605 35.533096224385396, -82.64435364411166 35.532131224335345, -82.64447564414434 35.53205022433135, -82.64556764443935 35.531310224292454, -82.64614064459406 35.530922224272075, -82.64699064482365 35.53034622424181, -82.64700864482882 35.53033222424085, -82.64878864532726 35.529011224154075, -82.64984864562378 35.52822622410266)))",6426,37,021,002302,370210023022,1737,1737,65,1713,1647,14,5,41,0,6,24,1259,37,1222,1246,1203,8,5,27,0,3,13,745,664,81
census_2010_blockgroups_view.fid--2dc29038_13ec899ba8f_-2653,"MULTIPOLYGON (((-82.49122260732864 35.606022223658925, -82.49146560735845 35.60609022369774, -82.49229060745907 35.60632522383042, -82.49265860750324 35.606434223890396, -82.4927006075082 35.60644722389741, -82.49283260752226 35.606498223921335, -82.49295360753335 35.606556223945574, -82.49307560754357 35.60662122397135, -82.49318560754996 35.606698223998336, -82.49332760755598 35.60681122403587, -82.49343760755606 35.60692922407122, -82.49350960755335 35.607024224097934, -82.4935866075481 35.60714122412971, -82.49370160752878 35.60739022419215, -82.49381360749834 35.607708224268336, -82.49384860748403 35.60783822429834, -82.49398760743506 35.608305224407665, -82.49404260739813 35.608604224474085, -82.49405460738217 35.60872022449896, -82.49405560736678 35.608821224519644, -82.49403160733418 35.60900722455495, -82.49400560731351 35.6091132245739, -82.49397260729248 35.609214224590986, -82.49388260724977 35.60939422461838, -82.49382260722358 35.60949922463354, -82.49344960708561 35.60999322469567, -82.49333060704303 35.61014122471363, -82.49301360692864 35.61054222476249, -82.49287460687651 35.61073022478648, -82.49278360683942 35.61087322480615, -82.49270760680665 35.611004224825024, -82.49264760677507 35.6111442248473, -82.49260960674899 35.611272224869495, -82.49257760672226 35.611411224894425, -82.49255660668284 35.61164422493968, -82.49255760666964 35.61173122495745, -82.4925586066596 35.611797224970985, -82.492578606625 35.61204322502306, -82.49259260659984 35.61222122506071, -82.49258960656867 35.6124202251009, -82.49257260654065 35.61258322513228, -82.4925516065207 35.61269022515186, -82.4925506065195 35.61269722515321, -82.49250960649212 35.61283022517606, -82.49243860645572 35.61299022520128, -82.49205760627959 35.61372222531105, -82.49199760624683 35.61387022533491, -82.49195760621815 35.61401322535991, -82.49192960619045 35.61416222538737, -82.49191260616583 35.61430422541449, -82.49188760605193 35.61501522555654, -82.49187960603118 35.61514122558136, -82.49185060599586 35.61533922561859, -82.49183060597723 35.615438225636645, -82.49179460594998 35.61557622566109, -82.49163860584495 35.61608922574936, -82.49159260581344 35.616244225776136, -82.49154760577494 35.616445225812434, -82.49152860575053 35.61658322583853, -82.49151560572196 35.61675422587196, -82.49152460569867 35.61691522590564, -82.49154360568022 35.61705522593609, -82.49157260566244 35.61720122596878, -82.49162960564311 35.61738822601268, -82.49170060562902 35.617555226054016, -82.4917876056179 35.617721226096606, -82.49189860560654 35.61791422614738, -82.49233460557531 35.61858522632861, -82.49242160556531 35.6187432263698, -82.49255060554742 35.618998226434925, -82.49283960549116 35.61967322660197, -82.49292260547983 35.61983622664358, -82.49297260547542 35.61991822666546, -82.49312060546784 35.620126226723, -82.49347560546224 35.62054422684454, -82.49359860545631 35.62071522689196, -82.49365660544815 35.620830226921385, -82.4936976054367 35.62094822694955, -82.49371160542243 35.62105622697297, -82.49371760540701 35.62116222699512, -82.49370460538816 35.621270227015756, -82.49367360536745 35.62137122703314, -82.49362760534545 35.62146422704727, -82.49357060532168 35.62155722706034, -82.49350560529824 35.62163922707033, -82.49341460526817 35.62173622708072, -82.49309360517621 35.62198722709876, -82.4928836051147 35.622160227112325, -82.49268460505242 35.6223502271305, -82.49253860500131 35.622524227150834, -82.49245660496798 35.622652227168494, -82.49237660493276 35.62279422718915, -82.49231360489908 35.62294522721334, -82.4922606048636 35.62311822724314, -82.49222160482776 35.6233082272777, -82.49219960480002 35.623464227307224, -82.49217760477141 35.62362622733789, -82.4921596047409 35.623804227372226, -82.49215160471358 35.62397322740581, -82.49215360467878 35.62420022745224, -82.49216460464652 35.62442122749827, -82.49218760461707 35.6246372275446, -82.49219160461385 35.62466222755007, -82.49224360457677 35.62495822761563, -82.49231060454542 35.625233227678436, -82.49255360446662 35.62600522786051, -82.49286260439432 35.626805228054955, -82.49308660435575 35.62729622817798, -82.49332660433559 35.62768422828159, -82.49354060433551 35.62791522835058, -82.49382260434811 35.628136228424566, -82.49482260442831 35.628691228640314, -82.49506760444272 35.62886122870015, -82.49525060444482 35.62904422875618, -82.49540460443575 35.62926822881766, -82.49550360441418 35.62951422887784, -82.49567960431652 35.63033622906314, -82.49577360428358 35.63065022913671, -82.49578860427874 35.63069822914803, -82.49593460425427 35.63101322922709, -82.49647960421736 35.63183822945107, -82.49661260419413 35.63213122952425, -82.4966656041583 35.63242022958849, -82.49665660411955 35.63266222963678, -82.49658160406875 35.632910229679595, -82.4964276040037 35.6331662297158, -82.49623060393822 35.63337822973867, -82.49597560386911 35.633552229747835, -82.49565260379202 35.63370422974553, -82.49379860338033 35.63437922969202, -82.4928336031591 35.634775229673245, -82.49256360309474 35.634902229671326, -82.49203960296316 35.635191229676174, -82.49158160283872 35.63550522969301, -82.4913216027629 35.63571722970932, -82.49103560267311 35.635991229735566, -82.49075560257285 35.6363392297776, -82.49053660248198 35.63669322982704, -82.49038260240619 35.63701822987733, -82.49026960233435 35.63736222993563, -82.4901896022557 35.63778523001344, -82.49017360222 35.6379992300554, -82.49020760216762 35.638375230135274, -82.4902786021471 35.638584230185145, -82.4903656021381 35.638736230225, -82.49046160213314 35.63887123026242, -82.49054260213384 35.63895323028738, -82.49058260213415 35.638994230299815, -82.49069060213795 35.63908623032971, -82.49081660214674 35.63916423035854, -82.49095660215798 35.639242230388824, -82.49113060217587 35.639313230421195, -82.49141560220804 35.639410230470226, -82.49181060225497 35.63953123053542, -82.49232460231428 35.63969923062255, -82.49249460233182 35.63976823065411, -82.49265860234543 35.63985623068887, -82.49283060235776 35.639961230727934, -82.4929696023655 35.64006023076242, -82.49309060236902 35.64016723079657, -82.49319060236981 35.64026923082764, -82.49328160236902 35.64037223085792, -82.49335060236521 35.640471230885225, -82.49341960235735 35.64059623091775, -82.49348360234633 35.64073623095283, -82.49353560233354 35.64087523098641, -82.49357460231667 35.64102623102112, -82.49359460229645 35.64117823105412, -82.49360060228658 35.64124923106918, -82.49360860227519 35.64133123108672, -82.4936096022468 35.64151623112439, -82.49359960220946 35.6417472311704, -82.49358160217206 35.64197023121393, -82.49355460213478 35.642182231254274, -82.49348060206162 35.642576231326764, -82.49347360205626 35.642603231331556, -82.49343560202449 35.64276823136122, -82.4933746019804 35.642988231399706, -82.49322060188902 35.64341423147048, -82.49312660184319 35.64361023150067, -82.49303660180217 35.643779231525826, -82.49292860175689 35.64395623155066, -82.49278960170469 35.64414523157488, -82.49264460165182 35.64433123159777, -82.49209360146963 35.64491923166063, -82.49189060139963 35.645154231687535, -82.4917436013448 35.64535123171252, -82.49162760129971 35.6455182317345, -82.49154460126469 35.645656231754025, -82.49145060122282 35.645826231779, -82.49136460117823 35.64602223180995, -82.49135560117308 35.6460462318139, -82.49128860113368 35.64622923184426, -82.49123960109297 35.646440231882124, -82.49121360105971 35.646627231917556, -82.49120160102595 35.64683323195816, -82.49120560095444 35.647300232053546, -82.49119960093921 35.6473922320717, -82.49119360092199 35.64749723209243, -82.49118260091448 35.647534232098835, -82.49114560088685 35.647673232123296, -82.49109460086093 35.647786232141016, -82.49106660084912 35.6478322321475, -82.49101860082935 35.64790923215823, -82.49100460082465 35.64792423215982, -82.49093160079984 35.648006232169, -82.49090560079205 35.64802923217101, -82.49087260078238 35.64805623217308, -82.49083860077205 35.648086232175665, -82.49076860075394 35.648128232177015, -82.49073360074466 35.648151232178115, -82.49062460071805 35.648206232178104, -82.49041060067177 35.64827623217026, -82.49022560063548 35.648312232158545, -82.49009160061244 35.648317232145786, -82.48997160059261 35.648317232133444, -82.48969360054821 35.64830623210262, -82.48858260037653 35.64822423197149, -82.4882096003179 35.64820323192888, -82.48771960023666 35.64820323187837, -82.48753060020424 35.64821023186038, -82.48736160017452 35.648221231845234, -82.48720160014389 35.648247231833984, -82.48701460010611 35.64829123182373, -82.48686860007415 35.648341231818925, -82.48673060004123 35.648406231817916, -82.48660860000953 35.648480231820386, -82.48650659997917 35.648567231827585, -82.48641759994942 35.64866423183816, -82.48632159991347 35.6487942318547, -82.48626759988886 35.648895231869666, -82.48624159987216 35.64897523188333, -82.4862185998535 35.64907123190042, -82.48620659983781 35.64916023191732, -82.48620459982921 35.649213231927845, -82.48620359982164 35.64926123193756, -82.48621159980799 35.64935823195806, -82.48625659978492 35.64955623200297, -82.48639659974283 35.649978232103244, -82.48652959970002 35.65039823220237, -82.48656259968558 35.65052723223199, -82.48658559967211 35.65063923225714, -82.48660159965789 35.650748232281046, -82.48660559963793 35.65088123230846, -82.48660259961592 35.65102123233661, -82.48658259959142 35.65115823236245, -82.48654859956315 35.651304232388654, -82.48650259953614 35.65143023240957, -82.48646659951712 35.65151423242294, -82.48639659948373 35.6516552324444, -82.48631559945052 35.65178323246213, -82.4861205993793 35.65203423249306, -82.48600559934036 35.65216323250744, -82.48581459927735 35.65236623252913, -82.48544559914386 35.652833232586104, -82.48534359908031 35.653135232637005, -82.48539759893315 35.654145232848066, -82.48527059885183 35.6545352329143, -82.48500859876235 35.65483223294772, -82.48415559851979 35.65548623299292, -82.48391859842205 35.65586423304537, -82.48395959835096 35.65636823315223, -82.48475159832847 35.65736323343606, -82.48490559830647 35.65767123351459, -82.48495259822505 35.6582482336368, -82.48475959812681 35.65867623370404, -82.48460559807825 35.65882523371844, -82.48444159802649 35.65898423373389, -82.48341359774724 35.659687233771045, -82.4824525974528 35.66056023384968, -82.48216659737743 35.66074123385707, -82.48168059727585 35.66087623383443, -82.48115959718636 35.66089623378487, -82.48041659705851 35.660926233714434, -82.4799475969485 35.66113423370839, -82.47971859687767 35.66134723372823, -82.47956359680488 35.66165123377406, -82.47944559662372 35.662696233974486, -82.47931659653939 35.663103234043916, -82.47888259638188 35.663656234111684, -82.4781275961592 35.66428623416208, -82.478053596139 35.66433723416484, -82.47780659607581 35.66448123416874, -82.47753359600748 35.664630234170886, -82.47716959591828 35.66481623417126, -82.47683059583383 35.664999234173536, -82.47672459580617 35.66506423417585, -82.47659959577325 35.6651432341791, -82.47643659572594 35.665274234188914, -82.4762725956716 35.66544923420761, -82.4761565956267 35.665615234229406, -82.47604959558187 35.66579023425396, -82.47590459550784 35.66611323430477, -82.47571559541517 35.66651023436604, -82.47559659536122 35.666731234398775, -82.47542259529934 35.666944234424165, -82.47524859524533 35.66710723443937, -82.47505159519272 35.667236234445284, -82.47479659512979 35.66736923444609, -82.47462359509055 35.667437234442055, -82.47394259494035 35.66767823442096, -82.47356359485539 35.66782123441097, -82.47317859476641 35.66798323440426, -82.47316959476427 35.667987234404166, -82.4728725946916 35.66813923440448, -82.47258259462133 35.66828223440371, -82.47235759456883 35.668380234400416, -82.472234594542 35.668422234396374, -82.47204859450599 35.668455234383835, -82.47181659446805 35.66845223435942, -82.47167759444953 35.66842223433896, -82.47179959452905 35.66803923427359, -82.47216759476727 35.666894234078605, -82.47229059484673 35.666512234013595, -82.47234359490469 35.66619423395438, -82.47234859490744 35.66618223395249, -82.47241759494256 35.66602923392844, -82.47253859498628 35.66587623390979, -82.47260659502307 35.665711233883286, -82.47266659510446 35.66524923379544, -82.47268059512301 35.66514423377552, -82.47276359516978 35.66493123374082, -82.47277459517605 35.66490223373599, -82.47282859521724 35.66469423369925, -82.47286159529568 35.66422223360664, -82.47280059538271 35.66359423347264, -82.47282759542803 35.663330233421746, -82.47284559544262 35.66325523340834, -82.47290159548606 35.6630342333692, -82.47295459555534 35.662643233295086, -82.47310959566592 35.66209423319944, -82.47324459573254 35.661808233155185, -82.47326459574614 35.661742233143784, -82.47331859576339 35.66168823313842, -82.47362759589973 35.6611382330583, -82.47363359591667 35.66103523303796, -82.47370159593684 35.66097723303321, -82.4737825959611 35.66090723302732, -82.47382259598042 35.6608252330147, -82.47398459604153 35.660604232986486, -82.47402459606484 35.660496232968654, -82.4742195961492 35.660160232920404, -82.47423359616161 35.66009423290837, -82.47425959616946 35.66007123290643, -82.47427359619215 35.65994023288123, -82.47430059620004 35.65991823287948, -82.47428659620121 35.65989523287337, -82.47436759624848 35.65967623283716, -82.4744955962987 35.65948923281233, -82.47467059635414 35.659318232795584, -82.47484559642704 35.65903423275583, -82.474885596439 35.65900023275304, -82.47500559649059 35.65879523272368, -82.47502759649981 35.65875923271863, -82.47516159657313 35.6584282326651, -82.47519559662895 35.65810423260273, -82.47518159664855 35.657962232572366, -82.47512759667028 35.65776423252658, -82.47489159671537 35.657219232391434, -82.47487659671616 35.657198232385625, -82.4748455967178 35.65715423237349, -82.47477059672225 35.65704523234358, -82.47474659672054 35.65703023233804, -82.4747025967177 35.657001232327595, -82.4746015968064 35.65631923217847, -82.47464559684985 35.65608523213548, -82.47465559685868 35.656039232127064, -82.47468959687139 35.65599323212125, -82.47469559687664 35.65596623211641, -82.47474259691579 35.65576323207993, -82.47481659700104 35.65529123199151, -82.47484359701212 35.65524823198559, -82.47487059704908 35.655038231945696, -82.47491059707593 35.65490723192315, -82.47494359714442 35.65450023184371, -82.47514559724517 35.65406523177605, -82.47517259727152 35.65392323174999, -82.47517959732218 35.653603231685594, -82.47521159735962 35.65339523164657, -82.47523259738337 35.653264231622124, -82.47526659744703 35.65288923154933, -82.47530659747557 35.6527472315246, -82.47542759751714 35.65260823150882, -82.47550659753519 35.65257623151035, -82.47569759757877 35.65249923151441, -82.47592859764828 35.65229723149711, -82.47601359767367 35.652224231491076, -82.47612059773655 35.65193223144266, -82.47616759780877 35.65151523136267, -82.47615459784579 35.65126223130985, -82.47609359788497 35.65094323123869, -82.47606159789747 35.650828231212024, -82.47603959790656 35.650745231192865, -82.47591759792193 35.650515231133575, -82.47579459791866 35.65040423109824, -82.47567559791582 35.650295231063865, -82.47557459790832 35.6502352310413, -82.47553459790164 35.65023523103717, -82.47548559789854 35.65020323102563, -82.47534559788903 35.65011423099309, -82.47530559789607 35.65002623097109, -82.47526459795377 35.649608230881825, -82.47521759796794 35.64946623084807, -82.47514359800037 35.64917723078174, -82.4750505980413 35.64881223069789, -82.47504259804451 35.6487832306912, -82.47494059807337 35.64848723062049, -82.47486659814588 35.64793823050117, -82.47486659817726 35.647735230459915, -82.47483959819817 35.64757123042377, -82.474825598201 35.647537230415374, -82.47479959820716 35.647470230399115, -82.4747185982096 35.64736723036986, -82.47446959819871 35.647170230304084, -82.47441559819326 35.647148230294036, -82.47410559814891 35.64710223025279, -82.474064598147 35.64707123024229, -82.47403759814273 35.64706923023904, -82.47367459813513 35.64672923013257, -82.4735395981373 35.64657023008632, -82.4731825981885 35.645856229904396, -82.47269059821886 35.645131229706294, -82.47253559824411 35.64480222962339, -82.47246759826058 35.64462222957975, -82.47217859833114 35.64385522939408, -82.47208359836117 35.64355922932407, -82.47209059837074 35.64350522931376, -82.47206359836962 35.64348322930655, -82.47205459838078 35.64340122928893, -82.47205059838633 35.64336122928043, -82.4720415983894 35.64333122927335, -82.47197959841073 35.6431272292255, -82.47195959841775 35.6430602292098, -82.47190059843813 35.64286522916405, -82.47188159844468 35.64280222914927, -82.47179759851379 35.64226422903124, -82.4717665985396 35.64206422898732, -82.47179459855244 35.642011228979456, -82.47180759855826 35.64198722897589, -82.47192959859274 35.6418952289698, -82.47197759860617 35.641860228967595, -82.47237059871685 35.64156522894804, -82.47238659872129 35.641554228947555, -82.47282359885344 35.64116722891375, -82.4728775988655 35.64114722891522, -82.47326759897865 35.64083322889157, -82.47347659904409 35.640634228872614, -82.47349859904992 35.64062022887198, -82.47391559915938 35.64035922886182, -82.47397359917466 35.64032222886035, -82.47405459920189 35.64023322885052, -82.47409959921208 35.64021522885155, -82.4741085992141 35.64021222885179, -82.47412259922164 35.64017822884637, -82.47417659923383 35.64015722884765, -82.4741895992412 35.640123228842036, -82.47431059927305 35.640047228839094, -82.47431759927773 35.64002422883508, -82.47437059929071 35.639997228835036, -82.47446559932685 35.639865228818046, -82.47445159934817 35.63971222878547, -82.4744415993515 35.63968022877798, -82.47442459935735 35.63962422876478, -82.47439759935618 35.63960222875754, -82.47438459937631 35.639458228726916, -82.47436359940001 35.639282228689, -82.47433659939894 35.63926022868166, -82.47429659943792 35.6389652286176, -82.47426959943684 35.63894322861032, -82.47426959945041 35.63885522859243, -82.47421559946011 35.63873422856224, -82.47418159949687 35.638460228502986, -82.47416259950032 35.63841722849232, -82.47414159950407 35.63837022848058, -82.47411659951638 35.638264228456435, -82.47401259956739 35.6378222283559, -82.47386559957376 35.63762322830027, -82.4735695995304 35.63758622826233, -82.47340759951236 35.637529228233994, -82.47327259950156 35.637454228204895, -82.47321859950637 35.63736522818118, -82.47316459953106 35.637147228131326, -82.47307659954903 35.636936228079314, -82.47296959955482 35.63678422803738, -82.47275359955648 35.63654122796574, -82.47268659957238 35.63636622792323, -82.4726525995924 35.63620022788605, -82.47273959972553 35.635432227738725, -82.47272659974031 35.63532222771502, -82.47273959975895 35.63521522769465, -82.4727535997772 35.63511222767512, -82.47280659981188 35.63494522764666, -82.47289459986902 35.634669227599524, -82.47290059995503 35.6341192274883, -82.4728875999633 35.634051227473186, -82.47284659996296 35.634009227460346, -82.47287359997458 35.633963227453826, -82.47283359998968 35.633822227421014, -82.47284660004627 35.633470227350784, -82.47284860004757 35.633464227349776, -82.47300160012307 35.6331392272994, -82.47296060013637 35.63300922726874, -82.47283960013702 35.63287522722906, -82.47261060011738 35.63275622718128, -82.47257060011756 35.632712227168255, -82.47250960014856 35.632446227107856, -82.47246960015366 35.63237022708827, -82.4723076001521 35.63220622703823, -82.47222360014419 35.63216722702166, -82.47221360014333 35.632162227019606, -82.47203860014154 35.63198622696585, -82.4720046001564 35.63185322693527, -82.4719776001536 35.63184222693027, -82.47195560017 35.63171222690151, -82.47198060017921 35.631680226897615, -82.47199960018584 35.63165722689493, -82.47205260020603 35.63158322688533, -82.47207660021488 35.631551226881264, -82.47228560029595 35.631251226841705, -82.47242960035337 35.63103422681245, -82.47246160036586 35.63098722680617, -82.4725156003905 35.63088622679124, -82.47258360042593 35.63072922676625, -82.47264060046709 35.63052422673047, -82.47275260056904 35.62998422663218, -82.4728186006362 35.629620226564924, -82.47283160065795 35.62949322654044, -82.47283660067805 35.62936822651549, -82.47283460069676 35.629245226490276, -82.47283260070016 35.6292212264852, -82.47282360072312 35.629062226451914, -82.47278860076163 35.62877522639004, -82.47275760077305 35.628668226365015, -82.47272960077746 35.628609226350136, -82.47270860078117 35.62856322633867, -82.47264660078477 35.62847322631397, -82.47255760078441 35.62838022628588, -82.47246860078246 35.628297226259846, -82.47217260077194 35.628047226178516, -82.4720826007702 35.62796222615197, -82.47205460077018 35.62793222614301, -82.4719906007705 35.62786122612201, -82.47189960077209 35.62775322609066, -82.47165760078038 35.62744022600208, -82.47133460078904 35.62703722588689, -82.47085960079261 35.6265042257296, -82.47020760076035 35.62601322556264, -82.47009760076907 35.62583822551574, -82.47007360077109 35.62579922550534, -82.47005360081025 35.62552422544743, -82.4701416008807 35.62516222538285, -82.47020960093185 35.62490422533737, -82.47032460102413 35.62443022525284, -82.4703436010351 35.62437922524434, -82.47038860106046 35.62426322522543, -82.47045460108896 35.62414922520901, -82.47050360110758 35.62408122520024, -82.47055560112598 35.6240182251928, -82.47064960115726 35.62391622518171, -82.47084960122365 35.62370122515859, -82.47099860128071 35.623491225131225, -82.47109760132174 35.6233322251091, -82.47117160135376 35.62320422509067, -82.47148960149416 35.62263622500787, -82.47153560151628 35.62254222499351, -82.47155860153026 35.6224762249824, -82.47156660154086 35.62241622497105, -82.4715646015493 35.62235922495922, -82.47154860155437 35.62230922494747, -82.47152060155955 35.6222452249315, -82.47141360156625 35.62208722488839, -82.4713536015727 35.62198122486065, -82.47132060158067 35.621894224839586, -82.47130360158945 35.621819224822545, -82.47130460160335 35.62173022480459, -82.47131960161879 35.62164622478899, -82.47135660164278 35.62153022476926, -82.47136660164938 35.62149822476382, -82.47149360172475 35.62114622470527, -82.47153260174295 35.6210702246938, -82.47157960176052 35.62100722468589, -82.4715826017615 35.62100422468552, -82.47163960177858 35.62095422468126, -82.47170660179741 35.62090422467805, -82.47179060181831 35.62085922467751, -82.47187860183827 35.62082422467944, -82.47201160186671 35.62078322468482, -82.4721676018975 35.620751224694295, -82.47236060193424 35.62072022470786, -82.47261760198184 35.62068822472776, -82.47294360204256 35.620644224752375, -82.47302760206021 35.62062022475612, -82.47311860208079 35.62058522475841, -82.47312960208369 35.620578224758084, -82.47319860210072 35.62054122475766, -82.47329560212846 35.6204662247524, -82.47338660215573 35.62038722474571, -82.47355560220957 35.62021922472897, -82.47375260227055 35.62003622471193, -82.47386960230472 35.6199402247045, -82.47397960233447 35.6198662247008, -82.47430360241464 35.61969422469915, -82.47438760243696 35.61964022469685, -82.47444960245313 35.61960222469545, -82.47454660247932 35.61953622469201, -82.47468160251933 35.61942222468267, -82.4747776025508 35.619321224672035, -82.47478960255538 35.61930422466984, -82.47483260257214 35.619242224661654, -82.47485860258449 35.61919022465377, -82.47489460260083 35.61912322464386, -82.4749316026208 35.61903322462934, -82.47501060266676 35.618820224594145, -82.47505760269372 35.6186962245738, -82.47509860271734 35.618587224555824, -82.47514860274225 35.61847922453893, -82.47515060274308 35.61847622453862, -82.47520760276781 35.6183772245243, -82.47532960281607 35.61819522449984, -82.475543602898 35.61789422446064, -82.4756816029504 35.617703224436, -82.47575460297895 35.617596224421796, -82.47597760306498 35.61727822438004, -82.4760526030936 35.61717322436638, -82.47610360311504 35.617089224354594, -82.47623260316858 35.61688122432556, -82.4762556031793 35.61683622431878, -82.47627060318565 35.616811224315214, -82.47629860320009 35.61674822430523, -82.4763656032333 35.61660422428291, -82.47642860327599 35.616395224246894, -82.47644760328828 35.616336224236804, -82.47653660333663 35.61611822420163, -82.47659060336385 35.61600022418319, -82.4767606034443 35.615661224131784, -82.47684160348201 35.61550422410815, -82.47690960351349 35.61537322408852, -82.47691560351613 35.61536222408693, -82.4770656035923 35.615030224034776, -82.47709660360839 35.61495922402354, -82.47715060363548 35.61484122400509, -82.47717460364709 35.61479222399763, -82.47719860365703 35.614753223992196, -82.47724060367385 35.614689223983426, -82.47719860367464 35.61463922396901, -82.47713260367938 35.61453722394147, -82.4771076036854 35.61447122392547, -82.47690260374286 35.61387922378395, -82.47684860375935 35.61371422374489, -82.47673960379342 35.61337622366488, -82.47669660380663 35.61324422363364, -82.47650660385382 35.612734223510394, -82.4764326038772 35.612503223455725, -82.4763466039171 35.612152223375574, -82.47627060396765 35.61174322328455, -82.4762276039853 35.61158222324739, -82.47617760399291 35.61147922322134, -82.47602460400553 35.611233223155544, -82.47574360403003 35.61077222303283, -82.47573560403089 35.61075822302919, -82.47568260403871 35.61065022300176, -82.47565160404623 35.61056822298189, -82.47561760407366 35.610354222934944, -82.47561060409022 35.61023922291082, -82.4755876041203 35.61001922286372, -82.47554860415644 35.60974322280361, -82.47554060416206 35.609698222793575, -82.47551960416999 35.60962422277638, -82.4754966041756 35.60956322276161, -82.47545360418687 35.609444222732996, -82.47530160421283 35.60911222264989, -82.47527860421887 35.60904822263445, -82.47527060422131 35.609024222628776, -82.47525360422956 35.60895222261235, -82.47526060424413 35.608865222595405, -82.47526560424856 35.60884222259124, -82.47529560426202 35.608787222583175, -82.47538660429001 35.608703222575414, -82.47543660430408 35.60866622257303, -82.47546560431203 35.60864522257168, -82.47554260433208 35.60859822257011, -82.47559960434987 35.60854422256502, -82.4756476043668 35.608486222558106, -82.4756786043814 35.60842422254875, -82.47569360439502 35.60835222253563, -82.47569260440692 35.608274222519626, -82.4756746044402 35.608039222469955, -82.4756796044533 35.607959222454305, -82.47567960445363 35.60795722245391, -82.47570660449288 35.607732222410874, -82.47570860450004 35.607687222401914, -82.47571060450495 35.607658222396246, -82.47571660452566 35.60753022237078, -82.47571560453001 35.607501222364846, -82.475711604552 35.607354222334486, -82.47569860456755 35.60723922230978, -82.47568060458498 35.60710722228106, -82.47565160459972 35.60698022225232, -82.47563960460235 35.60695022224491, -82.47559960461207 35.60684422221926, -82.47556260461546 35.606782222202895, -82.47547660462405 35.606634222163926, -82.47532560463384 35.606408222102395, -82.47517760464376 35.60618522204186, -82.47503760465106 35.60598722198719, -82.47498160465213 35.60592022196779, -82.4748146046528 35.6057362219132, -82.4747576046578 35.60564322188843, -82.47472760466326 35.60557522187157, -82.47470560467177 35.60549622185317, -82.47468760468469 35.6053932218304, -82.47468260470114 35.60528122180712, -82.4746806047135 35.60519922179025, -82.47468360473535 35.6050602217623, -82.47469460477134 35.60483922171849, -82.4747026047921 35.60471322169364, -82.47470360479237 35.60471222169353, -82.47470860483344 35.60445122164099, -82.47470460485057 35.604336221617174, -82.47470560487048 35.60420822159128, -82.47470560488676 35.6041022215697, -82.47470960492254 35.60387422152379, -82.47477060497266 35.603615221477405, -82.47485360503141 35.60332322142658, -82.47489860506634 35.60314522139497, -82.4749576051215 35.60285122134123, -82.47497460513642 35.6027722213269, -82.47504960519794 35.60245422126997, -82.47523260533468 35.601764221148464, -82.47531360539693 35.60144722109239, -82.47539160545635 35.60114622103914, -82.47541860547973 35.6010232210169, -82.47543060548851 35.60097922100924, -82.47544160549648 35.60093922100217, -82.47544560549932 35.60092522099974, -82.47545960551399 35.60084522098495, -82.4754596055185 35.6008162209791, -82.47546060552494 35.6007752209708, -82.47560960555981 35.60070922097268, -82.47605760566461 35.60051122097849, -82.47610760567609 35.60049022097938, -82.47620960569915 35.600450220981806, -82.4763486057305 35.60039622098507, -82.47640060574219 35.60037622098633, -82.47653560577236 35.60032622099006, -82.47662760579252 35.60029422099298, -82.47675460582117 35.60024522099608, -82.47687560585008 35.60018722099678, -82.47691960586185 35.60015822099544, -82.47695960587393 35.60012322099236, -82.47704660590446 35.60001822098001, -82.47706860591508 35.599973220973126, -82.47709060592675 35.59992122096474, -82.47710060593151 35.59990122096171, -82.47720360600313 35.599547220900334, -82.47745860620007 35.598544220722594, -82.47756660626679 35.59822722066922, -82.47763160630252 35.59806522064296, -82.47777860637193 35.59777322059877, -82.47787560641144 35.597621220577786, -82.4779716064477 35.59748922056085, -82.47829560656355 35.59708622051214, -82.47833960657935 35.5970312205055, -82.47860060667144 35.59671422046789, -82.47878960673418 35.59651022044587, -82.47894060677702 35.596394220437794, -82.47909260681882 35.59628722043163, -82.47918160684327 35.59622422042801, -82.47918360684392 35.59622222042779, -82.47946560691949 35.59603522041878, -82.47950160692903 35.596012220417876, -82.47956160694451 35.595976220416674, -82.47964760696661 35.595925220415154, -82.47971260698247 35.595892220415074, -82.47979060700152 35.59585222041492, -82.47986260701764 35.59582522041687, -82.47991860702999 35.5958052204186, -82.48007660706142 35.595771220427906, -82.48026160709453 35.59575522044366, -82.48046660712774 35.5957602204658, -82.48068760716222 35.59577422049137, -82.48086460718893 35.59579122051304, -82.48095660720266 35.59580122052456, -82.48120160724002 35.59582222055396, -82.48121360724181 35.59582322055542, -82.48150060729 35.59581922058412, -82.48160460730946 35.595805220591984, -82.48166960732148 35.59579722059702, -82.48189560736476 35.59575922061255, -82.48211260740848 35.59570922062469, -82.48230060744802 35.59565422063281, -82.48246260748489 35.59558922063628, -82.4826696075346 35.59548922063718, -82.48275360755595 35.595441220636054, -82.48289760759204 35.59536222063487, -82.4829796076115 35.59532422063551, -82.48311560764375 35.59526122063673, -82.48320060766392 35.5952212206373, -82.48323460767176 35.59520722063796, -82.48359760775388 35.59506522064636, -82.48359860775413 35.595064220646265, -82.48372560777993 35.59503322065308, -82.4838096078198 35.59486522062748, -82.4838126078215 35.59485722062623, -82.48393160788079 35.59460022058617, -82.48403760794254 35.594314220538884, -82.48410660798217 35.594131220508785, -82.48415960798879 35.594145220517035, -82.4844546080263 35.594219220562415, -82.48487860807838 35.59433722063, -82.48490260808127 35.59434422063387, -82.48554560815701 35.59454422074073, -82.48594160820166 35.59468022080915, -82.4863976082518 35.5948452208896, -82.4866456082782 35.594941220934594, -82.48705160831949 35.59510922101049, -82.48722560833556 35.595192221045295, -82.48737460834941 35.595263221075, -82.48763260837121 35.59539922112919, -82.48789060838992 35.59555522118745, -82.48794560839309 35.595593221200815, -82.4881296084039 35.59572122124576, -82.4881986084075 35.59577222126325, -82.48830860841326 35.59585322129107, -82.48850460842016 35.59601922134496, -82.4887766084273 35.59626522142297, -82.48889160842687 35.596392221460654, -82.48900060842621 35.59651322149643, -82.48909260842345 35.596630221529665, -82.48918160842075 35.59674322156181, -82.4893036084151 35.596911221608494, -82.4894756084009 35.59718822168256, -82.48957860838777 35.597384221732966, -82.48968060837299 35.597590221785346, -82.48981060833994 35.59794422187076, -82.4898636083175 35.59814722191744, -82.48986360831734 35.598148221917725, -82.48988760829353 35.598328221956805, -82.48989660826805 35.598503221993276, -82.48988660824202 35.59866122202439, -82.48979360816567 35.599056222095136, -82.48971560812058 35.5992652221297, -82.48963760808299 35.59942522215419, -82.48954660803216 35.599657222192015, -82.48938260794728 35.600031222251246, -82.48930760790323 35.60023622228517, -82.48924860785282 35.600500222332805, -82.48924360783411 35.60061622235593, -82.48924660781562 35.60073922238121, -82.48926860780247 35.60084822240566, -82.4893216077872 35.60100422244283, -82.48938660777281 35.60116722248269, -82.48960260775533 35.601513222575235, -82.48980960773369 35.60187622267038, -82.48987960771771 35.60205522271394, -82.48991560770035 35.60220622274836, -82.48992960767212 35.60240422279014, -82.48990560764885 35.602529222813125, -82.48989160762048 35.60269822284603, -82.4898276075788 35.602900222880486, -82.48977760755504 35.60300022289568, -82.4897016075182 35.603157222919826, -82.48957160745941 35.60339922295571, -82.48928860730777 35.60407822306463, -82.48921660726488 35.604279223098125, -82.48920660723662 35.60445122313209, -82.48921160721483 35.604598223162505, -82.48922460719743 35.604725223189725, -82.48925660718247 35.60485622321961, -82.48937360716475 35.605097223280644, -82.48939760716132 35.605145223292915, -82.48949960715824 35.605275223329826, -82.48965860716064 35.60543022337769, -82.48984460717149 35.60556022342328, -82.49007860719254 35.6056752234707, -82.49031860721756 35.60577122351494, -82.49071060726587 35.605879223577176, -82.49122260732864 35.606022223658925)))",6519,37,021,003001,370210030013,2157,2157,38,2117,2036,40,2,29,0,10,40,1707,27,1680,1694,1639,29,1,18,0,7,13,996,909,87
census_2010_blockgroups_view.fid--2dc29038_13ec899ba8f_-2652,"MULTIPOLYGON (((-82.53433364318025 35.418925190028546, -82.53507964305375 35.420563190437925, -82.5353316430106 35.421119190576796, -82.53598264290089 35.42254319093303, -82.53615064294027 35.42246719093482, -82.53648664301456 35.422345190944306, -82.53702064313322 35.42214719095869, -82.53788064332387 35.42183119098244, -82.53840164343887 35.421643190997514, -82.5386576434323 35.421964191088975, -82.53891464343235 35.42224219117179, -82.53905064343111 35.42239819121751, -82.53973264342447 35.423181191446496, -82.54003064346834 35.42321719148432, -82.5436126440188 35.42349719190774, -82.54386964405796 35.423519191938546, -82.54401664408022 35.42353319195637, -82.54432364412736 35.42355719199273, -82.54547764421274 35.42425019225171, -82.54677364429644 35.425107192558606, -82.54691364430575 35.42519819259145, -82.54675264425437 35.42536019260795, -82.54578164394904 35.42630619270104, -82.54426564348108 35.42772619283472, -82.54380964334017 35.42815419287512, -82.54453364336239 35.42879419307944, -82.54444864333112 35.42890619309346, -82.54433064329159 35.42903719310809, -82.54392364314903 35.42952919316651, -82.54252964266531 35.431184193360494, -82.54262264263559 35.431479193429965, -82.54270864261694 35.43169519348277, -82.54435164225926 35.435817194489324, -82.54523164213097 35.43761119494426, -82.54655164192353 35.440399195646485, -82.54895164230891 35.4404791959084, -82.54878564184706 35.443321196469554, -82.54877364181513 35.443517196508225, -82.5487386417193 35.44410619662445, -82.54872764168742 35.444303196663405, -82.54938764179825 35.44429319672893, -82.55682964304918 35.444177197467, -82.55795064323439 35.44418019758238, -82.55803464324833 35.44418019759099, -82.55813164326645 35.44416719759827, -82.55916864312007 35.44624919812794, -82.55943264305266 35.446976198302885, -82.55967164296712 35.44779519849397, -82.55972064294998 35.447960198532556, -82.55979264282676 35.44884419871979, -82.55964064269573 35.44953719884532, -82.55956364262923 35.449888198908816, -82.55926764254274 35.45013319892833, -82.55896764245523 35.45038019894786, -82.55845764231915 35.45071819896446, -82.55753164210691 35.45110219894777, -82.55675264194574 35.45131219891071, -82.55626464185657 35.45136619887183, -82.55576764176567 35.45142219883234, -82.55472764157874 35.45151719874511, -82.55305864124713 35.451877198647544, -82.55162064094299 35.45230819858798, -82.5506266407088 35.45276219857859, -82.550440640665 35.45284719857686, -82.55001364056427 35.45304319857301, -82.54942064041938 35.45334819857435, -82.54871264022454 35.453855198605005, -82.54795263999333 35.45454319866715, -82.54726663978578 35.455157198721835, -82.54675763962358 35.45566619877325, -82.54564263926568 35.4567981988894, -82.54475763895124 35.457895199021955, -82.54459663887087 35.45824619907687, -82.54451463879539 35.4586511991508, -82.54452763873756 35.45904319923187, -82.54463363871109 35.459331199301374, -82.54487863873645 35.459430199346606, -82.54551863879385 35.459748199476756, -82.5456436387996 35.45984619950955, -82.54618263882405 35.46027019965095, -82.5467706388349 35.46083619982633, -82.54694763883855 35.46100419987862, -82.54876963882751 35.46305020048145, -82.54913763882531 35.46346320060313, -82.54978263877993 35.464458200871675, -82.54998763876561 35.4647742009569, -82.55003463875299 35.46490720098882, -82.5501906387122 35.465343201093454, -82.55034563867115 35.465779201198046, -82.55057663860998 35.466429201353925, -82.55076563857489 35.466863201461635, -82.55105063855589 35.467296201578904, -82.55125663853828 35.4676342016687, -82.55165363854269 35.468035201791, -82.55206663854247 35.46848420192465, -82.552322638526 35.46886920202917, -82.55252563851262 35.469176202112415, -82.5527946384861 35.46964120223463, -82.55307763843001 35.47031420240047, -82.55323563837254 35.470860202527774, -82.55348763830858 35.47155120269412, -82.55369163823435 35.47225720285867, -82.55375363819537 35.47257920293054, -82.5538786381549 35.47297920302476, -82.5540846381471 35.473253203101564, -82.55427463813201 35.473557203182835, -82.55440163812094 35.47376720323867, -82.55453663811562 35.47394820328932, -82.55459263811345 35.47402320331028, -82.55471863809238 35.4742972033789, -82.55500363808068 35.474682203486445, -82.5553536380869 35.475020203591114, -82.55563863807531 35.47540520369861, -82.55574363805773 35.4756332037557, -82.5558916380338 35.475950203835424, -82.55604963801817 35.47622320390711, -82.55611063795956 35.47667220400477, -82.55620563791373 35.477074204096255, -82.55621863784708 35.47752420418919, -82.556296637811 35.47784420426223, -82.55624563771897 35.47839020436817, -82.55632263765798 35.478872204474094, -82.55638363760912 35.47925720455865, -82.55655763755927 35.479771204681064, -82.55676263754393 35.48009320476761, -82.55687363750373 35.480476204856885, -82.55699963748022 35.480766204928756, -82.55706263746617 35.48092620496785, -82.5572046374552 35.48115120502812, -82.55725063745489 35.481203205043414, -82.55736363745447 35.481328205080416, -82.55763163746242 35.481566205156305, -82.55737463741036 35.48162820514259, -82.55680563729769 35.48174820510872, -82.55649363723656 35.48180920508917, -82.55636863721223 35.48183320508127, -82.55626863719287 35.481851205074705, -82.55625663719034 35.48185420507404, -82.55559563706188 35.481978205031574, -82.55537163701803 35.482021205017425, -82.55506463696248 35.48205220499221, -82.55498563694907 35.482054204984564, -82.5549176369375 35.48205620497798, -82.55455563687723 35.48205820494132, -82.55445363686104 35.48205320492982, -82.55412263680911 35.48203420489207, -82.5539076367771 35.48201020486517, -82.55382763676562 35.48199820485453, -82.55372163675028 35.48198420484077, -82.55362263673643 35.48196720482723, -82.55355163672654 35.48195520481749, -82.5534466367126 35.48193220480205, -82.55339963670649 35.48192120479497, -82.55337463670313 35.48191620479149, -82.55326063668866 35.48188720477388, -82.55321463668271 35.48187620476693, -82.5529676366525 35.48180620472739, -82.55272163662409 35.48172520468571, -82.55270363662225 35.481718204682444, -82.552078636554 35.48148720457139, -82.55147563648913 35.48125820446305, -82.55120263645945 35.48115620441426, -82.55108663644698 35.48111220439346, -82.55095663643277 35.4810642043704, -82.55070263640503 35.48097020432522, -82.55016563634678 35.48076920422939, -82.54990863631889 35.48067320418346, -82.54973363630046 35.48060420415149, -82.54905463622622 35.48035420403107, -82.54855563617166 35.48017020394255, -82.54847163616245 35.48013920392766, -82.54801663611167 35.47997820384821, -82.54804163612737 35.47990320383557, -82.54842563633412 35.47896820368468, -82.54845863635512 35.47886720366745, -82.54847263636967 35.47878720365263, -82.54847363638419 35.478693203633625, -82.54846163639175 35.47863120361976, -82.5484576363963 35.478597203612516, -82.54841863640678 35.47848620358586, -82.54834263641182 35.478371203554644, -82.54825163640999 35.47828420352766, -82.54815163640522 35.478207203501775, -82.54802263639317 35.478146203476086, -82.54786963637471 35.478101203451295, -82.54702263625896 35.477940203331826, -82.54690863624243 35.477925203317106, -82.54682863623357 35.47789620330292, -82.54674063622807 35.47783720328191, -82.54627863616719 35.47773420321366, -82.54629763621416 35.47744820315737, -82.54591963622406 35.476974203022266, -82.54558463623843 35.47651820289519, -82.5451286362068 35.47623120279005, -82.5445536361188 35.47618320272137, -82.54353963597018 35.47605620259169, -82.54272963584377 35.47600520249828, -82.5421226357579 35.47590920241662, -82.54208763575272 35.47590520241223, -82.54071063554866 35.47574720223901, -82.53915263525926 35.47595120212088, -82.5392206356719 35.47332920159452, -82.53894663564049 35.47323820154796, -82.53812763554656 35.47296520140843, -82.5378546355151 35.47287520136221, -82.53782763551892 35.47282120134841, -82.53781663552044 35.472799201342845, -82.53774663552994 35.472661201307616, -82.53772063553377 35.47260820129417, -82.53752063556878 35.47216320118313, -82.53732063560376 35.471718201072164, -82.53728563560976 35.47164120105292, -82.53709163569944 35.470845200871025, -82.53701263571992 35.47062620081844, -82.53683663576582 35.47013520070054, -82.53642063580084 35.46945620051981, -82.53626163587124 35.46882420037499, -82.5360576358691 35.46861720031196, -82.53606163590185 35.46840820026985, -82.53606463592543 35.46825720023944, -82.53566163593405 35.46776420009792, -82.53529263596677 35.46715119993537, -82.53462363599431 35.466247199682996, -82.5340876360736 35.46514919940476, -82.53408163607472 35.46513519940123, -82.53380263613418 35.464444199232126, -82.53342263620411 35.46357619901669, -82.53337463623542 35.46331919895947, -82.53334663625435 35.46316519892528, -82.53336563627407 35.463057198905304, -82.53331863630106 35.46283019885431, -82.53326663632211 35.46263619880948, -82.5332446363337 35.462536198786935, -82.53324163633665 35.4625141987822, -82.53323463634759 35.462435198765355, -82.53321263636148 35.46232019873966, -82.53317763637118 35.462219198715566, -82.53303063638897 35.461943198644406, -82.53297563639278 35.461859198621674, -82.53295263639417 35.461825198612416, -82.53287063639593 35.46172519858366, -82.53276263639103 35.46164019855533, -82.53265463638716 35.46154819852555, -82.53254163638485 35.461441198492146, -82.5323476363871 35.46121619842653, -82.5322316363864 35.461095198390055, -82.53216663639203 35.460988198361676, -82.53211663639459 35.46091719834205, -82.53205963639778 35.46083419831932, -82.53200963639878 35.46077419830203, -82.53187663641744 35.4605081982343, -82.53183763643005 35.46038319820485, -82.53180563643224 35.460334198191646, -82.53184763644465 35.46029919818882, -82.53197563648159 35.46019619818097, -82.5320186364939 35.460162198178494, -82.53199063649907 35.46009819816256, -82.53198663649978 35.46008919816033, -82.53189163651065 35.459915198115304, -82.53185863651437 35.45985519809964, -82.53182263651854 35.459789198082504, -82.5318086365198 35.45976519807624, -82.53169363653096 35.45956819802438, -82.5316486365338 35.459501198006116, -82.53159263653754 35.45941619798313, -82.53155863653987 35.45936419796907, -82.53154763654011 35.45935019796513, -82.531444636543 35.45922019792813, -82.53139563654264 35.459169197912715, -82.53134163654225 35.45911319789577, -82.53131063654217 35.459080197885925, -82.53124563654043 35.4590211978673, -82.53117063653858 35.4589521978455, -82.53093963652834 35.458769197784626, -82.53083663652359 35.4586881977576, -82.53035463649724 35.45833919763731, -82.53022063648952 35.458244197604174, -82.529566636452 35.45778119744303, -82.52932163644145 35.45758519737817, -82.52918663643784 35.457462197339254, -82.52897163643655 35.45723819727169, -82.5285286364395 35.45673919712479, -82.52834863644071 35.456536197065084, -82.52802863644374 35.45617019695786, -82.52787863644458 35.45600219690837, -82.5276066364465 35.45569519681805, -82.52743463644865 35.45549519675976, -82.5272886364505 35.45532519671021, -82.52717063645198 35.45518719667008, -82.52716263645218 35.455177196667265, -82.52693663645762 35.454897196587154, -82.52684063646316 35.454757196548876, -82.52681463646464 35.45471919653848, -82.52674663647099 35.45460419650812, -82.52672163647335 35.45456119649678, -82.52661063649158 35.45432219643677, -82.52647563652695 35.453945196346346, -82.52646163653087 35.4539041963365, -82.52607563665185 35.45269519605111, -82.52593963671258 35.45215119592655, -82.52588463674289 35.45189319586851, -82.52583863676844 35.451676195819665, -82.52580863678817 35.45151519578381, -82.52573863682532 35.45119619571171, -82.52571663683759 35.451092195688325, -82.52568663685483 35.45094719565583, -82.52567663687215 35.4508231956295, -82.52567563687856 35.45078019562071, -82.52567563689465 35.450675195599324, -82.52567463694946 35.45031519552608, -82.52569263699834 35.45001519546686, -82.5257146370284 35.449842195433924, -82.52572563704217 35.44976419541919, -82.52577163708986 35.449502195370655, -82.52584363713729 35.44927019533082, -82.52591263717943 35.44906919529703, -82.52610763728103 35.44861619522488, -82.52616563731331 35.448468195200654, -82.52621263734596 35.448305195172374, -82.52627363740226 35.448003195117224, -82.52635163750223 35.44743419500944, -82.52645663763614 35.44667219486523, -82.52646363764723 35.44660719485272, -82.52647063765819 35.446543194840494, -82.52648863768329 35.44639819481282, -82.52649363769135 35.44635119480372, -82.5265006377023 35.446287194791445, -82.52652163773544 35.4460931947541, -82.52652563774068 35.446063194748476, -82.52655263778858 35.44577919469345, -82.52656963783235 35.44551119464069, -82.52658363786436 35.44531719460264, -82.52658963788127 35.44521319458214, -82.52659063788631 35.44518119457572, -82.52662163797388 35.444642194469246, -82.52878663835148 35.44451719466554, -82.53021563860348 35.444417194791555, -82.53028163861555 35.44440919479662, -82.53047963865224 35.44438419481178, -82.53054663866439 35.44437719481722, -82.53102663874581 35.444364194863795, -82.53250263899386 35.444341195010196, -82.53272563903064 35.44434219503323, -82.53403963925179 35.4443191951631, -82.53470463936377 35.444307195228674, -82.53484463938723 35.444305195242606, -82.53490363939719 35.44430419524848, -82.53489763943085 35.444077195201686, -82.53489563944446 35.443986195183, -82.53497363953977 35.44344719508136, -82.53505363967916 35.44262219492175, -82.53504363968072 35.44260119491649, -82.53503363973756 35.44221819483749, -82.53502963976592 35.442028194798475, -82.53466963970973 35.442006194757106, -82.53471063973953 35.441855194730614, -82.53487063982718 35.44145519466564, -82.53488063983191 35.44143519466266, -82.53491163984577 35.441378194654206, -82.53492263985054 35.44135919465143, -82.53493963985832 35.44132619464652, -82.53496663987006 35.44127919463962, -82.53498463988095 35.44122719463095, -82.53499763988829 35.44119319462531, -82.53509163994481 35.44092519458045, -82.53532864008638 35.44025619446861, -82.53537664011489 35.44012119444611, -82.53538164011756 35.44010919444418, -82.53541464013738 35.44001519442849, -82.53544864016871 35.43984719439779, -82.53554964025673 35.439381194313334, -82.5356006402844 35.43925519429294, -82.53561364029147 35.43922319428774, -82.53573064034234 35.43901719425782, -82.53585164038404 35.43887519424132, -82.53610364046986 35.43858719420852, -82.53657364063261 35.43803119414356, -82.53661564065457 35.437933194127936, -82.53670964070315 35.4377171940936, -82.53675064072418 35.43762419407892, -82.5367566407253 35.43762319407929, -82.53688564079803 35.437287194024215, -82.53661864075335 35.43729019399744, -82.5364186407184 35.4373021939794, -82.53637064077014 35.43691119389497, -82.53634164079457 35.43672019385315, -82.53550164065173 35.43674419377208, -82.53550064066764 35.436639193750565, -82.53549964071178 35.43634919369157, -82.53549564072566 35.43625419367178, -82.53345664039992 35.43617619344723, -82.53308764034091 35.436162193406666, -82.53268564027614 35.43615019336304, -82.53241664023298 35.43614119333368, -82.53219564019744 35.436134193309584, -82.53143664007543 35.43611019322699, -82.5314366400747 35.436115193228034, -82.53124464004257 35.43611719320882, -82.52915563969829 35.43610619299273, -82.52909563968866 35.436104192986214, -82.52904163967972 35.43610419298069, -82.52904163968874 35.4360451929686, -82.52905463972627 35.43581419292297, -82.52910163984987 35.43505619277365, -82.52916964003116 35.433943192554246, -82.52918764005545 35.433804192527866, -82.52923064018404 35.433009192370555, -82.52923964020474 35.43288319234592, -82.52927064028218 35.432410192252874, -82.5292766402963 35.43232419223592, -82.52942664066666 35.43006319179154, -82.52944664072537 35.429700191719746, -82.52946764078389 35.429340191648656, -82.52948164082179 35.42910719160268, -82.52948264082558 35.42908319159796, -82.52949464085941 35.42887519155685, -82.52949864087168 35.42879919154183, -82.52950964090189 35.42861319150512, -82.52952964096099 35.428248191432935, -82.52954364100285 35.42798919138168, -82.52956064106131 35.42762519130938, -82.52956764108185 35.42749819128427, -82.52959064115852 35.42702119118965, -82.52961464123696 35.42653319109289, -82.52963264129546 35.42617019102086, -82.52966464140003 35.42552019089198, -82.5297606417132 35.42357419050606, -82.52979364181772 35.42292519037745, -82.52983864182457 35.42292919038287, -82.52997364184478 35.422943190399515, -82.53001864185144 35.42294819040511, -82.53054264193553 35.422966190462425, -82.53157864210203 35.42299919057517, -82.5340146424922 35.423085190841924, -82.53472464264703 35.42284119086493, -82.53542764279979 35.42260319088843, -82.5350406428691 35.42173019067127, -82.53455264295745 35.42062219039604, -82.5338696430804 35.419076190011744, -82.53353964314014 35.418327189825646, -82.53338264316834 35.417972189737384, -82.5329136432528 35.416910189473434, -82.53281164327124 35.416679189416, -82.53294164329745 35.41664818942302, -82.53304464331833 35.41662318942842, -82.53326364336253 35.416571189440305, -82.53330264335577 35.41665818946194, -82.53334764334826 35.41675618948652, -82.5334746433265 35.41703618955651, -82.53385664326149 35.417876189766375, -82.53398464323996 35.41815618983642, -82.53433364318025 35.418925190028546)))",6231,37,021,002203,370210022032,1721,1721,289,1688,1354,204,0,15,2,113,33,1281,154,1127,1262,1050,144,0,10,1,57,19,769,697,72
census_2010_blockgroups_view.fid--2dc29038_13ec899ba8f_-2651,"MULTIPOLYGON (((-82.67984364592714 35.55877823340149, -82.67984064592818 35.55876823339919, -82.67983264593143 35.55873823339228, -82.67983064593251 35.5587292333902, -82.67980264594497 35.55861723336446, -82.67976764596108 35.55847423333175, -82.67973364598154 35.558304233293605, -82.6797316459849 35.55828023328854, -82.67972564600142 35.558166233264714, -82.67972464600369 35.558150233261316, -82.67972964602247 35.558033233238014, -82.67973064602343 35.558028233237046, -82.6797496460387 35.55794923322292, -82.67978064605916 35.55784923320566, -82.67982664608137 35.55775423319104, -82.67987564610326 35.557665233177964, -82.67988564610735 35.55764923317567, -82.6799496461326 35.5575542331629, -82.68001764615694 35.557469233152574, -82.68009564618339 35.55738123314266, -82.68017164620716 35.55730923313566, -82.68021964622064 35.55727323313327, -82.68035964625925 35.55717323312727, -82.68058464631788 35.55703523312214, -82.68108964644415 35.556760233117856, -82.68123164648028 35.556678233115726, -82.68132264650345 35.556626233114436, -82.68145064653902 35.55653323310853, -82.68150064655411 35.55648923310477, -82.68153964656797 35.556441233098894, -82.68157264657941 35.55640223309434, -82.68162864660495 35.556296233078534, -82.68164464661503 35.55624823307038, -82.68165464662562 35.55619023305954, -82.68165964664207 35.55608823303925, -82.68164564665388 35.55599623301907, -82.68164164665842 35.55596223301173, -82.6816056466687 35.555856232986464, -82.68155264667784 35.555739232957166, -82.6814096466955 35.555469232887475, -82.68114664672144 35.555014232767824, -82.6810416467336 35.55482123271769, -82.68099064673851 35.554734232694734, -82.68086664675067 35.55452023263843, -82.68194664690893 35.55466023277755, -82.6824636469855 35.55472123284299, -82.68284964704446 35.55475623288965, -82.68311664708624 35.55477323292049, -82.68337064712703 35.55478323294856, -82.68388764721225 35.55478823300249, -82.68415464725794 35.55478023302831, -82.68479164736995 35.554741233085544, -82.68506564742015 35.554711233107575, -82.68521864744866 35.55469123311909, -82.68544864749138 35.55466223313676, -82.68583564756567 35.554598233163354, -82.686514647699 35.55446523320582, -82.68656764770938 35.55445523320917, -82.6880866480101 35.554143233301225, -82.688854648161 35.553992233349085, -82.68910364820906 35.553949233365834, -82.68961564830657 35.55386923340199, -82.69023264842195 35.553786233448264, -82.69040964845424 35.55376823346274, -82.69101964856509 35.553707233512746, -82.69154164865816 35.55366723355812, -82.6918086487046 35.5536542335828, -82.69258064883707 35.55362823365654, -82.69308864892218 35.5536242337078, -82.6935606489997 35.5536312337576, -82.69391964906772 35.553577233783365, -82.69556964931968 35.553725233982505, -82.69610664939883 35.55379223405115, -82.69661664947144 35.553872234119765, -82.69713864954096 35.553985234196226, -82.69754964959623 35.554071234255865, -82.69795464965112 35.55415323431408, -82.6982596496917 35.554219234358705, -82.69986664990599 35.554566234594134, -82.70836965103744 35.55642023584301, -82.70925065115327 35.55662123597415, -82.70870365105256 35.55668423593103, -82.70876265105883 35.556707235941715, -82.70899165105997 35.55694823601429, -82.70924665108808 35.557042236059594, -82.70946765111687 35.55709423609291, -82.71044465124379 35.55732723624046, -82.71100265131243 35.55748623633005, -82.71152665138688 35.55756923640058, -82.71200465146146 35.557602236456255, -82.71209265147195 35.55762923647081, -82.71219965148474 35.557662236488504, -82.71262965153102 35.55782723656618, -82.71274465154943 35.55783223657899, -82.71278465154933 35.557876236592065, -82.71292065156264 35.55793723661838, -82.7132626516223 35.55791923664973, -82.71377065171097 35.557893236696465, -82.71412165177279 35.55787123672798, -82.7142876518016 35.55786323674328, -82.71463065186086 35.5578492367756, -82.71464365180582 35.558222236852984, -82.71466565176337 35.5585232369166, -82.71467265173293 35.55872923695939, -82.71468965166892 35.55916523704997, -82.71470265151657 35.56017223725666, -82.71472665140986 35.5608942374064, -82.71474565136106 35.561233237477495, -82.71475565134153 35.56137123750657, -82.7148016512622 35.56193823762696, -82.71482365121803 35.56225023769283, -82.71483865118762 35.562464237738006, -82.71484365117796 35.56253323775255, -82.7148456511742 35.562559237758094, -82.71489065110583 35.56305423786367, -82.71493865108391 35.56324923790826, -82.71498365107314 35.56336823793714, -82.71500865106738 35.563433237952935, -82.71510765105465 35.56362323800187, -82.71513065105142 35.563669238013624, -82.71530665103583 35.56396223809142, -82.71534865103145 35.564036238110795, -82.71545165102111 35.564215238157814, -82.71597865097773 35.565070238386184, -82.71609265096707 35.56526323843719, -82.71609365096687 35.56526623843801, -82.71615165095902 35.56538023846708, -82.71618965095071 35.56547523849042, -82.71619665093688 35.5655732385111, -82.716184650924 35.565644238524314, -82.71614965090727 35.565715238535205, -82.71612665089776 35.56575223854043, -82.71607265088089 35.565803238545335, -82.71598665085685 35.565867238549515, -82.71590465083496 35.56592023855193, -82.71551565073078 35.56617723856453, -82.71530065067287 35.56632123857185, -82.71519065064138 35.56640723857812, -82.71511565061827 35.566476238584556, -82.715053650599 35.56653423858998, -82.71505065059807 35.56653723859028, -82.71495965056319 35.566666238607326, -82.7149226505469 35.566732238616915, -82.71486565051926 35.56685023863515, -82.71482365049218 35.56698123865756, -82.71478965046316 35.567133238685074, -82.71477965044897 35.56721523870079, -82.71474365039383 35.56753523876235, -82.71471865034306 35.567839238821776, -82.71466165024742 35.568400238930316, -82.71464365020992 35.56862523897435, -82.71462665019075 35.56873123899428, -82.71461465017573 35.56881623901035, -82.71457965015423 35.568918239027546, -82.71449765012547 35.56901723903936, -82.71443765010713 35.56907123904424, -82.71437065008911 35.5691162390465, -82.714347650084 35.56912423904586, -82.71425265006287 35.5691592390432, -82.71395064999264 35.56928923903885, -82.71387664997646 35.5693142390363, -82.71353264990026 35.5694372390262, -82.71336764986695 35.56947523901699, -82.71325064984596 35.56948523900703, -82.71310664982269 35.569480238991275, -82.71292064979583 35.56945323896671, -82.71264564976158 35.569378238923264, -82.7124116497382 35.56927623887848, -82.7123966497367 35.569270238875724, -82.7122976497298 35.56920723885278, -82.71214664972356 35.569084238812174, -82.71202964972481 35.56894923877265, -82.71201164970661 35.56904823879103, -82.71195064967293 35.56920123881596, -82.7118946496448 35.56932423883533, -82.71182364961588 35.56943523885065, -82.71176664959567 35.56950523885911, -82.71168864957345 35.569565238863376, -82.71162364955788 35.569596238863035, -82.71158064954736 35.56961823886316, -82.71122564947653 35.56969423884224, -82.71082664940074 35.56975523881379, -82.71073364938172 35.569778238808944, -82.7106486493613 35.56981923880861, -82.7106126493493 35.569858238812905, -82.71056864933152 35.56992623882222, -82.71052464930666 35.570040238840996, -82.7104686492839 35.57012823885318, -82.71036064925178 35.57022023886084, -82.71026564922002 35.57032423887238, -82.71020464919535 35.57041823888527, -82.71020864918307 35.57050223890281, -82.71022364916384 35.57064423893328, -82.71024764914655 35.57078323896409, -82.71029664911761 35.571025239018475, -82.71031264910891 35.571099239035156, -82.71031664909914 35.57116723904947, -82.7103016490902 35.5712092390565, -82.71028164908236 35.5712382390604, -82.71024564907239 35.571264239061996, -82.71020564906387 35.57127623906036, -82.71016464905779 35.57127123905511, -82.71012964905387 35.5712592390491, -82.71006364904513 35.571244239039224, -82.70997364903477 35.57121423902393, -82.70992564902862 35.57120223901653, -82.70988264902226 35.57119723901111, -82.70983464901387 35.5711992390066, -82.70976564900072 35.57121023900177, -82.70973364899538 35.571210238998496, -82.70974164899289 35.571235239004395, -82.70976764898519 35.57131323902304, -82.7097766489828 35.571339239029214, -82.70989264894808 35.57169123911286, -82.70991064894277 35.571745239125725, -82.71007064888742 35.57227923925098, -82.71013264887466 35.572430239288195, -82.71019464886663 35.57254923931881, -82.7102756488613 35.57267223935215, -82.71030764885958 35.57271823936487, -82.71045964885143 35.57293623942489, -82.7105036488463 35.57301723944585, -82.71050664884466 35.57303123944906, -82.71051364884104 35.57306223945609, -82.71051764883937 35.57307723945957, -82.71051364882939 35.573138239471575, -82.71050564882484 35.573159239475096, -82.7104946488182 35.573190239480226, -82.71049264881701 35.5731962394813, -82.71046464880514 35.573243239487994, -82.71046264880393 35.57324823948876, -82.71043564879497 35.57327823949211, -82.71041164878665 35.573306239495345, -82.71037164877518 35.57333723949756, -82.71033564876454 35.573367239500065, -82.71033264876394 35.573368239499914, -82.71028064875026 35.57340123950133, -82.71025464874364 35.57341623950169, -82.71024564874119 35.57342223950206, -82.71017464872497 35.57345023950053, -82.71014864871887 35.57346223950028, -82.70999664868583 35.57351223949487, -82.70965364861668 35.573591239475796, -82.7096046486064 35.573604239473454, -82.70948164858058 35.57363923946802, -82.70935964855258 35.57368923946574, -82.70926364852741 35.57374923946811, -82.70918364850368 35.57381723947373, -82.70910964847668 35.57391223948553, -82.70906364845547 35.574001239498934, -82.70903964843801 35.57408823951426, -82.70903264842367 35.57417423953106, -82.70903864841247 35.57425423954803, -82.70904864840492 35.57431423956132, -82.70907864839869 35.57438723957928, -82.7091236483966 35.57444923959649, -82.70919064839768 35.57451523961679, -82.70938264840338 35.57468623967133, -82.70945964840288 35.57477323969698, -82.70948564840091 35.574814239708004, -82.70952564839808 35.57487623972479, -82.70956864839003 35.574975239749364, -82.70959964837603 35.57510023977799, -82.70960864836229 35.57519923979914, -82.70961964835362 35.57526723981409, -82.7096266483418 35.57535223983221, -82.70967664826678 35.57589523994798, -82.7097676481304 35.57688224015863, -82.70977964811719 35.57698124017999, -82.70981864807794 35.577279240244835, -82.70987364804989 35.57752124029975, -82.70993164802138 35.577770240356536, -82.71001064799157 35.57805024042172, -82.71016064793224 35.57859924054901, -82.7103066478747 35.57913224067268, -82.71033764786034 35.57925924070174, -82.71054164776973 35.580071240888266, -82.71057964774762 35.580256240929884, -82.71059364773997 35.58032124094459, -82.7106396477051 35.58059824100571, -82.7106516476795 35.58077824104365, -82.7106466476722 35.580820241051754, -82.71064464766998 35.58083224105398, -82.71063964766307 35.580872241061655, -82.71063864766087 35.580885241064216, -82.71063064764965 35.58094924107638, -82.71060964763545 35.58101924108851, -82.71058264761713 35.58110924110413, -82.71051564758208 35.581265241129024, -82.7104466475519 35.58138624114669, -82.71034264752018 35.58148024115519, -82.71023064749383 35.58153024115393, -82.71010964746876 35.58156224114799, -82.70983964741909 35.581593241126676, -82.70914764729119 35.58167524107251, -82.70884864723413 35.581722241051466, -82.7085906471834 35.58177324103534, -82.70836364713514 35.58184124102594, -82.7081666470893 35.58192624102309, -82.70801464705039 35.58201424102545, -82.70774264697566 35.582206241036765, -82.70760164693337 35.58232824104723, -82.70744764688487 35.582477241061795, -82.70735464685082 35.582598241076944, -82.7073016468295 35.58267924108801, -82.70725364680591 35.582781241103895, -82.707219646783 35.58289324112327, -82.70714864671803 35.58323924118659, -82.70712464669211 35.58338224121324, -82.70710164666562 35.58352924124086, -82.70701464655657 35.58414524135753, -82.70695264648832 35.58452224142803, -82.70694564647998 35.584569241436945, -82.70688664640419 35.584998241518385, -82.70686964637088 35.58519724155718, -82.70684964632872 35.58545024160675, -82.70682364629086 35.58566824164852, -82.7067336462044 35.58613324173416, -82.70670264617128 35.58631524176811, -82.70668164614374 35.58647224179793, -82.70668864612246 35.586618241828475, -82.70671464610494 35.58676024186006, -82.70680064607178 35.58706924193192, -82.70681964606467 35.58713624194748, -82.7068696460454 35.5873162419893, -82.70692164602302 35.58751824203578, -82.70695864600383 35.58768324207325, -82.70686664597103 35.58779724208716, -82.70673764592273 35.587971242109305, -82.70659264587128 35.588149242130804, -82.70651564583875 35.58827724214903, -82.70644364580191 35.58843924217469, -82.70640064578186 35.58852324218739, -82.70633164575784 35.588604242196844, -82.70622864572985 35.5886752422007, -82.70613264570457 35.58873524220312, -82.70610164569621 35.58875624220426, -82.70599164566428 35.58884524221109, -82.70591364563658 35.58894024222246, -82.70586564561128 35.58905324224061, -82.70583864558638 35.589186242265015, -82.70582664555322 35.58938924230514, -82.70580164551092 35.58963724235312, -82.70576264541842 35.59019724246336, -82.70569664533737 35.59065324254954, -82.70566764532072 35.590730242562316, -82.70562264530581 35.59077824256747, -82.70558564529537 35.590806242569386, -82.70536664524765 35.590879242561876, -82.70515264520243 35.59094124255257, -82.70502064517436 35.59098124254718, -82.70496664516402 35.590990242543405, -82.70483664513924 35.59101024253423, -82.70472164511851 35.59102024252447, -82.70454364509055 35.59100924250395, -82.70438564506978 35.59097324248046, -82.70388764499901 35.59089424241329, -82.70378164498301 35.59088324240013, -82.70353964494613 35.59086124237085, -82.70327264490147 35.59086224234371, -82.70319764489176 35.59084424233239, -82.70288864486515 35.59068224226764, -82.70270464484494 35.59061424223492, -82.7024876448182 35.59055324220028, -82.70234364480422 35.59048824217223, -82.70231164480101 35.59047424216606, -82.70202364475513 35.59046024213371, -82.70179964470776 35.5905262421242, -82.70152664463244 35.590720242135724, -82.70131864456799 35.590914242153964, -82.70109464450084 35.591108242170584, -82.70088664444147 35.59126924218208, -82.7005986443586 35.591496242198886, -82.70058564435065 35.59153424220524, -82.70050164429549 35.59180224225134, -82.70050164427394 35.59194224227994, -82.70050164426571 35.591996242290904, -82.70048564422093 35.59227024234511, -82.70048564418127 35.59252824239769, -82.70059764417023 35.59272124244851, -82.70070964415912 35.59291524249961, -82.700869644151 35.59314124256209, -82.70088464413367 35.59327024258993, -82.70091664410943 35.593463242632524, -82.70083664407363 35.593609242654146, -82.70029264396526 35.59372424262181, -82.70011364394284 35.59367624259371, -82.69994064392111 35.593630242566555, -82.69970064389311 35.59355224252605, -82.69937964385907 35.5934262424675, -82.69915564384114 35.593300242418785, -82.69885164381228 35.593158242358626, -82.6985636437788 35.59306424230998, -82.69833964376329 35.59292224225804, -82.69803564373447 35.59278024219799, -82.69779464372844 35.59255824212793, -82.69776264376934 35.59225724206331, -82.69769864378557 35.59208224202108, -82.69765064380452 35.59190724198041, -82.6975386438272 35.59163824191409, -82.69747464384838 35.59143124186535, -82.697452643869 35.59127324183093, -82.69744164387937 35.59119324181342, -82.69737764390777 35.59093924175511, -82.6973136439312 35.59071724170327, -82.69723364396185 35.590431241636786, -82.69715364396556 35.590320241605916, -82.6968976439423 35.59019424155401, -82.69667264389734 35.590243241540904, -82.69648064384045 35.59040524155423, -82.69643264380265 35.590599241588926, -82.69638464374519 35.590921241649575, -82.69635264370048 35.59117724169853, -82.69627564364843 35.591432241742616, -82.69625664363531 35.591497241753956, -82.69619264358045 35.59178524180606, -82.69614464352823 35.59207324185992, -82.69611264347861 35.5923612419153, -82.6961446434421 35.592633241974056, -82.69609864338032 35.5929852420411, -82.69609664337756 35.593001242044245, -82.69596864333171 35.593161242063694, -82.69568064326899 35.59325724205372, -82.6954886433157 35.59274524192964, -82.6953606433632 35.592297241825214, -82.69528064340392 35.59194524174525, -82.69504064344262 35.59143324161622, -82.69488064345778 35.59116124154432, -82.69463964344966 35.590953241477216, -82.69436764342889 35.59079324141676, -82.69387164336845 35.59064924133654, -82.69381464336084 35.590637241328224, -82.69332764329504 35.590537241257884, -82.69305564326459 35.59044124121049, -82.69268764322291 35.59031324114667, -82.6922236431407 35.59034524110553, -82.69171164306036 35.59031324104656, -82.69135964298208 35.59044124103658, -82.69095964289332 35.59058524102489, -82.69062364283003 35.590633241000276, -82.69019164274333 35.590729240975556, -82.68975964266158 35.5907932409443, -82.68943964260332 35.59082524091801, -82.68921564256607 35.59082524089508, -82.68900764253635 35.59079324086718, -82.68876764249889 35.59077724083933, -82.68851164245382 35.59079324081635, -82.68812764238979 35.59079324077694, -82.68555164184532 35.591545240666164, -82.68497564175681 35.59149724059729, -82.68433564171666 35.59106524044357, -82.68386964168283 35.59078024033779, -82.68367964166893 35.590665240294776, -82.68307164161439 35.59036124017045, -82.68217564148723 35.59021724004928, -82.68129564132363 35.59032923998187, -82.6805436411763 35.59047323993408, -82.68095964129516 35.59015023991094, -82.68220864165174 35.58918323984183, -82.68262564177066 35.58886123981894, -82.68303564187342 35.588636239815116, -82.68361464203991 35.5881802397816, -82.6836846420641 35.58809923977224, -82.68372164207636 35.588059239767844, -82.68390364214892 35.58778423973043, -82.68409864225579 35.58730023965172, -82.68449564242988 35.58659723954913, -82.68460964249955 35.58626723949358, -82.68461664253695 35.58603123944615, -82.68466364257259 35.58585023941407, -82.68474464260898 35.58570123939203, -82.68528264280657 35.58499823930384, -82.68558464289573 35.58474523928323, -82.68563164290936 35.58470723928033, -82.68577964295856 35.58454723926284, -82.68588764300274 35.58437723923926, -82.6859686430609 35.58408623918826, -82.68607564311084 35.583877239156635, -82.68631864317692 35.58371023914752, -82.68649964322606 35.58358623914075, -82.68668164329615 35.58332723910667, -82.68668164332136 35.58316323907318, -82.68664764333018 35.58306923905058, -82.68641864334181 35.582745238961046, -82.686385643359 35.58259723892747, -82.68637164343788 35.582069238818335, -82.68643264347502 35.58189323878877, -82.68644564350257 35.581728238756455, -82.68637164355258 35.5813222386661, -82.6863956435778 35.581184238640404, -82.686418643601 35.58105823861707, -82.68656664366686 35.5807892385774, -82.68656064369203 35.58061923854214, -82.68643864373519 35.58020623844546, -82.6862576437581 35.579860238356375, -82.68619664378933 35.57959123829531, -82.68602864378583 35.57943223824564, -82.68585364376847 35.57935523821196, -82.68556464373144 35.5792832381677, -82.68549064372492 35.579245238152396, -82.68545064373014 35.57916823813256, -82.6852756438714 35.57805823788832, -82.68527564395836 35.57749223777298, -82.68523464398442 35.57727823772511, -82.68506664402324 35.57684323761929, -82.68493264408117 35.57632123749909, -82.68485764409215 35.57616823746025, -82.68485864412195 35.575975237420955, -82.68484164412828 35.57591523740697, -82.68482464413488 35.57585423739281, -82.68476364413054 35.57581623737879, -82.68474364424871 35.57502523721547, -82.68482464441492 35.574030237021, -82.68479064445398 35.5737392369582, -82.68472764447175 35.57355523691422, -82.68446064454754 35.57277223672724, -82.68433364464373 35.57200823655845, -82.68417164469778 35.57148023643422, -82.6841426447891 35.57085423630362, -82.68413164482328 35.5706192362546, -82.68412464484514 35.570469236223325, -82.68427964490985 35.57021623618765, -82.68447364496842 35.57004523617272, -82.68465164502162 35.569891236159535, -82.68403564498023 35.569493236015255, -82.68364864495729 35.569223235920546, -82.68359964495431 35.569189235908546, -82.68330064494172 35.5689472358286, -82.68310164493991 35.56874323576664, -82.68296164494394 35.56856523571604, -82.68276164495907 35.56824923563106, -82.68264164496968 35.568050235578276, -82.68254964497808 35.56789623553745, -82.68242764499888 35.56762823547031, -82.68237364501307 35.56747723543396, -82.6823496450264 35.5673642354085, -82.68234564504245 35.56725523538588, -82.68235364506457 35.56712023535912, -82.68241364513948 35.566697235279086, -82.68243864518237 35.5664452352302, -82.682450645242 35.56606923515487, -82.68245464525802 35.56596923513489, -82.68245264528613 35.56578423509692, -82.68244164533024 35.5654842350347, -82.68242264537946 35.565143234963166, -82.68239664541751 35.56486723490426, -82.68213664537166 35.56488423488107, -82.68135764523383 35.564937234812135, -82.68109864518799 35.56495523478917, -82.68124164526797 35.56458923472924, -82.68137564535307 35.56418023465961, -82.68141364537685 35.56406623464031, -82.68147364542183 35.56383823459994, -82.68151864546047 35.5636352345632, -82.6815466454921 35.56345923453017, -82.68161064557846 35.56296623443626, -82.68161964559638 35.56285923441531, -82.68163564563882 35.562600234364226, -82.68162764565488 35.562487234340374, -82.68161564566762 35.56239123431951, -82.68157464569417 35.56217323427085, -82.68153664570751 35.56204523424096, -82.68144064573468 35.5617642341738, -82.68142864573821 35.56172823416522, -82.6813306457564 35.56150323410935, -82.68119164578819 35.561145234022085, -82.68112864579942 35.56100423398692, -82.68111064580258 35.56096423397692, -82.6810876458067 35.56091223396394, -82.68105364581133 35.56084523394679, -82.68103364581381 35.56080723393702, -82.68096364582313 35.56067023390194, -82.68088164582764 35.5605522338695, -82.68077864583353 35.56040223382836, -82.68059664583609 35.56018823376609, -82.68041764583604 35.55999423370822, -82.68030964583664 35.559873233672455, -82.68027164583692 35.559830233659824, -82.68022064583884 35.55976223364074, -82.68013664584468 35.55963323360583, -82.68013064584521 35.5596232336032, -82.68005864585687 35.559469233564414, -82.68004564585918 35.55944023355715, -82.67998664587441 35.55927723351783, -82.67992064590007 35.55903823346239, -82.67989464590904 35.558951233442016, -82.67984364592714 35.55877823340149)))",6574,37,021,002504,370210025041,2013,2013,37,1985,1943,16,12,7,0,7,28,1603,23,1580,1596,1560,14,10,6,0,6,7,946,840,106
census_2010_blockgroups_view.fid--2dc29038_13ec899ba8f_-2650,"MULTIPOLYGON (((-82.52333861444717 35.59439422459501, -82.52350561455967 35.59384422450029, -82.52357761460796 35.59360822445968, -82.52378561473327 35.59301822436106, -82.5237746148219 35.592431224240414, -82.52373161483372 35.592308224211024, -82.5236756148486 35.59215122417328, -82.5236286148756 35.591925224122484, -82.52336561503249 35.59062322383058, -82.52351261517305 35.58986922369228, -82.52355561529627 35.589115223543295, -82.52397261552747 35.588063223372046, -82.5244926156845 35.587603223331875, -82.52498961570079 35.58803322347046, -82.5246806157033 35.587684223367646, -82.52452861570086 35.58753622332192, -82.52374761568831 35.58677622308708, -82.52349061568525 35.58651922300839, -82.52324561568403 35.58626322293112, -82.52309261568408 35.58609822288186, -82.52284961568442 35.585834222803214, -82.52264761568874 35.58558822273241, -82.52260161568994 35.58553122271601, -82.52246361569291 35.58536322266768, -82.52241761569385 35.585307222651565, -82.52249261570876 35.58529122265604, -82.52272161575381 35.58524522267018, -82.52279761576877 35.58523022267487, -82.52288161578544 35.5852122226799, -82.52310761583006 35.585166222693786, -82.52313661583571 35.585160222695485, -82.52322261585269 35.58514322270089, -82.52340061588755 35.58510822271201, -82.52365961593776 35.58506122272907, -82.52434261606984 35.58493922277445, -82.52455861611045 35.584908222790304, -82.5249786161874 35.584861222823896, -82.5254216162682 35.58481322285968, -82.52550861628389 35.58480522286697, -82.52577361633139 35.584782222889494, -82.52586161634697 35.584775222897164, -82.52601461637448 35.58476222291025, -82.52627161641846 35.584753222934786, -82.52653761646401 35.58474422296029, -82.52692561651958 35.58480122301182, -82.52732061656543 35.58492922307834, -82.52752861657825 35.58507022312843, -82.52776461658827 35.58525922319111, -82.52814961658422 35.58570022332038, -82.52845661657916 35.586064223426035, -82.52848861657776 35.58610722343809, -82.52875661656755 35.58646222353787, -82.52891961655345 35.58673022360912, -82.52896461654942 35.5868042236288, -82.5291296165268 35.58712922371188, -82.52913161652651 35.587133223712854, -82.52926161649913 35.58745122379098, -82.52938261646376 35.587811223876656, -82.5295736164035 35.58840822401782, -82.52965161637933 35.58864922407478, -82.52971761636132 35.58883722411979, -82.52976961634691 35.58898722415569, -82.52983661632872 35.58917722420123, -82.5299136163022 35.589432224261, -82.52991661630107 35.589443224263576, -82.529957616284 35.589598224299344, -82.52998661627068 35.589715224326156, -82.53010261622659 35.5901272244219, -82.53013461621582 35.59023122444629, -82.53014561621275 35.590263224453984, -82.5302546161766 35.59061522453678, -82.5303846161291 35.591064224641535, -82.53061361605877 35.59176722480811, -82.5306916160352 35.592004224864375, -82.53079761601153 35.592272224929786, -82.53085361599918 35.592413224964204, -82.53088861599107 35.592503224986125, -82.53095461598107 35.59263922502062, -82.53109661595968 35.5929312250946, -82.53148361590804 35.593683225287364, -82.53149861590634 35.59371022529442, -82.53169761588583 35.5940582253856, -82.53177861587919 35.594188225420446, -82.53202361585936 35.59458122552556, -82.53210561585283 35.594712225560684, -82.53215961584858 35.59479722558352, -82.53222561584649 35.594882225607606, -82.53240061584081 35.595107225671356, -82.53262261583754 35.5953682257473, -82.53262661583744 35.59537322574873, -82.5327756158408 35.59551122579211, -82.53285961584278 35.59558922581659, -82.53307061585224 35.59575522587207, -82.53338761587152 35.59597122594864, -82.5336986158907 35.596182226023515, -82.53402761591234 35.59639622610085, -82.53452861594383 35.59673122622053, -82.53530461599313 35.59724722640524, -82.53543761600167 35.59733522643686, -82.53587961603122 35.597619226540075, -82.5359536160375 35.597658226555566, -82.53618961605902 35.59777322660321, -82.5364516160829 35.597900226655966, -82.53661561609901 35.597972226687546, -82.53668861610699 35.59799922670051, -82.53684561612425 35.59805622672822, -82.53691661613249 35.598079226740246, -82.53716661616096 35.59816322678294, -82.5374286161911 35.5982502268276, -82.53821661628132 35.598513226962105, -82.53847961631145 35.59860122700703, -82.53893061633352 35.59894422712324, -82.53902961633837 35.5990192271486, -82.54046061647317 35.59968622743143, -82.54097561652166 35.59992622753317, -82.54042461644035 35.599860227463104, -82.54001461637972 35.59981222741121, -82.53882661620688 35.59965422725704, -82.53877561619959 35.59964622725013, -82.5382276161211 35.59956522717737, -82.53804061609438 35.59953722715242, -82.53748161601439 35.59945422707809, -82.5372956159877 35.599427227053496, -82.53719561594036 35.59962722708389, -82.53660161565816 35.60081922726548, -82.5365886156489 35.60086522727348, -82.53654961562066 35.601006227298214, -82.53653761561144 35.60105322730644, -82.53650061558439 35.601189227330316, -82.53647861556095 35.601317227354116, -82.53649261554739 35.601420227376586, -82.53651061553104 35.60154622740406, -82.53653961552409 35.601622227422524, -82.53658661550865 35.60177322745804, -82.53660661549807 35.60186322747845, -82.53661461548832 35.60193522749384, -82.53659461547257 35.602016227508315, -82.53655761545085 35.602117227525035, -82.53654661543023 35.60223922754877, -82.53657761542365 35.60231522756743, -82.53665161541623 35.60244322760106, -82.53667961541422 35.60248622761271, -82.53684861540285 35.6027422276822, -82.53690661540647 35.60278122769605, -82.5369036153955 35.6028492277096, -82.53690161538559 35.602911227721975, -82.53687961536725 35.60300622773908, -82.53687961536009 35.603053227748674, -82.53687961535309 35.603098227757805, -82.53689261535213 35.6031182277632, -82.53693561534962 35.60318122778046, -82.53705261535484 35.60327322781115, -82.53716861535575 35.6033922278473, -82.537193615344 35.60349522787089, -82.5371546153228 35.60359122788638, -82.53697761527165 35.60373222789689, -82.53697061526962 35.60373822789739, -82.53684161522698 35.603876227912195, -82.53670761517901 35.60404322793244, -82.53667561515819 35.60414322794952, -82.5366706151229 35.60436722799459, -82.53666461510542 35.604474228015704, -82.536649615084 35.604597228039225, -82.53669461507171 35.60472522806994, -82.53671561506044 35.60482122809159, -82.53674961503975 35.60499222812986, -82.5367626150172 35.605152228163796, -82.5367816150005 35.60528122819202, -82.53684761496469 35.60558422826041, -82.53687561495504 35.60567722828223, -82.5368996149425 35.60578422830648, -82.5369516149379 35.60587022832929, -82.53698061492976 35.605954228349404, -82.5369866149148 35.60605822837117, -82.5369936149019 35.60614922839044, -82.5369796148819 35.60626422841234, -82.53701361486313 35.60642222844806, -82.53709561485375 35.60657122848678, -82.53720861483588 35.60680922854683, -82.53721461483302 35.606834228552565, -82.53722361482768 35.606878228562444, -82.53725161481191 35.60701122859241, -82.53726161480658 35.607056228602566, -82.53722061478722 35.60713822861504, -82.53720961477332 35.607216228629795, -82.53722561476117 35.60731222865094, -82.53725861475444 35.60739122867042, -82.5373516147528 35.607502228702536, -82.53745961475305 35.60761722873706, -82.53752361475037 35.607703228761125, -82.53756161473801 35.60782422878968, -82.5375736147171 35.60797322882122, -82.53757861467872 35.60822722887345, -82.53757061461349 35.60864222895707, -82.53756161459425 35.608757228979535, -82.53753361456681 35.60890522900679, -82.53747461452734 35.609097229039875, -82.537409614495 35.609237229061655, -82.53731761445377 35.6094062290866, -82.5372486144255 35.609515229101625, -82.5371766143992 35.6096082291132, -82.53712661438253 35.60966222911901, -82.53707561436684 35.6097092291234, -82.5369996143465 35.609759229125665, -82.53693161433063 35.60978922912485, -82.53680361430386 35.609825229119, -82.53666861427777 35.609849229110004, -82.53656961426202 35.60984422909883, -82.53643361424345 35.60981822907956, -82.53637261423626 35.6097992290694, -82.53621961421553 35.60976922904762, -82.53610561419909 35.609753229032634, -82.53602161418446 35.60975722902482, -82.53593761416812 35.60977322901939, -82.53579261413589 35.609826229015255, -82.53570061411185 35.60988322901742, -82.53563961409401 35.60993322902135, -82.53558661407516 35.609998229029166, -82.53554861405719 35.61007422904067, -82.53552561404274 35.61014322905234, -82.53550961403063 35.61020422906308, -82.53550961401889 35.61028022907858, -82.535563614002 35.610448229118354, -82.53564761397598 35.61070722917968, -82.53569361395255 35.61090922922548, -82.53570061393823 35.611009229246534, -82.53570061391065 35.611188229282995, -82.53567761387337 35.61140522932479, -82.53565461385016 35.61153122934807, -82.53560161382026 35.611668229370544, -82.53549461376069 35.61193922941473, -82.53535861369278 35.61223322946052, -82.5351906136117 35.6125782295134, -82.53491861348542 35.61310522959274, -82.53482661344 35.61330022962297, -82.53478961341621 35.613415229642634, -82.53477461340377 35.613479229654104, -82.53475161335655 35.613761229709134, -82.53473761334459 35.61382322972025, -82.53471861333334 35.61387622972913, -82.53466761331225 35.613958229740604, -82.53462261329746 35.61400522974548, -82.53457961328529 35.61403822974779, -82.53449361326437 35.61408122974768, -82.53437061323756 35.614122229743394, -82.5341986132038 35.61415622973261, -82.53402861316835 35.61420322972472, -82.53393861314818 35.61423722972233, -82.53383961312484 35.61428222972133, -82.5337126130908 35.61436622972542, -82.53330061296796 35.614719229754904, -82.53297361286945 35.615006229779674, -82.53291661285229 35.61505622978402, -82.53279161281489 35.61516422979316, -82.53267561277985 35.61526622980194, -82.53201661258136 35.61584422985188, -82.53184061252927 35.61599322986405, -82.53177961251191 35.616040229867366, -82.53156461245028 35.61620822987939, -82.53146561242272 35.61628022988394, -82.53127861237093 35.616415229892155, -82.53121061235039 35.6164752298974, -82.53114861233006 35.61654022990424, -82.53107861230455 35.61663022991533, -82.53104061228741 35.61670022992575, -82.53100561226377 35.616816229945705, -82.53088761217505 35.617264230024716, -82.53080561210967 35.61760023008464, -82.53072861204677 35.617925230142966, -82.53071761202492 35.61805523016824, -82.53072061200848 35.61816523019093, -82.5307996118439 35.619317230433474, -82.53086961177543 35.619836230546234, -82.53087461174609 35.620032230586695, -82.53086961173209 35.62011723060349, -82.53083361168972 35.62035323064779, -82.5307996116589 35.62051623067746, -82.53051261142537 35.6217222308934, -82.53041661134495 35.6221402309686, -82.53032861126988 35.62253223103931, -82.53028761124403 35.622655231060186, -82.53024761122427 35.62274023107331, -82.53019761120558 35.62280823108205, -82.53013361118397 35.62287923108989, -82.5300596111615 35.62294523109575, -82.52981461109152 35.62313523110918, -82.52955861101911 35.623329231122305, -82.52948161099724 35.623388231126434, -82.52936661096466 35.62347523113228, -82.52922161092435 35.62358123113897, -82.52903261087117 35.62372223114819, -82.52850461072164 35.624123231175524, -82.5282186106397 35.624347231191706, -82.52805661059293 35.62447623120135, -82.52789461054458 35.62461523121286, -82.5278646105357 35.62464023121488, -82.52777461050893 35.62471723122136, -82.52774561050008 35.62474323122366, -82.527563610446 35.62489823123644, -82.52702061028374 35.6253652312757, -82.52683961022973 35.625521231288786, -82.52673361019806 35.62561223129644, -82.52643761010926 35.62586923131827, -82.5264156101031 35.625885231319245, -82.52634961008451 35.62593523132261, -82.52630261007177 35.62596723132437, -82.52626861006256 35.6259902313255, -82.52618761004211 35.62603523132631, -82.5261416100316 35.62605423132548, -82.5260906100196 35.62607723132492, -82.52599260999756 35.62611423132236, -82.52587860997386 35.626145231316954, -82.52576560995222 35.6261642313092, -82.52561060992493 35.626174231295316, -82.52555960991587 35.626178231290815, -82.52544160989731 35.62617123127726, -82.52542860989553 35.626169231275526, -82.52533560988257 35.62615323126277, -82.52529760987721 35.626147231257605, -82.52517660986159 35.626118231239296, -82.52506560984975 35.62607523121912, -82.52505860984913 35.62607223121779, -82.52498260984251 35.626033231201966, -82.5249496098396 35.62601623119521, -82.52484660983164 35.625957231172585, -82.52477760982799 35.62590623115507, -82.52474660982641 35.625883231147256, -82.52468060982679 35.625810231125584, -82.52462660982843 35.62574123110599, -82.52457360983281 35.625656231083234, -82.52451160984758 35.625493231043706, -82.52445360987129 35.62527723099375, -82.52439160989681 35.62504523094016, -82.52438160990107 35.62500723093142, -82.5243386099161 35.62486323089771, -82.52430660992462 35.624773230876094, -82.52426860992982 35.62469923085714, -82.52423560993151 35.62465223084416, -82.52420560993131 35.624621230834734, -82.5240876099254 35.624533230804765, -82.52402160991782 35.624511230793445, -82.52396560991066 35.6244972307849, -82.52385560989313 35.624492230772546, -82.52378560988075 35.62449723076632, -82.52371960986788 35.6245102307622, -82.52371060986604 35.624512230761674, -82.52335460978938 35.624626230748305, -82.52305360972333 35.62473023073844, -82.52244860958835 35.62495423072184, -82.52176860943155 35.62523923070986, -82.52169560941574 35.6252632307073, -82.52155060938445 35.625310230701906, -82.52143460936058 35.62534023069608, -82.52127560932873 35.62537523068687, -82.52090460925857 35.625431230660105, -82.51992660907308 35.625581230590015, -82.51985860906028 35.625591230585066, -82.51965660902202 35.62562223057061, -82.51958960900917 35.62563323056593, -82.51936760896727 35.62566623054983, -82.51917660893086 35.62569623053633, -82.51870460884041 35.62577523050381, -82.51865560883085 35.625784230500685, -82.51854360880999 35.62579923049214, -82.51848260879939 35.625802230486485, -82.51845460879451 35.62580423048404, -82.5184426087923 35.62580523048301, -82.51837260878129 35.625801230474984, -82.51834560877697 35.625800230472, -82.51826460876472 35.62579223046201, -82.5181826087542 35.625772230449556, -82.51798060873088 35.62570623041537, -82.51788360871916 35.625678230399664, -82.51776060870203 35.62565623038257, -82.51765760868629 35.62564823037029, -82.51756560867058 35.625651230361434, -82.517315608625 35.62567723034103, -82.517302608623 35.62567623033955, -82.51723960861268 35.6256752303328, -82.5171586086017 35.625659230321226, -82.51708560859275 35.625639230309666, -82.51701660858811 35.62559523029363, -82.5169536085861 35.62554023027591, -82.51682060858427 35.6254092302356, -82.51675360858192 35.62535223021712, -82.51669360857693 35.62532023020441, -82.51663360857076 35.625295230193174, -82.51655860856118 35.625277230181794, -82.51650060855214 35.62527323017498, -82.51643260854033 35.62527623016859, -82.51635860852659 35.625286230163056, -82.51629460851551 35.62528923015707, -82.5162776085123 35.62529123015569, -82.51620360850033 35.62528923014776, -82.51615760849387 35.625282230141565, -82.51610560848746 35.62526723013323, -82.51605260848324 35.625238230121795, -82.51600160848001 35.62520423010961, -82.51594960847905 35.62515423009418, -82.51590160848015 35.6250952300772, -82.51575460848714 35.6248922300208, -82.51568160848781 35.62480922999634, -82.51559960848667 35.62472822997145, -82.51548160847851 35.624654229944284, -82.5153686084677 35.624603229922236, -82.51525060845472 35.6245602299014, -82.51513060844267 35.624509229878626, -82.51504260843733 35.62444922985742, -82.51490860843651 35.62431022981534, -82.51477660844012 35.624145229768196, -82.51470960843716 35.624092229750545, -82.51470360843696 35.62408722974883, -82.51462760843062 35.62404622973274, -82.5145036084171 35.62400022971064, -82.5142736083891 35.62393522967369, -82.51412560837205 35.62388622964847, -82.51396660835657 35.62381522961776, -82.51383260834562 35.62374222958911, -82.51373660833947 35.62367922956635, -82.51370560834683 35.62359822954678, -82.51363360838513 35.623272229472974, -82.51361560839545 35.62318622945362, -82.51347260843481 35.62277722935571, -82.51317160848919 35.622101229187216, -82.5130326085145 35.62178722910907, -82.5130226085245 35.62171222909278, -82.5130216085261 35.62170022909024, -82.51303660853976 35.62162822907709, -82.51303860854081 35.62162322907633, -82.51306760855473 35.621564229067246, -82.51316760859106 35.621436229051454, -82.51319460860067 35.62140322904758, -82.51325460862112 35.621335229039865, -82.51333260864851 35.621241229028826, -82.51355760872734 35.62097222899726, -82.51356560873086 35.6209582289952, -82.51363360875773 35.620857228981606, -82.5136776087812 35.62075222896478, -82.51373460880303 35.6206722289544, -82.51397760888511 35.62040122892424, -82.51401960890166 35.62033922891599, -82.5140386089144 35.620277228905294, -82.51403660892561 35.620202228889845, -82.51398260894585 35.62001322884576, -82.51396060895435 35.619934228827425, -82.51394360896822 35.619826228803696, -82.51394860897925 35.61976022879084, -82.51396760899095 35.619704228781345, -82.51400560900557 35.6196502287743, -82.51403560901413 35.61962722877276, -82.51399360902104 35.619537228750076, -82.51409060906816 35.61933622871913, -82.51412160912682 35.6189892286517, -82.51418260918865 35.61865422858984, -82.51444860931025 35.61815222851512, -82.51454360936255 35.617915228476576, -82.51458960947711 35.61722122834015, -82.51458760947858 35.617210228337676, -82.51451060953039 35.61679122824455, -82.51442160960094 35.61623822812295, -82.5143856096292 35.61601622807398, -82.51433760966098 35.615758228016595, -82.51432660966857 35.615697228003015, -82.5143576097254 35.615362227938064, -82.51452560979972 35.615061227894124, -82.51460460985501 35.61478722784645, -82.51473360994028 35.614373227775474, -82.51473760994251 35.614363227773865, -82.51477661002203 35.61388922768141, -82.51514761032048 35.61235322740712, -82.5155876106266 35.61084122714471, -82.5157636107506 35.6102262270377, -82.51655061109129 35.608863226841244, -82.51915661169419 35.6077572268841, -82.51945961183125 35.6071942268007, -82.52000161207607 35.606189226652035, -82.52025361235829 35.60462922636044, -82.52066961260918 35.60344922616316, -82.52109361279052 35.602729226060205, -82.52120361293095 35.601936225910165, -82.52208761326037 35.600750225759704, -82.52293561362296 35.59931022555393, -82.52322461411984 35.59639622499064, -82.52331261442964 35.594480224609896, -82.52333861444717 35.59439422459501)))",6171,37,021,001801,370210018011,1347,1347,27,1316,1208,74,7,20,0,7,31,1238,23,1215,1218,1125,65,7,15,0,6,20,1041,845,196
census_2010_blockgroups_view.fid--2dc29038_13ec899ba8f_-264f,"MULTIPOLYGON (((-82.57556562292834 35.59561723020938, -82.57562962294513 35.59557723020779, -82.57573962295854 35.59560923022563, -82.57604462299453 35.59570423027623, -82.57620762301678 35.59573523029927, -82.57643062304568 35.59578823033298, -82.57664862307507 35.59583223036437, -82.57685362310136 35.59588323039576, -82.57701462311951 35.59593923042373, -82.57714662313084 35.59600823045139, -82.5772286231364 35.59606023047034, -82.57729162314084 35.5960992304848, -82.57739462314517 35.596182230512206, -82.57753162314766 35.596314230553155, -82.5778496231463 35.59666623065749, -82.57796962314748 35.59678723069443, -82.57814462315234 35.59694523074459, -82.57828062316024 35.597040230777885, -82.57847362317654 35.59714323081869, -82.57867162319842 35.59721423085352, -82.57910662325092 35.597342230924205, -82.57935062327844 35.597427230966616, -82.58033562338296 35.59781123114592, -82.5804236233926 35.59784323116149, -82.58045162339556 35.59785423116658, -82.58066562342144 35.59791723120145, -82.58069362342528 35.59792223120531, -82.58078662343819 35.59793923121832, -82.58083462344473 35.59794823122509, -82.58111962348929 35.59796623125804, -82.58125462351032 35.59797523127374, -82.58164862357476 35.59798223131562, -82.58196162362692 35.59798123134752, -82.58212362365533 35.59797123136213, -82.58222262367254 35.59796623137127, -82.58234762369548 35.597952231381214, -82.58245662371617 35.597935231389016, -82.58274362370096 35.59834423150176, -82.58277362369684 35.59840323151684, -82.5828026236886 35.59848823153716, -82.58282362367815 35.59857823155763, -82.58283062367505 35.59860623156407, -82.58291362361632 35.59907723166846, -82.58295462360253 35.59921123169999, -82.58298362359515 35.59929023171902, -82.58307562358047 35.59948523176823, -82.58318762356535 35.599704231824255, -82.58328962355579 35.599876231869786, -82.58334262355308 35.59995123189047, -82.58340162355344 35.60001223190897, -82.58346062355538 35.60006323192539, -82.583532623559 35.60011723194381, -82.58395362358557 35.600399232044445, -82.58397062358655 35.60041123204866, -82.5844906236186 35.600764232173894, -82.58455962362204 35.60081623219162, -82.58457062362277 35.600823232194145, -82.5847836236363 35.60096523224496, -82.58483762363974 35.60100123225784, -82.58530462366622 35.601333232373364, -82.58540662367055 35.601415232400534, -82.58543262367151 35.60143623240752, -82.58556862367493 35.60156123244694, -82.58559362367464 35.60159023245539, -82.58562262367421 35.601624232465326, -82.5856706236713 35.60169523248474, -82.58568362367056 35.60171423248995, -82.58580662365573 35.6019432325491, -82.5858546236483 35.602043232574516, -82.58591162363936 35.60216223260453, -82.58597462362776 35.60230623264033, -82.58605062361416 35.60247623268275, -82.58616262359212 35.60274023274803, -82.58622462357994 35.60288623278413, -82.58631162356018 35.60310823283825, -82.58641262353743 35.60336523290099, -82.58653062350251 35.60371923298512, -82.58654662349537 35.603783232999845, -82.5865766234821 35.603901233027024, -82.58658562346565 35.604018233051704, -82.58658162345607 35.604076233063054, -82.58656862344489 35.60413423307361, -82.5863736233278 35.60468423316555, -82.58634762331148 35.604762233178796, -82.58629262327636 35.60493123320752, -82.5861576231882 35.6053582332806, -82.58600762310148 35.60575923334683, -82.5859396230632 35.605934233375486, -82.58591462304648 35.60601623338963, -82.58589362302862 35.60610923340645, -82.58588262300466 35.60625323343465, -82.58589462299065 35.60635723345705, -82.58591062298501 35.606411233469686, -82.5859326229809 35.606461233482136, -82.5859666229779 35.606517233497044, -82.58600362297683 35.60656423351038, -82.58605362297796 35.60661123352504, -82.58611962298153 35.606659233541606, -82.58636862299886 35.606815233598965, -82.5865406230108 35.606923233638604, -82.58667562301848 35.60701923367214, -82.5868056230239 35.607124233706784, -82.58685462302512 35.60716923372099, -82.58693562302406 35.607263233748405, -82.58696862302217 35.607311233761564, -82.58701662301885 35.60738423378143, -82.58709162300809 35.60753523381992, -82.58718762298784 35.60777023387751, -82.587264622972 35.60795623392339, -82.58729862295932 35.60807523395108, -82.5873026229514 35.60813123396289, -82.58729862293558 35.608229233982456, -82.58729062292545 35.60828623399324, -82.58723962288718 35.60848023402745, -82.5871966228603 35.608608234049136, -82.58714362283528 35.608713234065064, -82.58708662281228 35.60880123407715, -82.58694062275833 35.60899423410145, -82.58680862271402 35.60913923411743, -82.58665962266357 35.6093062341361, -82.58645662259858 35.6095092341566, -82.586188622512 35.6097822341847, -82.58578362238093 35.610196234227395, -82.58536962225209 35.610586234264275, -82.58528962222681 35.61066323427172, -82.58514462218032 35.610809234286556, -82.58509362216546 35.61085023428963, -82.5850196221469 35.61089123429042, -82.58482762210834 35.61093423427946, -82.58476962209745 35.61094223427512, -82.58473662209127 35.61094723427281, -82.58455162206036 35.610948234253875, -82.58441962203766 35.61095323424142, -82.58428762201586 35.61095223422764, -82.58418962199636 35.61097323422183, -82.584127621982 35.610999234220735, -82.58401662195334 35.611066234223046, -82.58381862189971 35.61120023422992, -82.5838006218946 35.61121423423095, -82.583553621823 35.61141223424593, -82.58351762182726 35.61134623422881, -82.5834776218305 35.61128223421165, -82.5833766218385 35.61112123416847, -82.58330662184251 35.611019234140514, -82.58323462184691 35.61091323411157, -82.58323062184698 35.610908234110084, -82.58316562184984 35.61082023408552, -82.58313662184908 35.61079323407697, -82.58308962183881 35.61080923407548, -82.58294862180762 35.61085923407119, -82.58290262179743 35.61087623406989, -82.58276662176733 35.61092523406593, -82.58204362160697 35.61118623404479, -82.58183762156115 35.61126123403886, -82.58173362153916 35.61129223403448, -82.58165362152351 35.611307234029404, -82.58156662150962 35.611303234019616, -82.58138762148693 35.611258233992096, -82.58114962145761 35.61119123395396, -82.58090162142835 35.61111423391276, -82.58078862141558 35.61107523389322, -82.58071862141024 35.611034233877696, -82.58064662140828 35.61096923385708, -82.58059162140994 35.61089923383715, -82.5805606214149 35.610833233820564, -82.58054562142509 35.61075123380235, -82.58054662143404 35.6106942337908, -82.58060862147256 35.61051123375987, -82.58064762149053 35.610436233748636, -82.58066662150284 35.61037723373862, -82.58068062151516 35.61031223372678, -82.5806866215254 35.61025223371521, -82.58067862158858 35.60983323362908, -82.58066862159679 35.609769233614976, -82.58065162161188 35.6096532335896, -82.58063162161885 35.60958623357388, -82.58060262162232 35.609532233559925, -82.58056962162225 35.6094972335495, -82.58051062161923 35.609453233534424, -82.58041562161232 35.609395233512814, -82.58003962158243 35.60918423343123, -82.58002962157995 35.609189233431245, -82.57997862156331 35.60924223343682, -82.57996862155443 35.6092892334453, -82.57998062154661 35.60935323345957, -82.58003062154671 35.60940623347555, -82.58018762155169 35.609543233519545, -82.58021162155129 35.60957223352791, -82.58024762155054 35.60961523354036, -82.58028962154816 35.60967623355712, -82.58031762154049 35.609756233576306, -82.58033462153251 35.609826233592315, -82.58032862151752 35.60991723361018, -82.58030162149964 35.61000423362516, -82.58023162147263 35.61010423363831, -82.58014062144441 35.61018923364624, -82.580021621414 35.6102582336481, -82.5799296213941 35.61028823364474, -82.5798216213733 35.61030623363729, -82.57973862135894 35.61031023362959, -82.5796576213467 35.61030223361966, -82.57959262133853 35.610285233609574, -82.57951762133025 35.61025823359634, -82.57941062132058 35.61020523357451, -82.57935562131652 35.610172233562196, -82.57931562131382 35.61014723355301, -82.57922262131001 35.610071233527925, -82.57914062130673 35.61000423350589, -82.57895262129936 35.609849233455, -82.57891362129787 35.60981723344448, -82.5787986212932 35.60972323341354, -82.57876062129165 35.60969223340334, -82.57869062128884 35.60963523338453, -82.57848062128025 35.60946423332814, -82.57841162127755 35.60940723330944, -82.57854262131703 35.60929223329948, -82.57857962134555 35.60914723327374, -82.57997862178435 35.60780723314462, -82.5801946218694 35.60748823310184, -82.58026362189646 35.607387233088396, -82.58035262199662 35.60683223298452, -82.58022362204844 35.606357232874515, -82.5798326221151 35.60550223266027, -82.57972362212226 35.60533823261569, -82.57945462213954 35.60493623250627, -82.57936862214109 35.60483323247638, -82.57931562214888 35.60472523244893, -82.5792636221569 35.60461723242164, -82.57888162221418 35.60383323222273, -82.57836162224021 35.60310323202073, -82.57740662223082 35.60213423172535, -82.57681162222374 35.60153823154285, -82.57650762221989 35.60123523144993, -82.57632362223826 35.600917231366275, -82.57622062224868 35.60073823131929, -82.5760696222897 35.600309231216386, -82.57601462240605 35.59949423104485, -82.57597562248938 35.59891123092213, -82.57593762257265 35.59832923079973, -82.57592562258712 35.59822223077669, -82.57591262260146 35.598115230753606, -82.5758826226348 35.597866230699836, -82.57585262266939 35.59760923064448, -82.5756826227089 35.59716923053738, -82.57529662272671 35.596637230389405, -82.57529162272694 35.59663023038746, -82.57501262273783 35.59625823028307, -82.57508162276288 35.59617023027227, -82.57529262283826 35.59590823024062, -82.57536262286327 35.59582123023003, -82.57539962287632 35.59577623022464, -82.5755036229121 35.59565623021098, -82.5755156229154 35.595647230210325, -82.57556562292834 35.59561723020938)))",4587,37,021,001400,370210014002,869,869,317,810,441,197,3,2,0,167,59,588,186,402,568,339,125,2,2,0,100,20,352,310,42
census_2010_blockgroups_view.fid--2dc29038_13ec899ba8f_-264e,"MULTIPOLYGON (((-82.31374157882942 35.600408204245845, -82.31341957874935 35.60058220424795, -82.31271257857614 35.60094720424915, -82.31234457848711 35.60113020424843, -82.31225657846564 35.60117520424845, -82.31223757846102 35.60118520424856, -82.31203157840937 35.601299204250445, -82.31193057838142 35.60137220425483, -82.31185657836069 35.60142720425834, -82.31183857835448 35.601448204260755, -82.3117945783392 35.60150020426683, -82.3117525783243 35.60155120427278, -82.31168757829488 35.60167220429068, -82.31166357828106 35.60173620430119, -82.31159757824126 35.60192320433234, -82.31156357822017 35.60202320434916, -82.31149157816964 35.60227320439246, -82.31143557812615 35.60249520443171, -82.31138757808834 35.60268820446591, -82.31136657807146 35.6027752044815, -82.31134057804641 35.60290920450597, -82.31126457797218 35.603308204579044, -82.31125157794905 35.60344420460537, -82.31125157793163 35.60355720462828, -82.31125357792807 35.60358220463357, -82.31126557791121 35.603704204659564, -82.31129057789951 35.603806204682826, -82.31132557788679 35.60392620471082, -82.3113265778867 35.603928204711316, -82.31136957788034 35.60401520473342, -82.31143857787474 35.60412520476281, -82.31150757787341 35.60420720478656, -82.31154257787367 35.60424320479744, -82.31160357787418 35.604305204816335, -82.31163657787559 35.60433120482503, -82.3117125778785 35.604393204845515, -82.3117705778819 35.60443320485956, -82.31189557788893 35.60452120489032, -82.3121775779116 35.6046762049508, -82.31220757791424 35.60469120495696, -82.31235857792687 35.604770204988576, -82.31243557793343 35.60481020500461, -82.3125325779417 35.60486020502481, -82.31266457795178 35.604936205053804, -82.31271557795571 35.604965205064936, -82.31273857795676 35.60498320507093, -82.31276557795816 35.60500320507784, -82.31280757796013 35.60503520508866, -82.31283957795945 35.60507320509969, -82.31286257795935 35.60509920510729, -82.31287857795454 35.60514720511867, -82.31288757795197 35.60517320512489, -82.3128925779355 35.605285205148185, -82.31283957788058 35.605584205203364, -82.31281757785699 35.60571320522726, -82.31275457780654 35.60597220527335, -82.31272157777236 35.60615820530771, -82.3127355777541 35.60629120533613, -82.3127655777468 35.60637020535529, -82.31281457774381 35.60644220537488, -82.31292457774661 35.60654120540634, -82.31331457777887 35.60674920548874, -82.31345057779025 35.60682120551745, -82.31362257780127 35.60693320555787, -82.31372257780366 35.60702520558681, -82.3137325778039 35.607034205589656, -82.31392557778968 35.607332205670076, -82.31400357778685 35.60743320569865, -82.31408057778746 35.607512205722564, -82.31418257779237 35.607589205748745, -82.31431057780473 35.607646205773506, -82.31433157780741 35.6076512057767, -82.31461057784179 35.60772720582085, -82.31531257792997 35.60790620592952, -82.31663557809922 35.6082252061307, -82.31693957813717 35.608304206178026, -82.31743357819879 35.6084332062552, -82.31770357822711 35.60853820630433, -82.31779257823598 35.60857620632116, -82.31779157824111 35.608542206314205, -82.31780257825679 35.60845220629706, -82.3177985782657 35.60839020628403, -82.31781257827576 35.608340206275344, -82.31787257830807 35.60819520625207, -82.31788457831439 35.608167206247636, -82.31796957834888 35.60803520622961, -82.31803857837274 35.60795420622033, -82.31814457840618 35.607851206210285, -82.31824057843332 35.607778206205396, -82.31835157846253 35.60770820620262, -82.3184565784874 35.60765920620347, -82.31863057852297 35.60761520621251, -82.31882857855656 35.60760920623181, -82.31888157856545 35.60760820623693, -82.31909557859362 35.60765520626857, -82.31921757861028 35.60767720628561, -82.3191285785675 35.60785920631335, -82.31900157849236 35.60820920637128, -82.31898957848486 35.60824520637741, -82.31887657840835 35.60861920644161, -82.31880157834985 35.60891820649457, -82.31876257830783 35.6091482065373, -82.3187305782444 35.60952420661029, -82.31872157820163 35.60979120666361, -82.31872157818476 35.6099002066857, -82.31872357815679 35.610083206723026, -82.31874557811796 35.61035820678113, -82.31874957810062 35.61047420680503, -82.31875057809678 35.610500206810414, -82.31875357808529 35.610578206826595, -82.3187555780814 35.6106052068323, -82.31876757803762 35.610901206893594, -82.31877757800397 35.61112920694089, -82.31881457790783 35.611791207079044, -82.31882457788443 35.611953207113, -82.31882457786347 35.61208820714044, -82.31882457782464 35.61234020719154, -82.31882457782378 35.612345207192526, -82.31882457780536 35.61246420721676, -82.31884657771091 35.6130992073479, -82.31885357768445 35.613277207384755, -82.31885657767337 35.61335220740021, -82.31885757766965 35.613377207405456, -82.31886057765865 35.613452207421005, -82.31886157765479 35.613478207426375, -82.31886557763966 35.613580207447455, -82.31887757759381 35.6138892075114, -82.31888257757878 35.61399220753278, -82.31888957755407 35.614159207567475, -82.31891257748043 35.614660207671534, -82.31892057745597 35.61482720770623, -82.31893057742029 35.61506820775621, -82.31893857739352 35.61525020779399, -82.31896557736766 35.61544620783646, -82.31899957735376 35.61557220786557, -82.31907657733589 35.615770207913734, -82.31911457732717 35.615867207937356, -82.31918257731984 35.61598720796868, -82.319201577318 35.61601920797719, -82.3192455773134 35.61609620799734, -82.31926057731263 35.61611720800308, -82.3192825773113 35.616149208011855, -82.31930357730981 35.6161812080205, -82.31932757730844 35.616216208030146, -82.31937257730651 35.616276208046955, -82.31939657730553 35.61630820805591, -82.31963357729634 35.61662120814392, -82.31976157729115 35.61679120819159, -82.31994057728252 35.61703820826018, -82.32010857727609 35.61725920832236, -82.32022557727363 35.61740020836304, -82.32036957727549 35.617542208406775, -82.32055557727806 35.61772420846281, -82.32061357728115 35.6177662084773, -82.32066757728523 35.61779720848918, -82.32066857728586 35.61779420848869, -82.32071057730242 35.6177322084804, -82.32081857731187 35.617786208502544, -82.32082157731193 35.617789208503446, -82.32102057730877 35.618022208571276, -82.32106457730717 35.61807920858737, -82.32114157730452 35.61817920861558, -82.32143957729349 35.61856820872527, -82.32144857729318 35.618580208728645, -82.3218145772826 35.61903920885956, -82.32201357727564 35.61929720893249, -82.32221457727002 35.61954820900412, -82.32227757725383 35.61972020904551, -82.3222865772398 35.61982020906679, -82.3222905772344 35.61985920907513, -82.32226057720968 35.619987209098, -82.32218957717511 35.620135209120704, -82.32212157713944 35.62029320914573, -82.32205757710818 35.620427209166344, -82.32186557701404 35.62083020922835, -82.32182357699305 35.620921209242546, -82.32180657698315 35.62096720925007, -82.32176657696476 35.6210432092614, -82.32175457695895 35.62106820926524, -82.32166257691107 35.62127920929864, -82.32162957689324 35.62135920931145, -82.32154657685219 35.62153620933878, -82.32129957672907 35.62206820942127, -82.32121857668817 35.62224620944906, -82.32106457660974 35.62258920950285, -82.321035576595 35.622653209512784, -82.32096657655408 35.62284420954453, -82.32092657652042 35.62301920957584, -82.32091457650344 35.6231162095943, -82.32090257648787 35.623204209610975, -82.32088257645974 35.62336420964132, -82.3208735764421 35.62346920966177, -82.32086757642723 35.6235582096792, -82.32085757641094 35.62365320969746, -82.32083357636583 35.623919209748934, -82.32083257636218 35.623941209753326, -82.32083157634708 35.62403820977287, -82.32082457631363 35.6242472098146, -82.32083557631528 35.624248209815924, -82.32084357629458 35.624390209845586, -82.32084457629301 35.62440120984791, -82.32088257627046 35.62458820988979, -82.32094057625127 35.624774209933534, -82.32095157624849 35.62480320994057, -82.32100357623656 35.624936209972915, -82.32101157623482 35.62495620997788, -82.32103557622933 35.62501720999268, -82.32104457622762 35.62503820999788, -82.32110557621495 35.62518521003401, -82.32128957617708 35.62562621014252, -82.32135157616464 35.62577321017877, -82.32139257615654 35.6258692102024, -82.32144257614682 35.625985210231164, -82.32150557611763 35.626241210289585, -82.32151457610229 35.62635021031263, -82.3215155760778 35.62650921034501, -82.32150657604832 35.62669021038082, -82.32149657602997 35.626798210401695, -82.32149357601337 35.62690221042254, -82.32148757600622 35.62694221043006, -82.32146457597304 35.62713221046621, -82.32145357594659 35.62729121049739, -82.32144857593305 35.62737321051355, -82.32144857593057 35.62738921051678, -82.32142857590746 35.62751721054068, -82.32142657590482 35.62753221054347, -82.3213895758779 35.62766721056711, -82.32136457586431 35.627728210576905, -82.32133457584716 35.62780721058982, -82.32125957581401 35.62794121060933, -82.32125457581171 35.62795021061063, -82.32117157578072 35.62806221062477, -82.32116057577662 35.628077210626685, -82.3209915757188 35.62827021064847, -82.32084757566899 35.628438210667696, -82.32084357566792 35.62844121066791, -82.3208335756646 35.62845221066906, -82.32083057566344 35.62845621066961, -82.32069757561868 35.62860321068576, -82.32066857560869 35.62863721068966, -82.32043957553124 35.62889321071802, -82.32029957548465 35.62904521073437, -82.32016557543979 35.62919121075022, -82.31998557542681 35.62908321070978, -82.31963557540152 35.62887321063098, -82.31944357538679 35.62876321058889, -82.319262575373 35.62865921054912, -82.31911457536229 35.6285702105158, -82.31867057533027 35.628303210415744, -82.31865857532932 35.62829621041308, -82.31857257532556 35.62822921039063, -82.31854857532826 35.62818621037941, -82.31854257532767 35.628183210378225, -82.31849457533204 35.6281042103572, -82.31848157533173 35.628092210353564, -82.31844857532877 35.6280762103468, -82.31841657532439 35.62807021034232, -82.31832157530945 35.6280652103315, -82.31777857522395 35.62803821026999, -82.31772357521518 35.62803621026389, -82.31759757519497 35.62803221025018, -82.31741757516598 35.62802721023051, -82.31734357515406 35.6280252102225, -82.31704157510667 35.62800921018815, -82.3168815750811 35.628003210170384, -82.31670257505255 35.627997210150745, -82.3165975750363 35.62799021013848, -82.31649757502052 35.627985210127115, -82.31628457498833 35.62796621010125, -82.31623757498113 35.62796221009562, -82.31618157497293 35.62795521008845, -82.31612957498051 35.627851210062, -82.31609557501272 35.62760621000876, -82.31608857502046 35.62754920999642, -82.31620957512717 35.62698820989503, -82.31629057517374 35.62677420985999, -82.31641357522385 35.62658120983352, -82.31649957525855 35.62644920981558, -82.31656557529945 35.62625520978302, -82.31636757542154 35.625254209559365, -82.31636057542256 35.6252402095558, -82.31629357542627 35.62514520952966, -82.31626857542653 35.62511620952123, -82.31624757543376 35.62504720950499, -82.31620157545113 35.62488620946761, -82.31619557547535 35.62472320943383, -82.31619457548052 35.624688209426665, -82.3162065754938 35.62461520941303, -82.31622157551152 35.62451720939478, -82.31626857554042 35.62438020937176, -82.3163185755601 35.62430620936192, -82.31635557557428 35.62425420935515, -82.31658457564373 35.62405020933742, -82.31669557567086 35.623993209337264, -82.31676157568646 35.62396220933781, -82.31678557569283 35.62394720933727, -82.31690757572251 35.623885209337224, -82.3171225757734 35.623786209339315, -82.31714457578038 35.6237642093371, -82.31719657579657 35.623715209332566, -82.31728457584938 35.62346820929138, -82.31728657585295 35.62344720928742, -82.31729657586398 35.62338620927608, -82.31729957586761 35.62336620927232, -82.31730457587386 35.62333120926566, -82.3173205758926 35.623227209246274, -82.3173265758988 35.62319320923999, -82.31734457592046 35.62307220921727, -82.31733157597532 35.62270420914123, -82.31733157597948 35.62267720913578, -82.31734557604396 35.62227520905561, -82.31730457608484 35.62196720898882, -82.31720357608933 35.62183020895065, -82.31698157607816 35.62166520889423, -82.31662457603363 35.6215722088386, -82.31660157603116 35.62156320883432, -82.31628157599829 35.62143420877516, -82.3161195759804 35.621377208746914, -82.3159985759669 35.621335208725895, -82.31581057594674 35.62126420869208, -82.31573957594324 35.62121120867405, -82.3156625759394 35.62115420865449, -82.31549457595835 35.62085220857586, -82.31533857595636 35.62069820852852, -82.31486357593157 35.620351208409176, -82.31484057593029 35.62033520840355, -82.31469857592725 35.6202032083621, -82.31468757592886 35.620181208356485, -82.31466957592752 35.620170208352356, -82.31464657592747 35.62014620834517, -82.31462957593037 35.620109208335876, -82.31459957593589 35.620041208318995, -82.31456957593159 35.620037208315054, -82.31448157591848 35.62002820830418, -82.31445257591409 35.620025208300596, -82.31432657589549 35.62001120828472, -82.31396857584232 35.61997220823987, -82.31251857562707 35.61981620805878, -82.31225857558834 35.61978920802647, -82.31203557555517 35.61976520799859, -82.31168957550379 35.619728207955404, -82.31138657545864 35.61969620791767, -82.31065157534793 35.6196272078279, -82.31048957532347 35.61961220780808, -82.31030557529516 35.619599207786564, -82.30990657523361 35.61957120773969, -82.30947657516548 35.61955220769143, -82.30940157515343 35.61955020768334, -82.30902757509286 35.61954220764311, -82.3075825748569 35.61952520749064, -82.30668857470978 35.619522207397914, -82.30632457464968 35.61952220736034, -82.30578457456173 35.619514207303006, -82.30578357456235 35.61950920730192, -82.3057595745656 35.61946220728986, -82.30574257456996 35.61941620727879, -82.30569457458314 35.61927920724602, -82.30562857457164 35.61928320724007, -82.30554957455789 35.61928820723287, -82.30543357453821 35.619291207221565, -82.30536857452708 35.61929420721551, -82.30528557451285 35.619297207207566, -82.30500157446639 35.619294207177596, -82.30495657445951 35.61929120717237, -82.30460857440464 35.619274207133024, -82.30420757434365 35.61924020708481, -82.30372857427345 35.619183207023795, -82.30332057421329 35.619136206972236, -82.3031075741822 35.61911020694496, -82.30299357416534 35.61909720693055, -82.30273857412791 35.61906720689824, -82.30233757406818 35.61902520684828, -82.30201357401899 35.61899720680922, -82.30195657401023 35.618993206802536, -82.30168657396823 35.618976206771244, -82.30129057390425 35.61896720672855, -82.30100157385729 35.61896220669775, -82.30029157373968 35.61896520662509, -82.3002145737265 35.61896820661776, -82.30010257370783 35.61896920660646, -82.29980557365803 35.61897420657683, -82.29970757364163 35.61897520656688, -82.29861257345843 35.618991206457196, -82.29807257336853 35.61899620640251, -82.29408457270357 35.61903820599975, -82.29316957255092 35.619049205907615, -82.29153557227791 35.61907020574331, -82.29063757212823 35.61907920565252, -82.2879465716794 35.61910920538105, -82.28786957166656 35.61911020537331, -82.28704957152976 35.61911920529049, -82.28705157150803 35.61926220531976, -82.28705257150716 35.61926920532125, -82.28705957144254 35.619694205408194, -82.28706257142068 35.61983820543772, -82.28706257141499 35.61987520544527, -82.28706257140823 35.61991920545419, -82.28706257140708 35.61992620545565, -82.287073571368 35.620191205510494, -82.28707557136434 35.62021620551577, -82.28707057135368 35.62028020552829, -82.28687257132052 35.620283205508464, -82.28666957128976 35.62026520548382, -82.28648157126155 35.6202472054608, -82.28647757126086 35.620247205460444, -82.28628357123563 35.62020320543147, -82.28605157120727 35.62013920539455, -82.2858045711818 35.62004020534897, -82.28543957114756 35.61987220527728, -82.28500657110165 35.619707205199084, -82.28481857107863 35.619655205169124, -82.28474757106991 35.619636205157974, -82.28444057102789 35.61958020511496, -82.28423657099623 35.619567205091236, -82.28408357097253 35.61955720507339, -82.28401857096209 35.619555205066305, -82.28336457085635 35.61954120499602, -82.2831475708211 35.619537204972815, -82.28314057081413 35.61957520497982, -82.28312057080818 35.61959220498119, -82.28287157075268 35.61968520497435, -82.28270257071206 35.61976720497359, -82.2825955706791 35.61986620498267, -82.28252757065162 35.61997120499688, -82.28250757060752 35.62023520504844, -82.28243057055515 35.62049120509239, -82.28239957053368 35.62059720511068, -82.28230357048706 35.62079620514119, -82.28229357048625 35.62079020513891, -82.28226257048551 35.62076220513008, -82.282205570484 35.62071120511385, -82.28215057048452 35.620649205095575, -82.28214057048454 35.620638205092284, -82.28212557048737 35.62060420508387, -82.28205057046141 35.62069220509394, -82.28202457045178 35.620726205098194, -82.28198357043622 35.62078320510552, -82.28196157042609 35.620825205111835, -82.28186957038912 35.62096620513095, -82.28177857035101 35.62111520515173, -82.28177157034798 35.621127205153506, -82.28169757031414 35.62126720517418, -82.28167557030403 35.62130920518048, -82.28151957023977 35.62155820521494, -82.28142257019972 35.621713205236354, -82.28132257016128 35.62185520525486, -82.28119657011554 35.62201620527453, -82.28107957007501 35.62215320529021, -82.28088057001126 35.62235320531026, -82.28071256995719 35.62252320532743, -82.28064956993421 35.62260420533736, -82.2805695699037 35.62271620535185, -82.28050756987987 35.622804205363295, -82.28035856981431 35.623069205401684, -82.28033556980397 35.62311120540786, -82.28029956978521 35.623194205420965, -82.28029456973252 35.62352920548841, -82.28028056957423 35.624537205691475, -82.28027656952153 35.62487320575926, -82.28008356950993 35.62474220571268, -82.27975556949022 35.62452020563384, -82.27951456947798 35.62434220557288, -82.27950556947754 35.624335205570496, -82.27937656947192 35.624234205536695, -82.27935356947602 35.62418320552395, -82.27934456947415 35.62418520552351, -82.27933456947336 35.62418020552141, -82.27928056946855 35.62415320551037, -82.27926356946713 35.624144205506795, -82.27919856946711 35.6240752054861, -82.27917056947024 35.6240252054731, -82.27911156947664 35.623921205445875, -82.2790705695003 35.62372420540167, -82.27906256951961 35.62359120537387, -82.2790615695245 35.62355820536711, -82.27903856953158 35.62348820535056, -82.27902056953498 35.62344720534032, -82.27909556955863 35.62337420533325, -82.2791405695795 35.62328720532021, -82.27917556959551 35.623221205310436, -82.27924856963789 35.623025205278275, -82.27929956967658 35.6228292052437, -82.2793255696993 35.62271020522229, -82.27933656970876 35.62266120521347, -82.27932656973057 35.622509205181615, -82.27930356974582 35.622386205154285, -82.27925156975721 35.62225720512273, -82.2792345697611 35.6222142051123, -82.27916956977204 35.622074205077126, -82.27906756977826 35.62192520503637, -82.27896156977825 35.62181220500255, -82.2788025697743 35.621668204956904, -82.2787685697725 35.621643204948334, -82.27855556976141 35.62148820489489, -82.27851856975929 35.62146220488581, -82.27850556975868 35.62145220488242, -82.27841756975592 35.621376204857995, -82.27838456975498 35.62134720484865, -82.2782985697535 35.621265204823146, -82.27823956975523 35.62119120480206, -82.27817656975998 35.62109320477568, -82.27817456976007 35.621090204774845, -82.2781505697679 35.62101420475698, -82.27810356977078 35.620945204738106, -82.27802756976877 35.62087720471644, -82.27795656975984 35.62085920470557, -82.27788456974785 35.62086020469827, -82.27782356973636 35.62086920469381, -82.27776956972282 35.620899204694354, -82.27768756970391 35.62093420469296, -82.27762456968723 35.620974204694605, -82.27749556965469 35.6210472046961, -82.27743756963845 35.621090204698774, -82.27737956962369 35.62112420469977, -82.27736456961962 35.62113420470019, -82.27733856961768 35.62111920469445, -82.27731156961586 35.62110220468826, -82.27728456961356 35.6210882046826, -82.27727856961319 35.62108420468118, -82.27724156961169 35.621054204671246, -82.27722156961015 35.621043204667, -82.27719456960924 35.62102020465959, -82.2771195696086 35.620944204636366, -82.27709656960344 35.620953204635846, -82.27702956958805 35.62098120463463, -82.27700756958285 35.62099120463436, -82.27704356956647 35.621135204667326, -82.2770865695473 35.62130520470622, -82.27714656952045 35.62154220476052, -82.27714256951593 35.62156720476516, -82.27712456949008 35.62171520479332, -82.27703656946606 35.621776204796625, -82.27697456944911 35.621820204799164, -82.27674156939979 35.621890204789366, -82.27672756939675 35.62189520478887, -82.27663856937924 35.621913204783404, -82.276571569366 35.62192720477934, -82.27652956935952 35.621924204774366, -82.27637956933624 35.62191520475702, -82.27619856930805 35.6219042047361, -82.27619056930672 35.62190420473526, -82.27608956929178 35.62189320472265, -82.2759955692778 35.62188320471093, -82.27599056924691 35.6220772047498, -82.2760225692347 35.622190204776004, -82.27611956919797 35.62253120485519, -82.2761525691858 35.62264520488169, -82.27618456918705 35.62267120489024, -82.27626556919034 35.62273620491181, -82.27626756918713 35.62275920491673, -82.27627256918126 35.62280220492594, -82.2762895691593 35.62296220496016, -82.27632056912142 35.623240205019776, -82.27625456908034 35.62343520505254, -82.27625356907937 35.6234402050534, -82.27623656906859 35.62349220506222, -82.27613656904921 35.62351020505553, -82.27598456901987 35.62353820504553, -82.27587456901348 35.623462205018804, -82.27525456897743 35.623034204868, -82.2752695689963 35.62292820484806, -82.27531056904704 35.622644204794675, -82.27523756903715 35.62263020478432, -82.27501856900734 35.622589204753346, -82.27494656899736 35.62257620474328, -82.27480956893292 35.62284720478414, -82.27479456892542 35.622879204789044, -82.27453356884638 35.62311220480943, -82.27437156880866 35.6231832048071, -82.2740225687532 35.62316920476828, -82.27394456874059 35.62316720475979, -82.27372956871538 35.62310120472421, -82.27364456867076 35.62329920475562, -82.27351456860171 35.62360620480448, -82.2734015685379 35.62389820485204, -82.27335456851075 35.62402320487254, -82.27332056849359 35.62409820488428, -82.27316056848157 35.62400520484889, -82.27301756847292 35.62390820481451, -82.27295156846984 35.623858204797514, -82.27293256847027 35.62383520479092, -82.27287156847164 35.6237612047696, -82.27274756848696 35.62353020470996, -82.27267156851464 35.623270204649366, -82.27265656853767 35.62310520461426, -82.27266256855265 35.6230152045967, -82.27268056857434 35.622894204573996, -82.2728115686544 35.622516204510816, -82.27285656868172 35.622388204489525, -82.27299056875106 35.622083204441445, -82.27312456882923 35.621720204381624, -82.27300956880686 35.62174220437425, -82.27298056880097 35.62174920437267, -82.27287056877881 35.62177520436656, -82.27276756875723 35.621805204362026, -82.27267456873695 35.621837204358975, -82.27256456871285 35.62187520435528, -82.27243756868421 35.62192520435231, -82.27210356864585 35.62181720429601, -82.27198856863194 35.6217842042774, -82.27174756860333 35.62171220423793, -82.2714925685713 35.6216472041984, -82.27138656855855 35.62161620418126, -82.27128556854436 35.621600204167564, -82.27104956850886 35.62157820413871, -82.27086856848085 35.621566204117656, -82.27059156843684 35.62155520408681, -82.27050556842308 35.621552204077354, -82.27024756838145 35.621546204049544, -82.27010756835966 35.62153820403349, -82.27001956834593 35.621533204023336, -82.27000056834322 35.62153020402079, -82.26979856831316 35.62150920399565, -82.26968256829693 35.62149020397984, -82.26958156828181 35.621480203967394, -82.26940056829038 35.62123120389819, -82.26936956829097 35.6211952038877, -82.26930956829486 35.62110620386348, -82.26868156831179 35.62032720364064, -82.26845656830989 35.62009920357117, -82.26838556830099 35.62008120356016, -82.26757356819206 35.61991920344353, -82.2673375681936 35.61965820336623, -82.26703456818012 35.619422203287165, -82.26674856815981 35.61924820322228, -82.26660856816079 35.61909320317646, -82.26644156816397 35.618894203118785, -82.26578756815329 35.61826620292398, -82.26484956805623 35.6178932027515, -82.26500756824959 35.61681220254852, -82.26503356827173 35.61669720252788, -82.26522356842062 35.61593720239336, -82.26526856846137 35.615722202354334, -82.26498556852889 35.61498420217549, -82.2647995685379 35.61472720210421, -82.26466756857182 35.61436720201753, -82.26517356875233 35.61374020194257, -82.26559856887897 35.61337520191241, -82.26688556912498 35.61315720200091, -82.2672915692369 35.6128662019838, -82.2675895693017 35.61276520199405, -82.26847256947586 35.612581202047814, -82.26871656957056 35.61222920200159, -82.26876256958187 35.61220520200148, -82.26893956965594 35.611915201960855, -82.26892556971113 35.61154320188401, -82.26890456978907 35.61101720177506, -82.26921856989243 35.610684201739986, -82.26966657013209 35.60961220156874, -82.27004757018217 35.6096952016249, -82.2706135703102 35.60947120163781, -82.271168570379 35.60961820172491, -82.27143157047138 35.609301201687664, -82.27158957048589 35.6093762017192, -82.27210057061176 35.609107201717336, -82.27351257083994 35.60913820186927, -82.27446057101425 35.60902220194351, -82.27535557116569 35.608998202030975, -82.27631657134383 35.60887120210436, -82.27668857139399 35.608944202157495, -82.27694557142232 35.609035202202456, -82.27730257146862 35.60911620225576, -82.27770557153517 35.60911620229732, -82.27797457158636 35.60907220231612, -82.27823757164501 35.60897320232311, -82.27845957171228 35.608775202305864, -82.2785535717456 35.60866020229229, -82.27870157182106 35.608330202240566, -82.27878357187869 35.608045202191235, -82.27883057194252 35.60768220212244, -82.27885757203285 35.60712720201263, -82.2789515721028 35.606775201950875, -82.27903257213899 35.606627201929264, -82.27932157223867 35.60629120189091, -82.27960457231168 35.606121201885536, -82.28027757247207 35.60580220189029, -82.28067457257407 35.605566201883306, -82.2810215726585 35.60539020188335, -82.28109257267761 35.605342201881015, -82.28131157274117 35.60516520186769, -82.28139357276288 35.60511220186538, -82.28151557279827 35.60501320185781, -82.28169157285302 35.604847201842304, -82.28185757290673 35.60467720182499, -82.28192857292525 35.604633201823376, -82.28206057296737 35.604501201810166, -82.2821905730804 35.6039092017035, -82.28228057320499 35.60319920156876, -82.28247857326514 35.60302120155306, -82.28307257339816 35.6027952015684, -82.28343857346862 35.602730201592976, -82.28409157357123 35.60276320166701, -82.28491257374043 35.60254520170743, -82.28546657387311 35.60227820171041, -82.28588257399544 35.6019312016829, -82.28639657410639 35.60176220170166, -82.28696057424683 35.6014552016975, -82.28761457442465 35.601003201673265, -82.28809057461172 35.600301201579825, -82.28845657474446 35.59983320152268, -82.28876357483375 35.59958320150356, -82.2886955748862 35.59917120141297, -82.28857757491036 35.59888920134359, -82.28890457504787 35.598348201267584, -82.28928157522127 35.59762920116056, -82.28935157530394 35.59716920107443, -82.28948057536749 35.596895201032105, -82.28988657549698 35.596491200992, -82.29035157562735 35.59614420096955, -82.29057957572974 35.59572520090804, -82.29076757578824 35.59554720089132, -82.29178657602743 35.59508720090305, -82.29184657605485 35.5949742008863, -82.29158957607486 35.59457020077787, -82.29164957614206 35.59419920070873, -82.29118657615174 35.593642200548, -82.29093157629411 35.59244820027945, -82.29087157641604 35.59159520010019, -82.29078457644958 35.59128520002834, -82.28597257627595 35.58726919871757, -82.28599557627977 35.58726919871994, -82.28607957629335 35.58727119872904, -82.28679257642567 35.58717619878321, -82.28723457650919 35.58710719881479, -82.28752757656488 35.58706019883547, -82.28782157662047 35.587014198856416, -82.28789857663486 35.58700319886215, -82.2882495767048 35.586925198882554, -82.28840457673499 35.58689519889237, -82.28869757679188 35.58684019891142, -82.28875757680363 35.58682819891517, -82.28893857683885 35.58679319892674, -82.28899957685066 35.5867821989308, -82.28911257685924 35.58684719895566, -82.28919457686536 35.58689519897381, -82.28942657690999 35.58685419898943, -82.28944757692257 35.58679519897965, -82.28949257694885 35.58667319895948, -82.28960257697057 35.58665019896614, -82.28966957698466 35.58663019896909, -82.2898115770141 35.58659119897577, -82.2900825770778 35.586468198978714, -82.29017457710067 35.586419198978305, -82.2903365771403 35.586335198977906, -82.29043357716417 35.586284198977594, -82.29060557720582 35.58619819897783, -82.2912085773517 35.58589819897912, -82.29141457740239 35.585790198978415, -82.29146257741397 35.58576619897851, -82.29158057744785 35.58567319897184, -82.29163257746941 35.58558919896017, -82.2916535774778 35.5855571989558, -82.29171557751137 35.58540619893157, -82.29176257753934 35.58527519890982, -82.29184257758607 35.58505819887409, -82.29190557761524 35.58493619885584, -82.29199557765156 35.584797198836895, -82.29211657769542 35.58464219881785, -82.29223157773933 35.584481198797064, -82.29227257775862 35.58440019878488, -82.29240357781975 35.58414419874649, -82.29241657782973 35.584093198737406, -82.29244657785266 35.58397719871697, -82.29245557788067 35.583805198683024, -82.29245957791917 35.5835601986337, -82.2924905779566 35.583351198594535, -82.29255157800142 35.583126198555135, -82.29257957802011 35.583035198539584, -82.2926365780577 35.58285219850833, -82.292775578144 35.58244219843941, -82.29286057818148 35.58229019841736, -82.2929335782066 35.58220519840763, -82.2930645782401 35.582128198405535, -82.2932215782733 35.58208119841218, -82.2937065783717 35.581962198437964, -82.29390557840985 35.58192819845164, -82.29408757844153 35.581917198468155, -82.29426957846759 35.58194319849214, -82.2945275784988 35.58201619853359, -82.29486557853856 35.58212019858951, -82.29513957857185 35.58219719863334, -82.29516757857576 35.58220219863728, -82.29536257860248 35.58223719866445, -82.29557057863424 35.58225419868933, -82.2958475786721 35.58230519872822, -82.29605057870124 35.58233319875484, -82.29623457873102 35.58233719877458, -82.29628357873888 35.58233819877987, -82.29636357875178 35.5823401987885, -82.29643057876295 35.582339198795225, -82.29648057877121 35.582339198800376, -82.29662657879548 35.582338198815194, -82.2967605788183 35.582334198828235, -82.29682557882913 35.58233319883467, -82.29683857883158 35.58233119883567, -82.29698257885919 35.58230619884536, -82.29710257888436 35.58227119885063, -82.29722057891236 35.582216198851626, -82.2973745789514 35.58212819884964, -82.29752757899254 35.582025198844505, -82.29776157905505 35.5818701988372, -82.29778957905889 35.58187519884109, -82.29784857906992 35.581867198845536, -82.2979205790842 35.58185119884971, -82.29870457925057 35.581612198882034, -82.29887957928584 35.58157019889153, -82.29895157929916 35.581561198897134, -82.29897357930278 35.58156119889946, -82.29903857931322 35.58156319890648, -82.29908757931898 35.581578198914606, -82.29915957932592 35.58161019892849, -82.29920257932777 35.58164419893984, -82.29923857932648 35.581691198953116, -82.29929757931345 35.58183819898895, -82.29936757930851 35.58194519901787, -82.29942157931063 35.58198919903242, -82.2994815793153 35.58202319904551, -82.2995415793216 35.582046199056364, -82.29977257934895 35.58211619909436, -82.29990157936287 35.58216419911741, -82.30004557937659 35.582229199145424, -82.3001835793853 35.582320199178056, -82.30026457938855 35.582385199199656, -82.30032357938904 35.58244519921781, -82.30037457938744 35.582510199236346, -82.30040857938192 35.58258219925445, -82.30042857937518 35.58264719926968, -82.30045057935769 35.58278419929969, -82.30046557935093 35.58284419931348, -82.30049257934826 35.58289019932552, -82.30052657934827 35.58292619933635, -82.30058057935291 35.58295419934764, -82.30063757935977 35.58297019935673, -82.3010025794165 35.582993199399056, -82.30110157943034 35.583009199412444, -82.30118757944028 35.58303719942704, -82.30126557944804 35.583070199441714, -82.30135757945628 35.58311519946036, -82.30154557946368 35.58326819951074, -82.30186657947027 35.58356819960474, -82.30196557947244 35.5836601996336, -82.30209057947175 35.583798199674455, -82.3022195794668 35.58396819972226, -82.30258157945032 35.58446219985983, -82.30265257944903 35.58454619988419, -82.3026685794487 35.58456519988967, -82.30271757944804 35.584622199906256, -82.30273457944782 35.584641199911864, -82.30276457944746 35.58467619992213, -82.3029795794511 35.584882199986055, -82.30302657945185 35.584927200000024, -82.3031545794551 35.585043200036694, -82.30365457946495 35.585514200183844, -82.30373157946605 35.58558920020701, -82.30397957946988 35.58582920028126, -82.30416957947325 35.586010200337526, -82.30448057947865 35.5863082004301, -82.30458757948297 35.58639420045853, -82.3046915794897 35.58646220048307, -82.30478157949835 35.58650220050043, -82.30488057950787 35.58654620051959, -82.30502757952443 35.58659620054484, -82.30520357954404 35.586657200575445, -82.30530757955228 35.5867152005979, -82.30539257955527 35.586786200621056, -82.30547857955465 35.586882200649356, -82.30552257955264 35.586942200666115, -82.30555357955136 35.58698420067776, -82.3056435795398 35.5871552007218, -82.30570657952374 35.58732620076297, -82.30590957945905 35.587962200912976, -82.30593857945469 35.58802120092789, -82.30596457945335 35.58805820093807, -82.30601057945331 35.58810720095278, -82.30610057945857 35.58816920097469, -82.30618757946989 35.58818920098764, -82.30625457947943 35.58819920099658, -82.30632757949067 35.588204201005084, -82.30651057952154 35.58820020102319, -82.30657557953134 35.588206201031056, -82.30660657953595 35.588209201034864, -82.30672757954942 35.58825120105592, -82.30679457955354 35.5882962010719, -82.30684757955407 35.58834920108819, -82.30702757954556 35.588597201156965, -82.30725357953435 35.588911201243995, -82.30732457953246 35.5889992012692, -82.30741057952343 35.58914920130849, -82.30743257951805 35.589208201322734, -82.30744257951038 35.58926820133597, -82.3074415795003 35.589332201348824, -82.3074315794883 35.58939920136134, -82.30740457947259 35.58947220137343, -82.3073695794571 35.589535201382574, -82.30732557943993 35.58959920139107, -82.30732357943896 35.58960320139171, -82.30725157940273 35.589761201416394, -82.30724457939294 35.58981720142696, -82.3072455793859 35.58986320143642, -82.30725657938017 35.58991220144745, -82.30726957937728 35.589945201455535, -82.30730957937638 35.58999420146953, -82.30735457937658 35.590040201483504, -82.30742157938049 35.59008720149999, -82.30750857938786 35.5901322015181, -82.30760557939827 35.590168201535384, -82.30768657940799 35.59019220154854, -82.30782457942746 35.59021320156703, -82.30791757944316 35.590211201576224, -82.30800557945919 35.59020120158329, -82.30808657947559 35.590182201587815, -82.3082055795027 35.59013320159014, -82.30850557957841 35.58996420158674, -82.30861057960234 35.589921201588794, -82.30870657962161 35.5898992015942, -82.3088205796418 35.58989020160418, -82.30891057965624 35.589893201614004, -82.30900957966973 35.58991120162793, -82.30910457968163 35.58993620164276, -82.30918457968973 35.58996920165766, -82.30925357969535 35.59000620167229, -82.30930357969632 35.59005320168704, -82.30936157969546 35.59012120170681, -82.30939857968782 35.590210201728695, -82.30941957967748 35.59029920174892, -82.30941557966176 35.59039720176837, -82.3093615796083 35.59068520182126, -82.30936457958813 35.59081920184876, -82.30938457958015 35.5908922018656, -82.30939057957809 35.59091220187027, -82.3094275795727 35.590986201889145, -82.30946657956956 35.59104820190576, -82.30951757956905 35.59110620192277, -82.30965357957184 35.591233201962574, -82.30984757957937 35.591392202014774, -82.31007157958959 35.59156520207299, -82.31011657959085 35.59160520208578, -82.31017557959255 35.59165720210237, -82.31020257959179 35.59169120211212, -82.31030257958945 35.59181320214715, -82.31033757958012 35.59191120217061, -82.3103515795763 35.591950202179966, -82.31036057956952 35.592004202191895, -82.31036257955995 35.5920682022051, -82.31034457953518 35.5922092022318, -82.31032957952226 35.59227720224404, -82.31031757949965 35.59241020226988, -82.31033257949038 35.59248620228676, -82.31035457948468 35.59254720230147, -82.31038557948044 35.592607202316835, -82.31043157947991 35.592660202332304, -82.31045957947957 35.592692202341695, -82.31062057948297 35.59284220238873, -82.31062157948304 35.592843202389055, -82.31066757948251 35.5928952024043, -82.31071157948041 35.59295620242123, -82.31074657947677 35.59301720243722, -82.31078657946978 35.59310520245924, -82.31080157946221 35.59317020247391, -82.31084657942685 35.59344720253479, -82.31087057941109 35.59357520256323, -82.31091557939314 35.59373920260111, -82.31095357938935 35.59380420261825, -82.31105357938642 35.59393020265412, -82.31112157938763 35.59399520267436, -82.31130457939771 35.59412520271957, -82.31158757941736 35.59430020278428, -82.3117325794278 35.594388202817065, -82.31180857942965 35.5944572028389, -82.31183157943008 35.59447920284577, -82.3118475794256 35.59452520285677, -82.31185457942257 35.59455220286295, -82.31184657941307 35.59460520287287, -82.31182357940445 35.59463620287679, -82.31180057939778 35.594655202878215, -82.3117555793867 35.59467820287826, -82.31172457938106 35.59468220287593, -82.31166357937087 35.59468220286959, -82.31159457936245 35.594663202858605, -82.31151857935643 35.59462120284227, -82.31145757935472 35.59456720282507, -82.3113045793554 35.59439920277518, -82.31120557935314 35.59430820274658, -82.31106857934698 35.59420120271069, -82.31094657934042 35.59411320268024, -82.31085457933646 35.59404120265621, -82.31074057933708 35.59391520261885, -82.31068657934046 35.593835202597035, -82.31061857935168 35.59369020256061, -82.31058057936782 35.59354520252723, -82.31054957938989 35.59336920248832, -82.31051957939727 35.593289202469, -82.31048857940212 35.593224202452646, -82.31042757940449 35.593144202430146, -82.31034357939998 35.59308320240909, -82.31023657939122 35.59302620238648, -82.30973357934413 35.592793202287375, -82.3096955793402 35.592778202280364, -82.30952757932067 35.59272520225236, -82.30943557930838 35.59270620223905, -82.30935957929702 35.592698202229535, -82.30926757928253 35.59269420221927, -82.30916857926489 35.592702202210624, -82.30891657921805 35.59273620219159, -82.30879457919265 35.59277020218595, -82.3086725791636 35.5928282021851, -82.30862757915125 35.592860202186976, -82.3085885791403 35.592889202188864, -82.30851857911577 35.59297320219871, -82.30849357910311 35.59302820220722, -82.30849657908976 35.593118202225874, -82.30852057908781 35.59315620223607, -82.30855057908792 35.59318720224544, -82.30858457908936 35.59321420225436, -82.30863757909651 35.59322520226211, -82.30870757910849 35.59322220226868, -82.3087625791199 35.593207202271294, -82.3088075791312 35.593182202270896, -82.30885957914535 35.59314620226888, -82.30898857918616 35.59301920225642, -82.3090515792045 35.59296820225255, -82.30911257922011 35.59293220225161, -82.30917557923327 35.5929142022545, -82.30922957924346 35.59290620225839, -82.30928557925274 35.59290620226416, -82.30933557926019 35.592911202270336, -82.3094385792736 35.59293420228554, -82.3095055792801 35.59296420229856, -82.30968157929262 35.593071202338436, -82.30986757930353 35.59319920238358, -82.31000057930592 35.59332620242309, -82.310041579302 35.593395202441236, -82.310094579297 35.59348420246483, -82.31012057928986 35.59355820248254, -82.31015157927719 35.59367320250907, -82.3102145792375 35.593997202581264, -82.31036057916597 35.59461620272195, -82.3103805791567 35.59469820274063, -82.31048057909705 35.59519120285101, -82.31054857909112 35.59530220288048, -82.31063957909377 35.595382202906166, -82.3107175791008 35.59542020292187, -82.31083257911422 35.595456202941094, -82.31098757913287 35.59550120296616, -82.31106357913998 35.595536202981116, -82.31114357914501 35.59558920300011, -82.31120957914695 35.5956472030187, -82.31129157914471 35.59574920304782, -82.31143657913834 35.59594520310257, -82.31152957913852 35.59604320313204, -82.31163957914298 35.596132203161424, -82.31173857914949 35.59619620318465, -82.31182857915813 35.596236203202, -82.31192257916965 35.596262203216924, -82.31201857918336 35.59627620322971, -82.31211257919871 35.59627720323963, -82.31228057923055 35.59625020325142, -82.31238457925346 35.59621320325462, -82.31250957928319 35.59615420325555, -82.31313257944159 35.59579520324687, -82.31316457944916 35.595780203247166, -82.31323557946553 35.59575020324836, -82.3132955794784 35.59573120325068, -82.31338657949645 35.59571120325603, -82.31346357951074 35.595701203261896, -82.31355957952645 35.59570220327202, -82.31365757954059 35.59571520328482, -82.31379557955846 35.59574720330542, -82.3139875795804 35.59581020333802, -82.31400657958245 35.59581720334142, -82.314242579608 35.59590420338338, -82.31437857962179 35.595960203408815, -82.31441057962503 35.59597320341468, -82.31444157962817 35.59598620342049, -82.31450457963393 35.596016203433145, -82.31453657963678 35.59603220343965, -82.31462457964447 35.596076203457656, -82.31505057967405 35.596340203555165, -82.31507357967533 35.59635620356082, -82.31525357968572 35.59648120360469, -82.31532457968547 35.59655920362785, -82.31537057967792 35.59665720365251, -82.3153925796699 35.59673220366997, -82.31541257965081 35.59687720370141, -82.31551057957506 35.597472203832304, -82.31552557954919 35.597656203871196, -82.31551657953581 35.597733203885916, -82.31548057951221 35.59784720390533, -82.31544657949807 35.59790220391296, -82.3154015794823 35.59795620391933, -82.31535757946813 35.59800120392388, -82.31532157945796 35.59802820392563, -82.31529257944945 35.59805220392753, -82.31521457942956 35.59809820392882, -82.3151165794062 35.59814420392807, -82.31494157936896 35.59819820392105, -82.31473857932825 35.59824520390966, -82.31471957932433 35.598250203908655, -82.31461557930515 35.598263203900615, -82.31447357928063 35.59827020388739, -82.31439157926876 35.598259203876694, -82.31430457925822 35.59823420386269, -82.31422257925038 35.59819720384669, -82.31408957924037 35.598120203817395, -82.31406557923887 35.59810420381168, -82.31386357922669 35.59796720376301, -82.3136595792145 35.597828203713796, -82.31356157921051 35.59774920368763, -82.31347157921022 35.597655203659265, -82.31338157921165 35.597549203628525, -82.31328057921604 35.5974132035905, -82.31324057921778 35.597359203575465, -82.313192579216 35.59731920356241, -82.31314357921326 35.59728420355018, -82.31310157920939 35.597264203541826, -82.31306457920442 35.597257203536635, -82.313016579197 35.59725420353105, -82.31297957919044 35.59725720352784, -82.3129275791795 35.597272203525506, -82.31287857916715 35.59730020352614, -82.3128245791506 35.59734920353052, -82.3127735791313 35.59742020353969, -82.31266957908171 35.597629203571344, -82.31263057906762 35.597679203577556, -82.31256857905011 35.597726203580635, -82.31249657903484 35.59774820357766, -82.31249157903366 35.59775020357757, -82.31243057902219 35.597759203573155, -82.31233257900743 35.59775020356122, -82.31224857899613 35.59773320354904, -82.3118005789387 35.59762620348119, -82.31162257891602 35.5975832034541, -82.31133957887963 35.59751620341133, -82.31119157885907 35.597491203391044, -82.31108557884211 35.59748720337929, -82.31103257883353 35.59748620337366, -82.31096657882135 35.597495203368645, -82.31090557880911 35.59750920336526, -82.31084757879775 35.59752020336145, -82.31079357878592 35.59753920335973, -82.31068657875944 35.597596203360325, -82.31063357874422 35.59763820336333, -82.31058757872951 35.59768420336796, -82.31054957871562 35.59773320337394, -82.31051957870069 35.59779820338408, -82.31050357869213 35.59783620339016, -82.31047357866298 35.59799320341893, -82.31048857864613 35.59811820344582, -82.31049357864474 35.598132203449225, -82.31052357863803 35.59820820346773, -82.31055357863524 35.59825820348098, -82.31059457863411 35.59830920349555, -82.31065357863524 35.598365203512955, -82.31071557863865 35.59840920352825, -82.31077357864281 35.59844420354139, -82.31083357864696 35.59848120355504, -82.31089857865211 35.59851720356909, -82.31091457865342 35.598526203572575, -82.3109655786577 35.5985532035833, -82.31098257865887 35.5985632035871, -82.31104957866438 35.598599203601246, -82.31146357869811 35.59882320368935, -82.31204257874539 35.59913620381259, -82.31290757881573 35.59960520399692, -82.31338957885504 35.599866204099534, -82.3135265788662 35.59994020412866, -82.3139385788995 35.60016520421679, -82.31407657891066 35.600240204246326, -82.31399457889218 35.600272204244284, -82.31374157882942 35.600408204245845)))",6390,37,021,003102,370210031024,1595,1595,57,1572,1466,47,10,22,2,25,23,1302,36,1266,1289,1206,44,7,14,2,16,13,846,660,186
census_2010_blockgroups_view.fid--2dc29038_13ec899ba8f_-264d,"MULTIPOLYGON (((-82.58312762688253 35.57808222741563, -82.58319162688899 35.57810922742767, -82.5832006268895 35.57811522742977, -82.58325662689515 35.57813922744041, -82.58342462691151 35.57821422747295, -82.58348062691688 35.578239227483756, -82.5835446269233 35.57826722749602, -82.58370562693904 35.57833822752703, -82.58374062694294 35.57835122753329, -82.58380762695023 35.57837622754521, -82.58387962695829 35.57840122755773, -82.58389462695985 35.57840722756049, -82.58407862698209 35.5784612275904, -82.58410062698518 35.5784652275935, -82.58417662699524 35.57848122760451, -82.58435862702036 35.57851522763015, -82.58462262705646 35.57856522766735, -82.5848996270971 35.578600227702914, -82.58490962709877 35.57860022770394, -82.58503462711872 35.5786052277178, -82.58509562712935 35.57860222772343, -82.58517062714242 35.5785982277303, -82.58527962716111 35.578594227740695, -82.58539762718247 35.578583227750585, -82.58547362719597 35.5785772277572, -82.58577662725034 35.578551227782924, -82.58618562732333 35.578518227818215, -82.58643062736553 35.57850822784139, -82.58658362739128 35.57850622785661, -82.58668762740751 35.57851322786872, -82.5867456274164 35.578518227875755, -82.58690062743945 35.578535227895074, -82.58698962745184 35.57855122790749, -82.58709362746649 35.57856822792165, -82.58740662751045 35.578620227964386, -82.58748462752145 35.57863322797499, -82.58751162752516 35.5786382279788, -82.58759962753746 35.57865322799088, -82.58786362757405 35.57870022802754, -82.58795262758633 35.57871622803997, -82.58820362762242 35.57875322807319, -82.58837162764816 35.578767228093305, -82.58855762767809 35.57877322811369, -82.58861462768732 35.57877522811991, -82.58874762771187 35.57875922813028, -82.58896162775326 35.578721228144545, -82.58901562776387 35.57871022814784, -82.58908362777699 35.578698228152334, -82.58930462782229 35.57864222816363, -82.58972562791229 35.57851222818035, -82.5898406279388 35.57846422818239, -82.58998862797505 35.57838822818213, -82.59007962800011 35.578323228178185, -82.59018662803236 35.57822922817007, -82.59028662806357 35.57813422816094, -82.59058862815755 35.57784922813394, -82.5905926281587 35.57784622813376, -82.59069562818878 35.57776222812719, -82.59075762820616 35.57771622812419, -82.59083762822665 35.577669228122836, -82.59085762823116 35.577661228123254, -82.59102362826874 35.577596228127085, -82.59127162832283 35.577512228135355, -82.59140062834972 35.57747722814154, -82.59142362835438 35.57747122814264, -82.59156362838061 35.57745222815314, -82.59159062838492 35.5774532281561, -82.59161762838934 35.577454228159084, -82.59169962840244 35.57745722816808, -82.59172762840696 35.577458228171196, -82.59174562840998 35.57745822817304, -82.59193262843483 35.577498228200405, -82.59203462844837 35.577520228215334, -82.59254062851168 35.57765522829482, -82.59267162852808 35.57769022831534, -82.59274562854081 35.577687228322326, -82.59285062855261 35.57772422834058, -82.59291162855877 35.57775022835221, -82.59305962857344 35.57781422838037, -82.59339062860134 35.57799022845026, -82.59354862861451 35.578075228483776, -82.59368862862665 35.578148228512966, -82.5941086286625 35.578368228600816, -82.59424862867446 35.57844222863028, -82.59425962867546 35.5784472286325, -82.59429562867855 35.57846622864007, -82.59429962867891 35.57846822864085, -82.59436862868478 35.57850422865523, -82.59457562870259 35.57861222869847, -82.59464462870835 35.57864922871307, -82.59463262868776 35.57877022873656, -82.59460662866027 35.57892122876469, -82.59458062863065 35.5790852287953, -82.5945596285981 35.579274228831636, -82.59453562853481 35.57966022890776, -82.59452762852068 35.57974322892387, -82.59450162847405 35.580018228977195, -82.59454362847754 35.580041228986246, -82.59457362847559 35.58008622899844, -82.5945786284632 35.580172229016505, -82.59455062841076 35.58048322907689, -82.59454962840742 35.58050322908089, -82.59452762834582 35.580880229155426, -82.59448162826202 35.58137522925148, -82.59446862824885 35.581447229264825, -82.59445162823924 35.58149122927203, -82.59437962822219 35.58152422927136, -82.59430162820755 35.581535229265604, -82.59397162815483 35.58152122922889, -82.59380062812738 35.58151522921007, -82.59352862808271 35.581512229181556, -82.59347162807185 35.581521229177554, -82.59371262807112 35.58178622925623, -82.59412062807026 35.58223222938895, -82.59435262806664 35.58250622946863, -82.59442762806611 35.5825912294936, -82.59457962806457 35.5827652295446, -82.59464762806898 35.58281022956078, -82.59468962807271 35.58283122956931, -82.59465762805948 35.58288222957642, -82.59450262800472 35.583071229599, -82.59448662799882 35.58309222960162, -82.59431962794494 35.58326222961912, -82.59425262792577 35.583314229622815, -82.59418162790828 35.583351229623126, -82.59412562789595 35.583371229621406, -82.59410862789251 35.583375229620486, -82.59406162788262 35.58338822961834, -82.59392562785835 35.583399229606535, -82.59370462782182 35.58339822958371, -82.59340062777136 35.583398229552486, -82.59311662772541 35.58339022952168, -82.59255662763465 35.583375229461254, -82.59226762758891 35.58336022942844, -82.59216562757277 35.58335522941697, -82.59198462754256 35.583356229398625, -82.59206762750738 35.583674229471896, -82.59209962749455 35.58379222949921, -82.59214962746938 35.58401022954872, -82.5921796274396 35.584236229597835, -82.59218762742414 35.58434522962083, -82.59218962739234 35.584554229663624, -82.59218062737622 35.58464922968201, -82.59216262734012 35.58486422972396, -82.59214762732029 35.584977229745455, -82.59212962729511 35.58512122977288, -82.59207762721971 35.585555229855906, -82.59206562720176 35.5856592298759, -82.59205962719442 35.58570022988357, -82.59205062718296 35.585765229895905, -82.5920316271577 35.58590822992305, -82.59202662714861 35.58596222993353, -82.59202162713767 35.5860282299465, -82.59200862711381 35.58616922997381, -82.59199362708382 35.58634823000877, -82.59198562705365 35.58653523004604, -82.59199062704556 35.586593230058405, -82.59200462702607 35.5867352300887, -82.59168662697357 35.586733230055685, -82.59165062696741 35.58673423005216, -82.59111462687561 35.586752230000826, -82.59075962681341 35.586773229968664, -82.59059262678352 35.58678722995435, -82.59024062672022 35.58681822992459, -82.58999862667568 35.58684622990542, -82.58977662663483 35.586872229887966, -82.5892756265396 35.58695022985234, -82.58924462653368 35.58695522985016, -82.58903762649298 35.58699622983724, -82.58860962640897 35.58708022981045, -82.58857662640237 35.58708722980852, -82.58784162625354 35.58726122976851, -82.58720762612427 35.58741722973514, -82.58675262603127 35.58753022971147, -82.58640562596175 35.58760722969151, -82.58621062592232 35.58765322968087, -82.58459162559329 35.588043229594085, -82.58405262548378 35.58817322956523, -82.58374962542257 35.58824422954847, -82.58371862541607 35.588252229547, -82.5832596253221 35.58836822952346, -82.58309962529044 35.5884012295138, -82.58284362523942 35.58845622949864, -82.58254062517908 35.588521229480854, -82.58191262505413 35.588655229443596, -82.5818796250476 35.58866222944165, -82.58160262499268 35.58872022942503, -82.58110262489232 35.588832229396495, -82.58078362482824 35.58890422937837, -82.58062262479592 35.588941229369404, -82.58017062470445 35.58904722934459, -82.58014062469863 35.58905322934275, -82.57998062466615 35.58909122933403, -82.5798476246396 35.5891202293263, -82.57973362461681 35.589145229319655, -82.5795366245773 35.58918922930841, -82.57939462454893 35.5892202293001, -82.57928162452617 35.589246229293764, -82.57911962449373 35.58928222928452, -82.57884862443997 35.589339229268326, -82.57828562432778 35.58946022923508, -82.57754162418796 35.5895662291803, -82.57710462410564 35.58962922914822, -82.57775462423487 35.58949122918689, -82.57775762423546 35.58949022918697, -82.57839162435849 35.589375229228736, -82.57890062446906 35.58920622924656, -82.57931262457615 35.58895522923775, -82.57954762465312 35.58870822921156, -82.57965162468685 35.58860122920049, -82.57992162479994 35.58815822913801, -82.57994462480794 35.58813122913489, -82.5800186248366 35.58802422912065, -82.58013962488339 35.58785122909785, -82.58034062495877 35.58757822906294, -82.58086362517533 35.58673522894499, -82.58110562524999 35.5865112289242, -82.58118562528041 35.58640022890983, -82.58128962531944 35.58625822889166, -82.58139962536909 35.58605422886132, -82.58146462539824 35.58593522884378, -82.58173762552164 35.5854282287686, -82.5819466256156 35.58504322871163, -82.58223862577864 35.58429822858995, -82.58237162587307 35.58382822850793, -82.58249262595865 35.58340222843363, -82.5825146259825 35.58327122840918, -82.58256662603985 35.58295422834997, -82.58263162611041 35.582566228277635, -82.58265462620172 35.58199722816414, -82.58266062622255 35.5818682281385, -82.58265662625129 35.581677228099224, -82.58265562625836 35.5816302280895, -82.58265462626754 35.581569228076965, -82.58264962627904 35.58148922806024, -82.5826476262858 35.58144322805066, -82.58264562628838 35.58142422804653, -82.58264262629649 35.581368228034854, -82.58264162629912 35.58135022803111, -82.5825826263947 35.58066522788562, -82.58255562643868 35.580350227818684, -82.58254062649557 35.579964227738564, -82.58255462655269 35.57960722766724, -82.58257562660825 35.57926922760064, -82.58264462672092 35.57861122747369, -82.58271662683774 35.57792922734225, -82.58279962684767 35.57795422735591, -82.58284662685313 35.57796922736374, -82.58285562685417 35.57797222736527, -82.58295762686559 35.578008227383044, -82.58304662687453 35.57804622739993, -82.58312762688253 35.57808222741563)))",6176,37,021,001100,370210011001,1371,1371,89,1338,1036,259,1,7,1,34,33,1162,53,1109,1139,905,207,1,6,1,19,23,717,664,53
census_2010_blockgroups_view.fid--2dc29038_13ec899ba8f_-264c,"MULTIPOLYGON (((-82.46755561454674 35.53366420651338, -82.46790761466556 35.53327020646946, -82.46797661468881 35.53319320646085, -82.46828161479988 35.532799206412065, -82.46882661496052 35.53234120637496, -82.46883561500627 35.53205320631732, -82.46923261504132 35.532252206398596, -82.46934661506025 35.532252206410256, -82.47007661518066 35.53225520648586, -82.47099261536742 35.53202720653352, -82.47103461537603 35.53201620653561, -82.47124661541889 35.53196520654698, -82.47143161545667 35.53191920655667, -82.47153461547789 35.531892206561736, -82.47293661576762 35.53151720662949, -82.4730026157811 35.53150020663283, -82.4745536161417 35.53082520665484, -82.47518561626522 35.53070220669469, -82.47632561647444 35.53056920678467, -82.4771146166299 35.53040820683296, -82.47754361671427 35.530321206859334, -82.47801561683681 35.53003220684908, -82.4783446169409 35.52970920681716, -82.47851961699645 35.52953620679991, -82.47904661716319 35.529019206748906, -82.47922261721874 35.528847206732074, -82.4797376173526 35.52853120672067, -82.4800906174282 35.52841920673413, -82.48050461749635 35.52842220677727, -82.4805216174987 35.528425206779524, -82.48170661766443 35.52862420694175, -82.48205261771302 35.52868020698865, -82.48222561773463 35.52872620701578, -82.48303361784859 35.52885520712495, -82.48319661787886 35.52883420713739, -82.48361161797371 35.528664207145404, -82.48407761810648 35.52830220711962, -82.48430961817682 35.52809420710112, -82.48439061821108 35.52795920708205, -82.48466661832704 35.52750120701721, -82.48504261851028 35.52671420689581, -82.48510761852575 35.526683206896216, -82.48525061855966 35.526617206897505, -82.4853006185722 35.52658920689687, -82.48536461858798 35.526555206896546, -82.48533061858362 35.52654720689146, -82.48523061857048 35.526525206876656, -82.48522861857022 35.52652420687631, -82.48519561856614 35.52651520687105, -82.48517861856425 35.526509206868155, -82.4851466185603 35.52650020686296, -82.48512961855863 35.52649320685988, -82.48511361855684 35.52648720685695, -82.48510361855583 35.52648320685512, -82.48507661855304 35.5264722068501, -82.48506761855207 35.526469206848624, -82.48503961854911 35.52645820684344, -82.48496061854534 35.526397206822956, -82.48490861854785 35.526325206802966, -82.48479661857334 35.52603820673317, -82.48479561857378 35.526034206732184, -82.4847226185835 35.525892206695836, -82.48459461859092 35.525706206644884, -82.48449061859888 35.525542206600875, -82.48446761860566 35.52547320658446, -82.48445461861576 35.52539320656686, -82.48445261864022 35.525232206533886, -82.48445661866296 35.52508820650502, -82.48447361867191 35.52504820649869, -82.48451061868269 35.525018206496384, -82.48456361869266 35.52501020650016, -82.48461261869728 35.52503320650993, -82.48465261869542 35.52508820652517, -82.48468161868718 35.52517320654548, -82.48471861868268 35.52524220656328, -82.48477461868262 35.52530320658145, -82.48478761868373 35.52531020658419, -82.48483361868739 35.525335206594015, -82.48491961869769 35.52536120660805, -82.48503461871482 35.52537420662258, -82.48520661874446 35.52536620663854, -82.48530161876235 35.525352206645515, -82.48545861879198 35.52532820665669, -82.48565061882793 35.525301206670925, -82.48582561885938 35.52528520668566, -82.48592961887576 35.525291206697524, -82.48593361887643 35.525291206697936, -82.48609161889895 35.5253142067189, -82.48626561892274 35.52534720674339, -82.48650861895489 35.52540020677917, -82.48670761897995 35.52545120680994, -82.4868306189938 35.525494206831326, -82.4868426189948 35.525500206833755, -82.48692161900165 35.525541206850164, -82.48699061900493 35.5255942068681, -82.48715861900735 35.52575920691888, -82.4872296190104 35.52581620693769, -82.4873306190178 35.52587720696047, -82.48776861906083 35.526069207044486, -82.48841761913536 35.526283207154634, -82.48864361915612 35.526392207199954, -82.48875361916437 35.52645720722448, -82.48884161916756 35.52653120724862, -82.48887861916835 35.52656620725945, -82.48905361917149 35.5267342073116, -82.48917861917613 35.526838207345634, -82.48927061918613 35.526873207362186, -82.48935461919675 35.526894207374994, -82.48940661920662 35.52688620737873, -82.48943461921188 35.52688220738081, -82.48952461923524 35.52682720737887, -82.48956861924911 35.52678420737468, -82.48970361929129 35.52665520736225, -82.48974861930516 35.526613207358395, -82.48982161930714 35.52667920737924, -82.4898286192986 35.52674220739282, -82.4898706192807 35.52690420743, -82.48989661927581 35.52696420744487, -82.48990461927453 35.526981207449225, -82.48995561927343 35.52704320746706, -82.49002261927622 35.527097207484886, -82.49010861928112 35.527158207506126, -82.49014561928261 35.52718820751603, -82.49026661928765 35.52728620754837, -82.49035161929245 35.52734620756931, -82.49043061929835 35.52739320758695, -82.49056961930184 35.52752020762704, -82.49065561930568 35.52758820764972, -82.49071961931169 35.52761820766243, -82.49074761931426 35.527631207667866, -82.49082561932721 35.52763120767588, -82.49093261934674 35.52761920768443, -82.49095561935138 35.527614207685765, -82.49105261937035 35.5275952076919, -82.49110561938036 35.527587207695646, -82.4911176193825 35.527586207696714, -82.4911846193951 35.527576207701564, -82.4913176194168 35.52757820771562, -82.49140661942916 35.527594207728015, -82.491472619435 35.527627207741475, -82.49152161943361 35.52768920775915, -82.49152161943339 35.527690207759306, -82.49156161942159 35.52781020778788, -82.49156761941867 35.52783620779371, -82.4915826194099 35.52790920781008, -82.49164461938993 35.52810620785655, -82.4916926193779 35.52823620788793, -82.49172261937039 35.528317207907435, -82.49172961936863 35.528336207911984, -82.49176861936186 35.528422207933495, -82.49189261935003 35.528633207989145, -82.49202361934118 35.528832208043035, -82.49206861933571 35.52891620806474, -82.49213661933298 35.52900720809022, -82.4922216193368 35.529074208112604, -82.49230161934328 35.52911820812972, -82.49239561935487 35.52914420814475, -82.49245261936325 35.52915120815196, -82.49249761937453 35.529126208151524, -82.49253561939337 35.5290442081387, -82.49253461940313 35.52898020812564, -82.49250861942234 35.52882720809184, -82.49249561943242 35.528747208074215, -82.49248261945374 35.528594208041795, -82.49250061947288 35.52848920802231, -82.49255261950556 35.52833220799572, -82.49256661951505 35.52828620798779, -82.49257261951841 35.528270207985145, -82.49264061953963 35.528205207978885, -82.49266861954588 35.528195207979785, -82.4926816195485 35.528192207980474, -82.4927156195534 35.52819720798492, -82.49274861955058 35.528250207999136, -82.492766619546 35.52830020801115, -82.4927666195456 35.52830220801154, -82.49277661953953 35.528353208022956, -82.49279861953225 35.528424208039645, -82.49284261952968 35.52848820805722, -82.49290761952938 35.52856020807848, -82.49294561953012 35.52859620808974, -82.49298261953086 35.52863120810066, -82.49303561953307 35.52867420811478, -82.49317161953866 35.52878420815114, -82.49334461955034 35.52889520819146, -82.49349761956042 35.52899420822731, -82.49366861957058 35.52911220826883, -82.49374561957356 35.529176208289776, -82.49397761959034 35.52931720834227, -82.49408561959706 35.52939020836823, -82.49414861959806 35.52945120838707, -82.4942556195968 35.52957520842326, -82.4942926195963 35.52961820843583, -82.49436261959865 35.52967820845519, -82.49443461960229 35.529732208473575, -82.49450561960992 35.52975920848635, -82.49457261962067 35.529761208493596, -82.49462461962992 35.529757208498154, -82.494688619643 35.52974120850144, -82.49473861965545 35.52971420850114, -82.49478561966872 35.52967820849864, -82.49484161968684 35.529620208492545, -82.49488761970449 35.52955520848411, -82.4949606197375 35.52941920846386, -82.4949676197413 35.52940220846112, -82.49500861976145 35.52931520844768, -82.49508461980322 35.52912520841681, -82.49512661982325 35.52904020840388, -82.49516861984652 35.52893420838664, -82.4952306198752 35.52881420836854, -82.4952936199022 35.528706208353114, -82.49543461995748 35.52849820832527, -82.49546361997692 35.52840320830894, -82.49547962000717 35.52822320827398, -82.49548762007025 35.527821208193025, -82.4954886200709 35.52781820819251, -82.49550262008572 35.52773620817729, -82.49553762009944 35.52768520817048, -82.49562162012026 35.527640208169906, -82.49567462013238 35.52761820817099, -82.49574962014606 35.527610208177, -82.49583762015881 35.52762220818856, -82.49593362016951 35.52765620820523, -82.49606162019302 35.527641208215364, -82.49607962019658 35.52763720821639, -82.4961466202092 35.52762720822125, -82.49629262023892 35.52759120822895, -82.49651562027263 35.52761220825603, -82.49653462027547 35.52761420825838, -82.49666262029903 35.52759920826853, -82.49696662036165 35.52751920828341, -82.49739862044551 35.52743920831148, -82.49792162053211 35.52743920836516, -82.49800662054628 35.52743920837394, -82.4985506206413 35.52740720842326, -82.49935062078612 35.527327208489105, -82.49984662088053 35.527247208523725, -82.5001666209532 35.52711920853052, -82.5004706210257 35.52697520853244, -82.50063062106695 35.52687920852931, -82.50082262112822 35.526687208509976, -82.50101462119201 35.526479208487395, -82.50127062127372 35.526223208461595, -82.50135162129894 35.52614620845429, -82.50155862136322 35.52595120843589, -82.50171862145851 35.52550320836115, -82.50191062156404 35.525023208283244, -82.50202462162903 35.52472320823394, -82.50203862163687 35.52468720822808, -82.50233962178193 35.52406720813282, -82.50244162183137 35.52385520810022, -82.50258262189895 35.5235672080561, -82.50267762194152 35.523392208030266, -82.50290062204095 35.52298520797037, -82.50297862207066 35.52287620795621, -82.5030966221149 35.52271520793557, -82.50332962211388 35.522973208011976, -82.50402862211041 35.52375020824169, -82.50426262210942 35.52400920831841, -82.50437062210892 35.52412920835382, -82.5046956221073 35.52449020846063, -82.5048046221068 35.524611208496395, -82.50502062210899 35.524830208563166, -82.50566862211522 35.525488208763505, -82.5058856221175 35.52570820883046, -82.50605362211573 35.525900208886775, -82.50628662212333 35.526102208951755, -82.50660462213355 35.52637920904073, -82.50699262216031 35.52662320913019, -82.50735762218567 35.5268522092142, -82.50764962219628 35.52709820929421, -82.50801562220944 35.5274072093946, -82.508087622214 35.527455209411784, -82.50852762224213 35.52774720951631, -82.50869462225278 35.52785820955599, -82.50923262229792 35.52814420966936, -82.50944762230661 35.52832020972725, -82.50973062229062 35.528729209839454, -82.5097836222879 35.52880420986015, -82.51005962228159 35.5291432099574, -82.50977862218821 35.52944820999063, -82.50949762207372 35.52989021005166, -82.50948262206188 35.52995121006259, -82.50938062197852 35.53038421014015, -82.50928562188989 35.530858210226846, -82.50909562179685 35.531259210288916, -82.50881562168107 35.53171121035206, -82.50830162153716 35.53209321037703, -82.50790762143546 35.5323302103848, -82.50769362138007 35.532460210389274, -82.50716462124801 35.532749210393696, -82.50703762121526 35.532825210396176, -82.5066016211031 35.53308521040432, -82.5064816210734 35.533149210405035, -82.50606062096892 35.53337521040771, -82.50544462080337 35.53378821042851, -82.50505862067541 35.53420521047372, -82.50498362064431 35.53432621049059, -82.50474562054534 35.534714210545154, -82.50470162050975 35.53489821057799, -82.50445262030719 35.53594821076601, -82.50416462017557 35.53649421084747, -82.50378762005934 35.53684421087993, -82.50331161993391 35.53714721089274, -82.50329361992887 35.53716021089352, -82.50257261974829 35.537558210900436, -82.50195561958384 35.537963210919465, -82.50131561937502 35.53863221098988, -82.50095361924673 35.53907621104303, -82.5005776191291 35.539436211077636, -82.50008361899583 35.539771211095015, -82.49946361884251 35.54010021109823, -82.49905161872161 35.540442211125566, -82.49894261869026 35.54052921113203, -82.49868361861562 35.54073521114735, -82.49843561851245 35.54113921120403, -82.49830161843327 35.54151021126571, -82.4983226183614 35.5420002113675, -82.49843261831498 35.54242121146447, -82.49868861827007 35.54298921160625, -82.49902061825111 35.543470211738175, -82.49937061821211 35.5441012119024, -82.49956961815316 35.544699212044485, -82.49956561808442 35.54514221213412, -82.49943161800508 35.54551421219601, -82.49924761793318 35.54578321223182, -82.49865261773328 35.54644221230477, -82.49826761760134 35.54688621235557, -82.49821861758043 35.54696921236744, -82.49798861748121 35.547366212424585, -82.49792861739854 35.54783921251453, -82.49795361731293 35.54842321263588, -82.49794961720345 35.549131212779436, -82.49802061704303 35.55025121301456, -82.49798761695048 35.550817213126265, -82.49791561686564 35.55129121321528, -82.49763061672438 35.55190321331044, -82.49731661659693 35.552393213377904, -82.49729061658807 35.552423213381296, -82.49696561647498 35.55280821342623, -82.49667461635143 35.55329821349601, -82.49641161621969 35.553871213585474, -82.49637161618388 35.55406121362004, -82.49631561613377 35.55432621366817, -82.49618561600005 35.55505621380327, -82.49609961587944 35.55574721393495, -82.49609461587387 35.555778213940805, -82.4960016157597 35.556420214061816, -82.49592661564407 35.55709121419053, -82.49579361552124 35.557746214310136, -82.49576161546507 35.5580772143741, -82.49567161535984 35.55866421448433, -82.4956136152702 35.55918421458406, -82.49552461520287 35.55952621464451, -82.49517461499381 35.56050821480829, -82.49495861490882 35.56082821485118, -82.4948056148484 35.56105621488177, -82.49448661473747 35.561433214925714, -82.49407561461743 35.56177121495222, -82.49399061459128 35.56184921495935, -82.49373761451793 35.56205321497479, -82.4936456144926 35.562119214978814, -82.49356161446912 35.562181214982786, -82.49336361441672 35.56230821498829, -82.49326861439154 35.56237021499111, -82.49307361437103 35.56229321495543, -82.49306261436986 35.562289214953466, -82.4924906143098 35.562063214848806, -82.49229661428937 35.561987214813364, -82.49205461426396 35.56189121476905, -82.49165061422154 35.561732214695205, -82.49142561419843 35.56164021465336, -82.49132961418833 35.561602214635705, -82.49108761416274 35.56150821459175, -82.49084561413798 35.5614082145466, -82.49047461409974 35.561257214477735, -82.49011661406169 35.5611192144129, -82.48987361403586 35.5610252143689, -82.4893916139847 35.560838214281276, -82.48933561397887 35.56081621427112, -82.4887026139141 35.56055521415296, -82.48848161389176 35.56046221411134, -82.48832861387753 35.56039021408099, -82.4880856138579 35.5602562140288, -82.48798561385064 35.56019521400607, -82.48796961384961 35.560185214002416, -82.48778061383888 35.56005121395576, -82.48762261383071 35.55993421391571, -82.48757061382885 35.559890213901426, -82.48754561382827 35.55986721389421, -82.4874706138263 35.5597992138727, -82.4874466138257 35.55977721386572, -82.48740761382497 35.55974021385418, -82.48737061382423 35.559705213843294, -82.48729761382451 35.55962421381926, -82.48726261382481 35.5595852138078, -82.48717161382525 35.559484213777864, -82.48716561382537 35.55947721377582, -82.48705361382905 35.559332213734834, -82.48694461383627 35.55916821369029, -82.48693661383687 35.559155213686886, -82.48686961384367 35.55903921365641, -82.48678261385392 35.55887921361489, -82.48666161387438 35.55861521354877, -82.48661861388233 35.558517213524404, -82.48651861390138 35.558286213467234, -82.48642561391566 35.558093213418374, -82.48632261392581 35.55791621337186, -82.48625861393074 35.55781521334475, -82.48613861393683 35.557646213298, -82.48600061393887 35.55748421325087, -82.48590461393889 35.55738121322011, -82.4857506139372 35.557226213172726, -82.48562261393248 35.557119213137874, -82.48556161393006 35.5570692131214, -82.48537561392025 35.556932213074404, -82.48515061390543 35.55678621302163, -82.48503661389792 35.556712212994846, -82.48498561389438 35.55668021298311, -82.48469261387412 35.556496212915604, -82.48457861386639 35.5564242128893, -82.48455461386469 35.556409212883736, -82.48451861386224 35.5563862128754, -82.48448461385988 35.5563652128676, -82.48446161385822 35.55635121286245, -82.48443861385668 35.55633621285699, -82.48436961385171 35.55629421284136, -82.48434761385026 35.55628021283623, -82.48432761384879 35.55626821283182, -82.48427061384483 35.55623221281859, -82.4842516138436 35.556220212814225, -82.4842366138425 35.55621121281083, -82.48419461383972 35.55618421280105, -82.48418061383855 35.556176212797965, -82.48416261383734 35.55616521279387, -82.48411161383378 35.556133212782115, -82.48409461383253 35.55612321277838, -82.48372461380745 35.55588721269232, -82.48347861379074 35.555731212635344, -82.4829036137512 35.55536921250264, -82.48282661374583 35.55532121248499, -82.48261161373097 35.555186212435444, -82.4824716137213 35.55509821240317, -82.48224161370561 35.554952212349946, -82.4822276137047 35.55494321234662, -82.4821866137019 35.554917212337074, -82.48217361370098 35.55490921233416, -82.48201461369011 35.55480921229743, -82.48178661367427 35.55466621224498, -82.48153061365429 35.55452021218905, -82.48136861364182 35.55442721215346, -82.48129761363616 35.554387212138, -82.48117761362597 35.55432421211291, -82.48088461360072 35.55417321205211, -82.4805946135729 35.55404121199545, -82.4805176135656 35.554006211980465, -82.4803966135535 35.55395421195744, -82.48018061353048 35.553871211918405, -82.47989261349976 35.553761211866416, -82.47963961347321 35.5536612118201, -82.47953461346134 35.55362521180195, -82.47931661343645 35.55355221176473, -82.47926361343058 35.5535332117554, -82.47923261342702 35.553523211750225, -82.47912461341483 35.55348621173159, -82.47910461341242 35.5534802117283, -82.47905261340647 35.55346321171951, -82.47885661338411 35.553397211685976, -82.47874361337183 35.553355211665824, -82.47861461335815 35.553305211642446, -82.47837261333181 35.553216211599505, -82.47828961332453 35.553174211582395, -82.47776961326878 35.55297621148875, -82.4777356132652 35.55296321148254, -82.47752061324297 35.552876211442765, -82.47740961323272 35.55282321142062, -82.47701361319636 35.55263321134132, -82.4769906131961 35.552610211334375, -82.47650661314559 35.55241721124527, -82.4764416131388 35.55239121123335, -82.47637861313228 35.55236621122174, -82.47612061310855 35.552242211170054, -82.47599161309681 35.552180211144226, -82.47562561306316 35.552004211070845, -82.47560661306142 35.55199521106708, -82.47547761304882 35.551938211042234, -82.47534161303543 35.55187921101626, -82.47532161303351 35.551870211012364, -82.47531761303357 35.55186521101095, -82.47528861302982 35.551858211006575, -82.47506261300238 35.55179321097007, -82.47492061298534 35.551751210946996, -82.47491161298422 35.55174921094568, -82.47488961298126 35.55174421094237, -82.47477961296828 35.551710210924156, -82.47470061295846 35.55168921091173, -82.47455961294138 35.55164821088892, -82.47425361290577 35.55155021083763, -82.47418061289724 35.55152721082539, -82.47337961279504 35.551329210702825, -82.47311961276175 35.551266210663435, -82.47299761274611 35.55123621064476, -82.47247561267947 35.5511072105649, -82.47062161244267 35.550650210281525, -82.46977661234051 35.55040521014485, -82.46930061228268 35.55026821006815, -82.46888261223116 35.55015321000178, -82.4687766122181 35.55012420998501, -82.46851661218749 35.550043209941904, -82.46806161213304 35.54990720986744, -82.46772961209436 35.54980120981183, -82.46697661200648 35.54956220968586, -82.46652761195506 35.549413209609455, -82.46540261182379 35.54905520942111, -82.46527361180877 35.54901420939945, -82.46512961179205 35.54896820937537, -82.46459561172968 35.5487982092859, -82.46382761164028 35.54855320915723, -82.46347661159723 35.548455209101235, -82.4630716115455 35.54835520903931, -82.46294961152996 35.54832520902065, -82.46253661147412 35.5482432089616, -82.46219961142681 35.54818820891573, -82.46190161138497 35.54813920887523, -82.458478610897 35.54762720841944, -82.45836961088146 35.547611208405, -82.45728161072597 35.54745120826067, -82.45696161068146 35.54739620821661, -82.45680261066018 35.54736320819357, -82.45672661064988 35.547348208182775, -82.45664361063957 35.54732620816975, -82.45649361062083 35.54728620814625, -82.4562486105917 35.54721220810601, -82.4560196105662 35.547131208065935, -82.45577561054108 35.54703220802082, -82.4554646105129 35.54688020795792, -82.45517261048875 35.54672320789603, -82.45489461046843 35.54655620783357, -82.45449861043716 35.54633320774751, -82.45429761041888 35.54623620770717, -82.45425761041467 35.546220207699776, -82.45413161040166 35.546169207676435, -82.45407061039546 35.546144207665144, -82.45402361039056 35.546125207656424, -82.45388461037527 35.54607520763195, -82.45382361036853 35.546053207621206, -82.45428661066774 35.54460620737471, -82.45497061110899 35.54247320701144, -82.45565461139047 35.541379206859325, -82.45653061161777 35.54084420684049, -82.45750461187014 35.54025120682006, -82.45787461194358 35.54017220684205, -82.45888461214494 35.539950206900635, -82.45890461214879 35.53994620690182, -82.46051661247145 35.53958320699366, -82.46192161274566 35.53931320708314, -82.46210961278216 35.53927820709535, -82.46260161288741 35.53912320711434, -82.4628886129593 35.53896420711145, -82.46314861301829 35.538861207117215, -82.46392861319455 35.53855420713494, -82.46404761322137 35.53850820713783, -82.4640756132491 35.538358207110235, -82.46458561342494 35.537763207041586, -82.4651076136082 35.537133206967155, -82.46515761362558 35.537074206960305, -82.46574461388049 35.53604820681208, -82.46586761393355 35.53583520678134, -82.46644461418357 35.53483020663629, -82.46711661439805 35.53415920656895, -82.46755561454674 35.53366420651338)))",6251,37,021,003201,370210032011,1733,1733,62,1710,1646,15,9,22,0,18,23,1450,43,1407,1439,1383,12,9,21,0,14,11,887,777,110
census_2010_blockgroups_view.fid--2dc29038_13ec899ba8f_-264b,"MULTIPOLYGON (((-82.58231662678439 35.577844227283904, -82.58239762679625 35.57785422729426, -82.58240362679715 35.57785522729509, -82.58263162682765 35.57790322732829, -82.58263762682826 35.57790522732929, -82.58271662683774 35.57792922734225, -82.58264462672092 35.57861122747369, -82.58257562660825 35.57926922760064, -82.58255462655269 35.57960722766724, -82.58254062649557 35.579964227738564, -82.58255562643868 35.580350227818684, -82.5825826263947 35.58066522788562, -82.58264162629912 35.58135022803111, -82.58264262629649 35.581368228034854, -82.58264562628838 35.58142422804653, -82.5826476262858 35.58144322805066, -82.58264962627904 35.58148922806024, -82.58265462626754 35.581569228076965, -82.58265562625836 35.5816302280895, -82.58265662625129 35.581677228099224, -82.58266062622255 35.5818682281385, -82.58265462620172 35.58199722816414, -82.58263162611041 35.582566228277635, -82.58256662603985 35.58295422834997, -82.5825146259825 35.58327122840918, -82.58249262595865 35.58340222843363, -82.58237162587307 35.58382822850793, -82.58223862577864 35.58429822858995, -82.5819466256156 35.58504322871163, -82.58173762552164 35.5854282287686, -82.58146462539824 35.58593522884378, -82.58139962536909 35.58605422886132, -82.58128962531944 35.58625822889166, -82.58118562528041 35.58640022890983, -82.58110562524999 35.5865112289242, -82.58086362517533 35.58673522894499, -82.58034062495877 35.58757822906294, -82.58013962488339 35.58785122909785, -82.5800186248366 35.58802422912065, -82.57994462480794 35.58813122913489, -82.57992162479994 35.58815822913801, -82.57965162468685 35.58860122920049, -82.57954762465312 35.58870822921156, -82.57931262457615 35.58895522923775, -82.57890062446906 35.58920622924656, -82.57839162435849 35.589375229228736, -82.57775762423546 35.58949022918697, -82.57775462423487 35.58949122918689, -82.57710462410564 35.58962922914822, -82.57690562406829 35.58965722913352, -82.57680062404837 35.589673229125985, -82.57631462395415 35.589761229094066, -82.576118623916 35.58979722908127, -82.57577262384898 35.58985922905831, -82.57538662377394 35.589930229033094, -82.57473762364582 35.590062228993354, -82.57439362357785 35.59013322897247, -82.5742806235557 35.59015522896537, -82.57394362348889 35.59022522894504, -82.57383162346675 35.59024822893817, -82.57367562343609 35.59027922892847, -82.57321062334424 35.59037422890005, -82.5730556233136 35.59040622889069, -82.57301962330672 35.59041222888821, -82.57291162328535 35.59043422888157, -82.57287662327836 35.59044222887962, -82.57277562325852 35.59046222887335, -82.57247562319927 35.59052322885496, -82.5723756231794 35.590544228849005, -82.57225962319316 35.59033022879349, -82.57191362323404 35.58969122862788, -82.57179862324772 35.58947822857267, -82.5717596232522 35.58940722855425, -82.57169662325974 35.58929022852394, -82.57163662326342 35.58920122849963, -82.57159262326623 35.58913522848172, -82.57127062328692 35.588653228350466, -82.57105962328876 35.58841422828013, -82.56978262329964 35.58696522785407, -82.5691916232755 35.58648422769542, -82.56911862327252 35.586425227675896, -82.56876662325955 35.586129227579534, -82.56853662326054 35.585874227504, -82.56845862326105 35.58578722747823, -82.5683176232675 35.58559322742437, -82.56820962327285 35.58544222738253, -82.56804162329827 35.58509522729456, -82.56772162346118 35.58369122697591, -82.56769862357821 35.582906226813726, -82.5677976237333 35.58200522664047, -82.56798062393902 35.580865226427235, -82.56819462410071 35.58004522628226, -82.56842362428901 35.57906822610692, -82.56852762443502 35.578231225947235, -82.56868262461018 35.57726022576547, -82.56862162471799 35.576493225603045, -82.5684236247725 35.575925225467095, -82.56807262480342 35.575345225313, -82.56761462479487 35.574906225176576, -82.5647226246955 35.5724302243757, -82.56389162468727 35.57158722411881, -82.56377662470861 35.57132422405349, -82.56367762476312 35.57086322394948, -82.56363162482478 35.570412223852934, -82.56360162490655 35.569848223735015, -82.56368562503073 35.56913122359773, -82.56381162510844 35.568762223535536, -82.56401462514046 35.56877322355861, -82.56411562515748 35.56877122356853, -82.5642346251775 35.56876922358039, -82.5643866252052 35.568753223592715, -82.56454062523574 35.56872122360206, -82.56470462526988 35.56867622360976, -82.56479862529089 35.56864122361222, -82.56486262529104 35.56870922363268, -82.56501162528606 35.568902223687175, -82.56507562528569 35.56897422370846, -82.5650826252858 35.56898022371037, -82.56526862529257 35.569137223761444, -82.56574862531423 35.569515223887656, -82.56599262532374 35.56971622395364, -82.56611862532932 35.56981622398689, -82.56625062533507 35.56992122402186, -82.56631162533566 35.569983224040676, -82.56634362533434 35.57002622405274, -82.56637962533047 35.57009022406948, -82.56638962532274 35.57015122408293, -82.56639962531287 35.57022622409923, -82.56639662530414 35.57028022410984, -82.56637762528247 35.570400224132385, -82.56637162527427 35.57044722414126, -82.5663736252643 35.570514224155175, -82.56638862525607 35.57058422417098, -82.56642062525071 35.570653224188256, -82.5665016252456 35.57077422422126, -82.56668162524295 35.57098522428262, -82.56672962524316 35.57103622429791, -82.5667526252433 35.571060224305214, -82.56680762524638 35.57109922431879, -82.56688862525495 35.57113122433359, -82.56695262526345 35.57114422434279, -82.56699262526892 35.57115222434858, -82.56710262528708 35.57115322436001, -82.56713662529347 35.571148224362545, -82.56719562530431 35.57114122436715, -82.56750962536971 35.57105522438191, -82.56763462539392 35.57103222439004, -82.56767762540186 35.57102722439347, -82.56774762541447 35.5710212243994, -82.56786262543372 35.57102022441104, -82.56794662544718 35.571023224420216, -82.56805662546336 35.57103722443445, -82.568273625491 35.57109122446764, -82.5684256255104 35.57112922449099, -82.56878062555325 35.571234224548824, -82.5688686255659 35.5712462245603, -82.5689386255784 35.57124122456641, -82.56901862559434 35.57122322457097, -82.56907862560941 35.57119022457046, -82.56914162562947 35.57112822456429, -82.5691806256499 35.571037224549734, -82.56920062566674 35.57094922453386, -82.56922962568109 35.57088722452427, -82.56927262569728 35.57082822451663, -82.56927262569745 35.570827224516464, -82.56931662570994 35.57079322451405, -82.56937262572454 35.5707592245129, -82.5694356257384 35.570737224514865, -82.5695096257526 35.57072422451981, -82.56966562577688 35.57073522453805, -82.56973562578736 35.570742224546684, -82.56983062580159 35.57075222455846, -82.5699306258153 35.570771224572596, -82.56994462581699 35.57077522457487, -82.57001262582494 35.57079722458632, -82.57008262583213 35.57082622459936, -82.57015462583755 35.570868224615296, -82.57019662583676 35.57091922462998, -82.57041262583276 35.57117822470492, -82.57056962583147 35.57135622475721, -82.57062762582986 35.571429224778036, -82.57063462582978 35.571437224780404, -82.5707886258298 35.57160322483003, -82.57083662583007 35.57165322484512, -82.570903625826 35.57175222487216, -82.57092062582515 35.57177622487881, -82.57101162581444 35.571944224922305, -82.57106462580433 35.572067224952775, -82.57109662579418 35.57216722497644, -82.57111562578099 35.57227422500017, -82.57111962577845 35.572294225004654, -82.57113062575436 35.57246322504021, -82.57113362574768 35.572510225050095, -82.57112962572238 35.57267022508224, -82.57112862571107 35.57274222509683, -82.5711086256887 35.57286622512004, -82.57106662565927 35.573012225145376, -82.5710126256269 35.57316422517075, -82.57098262560505 35.57327422519015, -82.57092862556514 35.57347522522546, -82.57086262555532 35.573468225217326, -82.57066262552348 35.57345922519489, -82.5705286255021 35.57345322517993, -82.5701746254443 35.5734472251424, -82.5698646253921 35.57345222511157, -82.56969362536327 35.573455225094634, -82.56960162534476 35.57347622508944, -82.56959062534246 35.57347922508898, -82.5694696253154 35.57352422508566, -82.56944062530572 35.573556225089256, -82.56942862529858 35.57358922509465, -82.569444625293 35.57364322510732, -82.56947762529101 35.57369122512051, -82.56951462528986 35.573739225134084, -82.56994662527632 35.574293225291164, -82.57024462526758 35.57467222539892, -82.57043462526175 35.57491522546791, -82.57050462526536 35.57496722548568, -82.5704466252219 35.57518722552449, -82.57043062520425 35.57528422554265, -82.57043062519595 35.57533822555366, -82.57043062518831 35.57538822556376, -82.5704526251681 35.57554322559758, -82.57051962513191 35.575851225667115, -82.57060062509458 35.57618122574271, -82.57065962506209 35.57645622580466, -82.57069862504083 35.57663622584535, -82.57071562502429 35.57676222587278, -82.57071262501304 35.57683222588672, -82.57090662503997 35.576866225913555, -82.57148962512113 35.57696822599418, -82.57168462514827 35.57700222602107, -82.57175062515721 35.57701522603048, -82.57176062515859 35.577017226031955, -82.5719666251868 35.577056226060996, -82.57258762527195 35.577173226148574, -82.57269762528696 35.577194226164146, -82.57279462529984 35.57721522617841, -82.57292662531756 35.57724222619742, -82.57327162536365 35.57731522624774, -82.57332562537094 35.577326226255494, -82.57345962538888 35.57735422627492, -82.57370862542217 35.577406226311105, -82.57445662552246 35.57756222641961, -82.5746286255454 35.57759822644464, -82.57470462555467 35.5776202264569, -82.57469562553723 35.57772422647717, -82.57469462553469 35.5777392264801, -82.57479062555498 35.5777112264843, -82.57481862555949 35.57771222648738, -82.57520362561989 35.577735226531544, -82.57533262564004 35.57774322654647, -82.57551662566956 35.57775022656681, -82.5760696257577 35.57777422662837, -82.57625462578712 35.57778222664907, -82.57692862589538 35.5778062267231, -82.57787562604747 35.57784022682722, -82.57895162621908 35.577886226947086, -82.57930662627557 35.57790222698671, -82.57962662632717 35.577912227021656, -82.5797816263518 35.577919227038976, -82.58024662642539 35.57794322709157, -82.5804026264501 35.5779512271092, -82.58049462646476 35.577955227119524, -82.58060062648144 35.577961227131546, -82.5807726265115 35.57795122714716, -82.58086562652751 35.57794722715594, -82.58088062653036 35.577945227157095, -82.58092862653888 35.57794122716121, -82.58094462654158 35.57794122716278, -82.58097962654844 35.57793422716496, -82.58108462656878 35.57791522717191, -82.58112062657563 35.577910227174534, -82.58134662661926 35.577870227189635, -82.58135762662141 35.5778682271904, -82.58173562669216 35.57781622721855, -82.58205462674545 35.577814227250904, -82.58207662674883 35.5778162272536, -82.58231662678439 35.577844227283904)))",6115,37,021,001000,370210010001,1485,1485,97,1450,1274,148,2,5,0,21,35,1255,66,1189,1235,1105,107,2,5,0,16,20,742,659,83
census_2010_blockgroups_view.fid--2dc29038_13ec899ba8f_-264a,"MULTIPOLYGON (((-82.51947562858345 35.49824220463832, -82.5195926285973 35.49827820465765, -82.51975562862084 35.49830120467907, -82.51982262862941 35.498317204689165, -82.51993562864368 35.49834620470669, -82.52021762868223 35.49840020474656, -82.52039262870758 35.49842320476916, -82.52078962877208 35.49843220481171, -82.52088462878794 35.49843120482122, -82.52091762879336 35.49843120482464, -82.52123462884444 35.49844120485918, -82.52124162884542 35.498442204860126, -82.52128162881944 35.49865520490754, -82.5212966288128 35.49871420492104, -82.52134262879231 35.49889720496304, -82.52151462874681 35.49938020507889, -82.52157062873732 35.499502205109444, -82.52159962873264 35.499564205125004, -82.52167462872642 35.49968620515747, -82.52170462872196 35.49974720517302, -82.52179162870962 35.49992220521751, -82.52205462869016 35.50033320532807, -82.52262162864848 35.50121820556625, -82.52316762861038 35.50205620579262, -82.52330762860062 35.50227120585078, -82.5235386285837 35.50263120594766, -82.52377762856477 35.50301320604984, -82.52387062855333 35.50318820609496, -82.52398762853926 35.50340620615128, -82.52412662851555 35.503711206227656, -82.52419062849981 35.50388320626917, -82.52427762848119 35.504098206321835, -82.52443962844318 35.50452120642451, -82.52461862840248 35.5049802065362, -82.52462062840182 35.50498620653758, -82.52485062834658 35.505595206685065, -82.52490562833381 35.505738206719826, -82.52507262829567 35.5061672068242, -82.52510162828916 35.50624120684224, -82.52512862828283 35.50631120685923, -82.52514662827875 35.5063572068704, -82.52521362826441 35.5065232069111, -82.52534462823641 35.50684720699043, -82.52546662820859 35.50716020706661, -82.52555062818976 35.50737420711883, -82.52560362817736 35.50751220715224, -82.5256386281695 35.507601207173906, -82.52574462813591 35.507935207252736, -82.5257896281215 35.50807720728623, -82.52584662809906 35.50828520733443, -82.52586362809191 35.50835020734935, -82.52589462807974 35.50846320737555, -82.52602262802505 35.50895820748935, -82.52607462800044 35.50917420753865, -82.52614162796924 35.509450207601645, -82.52631862800064 35.50943720761711, -82.52646762802623 35.509431207631216, -82.52654062803833 35.5094312076387, -82.52774162823552 35.50944320776429, -82.5281426283014 35.50944720780619, -82.52854462836719 35.50945220784846, -82.52891162842724 35.509457207887145, -82.52974162856006 35.509488207978514, -82.52975062856159 35.50948820797942, -82.53015362862766 35.50949320802179, -82.53068462871468 35.50949920807746, -82.53097262876248 35.509499208107016, -82.53113962879013 35.50949920812412, -82.5313996288378 35.509469208144715, -82.53151762885689 35.50947220815744, -82.53156162886513 35.50946620816066, -82.53158062886861 35.50946420816224, -82.53166962889057 35.50941720816182, -82.53213062900376 35.5091772081603, -82.53226862910289 35.50868020807331, -82.53229962915569 35.50836920801319, -82.53249362926852 35.50784320792606, -82.53256362930892 35.507655207894985, -82.53292162945893 35.50706420781149, -82.53320062955041 35.50676920778006, -82.53334762958252 35.506719207784975, -82.53371362966173 35.50659820779794, -82.53467762982153 35.506598207896744, -82.53742763024881 35.50678420821654, -82.53761463024641 35.50700220828011, -82.53778563021997 35.507359208370225, -82.53773863015505 35.50773220844134, -82.537468630051 35.50811820849214, -82.5372266299574 35.50846720853836, -82.53690462977089 35.50933520868189, -82.53692262973446 35.509592208736, -82.5371416297013 35.510045208850656, -82.53717462963196 35.51053320895331, -82.53705962955783 35.51089220901455, -82.53709362954261 35.5110282090457, -82.53717762953471 35.51117020908318, -82.53754662955433 35.51144120917617, -82.53779662957798 35.5115572092254, -82.53755162948255 35.511914209272916, -82.53748662941081 35.51231220934726, -82.53752762937475 35.51259120940816, -82.53769962925527 35.513556209622166, -82.5377906292076 35.51396520971475, -82.53761962913292 35.51426720975863, -82.53730162903338 35.51457220978804, -82.5367206288708 35.515004209816354, -82.53510562856937 35.5152242096955, -82.53537062860866 35.51525420972878, -82.53570262865767 35.5152932097708, -82.53591762868415 35.51535320980501, -82.53613862870544 35.51545320984801, -82.53638162872869 35.51556420989557, -82.53545862855376 35.51570720982995, -82.53488762845419 35.51573920977793, -82.53440262836953 35.51576720973382, -82.5332896281649 35.51589820964636, -82.53235162796598 35.516181209607744, -82.5317246278246 35.51642520959308, -82.53118662768327 35.51676520960705, -82.53074562755386 35.517132209636465, -82.53071162754314 35.517165209639714, -82.52965262720338 35.51823520974879, -82.52944062712974 35.51848620977812, -82.52905962699691 35.518940209831364, -82.52881362690944 35.51924420986805, -82.52870962687237 35.519374209883786, -82.52859162683576 35.51948520989425, -82.5284646267966 35.51960320990525, -82.52837762676934 35.519686209913175, -82.52805462667988 35.5199202099276, -82.52791562664109 35.520023209934386, -82.5277176265862 35.520167209943345, -82.52731462648342 35.520401209949554, -82.52705362641673 35.52055420995398, -82.5262686262079 35.521067209977836, -82.52561662603888 35.52146420999166, -82.52550462601111 35.52152420999236, -82.52488062585574 35.52186220999711, -82.52461462582426 35.52178020995316, -82.52443962580493 35.52171720992237, -82.52442562580332 35.52171220991995, -82.52420562578055 35.52162320987926, -82.52403062576326 35.52154720984584, -82.52389762575302 35.52147020981656, -82.52379462574608 35.52140420979257, -82.52369162573893 35.52133920976877, -82.52361062573462 35.52128020974849, -82.5235526257316 35.52123720973373, -82.52340362572558 35.52111520969362, -82.52328962572312 35.52100820966024, -82.52327162572331 35.52098720965409, -82.52310762572459 35.520802209599665, -82.5229766257291 35.520631209551446, -82.52287562573561 35.52048020951028, -82.52281562574109 35.52037920948361, -82.52274662574993 35.52024720944968, -82.52268362576235 35.52009820941297, -82.52261862578332 35.51989120936412, -82.52256762581746 35.519614209302574, -82.52255362583611 35.51947720927329, -82.52253562586311 35.51928220923175, -82.52253762595024 35.518716209116825, -82.52250562618424 35.517157208796405, -82.52249962627378 35.51656720867579, -82.52248162633248 35.51616520859213, -82.52242062637004 35.51585420852265, -82.52239662638189 35.515751208499246, -82.52234862640633 35.51554020845145, -82.52225062643352 35.51525720838375, -82.52222162643972 35.51518520836621, -82.52214562645644 35.51499420831957, -82.52203962647248 35.51477520826413, -82.52193662648227 35.51460020821794, -82.52168562649918 35.51421920811473, -82.52098262654614 35.51315320782574, -82.52093262654945 35.51307820780532, -82.52067962656545 35.51270020770252, -82.5206196265697 35.5126082076777, -82.52028162659323 35.5120892075374, -82.51968162663516 35.511168207288534, -82.5192546266627 35.51052720711433, -82.51908262667536 35.510259207042196, -82.51894962668503 35.51005220698651, -82.51880262669678 35.50981720692357, -82.518692626705 35.50964420687719, -82.51860662671167 35.50950820684068, -82.51854162671654 35.509406206813246, -82.51840562672622 35.50919620675662, -82.51834962673142 35.50910220673175, -82.51826862673897 35.50896520669552, -82.51816862675149 35.50877520664666, -82.51809462676277 35.50862220660792, -82.51804162677426 35.508490206575715, -82.51797162679436 35.50828320652643, -82.51794862680612 35.508182206503484, -82.51792162681963 35.508064206476746, -82.51791562682575 35.508018206466765, -82.51789762684501 35.50787320643542, -82.51789362687671 35.507662206392084, -82.51789962688646 35.50760520638114, -82.51791562690784 35.50748320635791, -82.5179716269599 35.50720420630693, -82.51803262701017 35.506942206259914, -82.5181036270641 35.50666720621124, -82.51821262714797 35.50623820613516, -82.51828262720564 35.50593820608134, -82.51834862725931 35.505659206031375, -82.51844862732833 35.50531720597201, -82.51854362739576 35.50498020591321, -82.51861462745619 35.50466320585605, -82.51869462752106 35.50432620579571, -82.51872862757514 35.5040102057349, -82.51873762762638 35.50368620566996, -82.51869962766139 35.50341720561133, -82.51869662766535 35.503388205605106, -82.51861662769588 35.50310220553871, -82.51850062774521 35.50265520543595, -82.51826462779769 35.502058205290325, -82.51818762782663 35.50178620522711, -82.51810862785923 35.501488205158395, -82.51810562786655 35.50143720514767, -82.51809262791188 35.50112720508336, -82.51812262796736 35.50079820501944, -82.51818262802348 35.500497204964425, -82.51826762807542 35.500250204922864, -82.5183746281309 35.500004204883815, -82.51850262818475 35.49979120485361, -82.51860262822782 35.49961820482867, -82.51861562823309 35.49959820482598, -82.51872862828002 35.499414204800146, -82.51893462836706 35.499069204751095, -82.51904262841042 35.49890320472841, -82.51936662854015 35.498407204660694, -82.51947562858345 35.49824220463832)))",6213,37,021,002204,370210022042,2419,2419,84,2378,2022,214,5,98,0,39,41,2135,65,2070,2123,1852,162,3,73,0,33,12,1576,1433,143
census_2010_blockgroups_view.fid--2dc29038_13ec899ba8f_-2649,"MULTIPOLYGON (((-82.39253159228018 35.59762621179732, -82.39256459227592 35.59768921181345, -82.39264959227401 35.597792211843135, -82.39271959227284 35.59787521186722, -82.39276359227189 35.59792821188254, -82.3929845922756 35.59814121194858, -82.39338559228035 35.59854021207087, -82.3934115922807 35.5985662120788, -82.39361259228426 35.59875821213855, -82.39364459228426 35.59879221214873, -82.3937295922848 35.59888021217538, -82.39374559228574 35.59889121217926, -82.39378459228784 35.59891921218896, -82.393804592289 35.5989332121939, -82.39382459229016 35.59894721219873, -82.39385559229422 35.59895421220334, -82.3938745922977 35.598952212204935, -82.39390059230216 35.59895121220737, -82.39395759231203 35.598948212212676, -82.39403559232835 35.59892621221625, -82.39430859238793 35.59883221222522, -82.39547559264217 35.59843621226487, -82.39552259265226 35.5984212122667, -82.39569759268967 35.59836621227358, -82.39593659273699 35.59831621228805, -82.39595759273162 35.598373212301766, -82.39600459272546 35.59846321232483, -82.39623259269636 35.59889621243632, -82.39630859268655 35.59904121247357, -82.39634959268118 35.59912021249383, -82.39647559266511 35.599359212555434, -82.39651759265969 35.59943921257593, -82.39660359264911 35.59960021261752, -82.39686159261672 35.60008621274284, -82.39694759260577 35.60024921278478, -82.39715059258027 35.60063221288346, -82.39738959253933 35.60115421301418, -82.39776159248245 35.60192121320823, -82.39779659247522 35.602005213228956, -82.3978445924653 35.602121213257476, -82.39789559245212 35.60226121329112, -82.39791459244711 35.602314213303906, -82.39792659244384 35.60234821331202, -82.39794759243861 35.602404213325535, -82.39796759243343 35.60245921333876, -82.39798859242644 35.60252721335473, -82.3979655924214 35.602535213353995, -82.39747159232068 35.602658213328176, -82.39701359222316 35.60279921330966, -82.39669359215183 35.602918213300846, -82.39640359208686 35.603028213293356, -82.39612059202183 35.60314621328822, -82.39584659195705 35.60327221328552, -82.39566359191144 35.603371213286835, -82.3954955918689 35.603467213289086, -82.39535759183195 35.603558213293375, -82.39486959169527 35.60392121331681, -82.39469459164928 35.60403121332117, -82.39454959161343 35.60410821332184, -82.39441159158304 35.60415721331772, -82.39424459154836 35.604203213309816, -82.39421959154336 35.60420821330822, -82.3940995915209 35.604225213299316, -82.39392459148907 35.60424421328517, -82.39260459125698 35.60433321316734, -82.39218959118446 35.60435821312968, -82.39202359115605 35.60436421311377, -82.391958591145 35.60436621310752, -82.39176359111177 35.60437221308859, -82.39169959110076 35.60437521308262, -82.39162259108075 35.60442221308424, -82.39145659103649 35.604531213089395, -82.39092359089392 35.604883213105914, -82.39073359084294 35.605010213112216, -82.39053059078805 35.605148213119286, -82.39049759077827 35.605176213121574, -82.39048059073546 35.605435213172434, -82.39047859072998 35.60546821317897, -82.39044359058833 35.60634821335413, -82.3904325905411 35.60664221341269, -82.39041659048675 35.60697721347913, -82.3903695903236 35.60798321367867, -82.39035459026928 35.60831921374537, -82.39034559023904 35.60850521378226, -82.39032059014865 35.609064213893234, -82.39031359011855 35.60925121393051, -82.39032359012008 35.60925221393175, -82.3903715901211 35.60929721394579, -82.39069459013405 35.60955921403229, -82.39079959013738 35.60965021406156, -82.39093459014141 35.60976821409947, -82.39114059014588 35.6099602141597, -82.39132959014826 35.61014721421709, -82.39143359014525 35.61027821425445, -82.39148559013748 35.61038421428135, -82.39153659012769 35.610502214310586, -82.39155859011098 35.61063421433966, -82.39156659009257 35.61076221436649, -82.39157459005216 35.61103221442216, -82.39156459003493 35.61113321444161, -82.39154359001306 35.611252214463626, -82.39143958989959 35.61187521457948, -82.3914345898929 35.61191321458667, -82.3913465898376 35.61217721463126, -82.39133558983158 35.61220421463562, -82.39129658981025 35.612300214651135, -82.39125758979152 35.612380214663354, -82.39122158977366 35.61245721467524, -82.3911945897576 35.61253221468777, -82.39119858974657 35.612608214703556, -82.39123258970947 35.612884214763135, -82.39124458970241 35.61294321477638, -82.39128558967992 35.613132214819046, -82.39131058966647 35.613246214844686, -82.3914015896471 35.61346921489945, -82.39142658963543 35.61357121492272, -82.39142958962914 35.61361521493198, -82.39141958961996 35.61366421494089, -82.39140058961053 35.61370521494723, -82.39136158959589 35.61375821495396, -82.39120058954822 35.61389421496506, -82.3906685893946 35.614319214996556, -82.39056258936017 35.614428215007855, -82.39044358931946 35.614564215023236, -82.39026358925094 35.614815215055664, -82.39011758917968 35.61512021510259, -82.39005758916029 35.61518121510875, -82.38997158913577 35.61524821511351, -82.3897005890629 35.61542921512238, -82.38958558903542 35.615484215121704, -82.38948558901635 35.61550021511469, -82.3892805889817 35.61550521509453, -82.38916658896481 35.61549221508017, -82.38901358894557 35.61545321505652, -82.38875258891647 35.61536221501111, -82.38855458889131 35.61531321498084, -82.38846158887914 35.615292214966885, -82.3881325888358 35.61522021491837, -82.38794958880855 35.61520121489573, -82.3878435887903 35.6152052148856, -82.38777458877786 35.6152122148799, -82.38768258875676 35.61525021487815, -82.38762858874206 35.6152872148801, -82.38758358872676 35.61533821488587, -82.3875535887164 35.61537321488982, -82.3875075886947 35.6154642149036, -82.38745358867287 35.615548214915094, -82.38740858866056 35.615579214916785, -82.3873775886532 35.61559421491659, -82.38736258865066 35.61559421491507, -82.38733158864493 35.61559821491272, -82.38727858863867 35.61558221490398, -82.38719358863155 35.615537214886125, -82.387140588626 35.61551621487636, -82.38710958862626 35.61548121486604, -82.38707558863052 35.61541721484953, -82.3870395886436 35.615294214820835, -82.38691058874394 35.61450621464745, -82.38683558877592 35.61421921458145, -82.38679858878866 35.61409721455296, -82.38671558879663 35.61395621451572, -82.38660958880278 35.61380321447364, -82.38646858880759 35.61362121442219, -82.38604558882969 35.61302521425759, -82.38580358884089 35.61269321416521, -82.38564258884963 35.612464214102054, -82.38551958885496 35.612298214055656, -82.38526058886738 35.611940213956316, -82.38509758887164 35.61173821389844, -82.38506658887438 35.611687213884885, -82.38505258888041 35.61163321387254, -82.38505058888582 35.61159621386478, -82.38509658891726 35.61144221383823, -82.38511358892782 35.61139121382959, -82.385191588976 35.611163213791286, -82.38539958911068 35.610514213680894, -82.38549458917146 35.610222213631374, -82.38554358920277 35.61007221360595, -82.38569058929673 35.609621213529486, -82.38574058932798 35.6094722135044, -82.38568658932124 35.609458213496005, -82.38560658931047 35.60944221348453, -82.38520458925638 35.609362213426856, -82.38507058923815 35.60933621340776, -82.38485858917451 35.60952121342348, -82.3846785891194 35.609685213438304, -82.38352058876353 35.61074921353513, -82.3831345886449 35.61110421356751, -82.38264758849662 35.61154221360625, -82.38118858805196 35.61285921372356, -82.38070258790374 35.613298213762654, -82.38057758786562 35.61341121377276, -82.38030258778083 35.61366521379601, -82.38020358775103 35.61375221380345, -82.38007858771309 35.61386421381336, -82.38002358769552 35.61391921381881, -82.37996258767551 35.613983213825534, -82.37991658765648 35.61405721383588, -82.37989558764484 35.61411021384445, -82.37987558763332 35.614163213853125, -82.37987258762956 35.6141842138571, -82.37986758761961 35.61424321386862, -82.37986758761714 35.614259213871854, -82.37987258760779 35.61432521388579, -82.37987858759406 35.61442021390571, -82.37988758758539 35.61448621391998, -82.37989858757561 35.614561213936376, -82.3798995875542 35.614701213964935, -82.37990258749407 35.61509321404487, -82.37990258748961 35.61512221405071, -82.37990958746911 35.61526221407991, -82.379918587456 35.61535721410012, -82.37994958743313 35.615538214140045, -82.37995758742781 35.61558121414966, -82.38001058739982 35.61581921420346, -82.38015058734028 35.6163542143265, -82.3801745873305 35.61644321434704, -82.38019058731402 35.61656721437391, -82.38019558730504 35.61663021438724, -82.38019558727466 35.61682721442725, -82.38010658727305 35.61674221440077, -82.38003058727871 35.61662421436903, -82.37980958732462 35.61609021423781, -82.37968858733345 35.61590421418754, -82.37948158734703 35.61559421410327, -82.37943358735808 35.61547121407331, -82.379401587365 35.615392214054, -82.37935058737607 35.61526621402312, -82.37926158739565 35.61504421396887, -82.379183587447 35.61462821387631, -82.37914358747382 35.61441221382831, -82.37905458753285 35.61393421372209, -82.37904058753553 35.61390221371411, -82.37884558757557 35.61343421359894, -82.378738587602 35.61314821352987, -82.37872458761333 35.61306021351051, -82.37850258764607 35.61261021339625, -82.37841658765247 35.61247721336041, -82.37839558765393 35.612445213351734, -82.37816658765685 35.61218121327454, -82.37805958765101 35.61210421324785, -82.37803858765021 35.612087213242276, -82.37811258768359 35.61195021322202, -82.3782545877224 35.611851213216625, -82.37829058773173 35.6118292132158, -82.37906258792984 35.611373213202704, -82.37921058797303 35.6112522131934, -82.37928258799685 35.6111752131852, -82.37949958806817 35.61094521316081, -82.37956658808655 35.610898213158144, -82.379794588149 35.6107382131491, -82.37983958815936 35.6107192131499, -82.37987758816863 35.61070021314993, -82.37992358817968 35.61067721315003, -82.3802885882755 35.61044821314108, -82.38035858829419 35.61040221313896, -82.38069458839041 35.610139213120114, -82.38088458844307 35.61000121311171, -82.38110258850313 35.60984621310263, -82.3815535886268 35.60952821308452, -82.38174158868323 35.60936421307056, -82.38194358874364 35.60918921305584, -82.38207258878234 35.609077213046376, -82.38238758888923 35.60872221300672, -82.3824485889098 35.608654212999205, -82.38257658896653 35.608424212965645, -82.38261758900217 35.608237212931854, -82.3826575890784 35.607786212844346, -82.38261158911988 35.60746821277501, -82.38253058912201 35.607368212746394, -82.38245458911942 35.60730321272537, -82.38243858917669 35.606915212644914, -82.38243558918856 35.60683521262832, -82.38251658923157 35.60664321259765, -82.38260558927864 35.606434212564416, -82.38260358929826 35.60630521253799, -82.38259858935203 35.605951212465534, -82.38262058937265 35.60584121244545, -82.38267958942491 35.60556621239573, -82.38281458946584 35.60544521238508, -82.38313758954806 35.60525921238049, -82.38357558966904 35.6049452123619, -82.38358958967378 35.604929212360055, -82.38366958969976 35.604846212351376, -82.38373658972938 35.6047262123339, -82.38376358976444 35.60452821229647, -82.38376858976717 35.60451621229458, -82.38380358978466 35.60444021228274, -82.38389858981567 35.60434121227246, -82.3840265898504 35.604253212267764, -82.38412158987417 35.60420121226694, -82.38430958992099 35.60409921226559, -82.38440358994585 35.60403921226311, -82.38472659002475 35.603874212262845, -82.38477959004024 35.60383021225939, -82.38507659011128 35.60368821226108, -82.38513059012193 35.6036772122644, -82.38537259018668 35.60351721225683, -82.3853855901916 35.6034992122545, -82.38550059023319 35.6033532122367, -82.3855685902784 35.60313321219896, -82.38558759029162 35.603068212187736, -82.38544559027223 35.603041212167646, -82.38534559026401 35.60298721214642, -82.38511359025766 35.60278021208047, -82.38481759025687 35.602468211986604, -82.38476459025422 35.602428211973056, -82.38453459024275 35.60225621191435, -82.38426259022145 35.60210321185529, -82.38347059013284 35.601828211717915, -82.38265659003945 35.601561211579835, -82.38210558996764 35.60143621149767, -82.38178058992598 35.60135821144834, -82.38157458989926 35.601310211417434, -82.38141958988209 35.60125521139034, -82.38134658987404 35.601229211377465, -82.38103458984784 35.60106521131205, -82.38077658980771 35.60104821128205, -82.38076458981257 35.60100421127185, -82.38071058981214 35.60094921125515, -82.38061458980476 35.60089421123406, -82.38039458978778 35.6007682111858, -82.38009858975408 35.6006692111352, -82.38005858975264 35.60063621112436, -82.38004258976186 35.600559211107075, -82.38000458978452 35.60037221106523, -82.38000458979076 35.60033121105685, -82.37981058976398 35.60029721102998, -82.37934058969864 35.60021721096537, -82.3792295896827 35.60020121095067, -82.37903558965495 35.60017321092502, -82.37881858962368 35.60014321089664, -82.37874358961263 35.600134210887056, -82.37822458953583 35.600076210821776, -82.37786658948096 35.60004821077925, -82.37766258944951 35.600033210755136, -82.37757358943553 35.600028210744995, -82.37705358935362 35.6000022106862, -82.37687258932434 35.599998210666755, -82.37644758925512 35.59999121062153, -82.37606058919077 35.59999321058207, -82.37576458914064 35.60000121055322, -82.37512158902994 35.60002921049272, -82.37477058896772 35.60005621046204, -82.3745635889311 35.60007221044399, -82.37407358884155 35.60012721040467, -82.37401858883133 35.60013421040048, -82.37386358880278 35.60015321038828, -82.37373858877966 35.60016921037869, -82.37357958875013 35.60019021036659, -82.37336658870971 35.60022421035155, -82.37324358868614 35.60024521034316, -82.37321658868098 35.600249210341225, -82.3731345886654 35.6002622103354, -82.37310858866041 35.60026721033373, -82.37280358860227 35.60031721031245, -82.37238758852114 35.60039721028589, -82.37217758847909 35.60044421027376, -82.37196158843584 35.60049321026151, -82.37155458835333 35.600592210239654, -82.37094658822774 35.60075421020994, -82.37047658812745 35.600900210191185, -82.3701675880607 35.60100221018006, -82.36977858797519 35.60113921016784, -82.36946058790357 35.60126221016009, -82.36923058785156 35.601353210154855, -82.36888958777318 35.60149521014862, -82.36858758770293 35.60162721014433, -82.36851858768688 35.60165721014329, -82.3683105876386 35.60174721014015, -82.36824258762252 35.601778210139386, -82.36810958759179 35.60183521013725, -82.36771058749899 35.60200921013152, -82.36757858746813 35.6020672101297, -82.3675545874693 35.6020342101206, -82.36749758747234 35.6019532100982, -82.36748658747337 35.601935210093416, -82.36746558747505 35.60190121008438, -82.36738158748184 35.60176721004852, -82.36723958749353 35.601540209987796, -82.36714358750572 35.601358209940905, -82.36712758750784 35.601327209933, -82.36707758751673 35.60121620990533, -82.36703958752373 35.60113020988391, -82.36701358752941 35.60106520986803, -82.3669355875468 35.6008692098202, -82.36682058756715 35.60061420975659, -82.36675358757917 35.60046520971943, -82.36670258758821 35.6003522096912, -82.36654958761505 35.600014209606826, -82.36649958762409 35.59990220957889, -82.36647858762771 35.599856209567385, -82.36645058763267 35.5997942095519, -82.36641458763815 35.59972020953322, -82.36639358764162 35.59967520952193, -82.36684058773176 35.599570209546684, -82.36818558800256 35.599256209621416, -82.36863358809273 35.59915220964639, -82.36926058821902 35.59900520968112, -82.37054858847739 35.59871120975403, -82.37119658860567 35.59857420979292, -82.37185458873279 35.598455209836565, -82.37263758888038 35.598338209893505, -82.3734305890252 35.59824920995701, -82.37410558914557 35.59819221001493, -82.37476658926055 35.59815521007549, -82.37529658935038 35.59814121012723, -82.3758215894379 35.59813621018035, -82.37636158952596 35.59814421023751, -82.37696858962404 35.598159210303066, -82.37729558967688 35.598167210338346, -82.37756458972031 35.5981742103675, -82.37854258987807 35.59820021047356, -82.38228559048096 35.59830421088002, -82.38353359068192 35.59833921101567, -82.38450459083838 35.59836621112113, -82.38742059130813 35.598447211437815, -82.38769959135296 35.5984552114682, -82.38823059144117 35.59845321152251, -82.38839259146884 35.59844721153792, -82.38860859150581 35.59843921155853, -82.38862559150864 35.598439211560326, -82.38916059160252 35.59840421160825, -82.38925559162013 35.59839221161557, -82.38947159165951 35.59836821163299, -82.3896865916989 35.59834321165003, -82.38969859170118 35.59834121165083, -82.39021059179873 35.59825821168667, -82.39037459183105 35.598224211696724, -82.39059859187529 35.59817821171039, -82.39091459193985 35.59809821172676, -82.39111159197982 35.59805021173726, -82.39161559208556 35.59790521175964, -82.39185659213682 35.597831211769424, -82.39216959220325 35.597736211782305, -82.39224159221872 35.597713211785106, -82.39245859226469 35.5976482117942, -82.39253159228018 35.59762621179732)))",6486,37,021,003002,370210030022,1114,1114,51,1086,1031,28,4,3,1,19,28,858,26,832,842,805,21,3,3,1,9,16,508,464,44
census_2010_blockgroups_view.fid--2dc29038_13ec899ba8f_-2648,"MULTIPOLYGON (((-82.56520463645235 35.49636020894258, -82.5658836365922 35.49618220897599, -82.56598063661033 35.4961692089833, -82.56624263665697 35.496148209005824, -82.56644563668904 35.49615920902893, -82.56666863671892 35.496205209061145, -82.56696863675565 35.49629020910913, -82.56720363677543 35.49641520915859, -82.56740863678708 35.49656120920931, -82.56765363679588 35.496769209276756, -82.56818463680702 35.49727120943337, -82.56844663681431 35.497507209508214, -82.56866263682595 35.49766520956254, -82.56887963684235 35.49779320961075, -82.56906163685998 35.49787520964614, -82.56934063689172 35.49797020969405, -82.56960563692661 35.49802920973325, -82.56980663695624 35.49805320975871, -82.57007963699839 35.49807420979098, -82.57027063702893 35.498081209811964, -82.57075963710695 35.49810120986616, -82.57149663722161 35.49815120995178, -82.57190163727805 35.49822121000754, -82.5722136373154 35.498315210058635, -82.57252863734846 35.49844021011632, -82.57279763737165 35.49858021017239, -82.57307163739094 35.498751210235326, -82.57365463742482 35.49916121037846, -82.57395363744351 35.4993632104502, -82.57419663746253 35.499502210503415, -82.57446963748909 35.499624210556235, -82.57469063751456 35.49969721059371, -82.57494363754724 35.49975821063201, -82.57519463758283 35.49979721066569, -82.57540563761492 35.499816210691186, -82.57566463765656 35.49982521071956, -82.57591763770911 35.49975621073142, -82.5763426377793 35.499758210775354, -82.57679663784927 35.49979321082901, -82.5770866378871 35.499860210872384, -82.57723763790416 35.499912210898415, -82.577464637925 35.50002221094407, -82.57809263797458 35.50037821108084, -82.57830363798865 35.50051521113037, -82.57855763801378 35.50062621117898, -82.57883263804563 35.500716211225516, -82.57903563807285 35.50075821125482, -82.57921763810108 35.500771211276124, -82.57946563814147 35.50077621130255, -82.57974163819141 35.50074921132536, -82.57995663823473 35.50069921133718, -82.58018463828337 35.50062821134611, -82.58066163839209 35.50043521135569, -82.5812166385207 35.500197211364124, -82.58159263860313 35.500066211375945, -82.58208863869942 35.4999752114083, -82.5824436387595 35.49996721144301, -82.58277663880861 35.50000721148528, -82.58321163886274 35.500125211553865, -82.5835826388964 35.50030721162889, -82.58379363890965 35.50044921167944, -82.58402363891933 35.50063521174083, -82.58447663893322 35.501035211868675, -82.58467063894295 35.50118221191849, -82.58489563895981 35.50131521196862, -82.58530463900352 35.50147321204265, -82.58569263905781 35.50153921209584, -82.58610063912337 35.50155321214045, -82.58610263912384 35.501552212140446, -82.58655763920554 35.501511212178826, -82.58687863926566 35.50146721220275, -82.58719163932645 35.501409212222974, -82.58783863945638 35.5012622122593, -82.58952163980192 35.50082921234357, -82.59003663990838 35.50069221236846, -82.59102564011096 35.50044121241871, -82.59133664017546 35.500357212433464, -82.5916346402358 35.50028621244947, -82.59171264025171 35.50026721245368, -82.59174364025823 35.500258212454966, -82.59206064032382 35.50017321247016, -82.59207064032594 35.50017021247054, -82.59217964034845 35.50014121247585, -82.59216364028454 35.50054121255564, -82.59214664022058 35.500940212635065, -82.59213764018567 35.50115821267851, -82.59226964013035 35.501662212794635, -82.59229064006391 35.50211921288985, -82.59230564001841 35.50243221295511, -82.59231963997284 35.502745213020255, -82.59234563989257 35.5032972131353, -82.5923286398461 35.50358221319158, -82.5922646396667 35.50468321340913, -82.59224163955594 35.505381213548915, -82.59232663948468 35.50593821367103, -82.59237963944055 35.50628421374691, -82.5925126392738 35.50751621401139, -82.5924856391673 35.50818221414409, -82.59235863909005 35.508548214205646, -82.5914136388261 35.5092472142511, -82.59105463873834 35.50943121425178, -82.59071963865624 35.50960421425266, -82.5903836385741 35.50977621425322, -82.58882063819162 35.510579214256566, -82.58762563791997 35.511057214231485, -82.58677363772604 35.511400214214, -82.58610063756774 35.511704214206915, -82.58466463716205 35.512796214282, -82.584569637136 35.51286321428594, -82.58447563711024 35.51292921428969, -82.58443563709926 35.51295721429127, -82.58398863698683 35.51320721429636, -82.5837476369261 35.51334221429914, -82.58290263672222 35.51375721429704, -82.58158563648675 35.51386821418473, -82.58044663630001 35.51385321406492, -82.57912963613283 35.51351821386173, -82.5781946360269 35.513197213700565, -82.57800963600573 35.513134213668756, -82.57674563586511 35.51268421344764, -82.57641763582855 35.51256721339018, -82.57635563582463 35.512526213375494, -82.57621663581557 35.51243421334253, -82.57565263577926 35.51206121320879, -82.57506763575402 35.51159221305335, -82.5749916357508 35.51153121303316, -82.5749156357477 35.511469213012745, -82.57423663571853 35.51092421283228, -82.5732346356576 35.51023721258972, -82.57225163560236 35.50953421234586, -82.57149463551968 35.50925421221131, -82.57126363548379 35.509238212184364, -82.57107363545411 35.509226212162446, -82.57088363542458 35.50921321214034, -82.57067963539293 35.50919921211659, -82.57006763522303 35.509645212144676, -82.56936863501454 35.51024821219579, -82.56862363480901 35.51078321222822, -82.56788963460636 35.511310212260284, -82.56770163454425 35.51151221228216, -82.56729063440842 35.51195321232973, -82.56728063440508 35.51196421233098, -82.56655363418852 35.51259021238388, -82.56640463412668 35.512832212417855, -82.56622763405312 35.51312021245833, -82.56605063397963 35.513408212498746, -82.56574863385404 35.513900212567954, -82.56539463366258 35.51476621270791, -82.56510863354349 35.515233212773644, -82.56503663351485 35.51534221278846, -82.56497363348987 35.515437212801324, -82.5649116334648 35.51553321281453, -82.5644706332885 35.516206212906255, -82.56415663314816 35.51678121299109, -82.56392063300137 35.517483213109784, -82.56378763295814 35.51762121312416, -82.56340963283515 35.51801421316542, -82.56289863263262 35.5187822132694, -82.56254563250083 35.519259213330216, -82.56209363234947 35.519757213385255, -82.56170063222552 35.5201402134229, -82.56124863210867 35.520413213432064, -82.56056063193545 35.520798213439896, -82.55999063178933 35.521134213449876, -82.5598166317377 35.52128321346232, -82.55967663169592 35.521404213472614, -82.55942163161886 35.52163021349243, -82.55910363149438 35.52209821355509, -82.55877463130919 35.52294921369456, -82.55875963129029 35.523056213714746, -82.55863363113333 35.523943213882376, -82.55852863100192 35.524686214022736, -82.55839963078422 35.525965214269824, -82.55842663072781 35.5263622143534, -82.5584606306567 35.526862214458646, -82.55863563054612 35.5277722146618, -82.55887063043777 35.52873221488121, -82.55918063038222 35.5294292150549, -82.55928463036372 35.52966221511299, -82.5594086303491 35.52989121517233, -82.55963863032188 35.53031721528258, -82.55980763029639 35.53066621537091, -82.55993263027733 35.5309252154365, -82.5601296302312 35.5314392155613, -82.5607746302333 35.532122215766464, -82.56086363023816 35.53218721578881, -82.56095263024307 35.53225121581096, -82.56114763025396 35.532391215859455, -82.5612896302151 35.53279721595664, -82.56138063019222 35.533045216016426, -82.56140163018716 35.53310121602999, -82.5614266301558 35.53333221607958, -82.56145063012572 35.533554216127236, -82.56145563006169 35.53397621621366, -82.56145963001845 35.534262216272204, -82.56145363000432 35.534348216289146, -82.5614216299276 35.53481321638044, -82.56134462981169 35.53548521650938, -82.56143362972085 35.53617321665853, -82.56150662966921 35.5365882167505, -82.56152962965318 35.53671721677902, -82.56159262962976 35.53693821683052, -82.5616576296057 35.537165216883395, -82.56177462956985 35.53752521696861, -82.56180162956139 35.537609216988514, -82.56186562954196 35.53780521703498, -82.56204062953462 35.53804221710116, -82.56213762953058 35.53817321713778, -82.56226562948544 35.53860521723876, -82.56253762950111 35.538797217305756, -82.56264962947307 35.53910121737918, -82.56265462947259 35.539109217381274, -82.56272962946665 35.539229217413414, -82.56285162946386 35.53937921745639, -82.56287362946351 35.53940521746405, -82.56306562946341 35.539613217526025, -82.56317062946967 35.53968621755164, -82.56327362947589 35.53975721757667, -82.5633496294792 35.53981721759666, -82.56337262948033 35.53983521760272, -82.56346362948432 35.53990721762666, -82.5635776294894 35.53999721765665, -82.56362162949765 35.539991217660024, -82.56390162952108 35.5401412177192, -82.56442762956497 35.5404242178308, -82.56464462958215 35.54054621787793, -82.56474162959003 35.54060021789875, -82.56483162959714 35.5406512179184, -82.56501962961204 35.540757217959246, -82.56507662961654 35.54078921797161, -82.56519962963041 35.54083221799298, -82.5652136296318 35.54083821799569, -82.56566562968204 35.540999218074845, -82.56574462968761 35.541048218092925, -82.56591062969912 35.541153218131306, -82.56593362970077 35.54116721813647, -82.56655062974342 35.541556218278984, -82.567069629758 35.54202221842708, -82.5672576297632 35.542191218480774, -82.56771962977707 35.54260021861129, -82.56808362978806 35.542922218714246, -82.5681916297959 35.542988218738806, -82.5687236298339 35.543315218859874, -82.56925562987203 35.543642218981056, -82.56945862988654 35.54376721902734, -82.56972662991271 35.54388621907902, -82.5703356299723 35.544156219196445, -82.5707956300172 35.544361219285314, -82.57108363005301 35.54443921933074, -82.57132663008322 35.544505219369135, -82.57156963011329 35.544572219407634, -82.57339063033918 35.54506921969568, -82.57447163045978 35.54545221988447, -82.576004630629 35.54600722015473, -82.57812663092037 35.54640422045319, -82.57934563107587 35.546709220640246, -82.5800526311342 35.54709322079097, -82.58038663114237 35.547401220887956, -82.58056363110377 35.54784422099629, -82.58117263112005 35.548396221171096, -82.58180263111825 35.54908922137684, -82.58254963114469 35.54972422158277, -82.58376863121435 35.55058922188392, -82.58446663127197 35.550968222032665, -82.58571563137524 35.55164622229882, -82.58612363141117 35.55185322238274, -82.58764263154517 35.55262322269532, -82.58818063156932 35.55304722283684, -82.58890163160177 35.5536152230265, -82.58897963160531 35.55367722304708, -82.58905863160903 35.55373822306763, -82.58939363165908 35.553774223109286, -82.58945063166446 35.553801223120665, -82.58950763166965 35.553829223132205, -82.58961063167918 35.55387822315279, -82.58948763165706 35.553889223142384, -82.58949463164979 35.553944223154296, -82.5896896316509 35.554148223215854, -82.58976363165362 35.55421022323603, -82.590395631677 35.55474122340899, -82.59041863167823 35.55475822341483, -82.5912906317235 35.55540622363617, -82.59170763172945 35.55581822376282, -82.59207063167928 35.556537223946464, -82.59251463159097 35.5575922242069, -82.59262263157746 35.55779722425971, -82.59275763156039 35.55805422432586, -82.5927846315513 35.55814222434655, -82.59290563151156 35.55853222443837, -82.5931956314558 35.55920822460576, -82.59326663142782 35.559467224665745, -82.59328263142129 35.55952722467958, -82.59328563139253 35.559717224718604, -82.59329663126505 35.560559224891165, -82.59320963119654 35.56091122495395, -82.59314263110767 35.56141722505013, -82.5931286310972 35.561470225059466, -82.59303463102466 35.56184022512513, -82.59302163099719 35.56200522515742, -82.59292763094021 35.56227422520253, -82.59249763074715 35.56306622531971, -82.59234263068852 35.56328022534741, -82.59165063045863 35.56402822542861, -82.59128763036033 35.56427522544172, -82.58910162987986 35.56503922537303, -82.5888256298174 35.56514722536662, -82.58792462961341 35.5655012253463, -82.5869096294009 35.565787225300355, -82.58567862916851 35.56596922521115, -82.5848986290348 35.56599622513659, -82.58416762893353 35.56586522503487, -82.58410562892492 35.5658542250263, -82.5832436288214 35.56559622488533, -82.58259162877138 35.56521722474132, -82.5822286287391 35.565035224666985, -82.58193262870498 35.56493722461664, -82.58157662865604 35.56487122456668, -82.58111162858562 35.56482722451003, -82.5803116284527 35.564827224427944, -82.58027162844951 35.56480522441931, -82.57873162817009 35.56495922429268, -82.57749362792055 35.565245224223816, -82.57612562767618 35.56535722410623, -82.57501262747724 35.56544922401078, -82.57412462730618 35.56560322395095, -82.57339762715839 35.565779223912195, -82.57154262679907 35.56611322378989, -82.57147562678428 35.56613722378779, -82.57042062655242 35.56650622375469, -82.56776462596754 35.567442223672614, -82.56636262568436 35.56777022359544, -82.56572462556835 35.56783622354346, -82.56520762547396 35.56789122350153, -82.5644906253034 35.56822722349635, -82.56406962520292 35.5684262234936, -82.56389062515177 35.56856522350351, -82.5637906251347 35.568568223493884, -82.56376462513013 35.568570223491655, -82.5635716251066 35.56851522346063, -82.5634976250941 35.56851622345319, -82.56339862507721 35.568519223443715, -82.56341962509902 35.56840022342166, -82.5634406251208 35.56828122339958, -82.56339562514148 35.56809822335767, -82.56338562514667 35.568053223347505, -82.56334662518293 35.56777522328694, -82.56333762519132 35.56771122327299, -82.5632986252456 35.56731622318858, -82.56334962534582 35.566719223072276, -82.563473625471 35.56603922294659, -82.56354262551335 35.56583822291282, -82.56363362555852 35.565642222882204, -82.56368862557858 35.56557122287338, -82.56387362564469 35.565341222845554, -82.5640866257102 35.56514522282754, -82.5642156257491 35.56503122281756, -82.56451162583804 35.56477222279519, -82.56460662586879 35.56467522278521, -82.56465362588904 35.56459422277355, -82.56464162590795 35.5644582227447, -82.5645476259101 35.56434222271138, -82.56417062588507 35.564098222623066, -82.56360662583437 35.563819222508386, -82.56348262581962 35.56378122248789, -82.5629766257591 35.563628222404795, -82.56295662575675 35.56362222240153, -82.56293662575435 35.563616222398245, -82.56289962575006 35.56360422239203, -82.56288162574783 35.56359922238918, -82.56275362573261 35.56356022236809, -82.5619436256152 35.563449222262356, -82.56160762556645 35.56340322221853, -82.56078162542958 35.56340222213352, -82.55970262525506 35.56337222201666, -82.5590946251542 35.56337222195423, -82.5585796250685 35.56337322190162, -82.55836062502868 35.56339622188382, -82.5581536249852 35.56345522187458, -82.55799062495116 35.563501221867284, -82.55750562484923 35.563640221845745, -82.55734362481512 35.563687221838656, -82.55666962466528 35.563934221819736, -82.55624462457449 35.56406622180294, -82.55587162449878 35.564156221783, -82.5554856244299 35.56418722174975, -82.55506862436165 35.56418122170567, -82.55491462433633 35.56417922168948, -82.55420862422677 35.564130221607, -82.5535616241324 35.56404522152334, -82.55311462407218 35.56395422145889, -82.55208362393134 35.56375822131317, -82.55172862387916 35.56371422126783, -82.55139962381972 35.56374622124057, -82.5511296237595 35.56384622123313, -82.55089062369143 35.56403122124631, -82.55028862350294 35.564607221301735, -82.54992262339054 35.564943221332555, -82.54961562330212 35.56518722135065, -82.54871062307564 35.56568322135868, -82.54836562298917 35.565873221362004, -82.54760462281064 35.56621322135306, -82.54721662271396 35.56642322135596, -82.54678062259435 35.566730221373625, -82.54667062256078 35.56683022138264, -82.54649462250704 35.56698922139694, -82.54617162240824 35.567283221423615, -82.54611962239144 35.56733622142908, -82.54597862234628 35.5674782214435, -82.54596362234128 35.56749422144524, -82.54583762229369 35.56766822146774, -82.54572362228271 35.56761622144545, -82.54558262226936 35.56755122141773, -82.5452246222348 35.56738922134809, -82.54494462220882 35.567256221292176, -82.54482562219948 35.56718822126611, -82.54477562219577 35.567159221255096, -82.544596622186 35.56702922121034, -82.54443062214918 35.56708922120539, -82.54440962214447 35.567097221204875, -82.54391862204548 35.56721122117771, -82.54374762201097 35.5672512211683, -82.54370462202182 35.56713422114007, -82.54357562205446 35.5667832210554, -82.54353262206517 35.56666722102736, -82.54347762207863 35.56652022099181, -82.54331462211894 35.56608222088595, -82.54326062213244 35.56593622085068, -82.54319162214958 35.56575022080572, -82.54301262219404 35.565268220689305, -82.5429806222001 35.565194220670904, -82.54290362221522 35.565012220626016, -82.54280662223327 35.56479022057085, -82.5427756222393 35.56471822055305, -82.54262462228046 35.56428722044987, -82.5425446222937 35.564115220406556, -82.54249162230268 35.56399922037752, -82.54248562230386 35.56398522037409, -82.5424386223093 35.56389922035173, -82.54236762231781 35.563767220317615, -82.54226762232429 35.56361722027679, -82.54219562232925 35.56350722024704, -82.54189762234002 35.563115220136744, -82.54175262235096 35.56288822007563, -82.54169762235382 35.56281022005407, -82.54150962236409 35.56254021997982, -82.54146062236543 35.562479219962405, -82.54072862239528 35.561495219687004, -82.54065562239892 35.561392219658536, -82.5406036223999 35.5613302196406, -82.54039462240158 35.5610932195709, -82.53994562240545 35.56058421942129, -82.53960962240919 35.56019721930804, -82.53935062241216 35.55989821922057, -82.53874662244962 35.55900321897642, -82.53870762245434 35.55893021895763, -82.53867062245897 35.558860218939536, -82.53860562247212 35.55870421890111, -82.5385536224839 35.558572218868974, -82.53853762248765 35.55853021885876, -82.53854662250434 35.558431218839495, -82.53849362249724 35.55842021883189, -82.53845262250663 35.55831521880632, -82.53844262250983 35.55828321879872, -82.53840062252421 35.55814421876619, -82.53834662254286 35.55796521872417, -82.53831162255213 35.55786721870062, -82.53826462256536 35.55773021866796, -82.53824562257053 35.55767621865502, -82.53820462258187 35.5575582186268, -82.53819362258645 35.5575162186171, -82.53818062259263 35.55746221860481, -82.5381086226191 35.55721221854649, -82.5380936226242 35.55716321853502, -82.53808462262978 35.55711721852475, -82.53805662264936 35.556959218489766, -82.53805262266891 35.556828218462684, -82.53805062268337 35.55673121844276, -82.53804962268815 35.556699218436094, -82.53806462272247 35.55649221839549, -82.53808462275057 35.55633121836484, -82.53809362276048 35.55627621835451, -82.53810162276768 35.556238218347595, -82.53814962279853 35.55608921832222, -82.53822862284426 35.555877218287215, -82.53834862290655 35.55560121824337, -82.53843262295244 35.55539321820968, -82.5385936230393 35.555002218146676, -82.53876862313324 35.5545802180787, -82.53879262314624 35.554521218069176, -82.5388516231903 35.554298218029885, -82.53886062319764 35.55426021802303, -82.53887662321961 35.55413421799906, -82.53888762324587 35.55397521796785, -82.5388786232731 35.55378821792884, -82.53881462331972 35.55341621784654, -82.5387536233309 35.55327721781206, -82.5387376233343 35.553238217802495, -82.5386576233433 35.55309321776472, -82.53859662335009 35.552983217736106, -82.53851962335227 35.55288621770848, -82.53844662335032 35.552820217687575, -82.53838262335147 35.5527432176653, -82.53835962335236 35.55271221765661, -82.53823962335709 35.552552217611776, -82.53781762335306 35.55212321748113, -82.53763462335515 35.55191221741946, -82.53758362335574 35.55185321740221, -82.53740962336089 35.551632217339346, -82.53736462336256 35.55157221732257, -82.53722962336792 35.55139221727209, -82.53718562336961 35.55133321725554, -82.5369906233776 35.551071217182226, -82.53650662339746 35.55041921699988, -82.53640562340121 35.55028621696247, -82.53633062340403 35.55018721693459, -82.5362156234104 35.550021216888986, -82.53616862341318 35.54995221687015, -82.53602962341812 35.549770216818864, -82.53584162342507 35.54952221674912, -82.53546762343981 35.54902221660895, -82.53528162344729 35.54877321653922, -82.5352186234499 35.54868821651553, -82.53506862345893 35.54846721645514, -82.53494562346646 35.54828621640571, -82.53475462348696 35.54794621631689, -82.53460262352202 35.5475542162215, -82.53457462353012 35.547471216201764, -82.5345086235488 35.54727821615576, -82.53445562356441 35.547119216117984, -82.53443062357171 35.5470452161003, -82.5343556235933 35.54682321604744, -82.53433062360043 35.54675021603007, -82.53428962361176 35.54663221600179, -82.5341686236456 35.54628121591803, -82.53412862365697 35.54616421589003, -82.53399662369146 35.54579721580188, -82.53395162370228 35.54567821577304, -82.53344762382335 35.54434621545038, -82.53340162383385 35.54422821542151, -82.5332156238769 35.54374721530461, -82.53320662387884 35.543725215299204, -82.53314462389314 35.54356521526032, -82.5329356239424 35.54301921512775, -82.53286662395874 35.542838215083826, -82.53282062396904 35.542721215055344, -82.53268562400056 35.54237021497005, -82.53264062401094 35.54225421494182, -82.53261062401766 35.54217821492333, -82.53252362403828 35.541950214868024, -82.53249462404494 35.541875214849725, -82.53241462406362 35.5416672147992, -82.53217562411962 35.541045214648186, -82.53209662413822 35.54083821459796, -82.53202962415394 35.54066321455542, -82.53194162417535 35.54042921449879, -82.53183662419777 35.54017021443534, -82.53182262419942 35.54014421442858, -82.53173562421024 35.5399802143863, -82.53164562422234 35.53980421434125, -82.5315536242284 35.53966521430353, -82.53151362422989 35.539612214288645, -82.53136562423629 35.53941121423262, -82.53072062425463 35.538595214000395, -82.53045462426229 35.53825821390454, -82.53032562426598 35.53809521385817, -82.5299386242769 35.537606213718874, -82.52981062428051 35.53744421367282, -82.52964662428612 35.53723121361268, -82.52933862429632 35.53683221349986, -82.52916262430408 35.53659121343286, -82.52900462431116 35.536375213372615, -82.52866362432628 35.53590821324262, -82.52864362432717 35.53588121323514, -82.52843262434234 35.535554213146874, -82.52829862435621 35.5353192130854, -82.52815762437405 35.53505121301636, -82.52805362439094 35.53482921296055, -82.5279776244107 35.53461821290978, -82.52792062443427 35.5344032128602, -82.52791162443968 35.5343582128501, -82.52787962446136 35.53418221281108, -82.52785862449821 35.53392021275561, -82.52785862451893 35.53378521272812, -82.52786262454907 35.53359321268952, -82.52788362458845 35.53335921264404, -82.52792962463353 35.53311521259908, -82.52792962463398 35.533112212598546, -82.52843562502015 35.53114421225006, -82.52860462514884 35.53048821213394, -82.52869462521785 35.53013621207154, -82.5288136253086 35.52967321198962, -82.52887562535575 35.52943321194712, -82.52896562542477 35.5290812118847, -82.52905662549375 35.52873021182266, -82.52908362551511 35.52862021180301, -82.52910262552939 35.52854721179018, -82.52916062557836 35.528291211744055, -82.52918562559914 35.52818221172441, -82.52925762567952 35.52773721164133, -82.5292846257121 35.52755421160687, -82.52930562574919 35.52733521156443, -82.5293346257971 35.52705421151022, -82.52945562603426 35.52564021123494, -82.52952662617814 35.5247792110671, -82.52953062618589 35.52473321105821, -82.52955062626519 35.524238210959545, -82.52954662629786 35.52402121091496, -82.52954462631222 35.52392521089524, -82.52954062633961 35.52374221085761, -82.52953862634315 35.52371721085229, -82.5295256263808 35.5234582107983, -82.52950462642032 35.523178210739204, -82.52949462643149 35.5230942107211, -82.52947162645928 35.52288821067687, -82.52944762648667 35.52268421063281, -82.52938662653517 35.52230221054882, -82.52937562654134 35.52225021053712, -82.52929662658806 35.521860210449674, -82.5292266266208 35.52157121038376, -82.52913462665671 35.52123821030659, -82.52904162668942 35.52092421023321, -82.52887162674416 35.52038421010588, -82.5287106267963 35.519870209984745, -82.52867962680669 35.51976920996102, -82.5286706268097 35.51974020995425, -82.52864362681825 35.51965520993419, -82.52863562682116 35.51962720992764, -82.52862662682419 35.51959820992083, -82.5285996268327 35.519513209900786, -82.52859162683576 35.51948520989425, -82.52870962687237 35.519374209883786, -82.52881362690944 35.51924420986805, -82.52905962699691 35.518940209831364, -82.52944062712974 35.51848620977812, -82.52965262720338 35.51823520974879, -82.53071162754314 35.517165209639714, -82.53074562755386 35.517132209636465, -82.53118662768327 35.51676520960705, -82.5317246278246 35.51642520959308, -82.53235162796598 35.516181209607744, -82.5332896281649 35.51589820964636, -82.53440262836953 35.51576720973382, -82.53488762845419 35.51573920977793, -82.53545862855376 35.51570720982995, -82.53638162872869 35.51556420989557, -82.53640262873263 35.51556120989706, -82.53771062895976 35.51549421001756, -82.53811362903565 35.515435210046874, -82.53880962916652 35.51533421009776, -82.53974362933768 35.515228210172, -82.54093862956383 35.51504521025723, -82.54191462974951 35.514890210325824, -82.54325463002073 35.514570210398105, -82.54383963013902 35.51443121042978, -82.54468763031174 35.51422221047422, -82.54480163033384 35.51420121048168, -82.54494763036217 35.51417421049109, -82.54517963040745 35.514130210505996, -82.54552563047459 35.514066210528426, -82.54587263054545 35.51397921054628, -82.54610263059215 35.51392321055847, -82.54948963128267 35.513083210734884, -82.54987963136209 35.51298721075531, -82.55104863159866 35.51270821081847, -82.55168763172644 35.51256621085503, -82.55244863187477 35.512422210903736, -82.55283163194795 35.51235921093017, -82.55315563200857 35.51231421095425, -82.55380663212851 35.51223621100511, -82.554997632342 35.51213221110605, -82.55533263240272 35.51209821113346, -82.55549863243367 35.51207621114597, -82.55571563247717 35.51202721115824, -82.5558366325032 35.51198821116275, -82.55597963253612 35.511928211165184, -82.55612163257072 35.511856211165124, -82.55624963260493 35.51177121116094, -82.5563656326383 35.51167921115412, -82.55648463267565 35.51156421114291, -82.5565826327106 35.51144221112811, -82.55665663274026 35.51132921111268, -82.55671763276906 35.51120721109413, -82.55675963279245 35.51110021107665, -82.55679163281616 35.510980211055546, -82.55681463284233 35.510834211028104, -82.55679563293997 35.51017721089256, -82.55676763300983 35.50969121079075, -82.5567826330787 35.50925821070421, -82.55685063315633 35.50882521062306, -82.55696663323543 35.5084352105556, -82.55698363324649 35.50838121054631, -82.55715663333864 35.507967210479805, -82.5573066334069 35.50768421043757, -82.55741263345135 35.50750921041287, -82.55758063351612 35.50726821038108, -82.55819863373527 35.50650721028951, -82.55838363380474 35.506254210256984, -82.55850263385945 35.506026210222785, -82.5585676339033 35.505810210185494, -82.55858963394546 35.50555921013673, -82.55857763396452 35.505422210107604, -82.55857063397423 35.505351210092485, -82.5585096340087 35.50506021002692, -82.558366634072 35.50449220989668, -82.55832763410268 35.50425020984349, -82.55832763413814 35.50401920979651, -82.55837263419764 35.50367920973191, -82.55843863426382 35.50331920966539, -82.55850063433182 35.50294220959504, -82.55852563438863 35.502598209527555, -82.55853163440004 35.5025312095146, -82.55851663445611 35.50214920943531, -82.55845663449796 35.50181120936033, -82.55832363455279 35.50130920924461, -82.55809963463209 35.50054920906695, -82.55800963467667 35.50016120897879, -82.55796163472712 35.499780208896354, -82.55796563476561 35.49953320884651, -82.55800863481554 35.49925420879411, -82.55806463485698 35.49904420875715, -82.55818863491726 35.49878520871713, -82.55832563496959 35.498592208691925, -82.55848663502309 35.4984172086728, -82.55879663511148 35.49817520865533, -82.55899463516234 35.498058208651884, -82.55935663524703 35.49789720865615, -82.55960863530089 35.497818208665954, -82.55995663537317 35.49772320868226, -82.56115863561372 35.497454208750646, -82.56148963568194 35.49736720876689, -82.5619736357788 35.497259208794446, -82.56230263584659 35.497172208810504, -82.56244463587632 35.49713220881696, -82.56490963639104 35.496441208928786, -82.56502263641455 35.49641020893408, -82.56506963642427 35.49639720893635, -82.56515463644202 35.496373208940085, -82.56520463645235 35.49636020894258)))",6258,37,021,002101,370210021011,1375,1375,13,1366,1344,13,3,4,0,2,9,1094,8,1086,1091,1072,13,3,2,0,1,3,698,562,136
census_2010_blockgroups_view.fid--2dc29038_13ec899ba8f_-2647,"MULTIPOLYGON (((-82.58042161695988 35.639582239660456, -82.58042361697031 35.63951723964744, -82.58042961700139 35.639322239608326, -82.58043261701174 35.63925823959568, -82.5804916170265 35.63922623959517, -82.5805586170401 35.639210239598775, -82.58061261705413 35.63917723959761, -82.58065561706319 35.63916523959965, -82.58069361707099 35.63915523960148, -82.58076061707702 35.63918823961509, -82.58093561710103 35.63922123963984, -82.58098261710374 35.63925423965142, -82.58108361711376 35.63929823967066, -82.5811776171177 35.63937423969584, -82.5812786171039 35.639572239746535, -82.58139361709758 35.639737239791984, -82.58152161710012 35.6398582398298, -82.58176361711578 35.64001723988705, -82.5819116171362 35.640045239907984, -82.58208661716961 35.640017239920255, -82.58218161719383 35.63996223991879, -82.5823696172513 35.63979223990351, -82.5827266173836 35.63931923984392, -82.58284061744841 35.63902223979515, -82.5828746174752 35.6388852397707, -82.58291461748854 35.638841239765846, -82.58294861751804 35.63868723973795, -82.5830066175368 35.63862823973196, -82.58301561753939 35.63862123973137, -82.58312361756748 35.63855523972913, -82.5833516176163 35.638484239738105, -82.58356761766915 35.638374239737836, -82.58364161768489 35.638352239740975, -82.58370861770283 35.6383082397389, -82.58393061775665 35.63819823973933, -82.5839846177666 35.638192239743695, -82.5842946178401 35.638049239746415, -82.58451661789066 35.63796123975132, -82.58457061790114 35.63795123975486, -82.58467761792662 35.63790123975564, -82.58493361797936 35.637835239768535, -82.58500161799066 35.63783523977547, -82.58512861800834 35.637857239793036, -82.58539161805982 35.63780723980985, -82.58568761811418 35.637774239833576, -82.58588961814773 35.63777423985438, -82.58609161817783 35.63779623987961, -82.5864956182254 35.63792323994703, -82.58654961822948 35.637955239959034, -82.58661661823727 35.63797723997043, -82.5866576182389 35.63801023998136, -82.5867716182494 35.63806524000429, -82.58698661825457 35.63826324006674, -82.58705461824215 35.63841724010507, -82.5871756182504 35.638494240133184, -82.58722961825772 35.63850524014099, -82.5873106182643 35.638549240158234, -82.58744461828077 35.63858724017977, -82.58753261828863 35.638631240197704, -82.58761961829288 35.63869724022019, -82.5877206182825 35.63887324026637, -82.58780161827906 35.6389832402971, -82.58803061829337 35.63913724035201, -82.58825961831269 35.63925824040018, -82.5885426183413 35.63937824045376, -82.58871061836834 35.6393842404722, -82.58879161838514 35.639362240476004, -82.58889961840988 35.63931824047817, -82.5891076184742 35.63912524046026, -82.58911461847879 35.63910324045655, -82.58905361857283 35.638428240312734, -82.58906061859183 35.638312240289885, -82.58908761860819 35.638235240277, -82.58914061862545 35.638180240271225, -82.58919461863952 35.63814724027008, -82.58930261866092 35.63812524027665, -82.58947061868453 35.63815324029963, -82.58961261870132 35.63819724032314, -82.58981461871984 35.63829524036395, -82.59001661874153 35.638372240400365, -82.59035261876684 35.63857024047524, -82.59067661879442 35.63874024054318, -82.59091161880548 35.6389222406044, -82.5910466188068 35.6390592406461, -82.59128861875462 35.63965824079304, -82.59130861874188 35.6397622408162, -82.59128661867189 35.6401922409016, -82.59128261865615 35.64029024092112, -82.59132961864113 35.64043824095605, -82.59136961864098 35.64048224096909, -82.59139761863545 35.64054824098544, -82.59143761863358 35.64060324100077, -82.5915386186377 35.640685241027874, -82.59161961865632 35.640652241029436, -82.59173361871579 35.640389240987595, -82.59176061873721 35.640279240968006, -82.59180061876015 35.64017424095072, -82.59194861879743 35.640092240949194, -82.5921776188364 35.640086240971506, -82.59231261885543 35.640108240989946, -82.59237961886144 35.64014124100348, -82.59303961894327 35.64032224110821, -82.5932286189628 35.64039924114338, -82.59336261898001 35.640432241163836, -82.59361861900734 35.64053124121031, -82.59385461902953 35.64064124125694, -82.59390861903609 35.64065724126581, -82.59406961904932 35.6407452413002, -82.59422661906797 35.64079324132621, -82.59426361907227 35.640805241332366, -82.59446961910241 35.64083224135902, -82.59509561921288 35.640790241414855, -82.5954546192897 35.64067924142911, -82.5955916193177 35.64064524143633, -82.5956306193252 35.64063924143911, -82.59568661933604 35.64062924144276, -82.59585761936872 35.640601241454725, -82.59591561937977 35.64059224145881, -82.59608861941308 35.640563241470645, -82.596577619497 35.64054624151748, -82.5967286195228 35.64054124153197, -82.59702361956835 35.64056424156694, -82.59707961957703 35.640568241573575, -82.5971326195843 35.6405782415811, -82.59750261963556 35.64064524163274, -82.59800061971752 35.64065024168494, -82.59829661977352 35.64060624170639, -82.59890261984084 35.640823241812875, -82.59913861986709 35.64090724185423, -82.59911661984756 35.64101024187291, -82.59904961978854 35.641320241929186, -82.5990286197691 35.64142424194824, -82.59921461972183 35.641931242070655, -82.59916661965956 35.642283242137395, -82.5993426195901 35.64292324228581, -82.5993906195625 35.64315324233761, -82.59951861949101 35.64375524247335, -82.5995646194534 35.6440482425378, -82.59967861935966 35.64477924269843, -82.59971061921685 35.645739242897235, -82.5997906191166 35.64647524305538, -82.59987061897684 35.6474672432657, -82.59989861882154 35.64850424347981, -82.59990261879965 35.64865024350991, -82.60006261870774 35.64941824368285, -82.6002246186037 35.65026724387243, -82.60026761857596 35.65049324392292, -82.60027061857446 35.65050624392587, -82.600542618524 35.651126244080125, -82.6006356185069 35.65133724413267, -82.6004146184767 35.65129524410132, -82.60026761845658 35.651267244080515, -82.59990061840618 35.65119824402877, -82.59975461838616 35.6511702440081, -82.59971761838116 35.65116324400281, -82.59953461835596 35.651129243977124, -82.5994266183353 35.65114624396942, -82.5993136183161 35.65114924395846, -82.59928561831116 35.651151243955944, -82.59911661828208 35.65115724393984, -82.59865361819504 35.651222243905494, -82.5984346181539 35.65125324388928, -82.59830261812894 35.65127224387952, -82.59828261812534 35.651274243877936, -82.59803961808089 35.65130024385818, -82.59782361804375 35.65130824383762, -82.5976706180173 35.6513152438233, -82.5976616180043 35.65138924383749, -82.59765861799956 35.6514172438429, -82.59769361799066 35.65151224386581, -82.59774861798945 35.65157924388516, -82.59775461798938 35.65158624388716, -82.59776261798922 35.65159624389009, -82.59780961799046 35.651638243903406, -82.59785561799166 35.651680243916715, -82.59823861800896 35.6519812440174, -82.59843761801585 35.652150244072295, -82.59857861801714 35.652294244116085, -82.598694618011 35.65245924416168, -82.59877461800083 35.65261124420084, -82.59882661798814 35.65274924423431, -82.59885761796713 35.65291924427206, -82.59885961795543 35.652997244288194, -82.59886161794557 35.65306324430184, -82.59885061793187 35.65314024431636, -82.59884561792464 35.65318124432422, -82.59880761789474 35.65333424435153, -82.5987556178619 35.653491244378095, -82.59856061775487 35.653974244456464, -82.59855061774934 35.653999244460586, -82.59839261766463 35.65437824452143, -82.59829461760921 35.65463124456293, -82.59821661756015 35.65486524460262, -82.59809361747097 35.65531024468058, -82.59804861743238 35.6555122447171, -82.59792761729817 35.65625124485516, -82.59786961726108 35.65642924488548, -82.59780661723417 35.65653524490063, -82.59770961720355 35.65662924490983, -82.5975346171542 35.65676024491845, -82.59706261702536 35.65708624493635, -82.59690761697944 35.657217244947134, -82.59679661694261 35.65733624495994, -82.59670661690599 35.65747624497921, -82.59663561687226 35.657618245000805, -82.59659561684462 35.65775424502438, -82.59657061681409 35.657925245056724, -82.59658061679522 35.65805824508477, -82.59661161677894 35.658197245116256, -82.59665161676749 35.65831424514426, -82.59671061675863 35.65843524517494, -82.5968026167528 35.6585722452123, -82.5969106167524 35.65869124524762, -82.59752961677671 35.659200245414965, -82.59769661678149 35.65934924546247, -82.59788061678447 35.65952824551788, -82.59801961678224 35.65969224556561, -82.59814561677806 35.65985524561172, -82.5982766167691 35.66005424566574, -82.59839861675542 35.660274245723095, -82.5984836167421 35.66045224576808, -82.59853161673274 35.66056424579589, -82.59862461670815 35.66082424585842, -82.5986786166916 35.66098924589751, -82.59873561667445 35.66116224593865, -82.59891861661534 35.661741246075415, -82.5989906165936 35.6619602461274, -82.59902861658705 35.66204324614825, -82.5990616165835 35.66210224616364, -82.59913361657934 35.66220624619231, -82.59918361657907 35.662262246208805, -82.59929361658223 35.662360246240056, -82.59947061659295 35.6624812462829, -82.59956661660017 35.6625382463044, -82.59975661661043 35.66267624635206, -82.59983161661292 35.662741246373, -82.59992561661251 35.66284524640385, -82.60003561660736 35.6629972464461, -82.60019461659478 35.66324924651386, -82.60084361654079 35.66429824679424, -82.60094461653492 35.664445246834624, -82.6009606165343 35.66446624684053, -82.60107661653001 35.664619246883596, -82.60132361652647 35.66490824696781, -82.60148761652815 35.66507424701859, -82.60175161653764 35.66529724709111, -82.60191661654565 35.66542224713356, -82.60205661655385 35.665520247167926, -82.60225361656737 35.665645247213604, -82.60334361664998 35.66628424745589, -82.60358261666642 35.66643524751123, -82.603938616686 35.66669224760019, -82.60419361669652 35.666898247668456, -82.60437561670258 35.667055247719105, -82.60439761670331 35.66707424772525, -82.60480361670324 35.66751224785624, -82.60484361670261 35.66755924786999, -82.60509961669719 35.66787024795958, -82.60533961669815 35.668122248035615, -82.60516761668424 35.66802724799854, -82.60494961665908 35.667955247961444, -82.60471361662617 35.66791424792881, -82.60469761662361 35.667913247927004, -82.604576616604 35.66791024791393, -82.60444861658085 35.66792224790321, -82.6043176165553 35.66794624789463, -82.6041586165213 35.667995247888285, -82.60334361633787 35.668305247867664, -82.60313061629175 35.6683742478598, -82.60293261625095 35.66842524784979, -82.60274161621545 35.66844924783497, -82.60270561620867 35.668454247832344, -82.60253861617922 35.66846524781745, -82.60238861615494 35.66846124780115, -82.60218061612338 35.66844124777573, -82.60206461610655 35.66842524776051, -82.60199061609592 35.66841424775065, -82.60140061601128 35.66832724767232, -82.6010286159578 35.6682722476228, -82.60079061592306 35.66824124759198, -82.60051361587917 35.668227247560665, -82.6002836158395 35.66823624753885, -82.60005261579573 35.66827124752225, -82.59984161575187 35.668327247511954, -82.59942761566177 35.66846524749748, -82.59912161559498 35.668568247486995, -82.59881261552722 35.66867324747663, -82.59879261552307 35.668679247475744, -82.59788361532415 35.66898824744521, -82.59781261530783 35.66901724744385, -82.59760661526042 35.66910224743992, -82.59736761520142 35.66922724744079, -82.59707961512548 35.66940824744811, -82.59688861507166 35.66955124745758, -82.59605661483366 35.67019624750337, -82.59527261461093 35.67079424754461, -82.59517661458352 35.67086824754974, -82.59491861451212 35.67105224756072, -82.59477261447604 35.6711292475614, -82.59466161445238 35.67116224755664, -82.59456361443354 35.671179247550086, -82.59448661442022 35.671182247542745, -82.59440661440722 35.67118024753409, -82.594345614398 35.671174247526636, -82.59443261439698 35.67127424755592, -82.59461361439207 35.67150124762075, -82.59463861439129 35.67153324762991, -82.59478861438639 35.671726247684596, -82.59491061438088 35.67189324773116, -82.59510161436737 35.67218624781049, -82.59516761435857 35.672314247843396, -82.59521461434632 35.672444247874694, -82.59524861432652 35.67260924791183, -82.59526661430787 35.672749247942185, -82.59527261430269 35.67278924795093, -82.59529361428754 35.67291024797776, -82.59533461426712 35.67308624801775, -82.59537861425699 35.67319924804535, -82.59545061424717 35.673340248081495, -82.59546461424546 35.673366248088264, -82.59556861423852 35.67352324813093, -82.59569961422604 35.67374524818957, -82.59578061421838 35.67388224822582, -82.59589461420784 35.67407324827646, -82.59595561420292 35.67417024830251, -82.59607261419382 35.67435524835219, -82.59631161417254 35.6747502484573, -82.59637261416272 35.674879248489844, -82.59641961415224 35.674998248518875, -82.59643361414521 35.67505824853256, -82.59651061410722 35.67538724860749, -82.59652361409891 35.67545524862269, -82.59656361407401 35.67565924866838, -82.59657761406578 35.67572724868363, -82.59660761404811 35.675874248716745, -82.59661561403185 35.6759882487407, -82.59661361400893 35.67613424877028, -82.59655561396148 35.67637924881417, -82.59652961394309 35.676470248830036, -82.59649561391221 35.67663324885976, -82.59646861388656 35.676770248884864, -82.5964316138453 35.67699724892729, -82.59639661381209 35.677174248959815, -82.59635261378385 35.677310248983, -82.59628861375475 35.677429249000646, -82.59620761372312 35.677547249016314, -82.59609361368344 35.677681249031934, -82.59596161364055 35.67781624904583, -82.59581761359239 35.677973249063, -82.59571561355637 35.678096249077555, -82.59547061347023 35.67839024911228, -82.59535561342837 35.678537249130365, -82.5950356133173 35.67891124917362, -82.59480561323738 35.67918124920494, -82.59467361319012 35.679345249224774, -82.59454961314273 35.67951824924731, -82.59447261311091 35.67964124926442, -82.59441461308681 35.67973424927739, -82.59434161305425 35.67986624929676, -82.59422861300177 35.68008424932959, -82.59415061297076 35.680201249345366, -82.5941266129628 35.680227249348185, -82.59404061293287 35.68032824935991, -82.59392061289685 35.68043224936876, -82.59389061288876 35.68045224936975, -82.59380261286452 35.68051424937333, -82.59367561283545 35.680565249370595, -82.59354561280904 35.68059624936358, -82.59337861277727 35.68062224935173, -82.59321861274977 35.6806282493365, -82.59307161272717 35.68061624931889, -82.59293361270885 35.68058624929861, -82.5928446127003 35.68054524928101, -82.5927416126936 35.680478249256794, -82.59267261269247 35.680411249236094, -82.59258561269435 35.68030524920554, -82.59236861270313 35.68001524912411, -82.5922146127004 35.679867249078136, -82.59208461269169 35.67978324904766, -82.59195661267782 35.67973524902467, -82.59180661265464 35.67972424900702, -82.59166961262945 35.679739248996015, -82.59149661259285 35.67979024898856, -82.59138961256717 35.67984124898796, -82.59128861254126 35.67990024898955, -82.59128261253977 35.679903248989575, -82.59106661247783 35.680071249001564, -82.59098461245341 35.6801412490074, -82.59088261242518 35.68021424901177, -82.59076761239665 35.680275249012425, -82.59062161236558 35.68031924900631, -82.59040361232496 35.68034724898961, -82.5903496123151 35.680353248985256, -82.5902816123022 35.68036324898028, -82.59019161228397 35.680384248975344, -82.59013961227332 35.68039724897261, -82.59018261229852 35.68028024895323, -82.59019461230297 35.68026424895113, -82.59022561232626 35.68014724893057, -82.59023161233073 35.68012424892649, -82.59028361238164 35.67985124887619, -82.5902926123902 35.67980524886783, -82.59034561246662 35.679368248784165, -82.59038061253328 35.67897424870752, -82.5903996126142 35.67847124860708, -82.5903966126626 35.67815524854234, -82.59039561270997 35.6778472484795, -82.5903886127489 35.67758824842607, -82.59038261278633 35.67733924837475, -82.59036861280254 35.67721924834879, -82.59034161283665 35.67696924829518, -82.5902856128609 35.67675224824519, -82.59022161287962 35.676562248199915, -82.59012161289174 35.67637624815173, -82.5899906128973 35.67619924810212, -82.58997461289793 35.67617824809623, -82.5897526128957 35.675953248027625, -82.58973161289451 35.67593824802235, -82.58957561285212 35.676045248028124, -82.58942361280658 35.676176248039184, -82.58881761262478 35.67670024808352, -82.58856361254749 35.67692724810362, -82.58854261254137 35.676944248104945, -82.58824661245302 35.677197248126035, -82.58828061245298 35.67723424813709, -82.58834761244233 35.67737524817269, -82.58847161242593 35.67761424823411, -82.58902761237722 35.67852824847752, -82.58934561235515 35.67901324860902, -82.58947061233934 35.67925024867017, -82.58945561231951 35.679362248691426, -82.58939061229475 35.67945224870308, -82.5890616122027 35.679694248718555, -82.58902861219333 35.67971924872022, -82.58860161207156 35.68004724874306, -82.58844261203606 35.68010624873871, -82.58812561197807 35.68014024871304, -82.58779161192113 35.68014924868053, -82.5872436118249 35.6801822486308, -82.58686861176321 35.680177248591264, -82.5865916117203 35.6801572485587, -82.58613061164807 35.68012824850534, -82.58524661150713 35.680089248406404, -82.58433361136251 35.68004224830294, -82.58408761132443 35.680024248273895, -82.5839606113039 35.68002024826006, -82.58376261127576 35.679989248233355, -82.58367561126549 35.67996224821891, -82.5836306112622 35.679935248208785, -82.58361561126203 35.679920248204155, -82.58359061126203 35.67989324819612, -82.58357661127346 35.67980424817653, -82.58358161129561 35.6796662481489, -82.58358461130668 35.67959824813542, -82.58364561135357 35.67936024809324, -82.58365661136308 35.67931024808413, -82.58370961140929 35.679068248040316, -82.58375261144336 35.678894248009286, -82.58381661149356 35.67863824796376, -82.583888611555 35.67831824790595, -82.5839216115828 35.67817424788012, -82.58398061162626 35.677956247841735, -82.58415761174561 35.67737424774144, -82.5841936117697 35.6772572477213, -82.58426461181122 35.67706524768947, -82.58435261185643 35.67686724765819, -82.58446961190067 35.676707247637665, -82.58460861194386 35.6765772476255, -82.58464261195304 35.67655424762425, -82.58476861198668 35.67647224762054, -82.58493961202703 35.6763952476225, -82.58626661232243 35.67591124766036, -82.58644261236311 35.675837247663395, -82.58647661237082 35.67582424766431, -82.58662161241212 35.67571324765658, -82.58670461244662 35.67557924763789, -82.58673861246587 35.675491247623384, -82.58675561249575 35.675316247589514, -82.58663161247695 35.675304247574296, -82.58657661246858 35.67529924756765, -82.58635161243663 35.67526424753736, -82.58626361242466 35.67524624752465, -82.58614261240832 35.67522224750733, -82.58610361240302 35.67521424750169, -82.5860526123971 35.67519824749316, -82.58586061237406 35.67514024746162, -82.58578861236641 35.67511224744847, -82.58570261235705 35.675080247433094, -82.5856186123369 35.675120247432616, -82.58549561230936 35.67516624742933, -82.585217612241 35.67530924742982, -82.5851926122347 35.675323247430136, -82.5849896121833 35.67543724743251, -82.58471861211575 35.675583247434304, -82.584347612024 35.6757772474357, -82.58406761195242 35.67593924743986, -82.58388061190155 35.67606724744664, -82.58382461188548 35.676111247449896, -82.58375561186551 35.67616624745399, -82.58365561183541 35.6762532474614, -82.58356161180492 35.67634924747134, -82.583441611764 35.676485247486646, -82.5834326117608 35.676496247488, -82.58332861171795 35.67666124751085, -82.58329961170557 35.67671024751784, -82.58317061164954 35.67693424755022, -82.5830746115972 35.677169247588246, -82.5830466115844 35.67722224759614, -82.58294961153945 35.677408247623994, -82.58079761017687 35.68390824872647, -82.58071461016031 35.683926248721605, -82.58058161013354 35.683956248714004, -82.58062461016134 35.683822248691136, -82.58095261037055 35.682822248521184, -82.58107661044932 35.68244624845742, -82.58128861058215 35.68181524835071, -82.58149561071498 35.68117824824228, -82.5817086108466 35.68055624813752, -82.58207761108294 35.67942424794493, -82.58211861110907 35.679299247923666, -82.58245361132043 35.67829224775304, -82.58253961137468 35.678033247709116, -82.58266561145406 35.67765524764509, -82.58326461183093 35.6758612473413, -82.58329561185438 35.675743247320476, -82.58335561189786 35.675526247282484, -82.58349761198664 35.67510424721112, -82.5835936120472 35.67481624716232, -82.58362661206709 35.67472224714662, -82.58388061222806 35.67395424701634, -82.5839766122884 35.67366724696781, -82.58400261230524 35.673586246953924, -82.58408261235549 35.67334724691353, -82.5840836123563 35.67334324691276, -82.5841136123734 35.67326424689975, -82.58418961243616 35.67294024684161, -82.5842706124902 35.672677246796326, -82.5845576126795 35.671761246639335, -82.58479361282743 35.67105824652041, -82.5850216129716 35.67037024640376, -82.58505061298597 35.67030824639408, -82.58511261301975 35.67015624636947, -82.58525961310876 35.6697382462995, -82.58536661317265 35.66944024624983, -82.58539861319453 35.66933324623134, -82.5854526132309 35.669155246200596, -82.58548761326202 35.668992246170994, -82.58552361329376 35.66882524614075, -82.58556261333618 35.66859224609725, -82.58560161339264 35.66826924603552, -82.58561461342477 35.66807524599732, -82.58561661349793 35.667603245901354, -82.58559561354316 35.667288245835024, -82.58557961354948 35.667230245821635, -82.58554961358443 35.66697124576574, -82.58552161359759 35.66685624573948, -82.5854766136245 35.666633245689425, -82.58538961365922 35.66631524561568, -82.58531861368434 35.666076245559736, -82.5852686137027 35.66590324551941, -82.58509761375893 35.66535524539012, -82.58507261376351 35.66529824537593, -82.58498761379175 35.665024245311386, -82.5848886138244 35.66470624523643, -82.58465261390273 35.66394524505719, -82.58459261392206 35.663755245012304, -82.58449461395463 35.66343924493788, -82.58436161399797 35.66301524483781, -82.58396361412807 35.66174424453804, -82.58383161417142 35.66132124443835, -82.58381461417707 35.66126624442536, -82.5837636141937 35.66110424438709, -82.58374761419935 35.66105024437452, -82.58365361422999 35.66075024430372, -82.58312161440399 35.659050243902804, -82.58249361460977 35.657042243429316, -82.58224161473947 35.65593024317688, -82.58217861483033 35.655274243036786, -82.58218361493206 35.65462024290412, -82.58242661523647 35.65291024258083, -82.58260661546134 35.65164724234214, -82.58263961550637 35.6513912422934, -82.58268261558827 35.65090724219926, -82.5826846156001 35.65083224218421, -82.5826876156253 35.6506722421519, -82.5826946156669 35.6504102420993, -82.58268861569937 35.65019324205447, -82.5826886157041 35.65016324204833, -82.58268261572297 35.650034242021476, -82.58267361575066 35.649845241982035, -82.58265461578854 35.64957924192595, -82.58262161582891 35.64928224186203, -82.58258161585849 35.64904724181005, -82.58255161588123 35.64886724177028, -82.5825006159126 35.648609241712535, -82.58244761594081 35.64836924165818, -82.58232161598633 35.64793824155746, -82.58219061602898 35.64752124145914, -82.58196161608895 35.646886241306206, -82.5817386161425 35.646299241163774, -82.58166461616297 35.64608624111276, -82.58165361616595 35.64605524110531, -82.58138461623224 35.645336240931236, -82.58121561627452 35.64488024082101, -82.58118261628276 35.644791240799485, -82.58108461630714 35.64452724073568, -82.58105261631545 35.64443924071444, -82.5808936163554 35.644009240610494, -82.58085561636729 35.643891240582626, -82.58073061640603 35.643505240491116, -82.58066961642928 35.64328924044091, -82.58055561648433 35.642809240331424, -82.58051561651119 35.64259224028309, -82.58045561656243 35.642195240196116, -82.58044961656854 35.642149240186136, -82.58042261659668 35.641938240140306, -82.58041361661382 35.6418172401148, -82.58039761664199 35.641617240072456, -82.58039661664598 35.64159024006684, -82.58038861665948 35.641494240046505, -82.58038061670534 35.64118823998331, -82.58037861672044 35.641088239962784, -82.58038661679537 35.640611239866466, -82.58040761689576 35.639983239740666, -82.58042161695988 35.639582239660456)))",6451,37,021,002701,370210027011,1369,1369,313,1343,1106,14,2,14,0,207,26,1055,188,867,1040,886,12,2,10,0,130,15,574,529,45
census_2010_blockgroups_view.fid--2dc29038_13ec899ba8f_-2646,"MULTIPOLYGON (((-82.49223562623617 35.48412419897436, -82.49208162623057 35.483994198932166, -82.49189362622388 35.48383519888059, -82.4916286262165 35.483597198804965, -82.49147962621213 35.483464198762746, -82.49123862620681 35.48323919869221, -82.49121662620634 35.48321819868572, -82.49080662619947 35.48282019856274, -82.4905376261973 35.48254419847907, -82.49045362619653 35.48245819845302, -82.4903126261968 35.48230419840719, -82.49020962619723 35.48219019837348, -82.49019362619752 35.48217119836793, -82.49000362620056 35.48194619830276, -82.48985762620562 35.48175519824893, -82.48974962620939 35.48161419820919, -82.48953262621664 35.48133219812961, -82.48944162621984 35.4812131980961, -82.48926562622674 35.48097819803026, -82.4890576262372 35.480685197949384, -82.4889126262466 35.48046719789021, -82.48873362625817 35.48019819781712, -82.4887166262593 35.4801721978101, -82.48849662627381 35.47984019772004, -82.48783662631712 35.478844197449845, -82.48761662633149 35.478513197360066, -82.48733762634866 35.47809919724728, -82.48713962636117 35.47780419716704, -82.48661562639546 35.47701419695269, -82.48656862639874 35.476942196933244, -82.48631062641537 35.47655519682814, -82.48589162644421 35.47591419665485, -82.48556262646487 35.4754241965215, -82.48444262653825 35.47373519606334, -82.48420762655344 35.47338219596743, -82.48362662659089 35.472510195730685, -82.48317862661999 35.47183619554772, -82.48295462663701 35.47148319545298, -82.48283062665075 35.47125919539471, -82.48268462666987 35.4709771953224, -82.48260662668388 35.47080119527869, -82.48256562669245 35.47070119525413, -82.48254162669764 35.47064119523951, -82.48250962670645 35.47054919521753, -82.48240862673387 35.470261195148574, -82.48238162674285 35.47017319512793, -82.48234662676266 35.470006195090384, -82.48227762681691 35.46957719499612, -82.48226162684507 35.4693761949536, -82.48225362687162 35.469194194915815, -82.482236626929 35.46880119483418, -82.48223762693955 35.468733194820466, -82.48223762696053 35.46859619479262, -82.4822376269623 35.468585194790364, -82.48221062701901 35.46818519470628, -82.48221062701978 35.4681801947053, -82.48220862703958 35.46804919467842, -82.48230462704988 35.4680851946956, -82.4824666270412 35.46831719475935, -82.48248562703773 35.46836019477005, -82.48262862701165 35.46868519485079, -82.48272662699047 35.46892919491046, -82.48282562696032 35.46923319498233, -82.48288962695194 35.46935719501409, -82.4829226269388 35.46947819504215, -82.48300862694586 35.469525195060484, -82.48301962694676 35.46953119506284, -82.48314662696379 35.46955719508111, -82.48320962697449 35.46955519508717, -82.48332262698986 35.46957719510324, -82.48343362700489 35.469599195119095, -82.48344262701816 35.469522195104375, -82.4834586270395 35.469400195081214, -82.48350062706193 35.469299195064956, -82.48353162707792 35.46922819505377, -82.4835516270887 35.46917919504576, -82.48361262712089 35.46903519502276, -82.48363362713172 35.46898719501523, -82.48368862716104 35.46885519499399, -82.48369362716335 35.46884519499249, -82.48372062718474 35.468735194972865, -82.48376062719973 35.46868019496581, -82.48382262724505 35.46845119492562, -82.48385462726829 35.468334194905076, -82.48386762727307 35.46831719490298, -82.48411062728631 35.46849319496366, -82.48432562729165 35.46869019502575, -82.48466862728354 35.469114195147114, -82.48512562731553 35.469399195251896, -82.48536662734047 35.46949619529634, -82.48593162739921 35.46972319540041, -82.48626662743791 35.469833195457106, -82.48705362751342 35.47019019561031, -82.4877926275702 35.470618195773085, -82.48812862760141 35.47077719583983, -82.48827662760907 35.470887195877395, -82.4883366276055 35.47097519590143, -82.48823662753603 35.47132119596149, -82.48898062767111 35.47124319602192, -82.4894696277376 35.47133719609112, -82.48965162774648 35.471476196138056, -82.48982762777636 35.4714711961551, -82.48998662778202 35.471606196198834, -82.49017562778884 35.47176519625055, -82.49028562779272 35.47185919628094, -82.49057462781954 35.471996196338424, -82.49087062785512 35.472084196386646, -82.491501627947 35.47216619646798, -82.4920286280311 35.472186196526096, -82.49184662789116 35.472903196653185, -82.49130062747113 35.47505519703468, -82.49111962733117 35.47577319716216, -82.49122962734833 35.47578019717485, -82.49156162739976 35.47580319721356, -82.49167262741688 35.47581119722663, -82.49189562745237 35.47582019725127, -82.49256462755868 35.47584919732571, -82.49278862759424 35.475859197350694, -82.49389862777112 35.47590419747368, -82.4946496278907 35.47593519755697, -82.49511062796243 35.47596519761028, -82.49558762803863 35.47598319766287, -82.49603462811092 35.475994197710904, -82.49623762814258 35.476007197734354, -82.49645662817775 35.476014197758275, -82.49664262820406 35.47604319778323, -82.49684362822715 35.47611019781747, -82.49704162824443 35.476211197858234, -82.49716862825242 35.47629619788852, -82.4972436282569 35.47634719790661, -82.49744562827507 35.47644719794768, -82.49767962830326 35.47651619798567, -82.49785362832718 35.476548198010036, -82.49804262835663 35.47656019803179, -82.49822762838426 35.47658019805482, -82.49829462840786 35.476498198045114, -82.49840562844298 35.47638919803424, -82.49848862846835 35.47631319802733, -82.49851862847747 35.4762861980249, -82.49866262851938 35.47616819801571, -82.49879662855703 35.476067198008955, -82.49894162859592 35.475970198004006, -82.49907862863024 35.47589419800261, -82.49943562871583 35.47572119800404, -82.49947962872633 35.47570019800429, -82.49964662876793 35.47560919800287, -82.49967662877577 35.47559019800214, -82.49976062879799 35.47553619799976, -82.49953662878201 35.47539819794871, -82.4994996287792 35.4753761979404, -82.49870662871811 35.47491819776604, -82.49861462871097 35.47486519774588, -82.49844262869755 35.47476719770826, -82.49826362868367 35.47466419766903, -82.498228628681 35.47464419766137, -82.49798762866237 35.474505197608416, -82.49793662865895 35.47447219759641, -82.4978486286533 35.474414197575605, -82.49768362864269 35.474305197536516, -82.49760662863854 35.474249197517274, -82.49740862862791 35.47410419746745, -82.49720162861738 35.47394919741475, -82.49658262858586 35.473486197257195, -82.4964746285804 35.47340519722967, -82.49642262858099 35.473345197212126, -82.49640162858314 35.47330819720249, -82.49644062859468 35.47327519719968, -82.49659762863645 35.47317219719489, -82.49666862865585 35.47312219719195, -82.49709962877301 35.47282319717534, -82.49747262887479 35.4725621971605, -82.49774062894762 35.472376197150204, -82.4980276290251 35.47218019713975, -82.49888862925705 35.471596197109285, -82.49917662933466 35.47140119709913, -82.49932362937287 35.47131019709569, -82.49937262938558 35.471280197094664, -82.49950062941585 35.4712211970957, -82.49959762943757 35.47118419709817, -82.4996836294558 35.47115819710165, -82.49980862948034 35.47113319710944, -82.49985762948987 35.471124197112594, -82.49998062951207 35.471112197122736, -82.50008462952958 35.47111019713303, -82.50016762954283 35.47111319714219, -82.50042662958418 35.47112319717068, -82.5007316296322 35.47113919720525, -82.50091962966181 35.47114919722653, -82.50129662972166 35.47116619726862, -82.50161362977182 35.47118119730422, -82.50369463010045 35.471285197538606, -82.50411563016694 35.47130619758602, -82.50438963021104 35.47131419761566, -82.50438863020223 35.471371197627214, -82.50437963017862 35.47151519765554, -82.50434563008058 35.472118197774684, -82.50433463004805 35.47231919781447, -82.5043266300293 35.472433197836814, -82.50430562997346 35.47277519790419, -82.50429862995458 35.47289019792688, -82.50445062998564 35.47285219793475, -82.5045156299997 35.47283019793692, -82.50516063013818 35.472623197960914, -82.50537563018423 35.47255519796912, -82.50576863026897 35.472427197983386, -82.50626863037637 35.47226619800189, -82.50676363048102 35.472118198022486, -82.50695763051883 35.472081198034836, -82.50701063052898 35.472072198038475, -82.50724963057219 35.47204819805809, -82.5073696305927 35.47204419806955, -82.50751063061617 35.472043198083774, -82.50765263063984 35.47204219809818, -82.50780763066446 35.47204919811549, -82.50793363068377 35.47205919813039, -82.5080746307052 35.472071198147276, -82.50817763072115 35.472079198159484, -82.50829863073963 35.47208919817388, -82.50848663076911 35.47210019819544, -82.5085906307852 35.472107198207546, -82.50881263082066 35.472116198232094, -82.50901963085366 35.47212419825491, -82.50963763095204 35.47215019832356, -82.50997263100474 35.4721681983616, -82.51030663105573 35.47219619840143, -82.5105386310911 35.47221619842934, -82.5107346311195 35.472242198454644, -82.51096263114998 35.47229019848779, -82.51100463115526 35.4723011984944, -82.51117763117647 35.472350198522015, -82.5112696311895 35.47236419853432, -82.51140163121094 35.47236719854845, -82.51147863122462 35.47236019855495, -82.51155363123918 35.47234719855997, -82.5115716312426 35.47234419856117, -82.51170063126881 35.47231219856791, -82.51181863129425 35.47227419857232, -82.51190563131263 35.472248198575905, -82.51208663135009 35.47219919858451, -82.5121286313589 35.472187198586354, -82.51218763137113 35.47217119858912, -82.51225563138465 35.47215619859306, -82.51229863139312 35.47214719859568, -82.51241463141635 35.472121198602224, -82.51254063143902 35.47210919861269, -82.51257763144561 35.472106198615904, -82.5128416314893 35.47210619864296, -82.51296063150761 35.472115198656965, -82.5132106315437 35.472150198689675, -82.5132746315523 35.472163198698915, -82.51351563158427 35.472215198734204, -82.51372663160616 35.472300198773084, -82.51436263167243 35.472555198890134, -82.51457463169454 35.4726401989291, -82.51461163169928 35.47264919893475, -82.51472263171317 35.472679198952235, -82.51475963171752 35.47269019895828, -82.51478463170548 35.472796198982394, -82.51485563168642 35.4729971990306, -82.51493463166535 35.473220199084004, -82.51508163162954 35.47361319917898, -82.51516763160622 35.47385819923757, -82.51518763160207 35.47390719924961, -82.51529263158068 35.47416019931178, -82.51531863157841 35.47420319932321, -82.51535163157547 35.47425819933777, -82.51545063156624 35.474425199381855, -82.5154836315632 35.474481199396706, -82.51556063155611 35.4746101994308, -82.51560863155174 35.47469119945216, -82.51578663153329 35.47500419953409, -82.51586163152545 35.47513619956866, -82.51588663152317 35.47517819957974, -82.51596463151633 35.47530719961401, -82.51599163151421 35.475350199625446, -82.5162806314881 35.47583319975326, -82.51630063148652 35.47586519976183, -82.5166716314478 35.47651919993285, -82.51686563143156 35.476835200017014, -82.51706763141209 35.47718020010787, -82.51712263140323 35.47729820013746, -82.51730063137447 35.47767820023302, -82.51734563136097 35.47781520026554, -82.51743763133207 35.478103200333535, -82.51748763131687 35.478256200369756, -82.51759163123168 35.478925200516436, -82.51760163122249 35.47899620053195, -82.51764563118375 35.47929620059745, -82.51764863118044 35.479321200602875, -82.51765763117004 35.47939920061959, -82.51766163116669 35.47942520062531, -82.51766763115903 35.47948120063732, -82.5176796311468 35.479574200657524, -82.51768863113678 35.479649200673656, -82.51769563112941 35.47970520068574, -82.51771863110363 35.47989820072735, -82.51775163106727 35.48017120078629, -82.51778363102557 35.48047820085204, -82.51779463101205 35.480578200873445, -82.51780963100036 35.48067120089391, -82.51781363099666 35.48069920089998, -82.5178286309858 35.480786200919255, -82.51783363098224 35.48081520092561, -82.51771563096901 35.48077420090521, -82.51736163092914 35.48065120084396, -82.5172446309159 35.4806112008238, -82.51666463080375 35.4807162007857, -82.5159866306725 35.480840200741426, -82.5156856306142 35.480895200721726, -82.51492463046702 35.48103320067181, -82.51476163043539 35.48106320066123, -82.51444163037354 35.48112120064018, -82.5143456303548 35.48113920063402, -82.51338463016292 35.481353200579036, -82.51301563008927 35.48143520055796, -82.51250962998806 35.48154820052902, -82.5111916297247 35.48184220045374, -82.51094662967591 35.481896200439564, -82.51050062958662 35.4819972004144, -82.50954062939466 35.482212200359726, -82.50950062938664 35.48222120035742, -82.50938162936244 35.48225020035116, -82.50934262935438 35.482261200349456, -82.509291629343 35.482280200347994, -82.50913862930878 35.48233820034418, -82.50913762930846 35.482339200344235, -82.50908862929741 35.48235820034308, -82.50890062925973 35.48240120033254, -82.50833762914654 35.48253120030126, -82.50815062910875 35.48257520029103, -82.50809462909758 35.48258820028796, -82.5079816290749 35.48261420028166, -82.50747462897283 35.4827322002537, -82.50730662893882 35.48277220024463, -82.5064566287771 35.48290920018532, -82.5057916286504 35.48301720013909, -82.49847062710994 35.48515919982408, -82.49680862676026 35.48564519975256, -82.49572062652977 35.48597319970774, -82.49531262642012 35.48624819972175, -82.49519062641203 35.486169199693194, -82.49491562639301 35.485996199629845, -82.49476362638255 35.48590019959471, -82.4947426263818 35.485882199588836, -82.49462162637757 35.48577919955555, -82.49459462637556 35.48576319954949, -82.49451662636996 35.48571519953171, -82.49449062636809 35.4856991995258, -82.49437662635995 35.48562919949996, -82.49428762635405 35.485572199479186, -82.49368462631323 35.48518719933912, -82.49348362629952 35.48505919929249, -82.49347262629892 35.48505119928972, -82.49343962629683 35.48502919928189, -82.4934296262963 35.48502219927937, -82.49341162629528 35.485009199274934, -82.49335762629198 35.48497219926184, -82.49334062629099 35.484960199257635, -82.49330762628911 35.484937199249565, -82.49321062628327 35.48487019922605, -82.49317862628139 35.4848481992183, -82.49315362627983 35.484831199212245, -82.49308162627574 35.484780199194475, -82.49307562627531 35.484776199193085, -82.49305762627431 35.48476319918854, -82.49288862626507 35.48464119914644, -82.49285262626313 35.48461519913745, -82.49253862624833 35.48437219905591, -82.49239662624278 35.48425519901748, -82.49223562623617 35.48412419897436)))",6235,37,021,002205,370210022052,2293,2293,43,2264,2115,101,3,27,0,18,29,1805,32,1773,1788,1684,71,3,19,0,11,17,1011,950,61
census_2010_blockgroups_view.fid--2dc29038_13ec899ba8f_-2645,"MULTIPOLYGON (((-82.4805246302505 35.44525418987233, -82.48062263026709 35.44525118988186, -82.48062363026742 35.44525018988172, -82.4806626302741 35.44524918988548, -82.4822706305434 35.44522719004576, -82.4822706305436 35.445226190045574, -82.48715263136235 35.445154190531106, -82.48720663137112 35.44515519053677, -82.48820563153458 35.445167190641556, -82.48837863156331 35.44516619065913, -82.48911163168633 35.445155190732, -82.48911363168676 35.44515419073198, -82.49170663212116 35.44511919099047, -82.4946146326191 35.44501019126621, -82.4947916326493 35.44500419128311, -82.49479263264944 35.44500419128328, -82.49479563264991 35.445004191283545, -82.49479763265032 35.44500419128372, -82.49501963268624 35.44500919130749, -82.49536863269108 35.4453551914136, -82.4958616326956 35.4458591915666, -82.49674263270364 35.44675919183978, -82.4970366327061 35.44706119193127, -82.49780963271223 35.447857192172236, -82.49799263270893 35.44807719223574, -82.49811863269932 35.44827619228912, -82.49825463268469 35.44851919235247, -82.49831863267795 35.44863219238198, -82.49853563265154 35.44903919248691, -82.49884663262338 35.449560192624766, -82.4991566326054 35.45001319274861, -82.49937063260352 35.45025719282013, -82.49955763260478 35.45045119287869, -82.49981163261519 35.45065719294661, -82.4998576326177 35.45069119295829, -82.50001363262541 35.45080919299818, -82.50140663270192 35.45181619334569, -82.50245763275895 35.4525801936087, -82.50309363279453 35.453036193766515, -82.5035296328113 35.45339819388483, -82.50354463281126 35.45341419388967, -82.50377963281164 35.45366619396487, -82.5039906328051 35.45393719404163, -82.50416663279019 35.45422519411827, -82.50434763274839 35.45469419423213, -82.50435763274609 35.45472019423844, -82.50460563265716 35.4555691944364, -82.50477863263423 35.455906194522676, -82.50501263262156 35.45624219461499, -82.50517163262234 35.456409194665184, -82.5052206326225 35.45646119468076, -82.50544863263252 35.45664219474096, -82.50576963265242 35.456859194817966, -82.50645663270484 35.45726019496986, -82.50703463274985 35.45759119509639, -82.50743963278128 35.457824195185296, -82.508520632865 35.458446195422525, -82.50925363292323 35.4588591955815, -82.50992063297286 35.459256195730596, -82.51013363298702 35.45939419578053, -82.51036963300265 35.459547195835825, -82.51092463303044 35.45996619597787, -82.5114406330486 35.460406196120154, -82.51165163305575 35.460587196178615, -82.5118306330577 35.460768196233744, -82.51203563305984 35.46097619629704, -82.51236863306822 35.4612811963932, -82.51238463306876 35.461295196397636, -82.51258163307646 35.461458196451, -82.51265563307831 35.4615261964724, -82.51288063308418 35.46173119653716, -82.51295663308616 35.461800196559025, -82.51298363308605 35.46183019656779, -82.51306663308588 35.461921196594844, -82.5130946330857 35.46195219660401, -82.51346663309442 35.46229819671246, -82.51357463309701 35.46239819674387, -82.513798633098 35.46263419681484, -82.51399763309115 35.46289419688807, -82.51422363307836 35.46322219697797, -82.514391633063 35.463504197052536, -82.51466063304156 35.463935197167736, -82.51460263302755 35.463964197167655, -82.51443063298568 35.46405119716776, -82.51437363297165 35.464081197168014, -82.51403263289608 35.46420619715849, -82.51317563270585 35.464522197134905, -82.51301563266846 35.46459319713297, -82.51268563259104 35.46474219712947, -82.51266663258662 35.464750197129156, -82.51261263257368 35.464776197128906, -82.51259463256925 35.464786197129065, -82.51256263256161 35.46480119712887, -82.51228363249916 35.464907197121825, -82.51215763247171 35.46495019711763, -82.51153063233453 35.465168197097825, -82.51139563230406 35.46522119709469, -82.51124763226852 35.46529319709416, -82.51120663225794 35.46531819709507, -82.51114363223932 35.46537119709933, -82.51107263221657 35.46544319710674, -82.51101663219514 35.46552219711705, -82.51097363217468 35.465610197130545, -82.51097163217348 35.465615197131385, -82.5109066321266 35.465851197172746, -82.51085063208525 35.46606119720961, -82.51080763205849 35.46618919723134, -82.51080163205435 35.466210197234936, -82.51076063203216 35.46631019725106, -82.51063863198075 35.46651419728004, -82.51061163197198 35.46654219728297, -82.51052163194164 35.466643197294275, -82.51046663192439 35.46669619729943, -82.51025063186093 35.46687719731414, -82.5102286318544 35.466896197315734, -82.50941263161941 35.46754819736472, -82.50936663160611 35.46758519736746, -82.5092476315717 35.46768119737481, -82.50913563153884 35.46777519738242, -82.50907163151858 35.46783819738874, -82.50903863150808 35.46787119739206, -82.50898963148954 35.46793919740093, -82.5089356314662 35.4680331974144, -82.50892263145968 35.4680611974188, -82.5088996314481 35.46811219742679, -82.50888963144142 35.4681451974325, -82.50886163142151 35.46824519744998, -82.50885863141964 35.468254197451515, -82.50878763135978 35.46856819750808, -82.50878163135603 35.46858619751113, -82.5087496313341 35.468695197529975, -82.5087056313047 35.46883919755475, -82.50869963130013 35.468862197558835, -82.5086426312661 35.469023197585734, -82.50856963121612 35.46927019762846, -82.50855463120556 35.4693231976377, -82.50853263118768 35.469416197654326, -82.50852663118269 35.46944219765907, -82.5085086311678 35.469520197673035, -82.5085026311628 35.46954619767767, -82.50847963114374 35.46964619769568, -82.50844363112184 35.46975019771315, -82.50842963111492 35.46978019771785, -82.50840263110095 35.46984219772767, -82.50833263107147 35.46995919774435, -82.50813863099839 35.470226197778715, -82.50802563095334 35.47039819780212, -82.50800663094545 35.47042919780643, -82.50790163090025 35.470611197832675, -82.50781763086385 35.47075819785392, -82.50766963080558 35.470978197883504, -82.50765863080107 35.4709961978861, -82.50759663077959 35.47106919789461, -82.50750663075031 35.471163197904445, -82.50741463072323 35.4712401979107, -82.50732863070016 35.47129819791368, -82.50723963067894 35.47134019791308, -82.50715463066055 35.47136819791005, -82.50707663064556 35.47138219790494, -82.50701363063448 35.47138619789928, -82.50692663062074 35.47138219788953, -82.50682163060567 35.47136719787575, -82.50651563056458 35.47130419783158, -82.50631963053827 35.471264197803386, -82.50620863052276 35.47124519778814, -82.50608763050464 35.47123319777324, -82.50600263049171 35.471225197762976, -82.50595363048392 35.471223197757496, -82.50588763047331 35.47122119775032, -82.50570563044228 35.47122719773289, -82.50555363041498 35.47124119772014, -82.50542163039117 35.47125419770932, -82.50532863037401 35.47126519770201, -82.50510063033197 35.471293197684396, -82.50505163032338 35.471296197679926, -82.504959630307 35.47130419767212, -82.50484563028724 35.47130919766146, -82.50471563026485 35.471315197649304, -82.50450363022995 35.47131419762741, -82.50438963021104 35.47131419761566, -82.50411563016694 35.47130619758602, -82.50369463010045 35.471285197538606, -82.50161362977182 35.47118119730422, -82.50129662972166 35.47116619726862, -82.50091962966181 35.47114919722653, -82.5007316296322 35.47113919720525, -82.50042662958418 35.47112319717068, -82.50016762954283 35.47111319714219, -82.50008462952958 35.47111019713303, -82.49998062951207 35.471112197122736, -82.49985762948987 35.471124197112594, -82.49980862948034 35.47113319710944, -82.4996836294558 35.47115819710165, -82.49959762943757 35.47118419709817, -82.49950062941585 35.4712211970957, -82.49937262938558 35.471280197094664, -82.49932362937287 35.47131019709569, -82.49917662933466 35.47140119709913, -82.49888862925705 35.471596197109285, -82.4980276290251 35.47218019713975, -82.49774062894762 35.472376197150204, -82.49747262887479 35.4725621971605, -82.49709962877301 35.47282319717534, -82.49666862865585 35.47312219719195, -82.49659762863645 35.47317219719489, -82.49644062859468 35.47327519719968, -82.49640162858314 35.47330819720249, -82.49642262858099 35.473345197212126, -82.4964746285804 35.47340519722967, -82.49658262858586 35.473486197257195, -82.49720162861738 35.47394919741475, -82.49740862862791 35.47410419746745, -82.49760662863854 35.474249197517274, -82.49768362864269 35.474305197536516, -82.4978486286533 35.474414197575605, -82.49793662865895 35.47447219759641, -82.49798762866237 35.474505197608416, -82.498228628681 35.47464419766137, -82.49826362868367 35.47466419766903, -82.49844262869755 35.47476719770826, -82.49861462871097 35.47486519774588, -82.49870662871811 35.47491819776604, -82.4994996287792 35.4753761979404, -82.49953662878201 35.47539819794871, -82.49976062879799 35.47553619799976, -82.49967662877577 35.47559019800214, -82.49964662876793 35.47560919800287, -82.49947962872633 35.47570019800429, -82.49943562871583 35.47572119800404, -82.49907862863024 35.47589419800261, -82.49894162859592 35.475970198004006, -82.49879662855703 35.476067198008955, -82.49866262851938 35.47616819801571, -82.49851862847747 35.4762861980249, -82.49848862846835 35.47631319802733, -82.49840562844298 35.47638919803424, -82.49829462840786 35.476498198045114, -82.49822762838426 35.47658019805482, -82.49804262835663 35.47656019803179, -82.49785362832718 35.476548198010036, -82.49767962830326 35.47651619798567, -82.49744562827507 35.47644719794768, -82.4972436282569 35.47634719790661, -82.49716862825242 35.47629619788852, -82.49704162824443 35.476211197858234, -82.49684362822715 35.47611019781747, -82.49664262820406 35.47604319778323, -82.49645662817775 35.476014197758275, -82.49623762814258 35.476007197734354, -82.49603462811092 35.475994197710904, -82.49558762803863 35.47598319766287, -82.49511062796243 35.47596519761028, -82.4946496278907 35.47593519755697, -82.49389862777112 35.47590419747368, -82.49278862759424 35.475859197350694, -82.49256462755868 35.47584919732571, -82.49189562745237 35.47582019725127, -82.49167262741688 35.47581119722663, -82.49156162739976 35.47580319721356, -82.49122962734833 35.47578019717485, -82.49111962733117 35.47577319716216, -82.49130062747113 35.47505519703468, -82.49184662789116 35.472903196653185, -82.4920286280311 35.472186196526096, -82.491501627947 35.47216619646798, -82.49087062785512 35.472084196386646, -82.49057462781954 35.471996196338424, -82.49028562779272 35.47185919628094, -82.49017562778884 35.47176519625055, -82.48998662778202 35.471606196198834, -82.48982762777636 35.4714711961551, -82.48965162774648 35.471476196138056, -82.4894696277376 35.47133719609112, -82.48898062767111 35.47124319602192, -82.48823662753603 35.47132119596149, -82.4883366276055 35.47097519590143, -82.48827662760907 35.470887195877395, -82.48812862760141 35.47077719583983, -82.4877926275702 35.470618195773085, -82.48705362751342 35.47019019561031, -82.48626662743791 35.469833195457106, -82.48593162739921 35.46972319540041, -82.48536662734047 35.46949619529634, -82.48512562731553 35.469399195251896, -82.48466862728354 35.469114195147114, -82.48432562729165 35.46869019502575, -82.48411062728631 35.46849319496366, -82.48386762727307 35.46831719490298, -82.48385462726829 35.468334194905076, -82.48382262724505 35.46845119492562, -82.48376062719973 35.46868019496581, -82.48372062718474 35.468735194972865, -82.48369362716335 35.46884519499249, -82.48368862716104 35.46885519499399, -82.48363362713172 35.46898719501523, -82.48361262712089 35.46903519502276, -82.4835516270887 35.46917919504576, -82.48353162707792 35.46922819505377, -82.48350062706193 35.469299195064956, -82.4834586270395 35.469400195081214, -82.48344262701816 35.469522195104375, -82.48343362700489 35.469599195119095, -82.48332262698986 35.46957719510324, -82.48320962697449 35.46955519508717, -82.48314662696379 35.46955719508111, -82.48301962694676 35.46953119506284, -82.48300862694586 35.469525195060484, -82.4829226269388 35.46947819504215, -82.48288962695194 35.46935719501409, -82.48282562696032 35.46923319498233, -82.48272662699047 35.46892919491046, -82.48262862701165 35.46868519485079, -82.48248562703773 35.46836019477005, -82.4824666270412 35.46831719475935, -82.48230462704988 35.4680851946956, -82.48220862703958 35.46804919467842, -82.48220762705272 35.46796219466067, -82.48219762707373 35.46781419462955, -82.4821946270876 35.46772019461008, -82.48217262719794 35.466976194456635, -82.48217062722841 35.46677519441559, -82.48216762723406 35.46673519440715, -82.48215362726162 35.466540194366075, -82.48215262728174 35.4664071943389, -82.48215262728958 35.4663561943286, -82.48214462731563 35.46617719429137, -82.48214362734504 35.46598419425199, -82.48212762737417 35.46577719420825, -82.48212562738375 35.46571219419487, -82.48212362740122 35.46559619417105, -82.4821116274304 35.46539219412841, -82.48210762745381 35.46523519409604, -82.4821096274849 35.46503419405537, -82.48208662753717 35.46466819397867, -82.48206662755904 35.46450419394326, -82.48202662758577 35.464286193894814, -82.48195162760933 35.464051193839396, -82.48189662762269 35.463904193803835, -82.48177262763576 35.463685193746656, -82.4817416276392 35.46362919373212, -82.48138162765902 35.463111193589896, -82.48129762766355 35.46299019355669, -82.48119562766769 35.46285319351836, -82.48106462767481 35.46266519346676, -82.48096562768043 35.462521193427314, -82.48085962768852 35.462354193382495, -82.48076562769195 35.46223019334773, -82.48066562769809 35.462082193307324, -82.48057962770356 35.461953193272336, -82.48047062770819 35.46180519323106, -82.48031562772167 35.46155019316333, -82.48018462774067 35.46128419309582, -82.48012062774984 35.46115519306308, -82.48000562777614 35.460859192991045, -82.47998262778478 35.46077819297227, -82.47997462778724 35.460753192966415, -82.47994562779728 35.46065619294373, -82.47991962781165 35.460534192916185, -82.4799116278166 35.46049319290711, -82.47987962783952 35.46030919286642, -82.47987362785942 35.46017219283789, -82.47987862788698 35.45999819280303, -82.47988362791307 35.459833192770056, -82.47989162794225 35.4596511927339, -82.47990062797282 35.45946119269618, -82.47991962802999 35.45910819262637, -82.47992962805935 35.45892719259062, -82.47993062806367 35.45890019258525, -82.47993462807622 35.45882219256976, -82.47993662808061 35.45879619256468, -82.47994562810983 35.458615192528875, -82.47995262813008 35.45849019250409, -82.47996262817273 35.45822219245073, -82.47996062819536 35.45807219241997, -82.479960628213 35.457957192396634, -82.4799566282224 35.45789119238281, -82.47994962823677 35.45779019236156, -82.47994062824387 35.45773419234927, -82.4799236282589 35.45761719232371, -82.47989462827536 35.45747819229246, -82.47985562829004 35.45734019226042, -82.47983162829607 35.45727519224473, -82.47980262830325 35.4571971922259, -82.47977362830885 35.45712919220913, -82.47973162831659 35.457033192185285, -82.4796526283277 35.45687519214512, -82.47949362834258 35.456606192074155, -82.47943862834663 35.45652019205102, -82.47832662843287 35.45475519157833, -82.47825762843827 35.454645191548906, -82.47810662845151 35.454395191482554, -82.4780116284635 35.4542141914361, -82.4779826284682 35.45415219142046, -82.47793962847524 35.454060191397396, -82.47792962847784 35.45403219139073, -82.47788762848867 35.45391619136279, -82.47784462850649 35.45375319132522, -82.47782262851786 35.45365519130306, -82.47781162852426 35.453601191291, -82.47780362853442 35.45352619127501, -82.47778062856999 35.453269191220286, -82.47779462857548 35.45324819121751, -82.47779562859317 35.45313419119437, -82.4778056286262 35.452929191153764, -82.47785362874004 35.452237191018035, -82.47794062894403 35.45099819077508, -82.4779496289789 35.450780190731784, -82.47794562901439 35.4505431906831, -82.47793462904262 35.45034719064219, -82.47788762909138 35.449978190562355, -82.47785362911331 35.449798190522294, -82.47776262915302 35.449440190440214, -82.47770162917554 35.44922719039066, -82.47744162927357 35.44830519017662, -82.47742762927928 35.44825319016462, -82.47740962928577 35.44819119015017, -82.47733862931226 35.44794119009207, -82.47707462941179 35.44700518987483, -82.4769866294448 35.44669418980257, -82.47661462958467 35.44537818949699, -82.4766776295953 35.4453771895032, -82.48042763023413 35.44525618986282, -82.48042863023447 35.445255189862756, -82.4805246302505 35.44525418987233)))",6147,37,021,002205,370210022051,3229,3229,66,3164,2930,129,7,67,1,30,65,2381,39,2342,2359,2203,92,6,40,1,17,22,1274,1209,65
census_2010_blockgroups_view.fid--2dc29038_13ec899ba8f_-2644,"MULTIPOLYGON (((-82.64218463690655 35.57672323319815, -82.6423446369765 35.57644123315711, -82.64240163700127 35.57634223314276, -82.64250863705003 35.57614023311263, -82.64260863710538 35.57588823307151, -82.64272863717727 35.57555023301491, -82.64278063720812 35.57540623299093, -82.64285763724419 35.57525423296778, -82.6429286372759 35.57512523294882, -82.64302363730965 35.575008232934685, -82.64303063731187 35.57500123293398, -82.6431296373488 35.57486823291712, -82.64318663737575 35.57475423289971, -82.64322263740571 35.57459823287158, -82.64325163743878 35.574414232837135, -82.6432666374789 35.57416923278867, -82.64326963748479 35.57413423278189, -82.64330163753024 35.573873232731955, -82.64350063755506 35.57392723276334, -82.6435826375651 35.57395023277648, -82.64388963759667 35.574077232833844, -82.64406163761285 35.57415823286799, -82.64407263761365 35.574165232870506, -82.64419163762238 35.57423723289739, -82.64424563762486 35.57427923291154, -82.64445863763507 35.57444323296676, -82.64450763763968 35.57446623297647, -82.64463163765126 35.57452523300118, -82.64479963767118 35.574577233029, -82.64527763773273 35.574694233101916, -82.64544263775578 35.574723233124736, -82.64566163778612 35.57476223315516, -82.64575863779723 35.5747952331718, -82.64584663780724 35.57482523318698, -82.64596263781675 35.57488923321184, -82.64602363782147 35.5749242332253, -82.64616463782957 35.57502423326011, -82.64629563783568 35.57512623329432, -82.64640363783872 35.575223233325126, -82.6464956378415 35.57530523335133, -82.64659163784405 35.575392233378885, -82.64665663784383 35.57546423340024, -82.64673963784334 35.575557233427695, -82.64681563783506 35.57569323346316, -82.64683963781248 35.575866233500896, -82.64683763781044 35.57587723350293, -82.64681463777339 35.57609323354463, -82.64677763774023 35.576269233576646, -82.64676863770505 35.57648823362038, -82.64679763767728 35.57670023366648, -82.64689163760659 35.57726223379071, -82.64690563759653 35.57734323380863, -82.64696063757353 35.57755223385682, -82.64700763755643 35.577714233894646, -82.64700863755553 35.577721233896185, -82.64711063755438 35.577839233930675, -82.64720163756043 35.57789823395208, -82.6473066375675 35.577966233976674, -82.6475846375919 35.57810823403419, -82.64780363761399 35.57820123407554, -82.64794363763275 35.578231234096016, -82.64797163763643 35.57823723410011, -82.64821563767613 35.578243234126354, -82.6482936376891 35.57824323413428, -82.64853063772851 35.57824323415865, -82.64860963774163 35.57824323416673, -82.648652637749 35.578242234170965, -82.64868863775418 35.57824723417565, -82.6488996377842 35.578280234204016, -82.64892263778644 35.578290234208424, -82.64899563779373 35.57832223422248, -82.64905763779973 35.578350234234506, -82.64922363781177 35.57845123427211, -82.64922863781221 35.57845423427326, -82.64936563781657 35.57857423431172, -82.6495246378146 35.578759234365734, -82.64962763781448 35.57887123439916, -82.64973663782216 35.57893923442413, -82.64981263783366 35.57894623443336, -82.64984263783832 35.57894923443711, -82.6499336378588 35.57891423443929, -82.64998563787047 35.57889423444051, -82.65003963788857 35.57883523443405, -82.650106637911 35.57876123442585, -82.65019463794566 35.57863123440838, -82.65023263796041 35.578576234401105, -82.65032763798811 35.57849923439514, -82.65047363802631 35.57840823439153, -82.65070663808115 35.578304234394196, -82.6508106381048 35.57826223439634, -82.6508486381133 35.57824823439735, -82.65108863816752 35.578155234403084, -82.65123863820183 35.578094234406024, -82.65126963820968 35.578077234405725, -82.65145263825447 35.5779832344053, -82.65166863830503 35.57788823440813, -82.65181163833483 35.57784923441485, -82.65200263837424 35.577799234424255, -82.65203763838143 35.577790234425976, -82.65214363840323 35.5777632344313, -82.65217963841049 35.57775523443341, -82.65223763842228 35.57774123443654, -82.65224863842474 35.57773723443686, -82.65245263846849 35.57767323444467, -82.65245463846914 35.57767123444448, -82.6525216384844 35.57764423444592, -82.65259763850212 35.577611234446906, -82.65267063851886 35.5775812344483, -82.6528096385568 35.57748523444301, -82.65283163856252 35.57747123444238, -82.65287163857556 35.57743023443818, -82.65299963861665 35.577301234424965, -82.65336863874577 35.57686023437295, -82.6540996389927 35.5760442342816, -82.65428063905892 35.57580923425233, -82.6543886390959 35.57568523423814, -82.6544656391177 35.57562723423419, -82.65452763913217 35.57560023423506, -82.65458263914311 35.575588234238225, -82.65464063915279 35.57558823424421, -82.6547336391654 35.575607234257646, -82.65484663917968 35.57563623427504, -82.65522663922508 35.57575223433772, -82.65565763927358 35.5759032344127, -82.65579763929131 35.57593923443432, -82.65579963930162 35.57587423442131, -82.6559196392923 35.576065234472516, -82.65596763927212 35.57624823451476, -82.65601463918303 35.576879234648146, -82.65597263911978 35.57724523471842, -82.65597663908792 35.57745723476202, -82.65597963906401 35.57761623479472, -82.65618163896725 35.57846423498831, -82.65631063895498 35.57868423504636, -82.65640963892808 35.578966235113946, -82.65644363893163 35.57898023512031, -82.65657763894744 35.579022235142574, -82.6566786389587 35.57905823516028, -82.65674663896404 35.579097235175254, -82.65676463896455 35.57911323518033, -82.65681563896617 35.579158235194726, -82.65689963896581 35.57925123522231, -82.65697363896426 35.57934123524826, -82.65703963896301 35.579421235271326, -82.65710363896167 35.57949923529371, -82.65712863896115 35.579529235302445, -82.65730763895877 35.57973923536359, -82.65731463895861 35.5797472353659, -82.65754363895356 35.58002823544665, -82.65766363894815 35.58019323549263, -82.65770563894444 35.580263235511175, -82.65778763893717 35.58039923554737, -82.65782063892989 35.58048223556764, -82.65784263892236 35.58055523558476, -82.65788263888842 35.580819235642664, -82.65793663884365 35.581169235719535, -82.65794563883546 35.58123223573325, -82.65795163882933 35.58127823574325, -82.65797163881099 35.581419235774085, -82.65797863880498 35.581466235784376, -82.65801663875781 35.58181423585919, -82.65804863871982 35.58209623591988, -82.65809063869453 35.582306235967, -82.65813263868198 35.58243323599718, -82.65820463866031 35.582652236049164, -82.65827063864413 35.582829236092095, -82.6583376386279 35.58300723613523, -82.65835463862072 35.5830722361502, -82.6583786386107 35.583163236171174, -82.65839963859892 35.58326323619371, -82.65840763858237 35.58337923621822, -82.65840463854411 35.58362523626803, -82.65840463853303 35.58369723628269, -82.65841163851562 35.583818236308105, -82.658456638487 35.5840532363606, -82.65849763847223 35.58419323639338, -82.65854863845811 35.5843402364285, -82.65859963844694 35.58446823645985, -82.65866263843745 35.58459823649273, -82.65882463841942 35.58489123656909, -82.65884463841674 35.58493023657909, -82.6589116384077 35.58506123661265, -82.65896263839589 35.585193236644805, -82.65898163838885 35.58526023666039, -82.65900263838091 35.58533423667759, -82.65900663837697 35.58536423668412, -82.65901963836542 35.58545323670361, -82.6590266383606 35.585492236712334, -82.65904663832848 35.58572323676145, -82.65904763832711 35.58573323676354, -82.65905863831667 35.585813236781036, -82.65908463829132 35.58600623682303, -82.65912963826543 35.586223236871874, -82.65914763825548 35.58630723689081, -82.65924263820585 35.58673323698734, -82.6592566381986 35.586795237001425, -82.65932263817254 35.587036237057326, -82.65937163815903 35.58717723709106, -82.65943263814627 35.58732623712779, -82.6594756381387 35.5874222371517, -82.65948463813746 35.587440237156265, -82.65957163812604 35.587608237199426, -82.6596486381169 35.58775123723645, -82.65966763811512 35.58778323724494, -82.65967263811491 35.587790237246914, -82.65980463810257 35.5880132373059, -82.66000563808406 35.588351237395386, -82.66014363807243 35.58857623745538, -82.66021163806764 35.58868123748375, -82.66033663805864 35.58887523753611, -82.66034763805617 35.58890323754291, -82.66036463805203 35.58894823755385, -82.66037163805052 35.58896623755823, -82.66037263805032 35.58896823755874, -82.66039763803815 35.58907423758289, -82.66040363802519 35.5891652376021, -82.66040663801957 35.58920523761058, -82.66040463801488 35.58923323761606, -82.66040063800692 35.58928123762539, -82.66039663799519 35.58935323763968, -82.66038663798207 35.58942723765374, -82.66038063797353 35.589476237663106, -82.66036463795372 35.589588237684275, -82.66036363795226 35.58959623768584, -82.66030663791253 35.589793237720166, -82.66026563788695 35.589915237740804, -82.66022963786436 35.59002323775913, -82.66020463784876 35.59009723777161, -82.66015063781784 35.59024023779526, -82.66014263781285 35.59026423779928, -82.65999363773669 35.5905982378521, -82.65986063767323 35.59086723789326, -82.65975963762442 35.59107523792532, -82.65973463761304 35.59112223793239, -82.6596726375849 35.59123823794957, -82.65966063757901 35.591263237953484, -82.65964863757308 35.591289237957554, -82.65963663756771 35.59131123796078, -82.65960663755395 35.5913682379693, -82.65942563747474 35.59168723801577, -82.6591986373721 35.592109238078464, -82.65908263731465 35.59235723811718, -82.65903263728693 35.59248323813768, -82.65907663728676 35.59253223815219, -82.6590856372845 35.59255623815802, -82.65908563728401 35.59256023815883, -82.65908863727726 35.5926072381687, -82.65908363726884 35.59265623817816, -82.6590696372587 35.59270723818709, -82.65900663722546 35.59285523821087, -82.65896863720725 35.59293223822268, -82.65894863719586 35.59298523823142, -82.65893163718661 35.59302623823802, -82.65891963717762 35.593072238246165, -82.65890063716384 35.593141238258305, -82.65886763714374 35.59323623827424, -82.65882963712356 35.5933262382887, -82.65870363707141 35.59352923831714, -82.65862663704108 35.59364323833246, -82.65850463698585 35.593870238366186, -82.65844363696098 35.5939662383795, -82.65840763694324 35.594042238391324, -82.65824963685485 35.59444623845748, -82.65804463677651 35.59473423849511, -82.65795963673777 35.59489423851901, -82.65791363671224 35.59501023853791, -82.65786763667278 35.59521723857542, -82.6576946366159 35.59539923859471, -82.65761763659238 35.59546923860109, -82.6575406365702 35.59553023860567, -82.65745963654443 35.59561023861364, -82.65738063651543 35.59571323862653, -82.65732563649054 35.59581523864167, -82.65721463643212 35.59607523868331, -82.65716763640373 35.596209238705804, -82.65715763639294 35.59626823871676, -82.65714863638273 35.59632523872745, -82.65714163636295 35.596446238751376, -82.65712663634274 35.59656123877328, -82.65709963632207 35.596666238791954, -82.65708663630423 35.59676823881137, -82.65708763629031 35.596860238830246, -82.65709863627745 35.596955238850725, -82.65718663625478 35.59719823890927, -82.65732263620913 35.59764223901371, -82.65780163618491 35.59831823920065, -82.65827663616076 35.598989239386064, -82.65927763629561 35.599195239530765, -82.65991563638687 35.599292239616005, -82.66073563650392 35.59941823972577, -82.66024663636118 35.59981723975698, -82.65979163624648 35.60007123976207, -82.65924763613785 35.600188239730095, -82.6589796360844 35.60024623971438, -82.65794263590493 35.600291239617235, -82.65688963570294 35.60046523954459, -82.65581763545114 35.60094223953186, -82.65518363528916 35.60130923954158, -82.65472863516945 35.60159523955321, -82.65446363510256 35.60174323955617, -82.65438663508303 35.60178723955726, -82.65402963498933 35.60201023956606, -82.6536076349143 35.602041239529086, -82.65307263486001 35.601815239428156, -82.65291163485 35.60170623938934, -82.65261563482368 35.60155723932865, -82.65257463481997 35.6015372393204, -82.65222563478498 35.60138723925402, -82.65186763473616 35.601317239202984, -82.6517096347043 35.60135323919416, -82.65167263469681 35.6013622391922, -82.65135263463121 35.601442239175604, -82.65086863450637 35.601730239184604, -82.65081263449188 35.60176423918585, -82.6502746343396 35.602172239213736, -82.64975863419153 35.60257623924317, -82.64967563416758 35.60264223924815, -82.64953363412555 35.602762239257984, -82.6494136340897 35.60286523926663, -82.64907963399891 35.603094239278995, -82.64899263397682 35.60314323928007, -82.64893163396128 35.60317823928095, -82.6487316339104 35.60329323928393, -82.64864563388832 35.60334323928529, -82.64854063386309 35.60339423928491, -82.64846163384368 35.603434239284866, -82.64835563381976 35.603475239282396, -82.64825163379638 35.6035152392799, -82.64821763378868 35.603528239279015, -82.64810963376397 35.60357223927695, -82.64794063372246 35.603659239277306, -82.64743663359826 35.603921239279, -82.64741963359388 35.60393123927921, -82.64728163355569 35.604030239285294, -82.64654963342042 35.60411823922816, -82.64435763301472 35.60438423905735, -82.64362663287942 35.604473239000484, -82.6429676327445 35.60463723896623, -82.64255663264615 35.604832238963816, -82.64198563250937 35.60510423896062, -82.64168263244797 35.60517523894402, -82.64103663233284 35.60522523888788, -82.64086163230638 35.60520823886652, -82.64061263227426 35.605147238828515, -82.63991263219827 35.60488423870304, -82.63960363215381 35.60483923866216, -82.63943563215284 35.60466423860926, -82.63936463214563 35.604634238595864, -82.63932763214183 35.60461923858902, -82.63889663207522 35.6045862385381, -82.63829363201648 35.60431523842094, -82.63813663200116 35.604245238390575, -82.63791463198963 35.60408023833413, -82.6376996319682 35.60398723829313, -82.63738063194866 35.60376923821603, -82.63704763192823 35.60354223813552, -82.63595063182284 35.60304123792088, -82.63557363179564 35.602810237835136, -82.63513663175084 35.602629237753376, -82.6345006316707 35.60246223765408, -82.63447763166782 35.60245623765052, -82.63404663161357 35.602343237583234, -82.6337036315777 35.6022052375199, -82.63356963156805 35.60212323748949, -82.63349463156484 35.60206323746959, -82.6333536315412 35.60206423745525, -82.63309063149718 35.60206623742868, -82.63293163147158 35.602060237411195, -82.63279163144892 35.602056237395985, -82.63268063144514 35.601961237365224, -82.63265063144414 35.60193523735683, -82.63254663143849 35.601859237330764, -82.63243663143066 35.601791237305555, -82.6323176314212 35.60172423727964, -82.63219163141116 35.601653237252314, -82.63203863139944 35.60156423721845, -82.63195863139322 35.60151823720088, -82.63175963138197 35.601376237151506, -82.63160163137304 35.6012632371123, -82.6315736313715 35.60124323710531, -82.63144963136133 35.60117523707876, -82.63138463135604 35.60113923706478, -82.63113963133182 35.60103123701756, -82.63104563132185 35.60099523700065, -82.63091663130773 35.600947236977575, -82.63066963128162 35.60085023693248, -82.63036163125089 35.600717236873784, -82.63005963122154 35.600581236815046, -82.62983463119902 35.600484236772196, -82.62982563119827 35.6004792367703, -82.62971963118869 35.600427236748786, -82.62960663118002 35.60036123672379, -82.62953263117716 35.600300236703724, -82.6294716311784 35.600226236682445, -82.6294486311794 35.6001942366735, -82.62943963118057 35.60017723666917, -82.62941263118421 35.60012423665554, -82.62937263119359 35.60002023663019, -82.62937163119386 35.60001723662955, -82.62935463119952 35.59996223661662, -82.62917063117831 35.59990123658535, -82.62882963113053 35.59984323653846, -82.6284846310821 35.59978523649124, -82.62817263105123 35.59964823643131, -82.62812063104603 35.59962623642147, -82.62740163095611 35.59943323630836, -82.62732763094921 35.59939823629364, -82.62680363090064 35.59914723618873, -82.62629863085392 35.59890523608761, -82.62599563083064 35.59872923602066, -82.62520163074352 35.598437235879636, -82.62491563072592 35.59824223581056, -82.62484163072217 35.598187235791826, -82.6248176307214 35.59816623578504, -82.62470663071814 35.59806723575355, -82.62448463069568 35.597973235711564, -82.62383163061153 35.59781423561212, -82.62370363060467 35.59772123558003, -82.62369763060471 35.59771423557799, -82.62394563064089 35.59774723561018, -82.62415363067097 35.59777623563748, -82.62432063069616 35.597793235657996, -82.62462763074642 35.59779823569062, -82.62469363075786 35.59779523569671, -82.62481063077804 35.597790235707755, -82.62484363078458 35.5977832357097, -82.62488263079325 35.59776923571086, -82.62493363080607 35.59774123571037, -82.6249826308214 35.5976942357058, -82.62501763083736 35.59762823569599, -82.62504863085765 35.59753023567915, -82.62506763087619 35.597430235660774, -82.62507263089226 35.59733123564107, -82.62507963091079 35.59721823561875, -82.62505863096023 35.59687423554656, -82.62499663100516 35.59651523546707, -82.62491263103702 35.596217235397766, -82.62484663105624 35.59602123535101, -82.6247936310717 35.5958632353134, -82.6247516310947 35.59566823526934, -82.62474263110533 35.59558923525234, -82.62474063111273 35.59553923524202, -82.62473963112069 35.59548623523105, -82.6247426311357 35.59539223521218, -82.62474563114364 35.59534323520255, -82.624764631162 35.59524523518453, -82.62481363119828 35.595062235152284, -82.62488563124067 35.59486423511928, -82.6249766312932 35.59462123507917, -82.62508163135261 35.594348235034325, -82.62514663139373 35.594151235000865, -82.62516263140861 35.594072234986434, -82.625191631443 35.593880234950284, -82.62519763146399 35.59375023492438, -82.62519163149568 35.593537234880394, -82.62519063151426 35.59341523485545, -82.62518963156916 35.59305723478238, -82.62519563158902 35.59293523475812, -82.6251976315922 35.59291623475448, -82.62521363161677 35.59277323472704, -82.62522963163534 35.59267023470767, -82.62525363165939 35.592540234683604, -82.62526263166428 35.59251823468007, -82.62530063168592 35.59241823466365, -82.62532663170052 35.59235123465267, -82.62536263171629 35.59228823464355, -82.62537563172143 35.59226823464081, -82.6254276317407 35.59219923463199, -82.62549063176364 35.592118234621964, -82.62555163178338 35.59205623461559, -82.62558863179494 35.592021234612275, -82.6257336318355 35.59191423460538, -82.62596663189579 35.59177423460076, -82.62602263190999 35.59174223460005, -82.6261166319338 35.59168923459884, -82.62618963195156 35.591652234598754, -82.62621363195765 35.59163923459862, -82.62627463197343 35.591602234597346, -82.62643263201427 35.591507234594175, -82.62652263203945 35.591441234589986, -82.62660263206169 35.591383234586424, -82.62649363206137 35.59126723455153, -82.62647063206123 35.591243234544315, -82.62634963206541 35.591085234499694, -82.626213632074 35.59088223444436, -82.62613063207912 35.59075923441078, -82.62612363207903 35.59075223440866, -82.62608763207894 35.590714234397254, -82.62601063207396 35.59066323437894, -82.62588263205606 35.590641234361364, -82.62581163204452 35.59063923435361, -82.62562463200892 35.59066823434038, -82.6253826319591 35.59073123432832, -82.62501363188265 35.590829234310426, -82.6248606318527 35.59085823430064, -82.6246626318129 35.5909032342895, -82.62455763179294 35.590919234282005, -82.62445663177787 35.59090823426939, -82.6243856317693 35.590887234257806, -82.62430663176312 35.59084223424054, -82.6242436317605 35.59079123422369, -82.62420663176125 35.59074623421075, -82.62417863176607 35.590684234195244, -82.62416163177586 35.59060223417679, -82.62415163178626 35.590524234159865, -82.62416363181478 35.59035123412587, -82.62415863183843 35.59019223409298, -82.6241496318473 35.59012523407839, -82.62413263185339 35.59006723406479, -82.62410663185881 35.590003234049156, -82.62404163186638 35.589884234018186, -82.62392563187355 35.589712233971255, -82.62371063188678 35.58939323388426, -82.62359563189345 35.589226233838396, -82.6235066318957 35.58911523380664, -82.6234696318957 35.58907523379474, -82.62338063190192 35.58893823375767, -82.62326863190988 35.5887652337109, -82.62311963192182 35.5885272336472, -82.62311363192237 35.588517233644474, -82.62309563192576 35.58847523363408, -82.62308163193146 35.588423233622095, -82.62308063193902 35.58837323361183, -82.62312663195426 35.58832323360632, -82.62316163197015 35.588258233596726, -82.62319763198612 35.588193233587134, -82.62332763204722 35.587936233548135, -82.62335763206067 35.58788123353997, -82.62340763208225 35.58779523352758, -82.62343363209165 35.58776223352349, -82.62345963210088 35.58773023351973, -82.62346663210332 35.587722233518726, -82.62351763212017 35.587667233512825, -82.6235826321387 35.587617233509306, -82.62359163214109 35.587611233508966, -82.62362663215016 35.58759023350836, -82.62365363215726 35.587573233507584, -82.62373163217659 35.58753223350729, -82.62380963219427 35.58750123350892, -82.6238346321997 35.587493233509875, -82.62407563225109 35.587419233519554, -82.62450063233833 35.58731123354115, -82.62466263237157 35.587270233549425, -82.62472363238422 35.58725423355243, -82.62486463241369 35.587215233558965, -82.62496963243534 35.587187233564045, -82.62522363248885 35.58711423357523, -82.62528963250297 35.58709423357788, -82.62543163253268 35.58705423358437, -82.62577863260596 35.58695323359935, -82.62584863262055 35.58693423360269, -82.62589763263065 35.58692123360504, -82.62606863266578 35.58687723361363, -82.62624463270093 35.58683923362392, -82.62631663271519 35.58682423362823, -82.6267506327983 35.586753233658335, -82.62709463286319 35.58670323368346, -82.62712763286952 35.5866972336856, -82.62745063293161 35.58664323370771, -82.6275566329517 35.586627233715376, -82.62774363298723 35.58659823372868, -82.6283046330934 35.58651423376906, -82.62849263312901 35.58648623378265, -82.62867063316321 35.58645623379484, -82.62912863325106 35.586380233826326, -82.62920763326647 35.58636523383144, -82.629386633301 35.58633423384343, -82.62950663332462 35.58631023385088, -82.62957763333812 35.5862992338559, -82.62964363335048 35.586290233860865, -82.62977663337483 35.58627623387167, -82.62992863340034 35.58627423388685, -82.63015863343657 35.586287233913055, -82.63035263346723 35.58629823393522, -82.63044663348155 35.58630623394649, -82.63061063350656 35.58632123396641, -82.63080663353723 35.58633323398893, -82.63101363356762 35.58636023401569, -82.63111763358214 35.586378234029944, -82.6311776335905 35.586388234038154, -82.63132063360668 35.586438234063074, -82.63147963361779 35.586537234099524, -82.63155963361929 35.58661423412344, -82.63160163361994 35.58665523413612, -82.63175363361094 35.58687823419708, -82.63180763360607 35.586968234221004, -82.63184663360414 35.58702323423622, -82.63192763360613 35.587098234259784, -82.63197663360806 35.58713823427301, -82.63204763361409 35.587175234287834, -82.63220263363056 35.58723623431609, -82.6323496336483 35.58728023434015, -82.63246763366477 35.587300234356356, -82.63265963369425 35.587316234379294, -82.63278163371474 35.58731523439158, -82.63302363375942 35.58728623441054, -82.63316163378612 35.587262234419796, -82.63358063386393 35.58720923445198, -82.63377563389894 35.58719223446854, -82.63390963392295 35.58718123448007, -82.63417863397284 35.58714723450076, -82.6343696340106 35.58710823451232, -82.63456163405068 35.58705523452131, -82.63473063408881 35.58699023452538, -82.635062634162 35.586873234535595, -82.63524863420297 35.58680823454146, -82.63546263424882 35.58674123454971, -82.6358196343237 35.58664023456582, -82.6359976343633 35.5865752345708, -82.63619163441145 35.58647223456974, -82.63625963442914 35.586430234568155, -82.6362936344381 35.586409234567306, -82.63640563446502 35.58635523456781, -82.63646363447862 35.586329234568495, -82.63678163455091 35.58620323457545, -82.6368636345698 35.58616923457693, -82.63687863457321 35.586163234577235, -82.63701263460547 35.58609823457775, -82.63702363460825 35.58609223457764, -82.63703763461213 35.58608223457703, -82.63711463463234 35.58603323457496, -82.63714063463924 35.58601723457437, -82.63719663465434 35.5859792345724, -82.63722063466061 35.585964234571804, -82.63735463469999 35.585853234562954, -82.63740763471546 35.585810234559574, -82.63749663474191 35.58573423455325, -82.6376826347999 35.58555823453641, -82.63834763500671 35.58493223447715, -82.63849663505404 35.58478623446268, -82.63865263510316 35.58463523444791, -82.63877163513841 35.584534234439516, -82.63878663514342 35.584518234437816, -82.63883263515798 35.58447323443333, -82.6388486351629 35.584458234431956, -82.63886863516991 35.5844342344291, -82.63893163519086 35.584366234421765, -82.63895363519795 35.58434423441951, -82.63897763520595 35.58431823441671, -82.63899663521333 35.584290234412904, -82.6390496352336 35.58421623440327, -82.63908463524912 35.58415323439405, -82.63909863525777 35.58411223438714, -82.63910663526254 35.584089234383185, -82.63911363526667 35.584070234380064, -82.63911663527082 35.584046234375464, -82.63911963527656 35.58401223436895, -82.63912663528676 35.58395323435763, -82.63912663529341 35.58391023434884, -82.63912763529886 35.58387623434201, -82.63912863532248 35.583723234310895, -82.63911563533497 35.583628234290224, -82.63908363534178 35.58354923427083, -82.63903463534473 35.58347723425115, -82.63897463534403 35.583416234232566, -82.63895963534374 35.583402234228146, -82.638897635342 35.583346234210374, -82.63882063533721 35.5832942341919, -82.63870063532829 35.58322223416489, -82.63856963531641 35.583158234138445, -82.6384336353013 35.583109234114566, -82.6382916352835 35.583071234092195, -82.63812763526039 35.583044234069895, -82.63794363523317 35.58302223404649, -82.63766663519036 35.58300123401379, -82.63746963516054 35.58298223398976, -82.63694563508109 35.582932233925845, -82.63686263506848 35.582924233915676, -82.6366156350311 35.58290023388544, -82.63653363501855 35.58289323387557, -82.63666863505092 35.58282823387625, -82.63679063507753 35.58278723388034, -82.63703163512976 35.582708233888944, -82.63740763521442 35.58256423389827, -82.63757763525177 35.5825052339036, -82.63763263526374 35.58248723390565, -82.63768963527443 35.5824792339098, -82.63785163530487 35.58245623392182, -82.63785763530596 35.58245523392222, -82.63796263532461 35.58244823393155, -82.63808063534394 35.58245023394403, -82.63820963536428 35.58245723395872, -82.63834463538421 35.582473233975804, -82.6383686353878 35.58247623397883, -82.63852663540976 35.5825042340008, -82.63865563542639 35.58253523402029, -82.63874563543686 35.58256523403568, -82.63889563545266 35.58262423406307, -82.63914463547299 35.582761234116575, -82.63924863548289 35.58280923413695, -82.63932963549415 35.58282423414837, -82.6393936355041 35.58282823415574, -82.6394666355188 35.58281223415999, -82.63953963553722 35.582771234159104, -82.63960663555862 35.582704234152274, -82.6396696355839 35.58260823413926, -82.63969863559508 35.58256623413367, -82.63976263562348 35.58245123411681, -82.63979663563879 35.58238823410742, -82.63987463567096 35.582263234089986, -82.63993163569197 35.58218823408055, -82.63994463569664 35.5821722340786, -82.64002963572244 35.582096234071834, -82.64009163573824 35.58206023407086, -82.64010363574121 35.582054234070874, -82.64019663576063 35.58202823407515, -82.64033263578621 35.58200923408522, -82.64059563583429 35.58198123410651, -82.64070363585436 35.58196723411462, -82.64088063588717 35.581945234128355, -82.64090863589279 35.58193923413008, -82.6409566359023 35.58192923413293, -82.64110563593442 35.581881234138386, -82.6412766359753 35.58180023413944, -82.64137463599852 35.58175523414029, -82.64152263603589 35.58167223413855, -82.64160163605725 35.581619234135914, -82.64165963607873 35.58154223412616, -82.64168563609668 35.581453234110676, -82.64168563611159 35.58135623409094, -82.64166163613444 35.581181234052785, -82.64165263615588 35.58103223402151, -82.64165263617438 35.58091223399706, -82.64166363618861 35.580831233981684, -82.64168163621095 35.58070523395787, -82.64169863623749 35.58055123392823, -82.64169063624841 35.58047123391111, -82.64168163625172 35.58044023390387, -82.64167163625513 35.580407233896096, -82.64163563626117 35.58032923387652, -82.6416246362612 35.58031723387293, -82.64149063626282 35.5801612338274, -82.64136863626717 35.58000123378234, -82.64135663626757 35.57998523377785, -82.64131163627269 35.57990323375653, -82.6413066362751 35.579882233751725, -82.64128563628647 35.579785233729794, -82.64128463628931 35.57976623372584, -82.6412826363026 35.57967723370747, -82.64131663634376 35.57944623366394, -82.64131563634821 35.579416233657675, -82.64131563635802 35.579352233644705, -82.64130763636466 35.579300233633205, -82.64127063639515 35.57906223358095, -82.64128763643222 35.57883923353723, -82.64130163645132 35.578730233516474, -82.64131963647475 35.57859723349119, -82.64130463650541 35.57838123344573, -82.6412736365289 35.5781952334046, -82.64129763656554 35.57798223336364, -82.64137563660196 35.577830233340656, -82.64152063665706 35.5776282333144, -82.6418566367798 35.57719323326025, -82.64201063683586 35.576995233235664, -82.64218463690655 35.57672323319815)))",6417,37,021,002506,370210025062,1683,1683,177,1654,1483,46,15,3,6,101,29,1311,115,1196,1299,1175,34,15,2,4,69,12,766,693,73
census_2010_blockgroups_view.fid--2dc29038_13ec899ba8f_-2643,"MULTIPOLYGON (((-82.42289859496576 35.612783218003365, -82.42296859497496 35.6127982180136, -82.42311359499558 35.61282021803303, -82.42326659501784 35.61284021805285, -82.42354059505976 35.61286221808548, -82.42394959511337 35.61295421814629, -82.42415859513609 35.613031218183444, -82.42437259515384 35.61314521822867, -82.42472059517812 35.61336121830838, -82.42473459517906 35.61337021831169, -82.42500959519462 35.61356421837939, -82.42517659519855 35.61371821842792, -82.42529159519533 35.61386221846895, -82.4254335951856 35.61407721852729, -82.4256105951719 35.61435621860222, -82.42578459515576 35.61464721867929, -82.42612159512754 35.61519121882455, -82.42627659511459 35.61544121889129, -82.42673759507603 35.61618521909001, -82.42682559506822 35.61633021912852, -82.4270015950528 35.616619219205376, -82.42709859504642 35.61676421924482, -82.42719359504004 35.61690721928372, -82.42725859503607 35.617003219309886, -82.42741959502992 35.617215219369584, -82.42757359502691 35.61740021942303, -82.42761859502649 35.61745121943799, -82.42782059502497 35.617677219504735, -82.42786859502459 35.61773121952066, -82.42797259502387 35.6178472195549, -82.42826059502431 35.61815321964679, -82.42893159502275 35.61888321986421, -82.42901959502237 35.61898021989303, -82.42948559502047 35.619492220045096, -82.42971859501927 35.61974922012128, -82.43000859501794 35.62006922021617, -82.43042259501725 35.62051722034988, -82.43065859501701 35.620772220426026, -82.43091859501573 35.62105922051109, -82.43103359500915 35.62122522055664, -82.43109659500016 35.62135122058881, -82.43113059498705 35.6214722206169, -82.43114159497809 35.621542220632264, -82.43114859497258 35.621585220641705, -82.43115159495656 35.62169222066375, -82.43113359493553 35.62180922068567, -82.4310775948964 35.62200222071916, -82.43098459483703 35.62228722076747, -82.4304995945374 35.62370722100617, -82.43033759443536 35.62419422108847, -82.43023959437318 35.6244912211388, -82.43011259428977 35.62489522120778, -82.43004359425065 35.625074221237064, -82.42994959419917 35.62530722127477, -82.42985059415261 35.62550222130417, -82.42971559409641 35.62572122133481, -82.42938259398107 35.62611122137984, -82.42924359393596 35.62625422139457, -82.4284625936818 35.6270622214784, -82.42813759356733 35.62745522152472, -82.42778859343548 35.62793422158614, -82.4267125930282 35.629417221776826, -82.42657559297115 35.629639221807835, -82.42636259288206 35.62998722185659, -82.42620259281547 35.63024722189294, -82.42585059265899 35.63088222198572, -82.4257825926295 35.63100022200274, -82.42561959256493 35.6312432220354, -82.42560559255918 35.63126522203837, -82.4255335925347 35.631347222047594, -82.42545559250972 35.631425222055476, -82.4253045924655 35.63154922206508, -82.4252225924436 35.631603222067675, -82.4248725923563 35.631793222070165, -82.42463159229759 35.63191522207019, -82.42456059228005 35.631952222070396, -82.42418159218609 35.6321542220724, -82.42385859210616 35.632325222073945, -82.42309259191619 35.63273322207799, -82.42288959186713 35.63283322207739, -82.42279459184402 35.632881222077295, -82.42270359182389 35.6329142220747, -82.42254759179151 35.63295622206716, -82.4224535917726 35.63297822206188, -82.42170759163186 35.633089222007655, -82.42169159162876 35.633092222006624, -82.4203195913683 35.633307221909, -82.42007159132287 35.6333352218891, -82.4199055912959 35.63333222187141, -82.41976359127503 35.633315221853344, -82.41953059124388 35.63326722181955, -82.41923859120914 35.63317922177162, -82.41919559120431 35.63316422176416, -82.41890859117197 35.63306622171463, -82.41872159114976 35.63300922168385, -82.41857059113056 35.632972221660765, -82.41837759110415 35.63293622163358, -82.41813159106931 35.632898221600456, -82.41776159101444 35.63285622155379, -82.41759659098997 35.63283822153323, -82.41704959090718 35.63278822146664, -82.41679959086984 35.63276122143544, -82.41659459084025 35.63273322140866, -82.41628759079839 35.63267522136517, -82.41598059075753 35.632611221320566, -82.41591759074892 35.632599221311644, -82.41530759066583 35.63248322122528, -82.41490359060916 35.632417221170236, -82.41374359044592 35.63223022101271, -82.41369159043909 35.63221922100509, -82.4134975904132 35.632179220977044, -82.41329359038735 35.632127220945435, -82.41235459027618 35.631841220790555, -82.41214659025066 35.63178322075736, -82.41205359023886 35.63176022074309, -82.41197459022867 35.63174122073115, -82.41177559020238 35.631698220701836, -82.41169659019164 35.63168322069067, -82.4112165901261 35.63159322062295, -82.40987058994094 35.63134922043469, -82.40962758990564 35.631317220403176, -82.40938158986847 35.631294220373135, -82.4090375898136 35.63128122033505, -82.40821658967944 35.63126922024805, -82.40790258962816 35.631265220214935, -82.40748158955759 35.63127122017275, -82.40723258951465 35.63128222014935, -82.40700558947296 35.631308220131196, -82.40692758945809 35.63132122012586, -82.406732589421 35.63135222011203, -82.40658258939169 35.631381220102504, -82.4064285893604 35.63141922009433, -82.4062485893227 35.6314702200862, -82.40604458927821 35.63153922007915, -82.405322589115 35.63182222006231, -82.40526558910202 35.631845220061095, -82.40514158907354 35.63189622005869, -82.40485558900934 35.63200522005135, -82.40458958894826 35.63211622004648, -82.40442958891359 35.632169220040836, -82.40430058888303 35.63222822003955, -82.40377458876384 35.63243622002755, -82.40336958867087 35.63260422002003, -82.4032595886446 35.63265622001922, -82.4031495886171 35.63271622002006, -82.40295258856437 35.63284622002624, -82.40277958851351 35.63299022003765, -82.40240658839876 35.6333332200689, -82.40096158794917 35.63469422019661, -82.40090758793221 35.63474622020161, -82.40084958791364 35.634804220207435, -82.40066358785344 35.63499422022682, -82.40043758777541 35.63525722025701, -82.39990258758574 35.635911220334705, -82.39982158755606 35.636016220347685, -82.39974058752354 35.63613922036435, -82.39968858749994 35.63623722037896, -82.39964758747638 35.63634522039666, -82.39962758746177 35.63641822040939, -82.39961458744564 35.63650922042657, -82.39961058742489 35.636639220452594, -82.39963258738706 35.636907220509315, -82.39964158737158 35.6370172205326, -82.39963658734538 35.637181220565374, -82.39959458727313 35.63760322064683, -82.39957558724507 35.63776422067754, -82.3995235871923 35.63805022073032, -82.39942858710756 35.63849622081117, -82.39942158709313 35.638582220827935, -82.39942458707733 35.638687220849555, -82.39943858706248 35.63879822087356, -82.39950458702351 35.63912122094595, -82.39963558695747 35.63968822107474, -82.39972258691374 35.64006422116004, -82.3998025868753 35.64039822123616, -82.39980458686745 35.640451221247105, -82.39980158686157 35.64048622125392, -82.39978258685208 35.640527221260335, -82.39973758683476 35.6405912212687, -82.39978758683853 35.640620221279754, -82.39992258685233 35.64067522130487, -82.40000558685871 35.64072322132311, -82.40029958688065 35.64089622138855, -82.4006085869141 35.64101022144359, -82.40081258693162 35.641115221485904, -82.40098558694655 35.641204221521825, -82.40107358695175 35.64126422154308, -82.40106858695033 35.641268221543406, -82.40105758694615 35.64128322154535, -82.40105258694467 35.64128822154582, -82.40116558695492 35.64134222156845, -82.40118758695706 35.64135222157268, -82.40123858695624 35.64141222159021, -82.40125058694598 35.64149122160743, -82.40126058693806 35.641553221621095, -82.40124958682287 35.64228622176897, -82.40125458670263 35.64306922192851, -82.4012565866576 35.64336222198823, -82.40125858661699 35.64362722204233, -82.40126558647763 35.644535222227525, -82.40126958638751 35.645122222347226, -82.40391058636241 35.64811122322679, -82.40444958636179 35.64869222340041, -82.40490058636111 35.649179223545836, -82.40516358617349 35.6506732238766, -82.40514958616271 35.650728223886304, -82.40518258606434 35.65139922402609, -82.4052305859854 35.65196022414499, -82.40529058594127 35.652310224222305, -82.4053445859279 35.65245422425712, -82.40537158592902 35.65247622426435, -82.40540958589322 35.65274822432361, -82.40541158589127 35.652762224326615, -82.40539758582621 35.65316822440771, -82.4053635857661 35.65352022447578, -82.40527658569292 35.65390022454403, -82.40527658563536 35.6542722246196, -82.40532358559906 35.65455722468236, -82.40535058560174 35.65456822468735, -82.4053765855666 35.65482322474187, -82.40539058555876 35.654888224756526, -82.40541758555996 35.65491022476371, -82.40543758553792 35.65507422479918, -82.40541058549911 35.65529622484154, -82.40538358549153 35.655316224842736, -82.4053425854626 35.65545922486763, -82.40528958544493 35.65551622487372, -82.405208585403 35.655701224903, -82.40517458537178 35.655866224933014, -82.40518858533497 35.65611922498584, -82.40526158525167 35.65673522511857, -82.40530258522614 35.65694422516524, -82.40532958522749 35.65696422517207, -82.40536258519045 35.65723922523138, -82.4053895851915 35.65726122523864, -82.40543058515895 35.65751522529449, -82.40545658515967 35.65753822530192, -82.40545658515133 35.657592225312854, -82.40552458514384 35.65771322534446, -82.40555158513136 35.65782322536956, -82.40559158513116 35.6578672253826, -82.40569258510548 35.658141225448716, -82.4057195851082 35.65815222545369, -82.40574658509739 35.658251225476654, -82.40565158504756 35.658471225511555, -82.40565158504066 35.658516225520664, -82.4055985850234 35.65857122552642, -82.40551058498433 35.65872922554943, -82.4054775849741 35.65876022555237, -82.40544358496298 35.65879522555598, -82.4054425849561 35.65883822556457, -82.40538958493853 35.658895225570696, -82.40537558492433 35.65897222558488, -82.40534858491665 35.65899322558638, -82.40530858489284 35.65910422560485, -82.40530858488636 35.659146225613334, -82.40528158487828 35.65916922561521, -82.40509958478533 35.65957522567899, -82.40507258477722 35.65959822568088, -82.40493758471256 35.65987222572264, -82.4049105846937 35.659965225738745, -82.40483658466763 35.660054225749306, -82.40483658466255 35.66008722575589, -82.40468858459538 35.660362225796526, -82.40463458457816 35.66041622580198, -82.404513584531 35.66059122582506, -82.4044995845098 35.660713225848404, -82.40453358449344 35.660855225880766, -82.40481558449073 35.66117422597469, -82.40492358447122 35.66141622603503, -82.40497058442112 35.661790226115826, -82.40495758438828 35.66198822615472, -82.40495858438632 35.66200222615768, -82.40499058434945 35.66227422621619, -82.40511158432011 35.66259322629359, -82.40516558428833 35.66285622635262, -82.40513158424541 35.66309722639802, -82.40502458420025 35.66327422642297, -82.40482158414525 35.66341222643015, -82.40464658410271 35.66350022642995, -82.40463358409744 35.663520226432716, -82.40460658409295 35.663520226429874, -82.40447858405123 35.66365322644372, -82.40439758401924 35.663773226459725, -82.40419558391419 35.66423522653285, -82.40415458390247 35.664267226535124, -82.40394558382243 35.6645612265733, -82.40377058376976 35.66471422658627, -82.40362258373 35.664812226590996, -82.4033805836728 35.66492322658857, -82.40311758360626 35.66507122659158, -82.402955583559 35.665203226601626, -82.40290158354149 35.66525822660729, -82.40288858353279 35.66530122661464, -82.40276758349579 35.665410226624424, -82.40275658347811 35.665513226644116, -82.40273358343741 35.66575122669017, -82.40277358339277 35.66608222676155, -82.40280058339555 35.66609322676654, -82.40284158337525 35.66626822680638, -82.40286758337604 35.66629122681365, -82.40290158334756 35.66651122686194, -82.40292858335036 35.66652222686694, -82.40292858330463 35.6668172269269, -82.40283358326396 35.666978226949766, -82.40284758325801 35.667032226962235, -82.40278658322046 35.667209226991915, -82.40266558317686 35.6673612270103, -82.4025845831308 35.66757222704481, -82.40254458311753 35.66761522704943, -82.40251758309942 35.667703227064514, -82.4024765830876 35.66773522706685, -82.40244258306164 35.66786722709015, -82.4024025830497 35.66790122709296, -82.40232158300236 35.66812022712907, -82.4022275829775 35.66818022713158, -82.40199858292773 35.66825722712363, -82.40193058290623 35.66832322713, -82.40189058287739 35.66846622715495, -82.4018895828771 35.66846722715502, -82.40182958281282 35.66881822722021, -82.40192458278612 35.669092227285645, -82.40206558276691 35.66936722735608, -82.4021195827452 35.669565227401925, -82.40211958272454 35.66969822742893, -82.4020655826935 35.66984122745244, -82.40184358264302 35.669929227447454, -82.40176258261867 35.670000227453514, -82.40174858260632 35.67006522746528, -82.40172158259824 35.670088227467126, -82.40169458257517 35.67020822748871, -82.40169458255467 35.67034122751575, -82.40171458251223 35.67063622757782, -82.40174158251327 35.67065822758502, -82.40176158238887 35.671483227754734, -82.40173458235179 35.67169322779468, -82.4017075823441 35.67171422779613, -82.40166758231021 35.67189022782784, -82.40164058230222 35.67191322782966, -82.40155258225188 35.67214422786752, -82.4013905821734 35.67247722791848, -82.40127658210517 35.672796227971574, -82.40119558202872 35.673203228045914, -82.40112758198346 35.67342222808341, -82.40106658195616 35.67353322809971, -82.40102758192528 35.673691228127815, -82.40095858187037 35.67397222817771, -82.40088558180122 35.67434022824499, -82.40091158176287 35.67461522830365, -82.40099258175586 35.67474722833881, -82.40111358175564 35.6748782283779, -82.4015105817693 35.67521422848708, -82.40159158177597 35.67525822850438, -82.40161858175638 35.67541322853863, -82.40157158171108 35.67565522858302, -82.40163858168987 35.67586422863233, -82.40170558168221 35.67598522866385, -82.40175958168288 35.67603822868026, -82.40180058167094 35.67615922870907, -82.40182058163833 35.67639122875822, -82.40173958153294 35.67698522887062, -82.40169158149969 35.67714822889884, -82.40169158144946 35.67747222896468, -82.40171858141616 35.67771622901701, -82.40168558136676 35.67800022907131, -82.40168358136589 35.67800322907176, -82.40161758133328 35.67814322909337, -82.40155058130671 35.67824322910681, -82.40155058130014 35.67828522911534, -82.40139458121469 35.67867022917748, -82.40128058107402 35.67945622932548, -82.40125958094089 35.68029322949334, -82.40128658089758 35.68060122955872, -82.40131958087413 35.68078822960021, -82.40129258082901 35.681050229650594, -82.40126658081776 35.68109522965713, -82.40119158075593 35.68141422971418, -82.40116558074851 35.68143422971553, -82.40116458072771 35.68156722974253, -82.40125258063165 35.68228122989668, -82.40148058059093 35.68278723002303, -82.40156858054763 35.68316123010809, -82.40153458046035 35.6836882302117, -82.40153458042109 35.68394123026313, -82.40156158041525 35.68400823027948, -82.40155458033827 35.68449723037817, -82.40152758028624 35.68480423043779, -82.40154058028313 35.68483823044601, -82.401493580226 35.685156230505854, -82.40132458011277 35.68570623060015, -82.40129758008318 35.685868230630305, -82.40131158008337 35.68588223063463, -82.40125758005243 35.68602423065792, -82.40124358002981 35.686155230683006, -82.40121658001088 35.68624823069914, -82.40116957997648 35.68642023072927, -82.40106157992025 35.686667230768286, -82.40104857990445 35.686755230784804, -82.40098157987472 35.68687523080235, -82.40087957980482 35.6872172308613, -82.40085257976646 35.687436230903046, -82.40087257969829 35.687897230998814, -82.40128357960596 35.688932231251556, -82.40132357960921 35.688954231260155, -82.4014855796039 35.68916123131892, -82.40211157962132 35.6897182314967, -82.40217857961548 35.6898272315258, -82.40219057960377 35.6899152315449, -82.40219257960247 35.6899262315473, -82.40230657959076 35.69012323159913, -82.40264357958182 35.690541231718825, -82.40285257955837 35.690915231816405, -82.4030005795521 35.69111423187214, -82.40340457955864 35.69150323199289, -82.40349157955262 35.691635232028645, -82.40370757955242 35.69186723209813, -82.40393657955829 35.69207423216379, -82.40419857956927 35.69228323223335, -82.40446857956458 35.692602232325996, -82.4046845795234 35.693098232449124, -82.40479757950213 35.69335623251316, -82.40491957948844 35.69357523257027, -82.40498657947384 35.693741232610975, -82.40504657942759 35.694103232690736, -82.40500657939542 35.69426823272014, -82.40496657937186 35.69437723273819, -82.40500857931741 35.69477323282295, -82.40506957924087 35.69533223294292, -82.405083579145 35.695965233073046, -82.40508857911257 35.6961802331172, -82.40513257909201 35.69635923315807, -82.40514757908502 35.696420233172084, -82.40519257906404 35.69660423321409, -82.40520757905692 35.6966662332282, -82.40467457890418 35.6970812332576, -82.40393057869083 35.6976622332989, -82.40349057858421 35.69788023329778, -82.40290057847743 35.697938233248685, -82.40278857845706 35.69795023323959, -82.40224957839256 35.69779023315146, -82.40168657832513 35.69762323305938, -82.40154057830489 35.6975982330393, -82.40102957823363 35.69751123296881, -82.4006315781611 35.69755423293654, -82.40034957810002 35.697647232926286, -82.3994465778881 35.69804923291483, -82.39935057786535 35.69809323291386, -82.39872857774816 35.698184232868215, -82.3986565777365 35.6981822328604, -82.39850557771425 35.6981652328413, -82.39837157769662 35.69813523282142, -82.39829157768776 35.69810723280742, -82.39778057764052 35.697866232705735, -82.39645657754063 35.6970962324126, -82.39609457750856 35.69691623233867, -82.39566457746167 35.69675923226239, -82.39532157741657 35.69668423221173, -82.39486757734802 35.69664123215615, -82.39298857704257 35.696604231954744, -82.39260357697982 35.6965972319136, -82.39169957683959 35.69653623180787, -82.39129957678192 35.69648123175543, -82.39089657673347 35.696363231689865, -82.39063857671135 35.69623023163624, -82.3903375766987 35.6959902315564, -82.39017057670593 35.6957652314934, -82.39006157672556 35.69552223143281, -82.39003357677974 35.69514323135293, -82.3900945768505 35.694752231279764, -82.39052757716614 35.6931792310048, -82.39064657727556 35.6926002308994, -82.39067357734143 35.692204230821744, -82.39057257741253 35.6916382306963, -82.39045057744075 35.69132623062026, -82.389805577535 35.69002923029015, -82.38968157757759 35.68962223019475, -82.38964657766452 35.689024230069556, -82.38972057781547 35.68812922989538, -82.38978157786828 35.68785422984569, -82.38979557795462 35.687312229737074, -82.38971257804769 35.68662322958851, -82.38962157810485 35.68615722948445, -82.38946457815204 35.68568522937227, -82.38922057819951 35.685118229231925, -82.38881257825024 35.68435522903479, -82.38793257829687 35.68311422869179, -82.38769657830463 35.682812228606046, -82.38737857830958 35.682440228497676, -82.38727357830761 35.68234122846674, -82.38718457830471 35.68226422844189, -82.3870925782985 35.6822062284206, -82.38698157828664 35.68216422840069, -82.38687157827341 35.68213222838282, -82.38669757824772 35.68211222836075, -82.38659957823104 35.68211522835128, -82.38658457822835 35.68211622834991, -82.38651957821644 35.68212322834467, -82.38642857819693 35.682152228341174, -82.38634457817774 35.6821862283394, -82.38622657814612 35.68226422834311, -82.38611657811401 35.68235422835001, -82.38593757804502 35.68260822838313, -82.38578857798069 35.682864228419774, -82.38568257793332 35.683056228447896, -82.38561557790116 35.68319222846857, -82.38533857774817 35.68388322858044, -82.38488857739989 35.685649228892835, -82.38462457730228 35.68599722893628, -82.38384057705571 35.68675022900834, -82.38370257696063 35.687216229088826, -82.3834995769393 35.68713722905184, -82.38349057693821 35.687134229050265, -82.38322957690275 35.68708422901322, -82.38301657688028 35.68700222897459, -82.38289057687179 35.68692222894532, -82.382836576868 35.68688922893301, -82.3826895768506 35.68684422890871, -82.38255957683494 35.68680622888756, -82.38250257682819 35.686789228878276, -82.38239557681544 35.68675722886064, -82.38218257680283 35.68661122880906, -82.38180657676332 35.68646422874037, -82.3814795767419 35.68625322866379, -82.38116757672053 35.68605822859195, -82.38089057670068 35.68589022852925, -82.38079057669347 35.68583022850673, -82.3804285766837 35.68550622840357, -82.3802145766833 35.68528022833551, -82.38002957670771 35.68492522824433, -82.37991057673318 35.68463422817291, -82.37951757670338 35.684406228086054, -82.37917157669891 35.68406622798124, -82.37867557669459 35.68356422782809, -82.37822857670339 35.68303022767347, -82.37787657674288 35.68239922750898, -82.37763757680351 35.68175322735299, -82.37754957683649 35.68144622728156, -82.37741557685452 35.68118722721515, -82.37732957685975 35.68106122718066, -82.37721557686646 35.68089622713536, -82.37701857685902 35.680734227082176, -82.37672057686243 35.68039422698232, -82.37640857685088 35.68013522689753, -82.37619457685064 35.679908226829276, -82.37610757687636 35.67964922676769, -82.37607257689301 35.67950422673469, -82.37612057692328 35.6793602267103, -82.37616857694617 35.6792642266958, -82.37624857697676 35.67915222668132, -82.3763605770102 35.679056226673325, -82.37650457706629 35.678848226645925, -82.37660057711432 35.67864022661359, -82.37677657718324 35.67838422657977, -82.37717657731878 35.677936226529994, -82.3775605774642 35.67740822646235, -82.3780565776504 35.676736226377, -82.37831257774236 35.67641622633845, -82.37850457782129 35.67611222629643, -82.37882457792877 35.675760226257964, -82.37924057803984 35.675488226245555, -82.37972057818378 35.67507222621063, -82.38005657830378 35.67465622616079, -82.3800575783043 35.67465422616041, -82.38023257837266 35.67440022612689, -82.38047257848915 35.67390422605085, -82.38066457859784 35.67340822596989, -82.38088857873406 35.67276822586308, -82.38100057881954 35.67233622578679, -82.38106457888956 35.671952225715366, -82.38104857894147 35.67160022564217, -82.38116057900461 35.67131222559524, -82.38133657909579 35.67091222553211, -82.3815125791918 35.670480225462505, -82.38168857927799 35.6701122254059, -82.38181657934868 35.669792225354094, -82.38199157943967 35.669392225290885, -82.38202357953162 35.66883222518037, -82.38210357960195 35.668464225113894, -82.38235957970379 35.66808022506224, -82.38263157983555 35.66752022497652, -82.38271157988098 35.66731222494254, -82.38282357994662 35.667008224892335, -82.38283957998888 35.66675222484198, -82.3828715800462 35.66641622477704, -82.38288758009355 35.66612822472018, -82.38282358013997 35.66576022463883, -82.38256758014212 35.66547222455386, -82.38240758016273 35.66516822447563, -82.3822955802012 35.66480022438928, -82.38218358023465 35.66446422430947, -82.38226358031241 35.6640482242332, -82.38232758038245 35.663664224161785, -82.38239158045991 35.66323222408065, -82.38247158053255 35.66284822401082, -82.38247158061434 35.66232022390357, -82.3823755806877 35.66174422377668, -82.38232758074412 35.66132822368717, -82.38224758086471 35.66046422350346, -82.38226358095649 35.659888223388066, -82.38243958103762 35.65955222333791, -82.38264758109938 35.659376223323626, -82.38295158118929 35.65912022330298, -82.38320758128118 35.65880022326436, -82.38351158139837 35.65836822320795, -82.38383158150836 35.65800022316618, -82.3840235815897 35.657680223120906, -82.38419958169057 35.65721622304479, -82.38422458171111 35.65711022302582, -82.38429558176844 35.65681622297346, -82.38432758181585 35.6565442229215, -82.3843595818533 35.65633622288254, -82.38434358191012 35.6559522228029, -82.38415158192791 35.65563222271809, -82.38397558195574 35.65526422262517, -82.38376758197334 35.654928222535474, -82.38363958198926 35.65468822247349, -82.38349558201743 35.654352222390365, -82.3832075820094 35.65409622230866, -82.38306358204754 35.65369622221257, -82.38272758206365 35.65323222208358, -82.38272758211082 35.65292822202193, -82.38247158213525 35.65249622190776, -82.38226358219002 35.651920221769274, -82.38205558223486 35.65140822164379, -82.38130358242734 35.649360221150246, -82.3811115824699 35.6488802210329, -82.3807755824935 35.64836822089433, -82.38055158251954 35.64796022078822, -82.38050358252521 35.647872220765414, -82.38039158256363 35.64750422067914, -82.38031158259001 35.64724822061886, -82.37987958269674 35.646096220340326, -82.37960758279536 35.6451682201238, -82.37920758290251 35.644048219854966, -82.37895058313963 35.64224021946125, -82.37874258316712 35.641840219358514, -82.37872658319418 35.641648219317865, -82.37885458324006 35.6414882192986, -82.37963858349856 35.64065621921039, -82.38107858398926 35.639024219027284, -82.38136658410117 35.63860821897245, -82.38165458420585 35.63824021892735, -82.38179558425558 35.63806921890721, -82.38181458426199 35.63804821890482, -82.38197458433542 35.63774421885962, -82.38197458437014 35.63752021881405, -82.38200658442734 35.63718421874912, -82.38216658469389 35.63563221845032, -82.38218258487966 35.63444821821144, -82.38222858490064 35.634361218198535, -82.38237458496579 35.634096218159726, -82.38258258505958 35.63371221810317, -82.38283858515638 35.633360218058016, -82.38323858529188 35.63291221800828, -82.38392658551443 35.63220821793616, -82.38472658571368 35.63177621793086, -82.38771858647833 35.63003221788489, -82.38840658666146 35.62958421786473, -82.38887058680257 35.62916821782804, -82.38938258694415 35.62880021780597, -82.38962258700359 35.62867221780473, -82.38981458705769 35.62852821779525, -82.39003858712684 35.62832021777611, -82.39015058717264 35.628144217751846, -82.39011958717886 35.62807021773361, -82.38411258706456 35.622380215958785, -82.3824635869424 35.621405215590826, -82.38229458689145 35.6215542156037, -82.38211958685022 35.621633215601726, -82.38189958679814 35.62173521559975, -82.3818845868139 35.621617215574275, -82.38173158682201 35.6214002155144, -82.38165558683193 35.621255215477134, -82.38160258685323 35.62106021543206, -82.3815795868748 35.62089621539641, -82.38155658693925 35.620454215304235, -82.38160458696963 35.62030921527972, -82.38157358697624 35.620233215261116, -82.38137558699758 35.61988321516962, -82.3813315870025 35.619804215148974, -82.38121758702941 35.61950821507718, -82.38118158704219 35.61938721504883, -82.3811365870585 35.61923321501291, -82.38111058709507 35.61896921495662, -82.3811555871357 35.618754214917566, -82.38117058714913 35.61868321490468, -82.38117158717304 35.61852921487351, -82.38115958717782 35.61848621486356, -82.38114458718398 35.61843021485062, -82.38102358719777 35.61821121479371, -82.38091558720119 35.61807321475446, -82.38069358722225 35.617699214655666, -82.3805725872735 35.61723821454956, -82.38051958727998 35.61713921452402, -82.38019558727466 35.61682721442725, -82.38019558730504 35.61663021438724, -82.38019058731402 35.61656721437391, -82.3801745873305 35.61644321434704, -82.38015058734028 35.6163542143265, -82.38001058739982 35.61581921420346, -82.37995758742781 35.61558121414966, -82.37994958743313 35.615538214140045, -82.379918587456 35.61535721410012, -82.37990958746911 35.61526221407991, -82.37990258748961 35.61512221405071, -82.37990258749407 35.61509321404487, -82.3798995875542 35.614701213964935, -82.37989858757561 35.614561213936376, -82.37988758758539 35.61448621391998, -82.37987858759406 35.61442021390571, -82.37987258760779 35.61432521388579, -82.37986758761714 35.614259213871854, -82.37986758761961 35.61424321386862, -82.37987258762956 35.6141842138571, -82.37987558763332 35.614163213853125, -82.37989558764484 35.61411021384445, -82.37991658765648 35.61405721383588, -82.37996258767551 35.613983213825534, -82.38002358769552 35.61391921381881, -82.38007858771309 35.61386421381336, -82.38020358775103 35.61375221380345, -82.38030258778083 35.61366521379601, -82.38057758786562 35.61341121377276, -82.38070258790374 35.613298213762654, -82.38118858805196 35.61285921372356, -82.38264758849662 35.61154221360625, -82.3831345886449 35.61110421356751, -82.38352058876353 35.61074921353513, -82.3846785891194 35.609685213438304, -82.38485858917451 35.60952121342348, -82.38507058923815 35.60933621340776, -82.38520458925638 35.609362213426856, -82.38560658931047 35.60944221348453, -82.38568658932124 35.609458213496005, -82.38574058932798 35.6094722135044, -82.38569058929673 35.609621213529486, -82.38554358920277 35.61007221360595, -82.38549458917146 35.610222213631374, -82.38539958911068 35.610514213680894, -82.385191588976 35.611163213791286, -82.38511358892782 35.61139121382959, -82.38509658891726 35.61144221383823, -82.38505058888582 35.61159621386478, -82.38505258888041 35.61163321387254, -82.38506658887438 35.611687213884885, -82.38509758887164 35.61173821389844, -82.38526058886738 35.611940213956316, -82.38551958885496 35.612298214055656, -82.38564258884963 35.612464214102054, -82.38580358884089 35.61269321416521, -82.38604558882969 35.61302521425759, -82.38646858880759 35.61362121442219, -82.38660958880278 35.61380321447364, -82.38671558879663 35.61395621451572, -82.38679858878866 35.61409721455296, -82.38683558877592 35.61421921458145, -82.38691058874394 35.61450621464745, -82.3870395886436 35.615294214820835, -82.38707558863052 35.61541721484953, -82.38710958862626 35.61548121486604, -82.387140588626 35.61551621487636, -82.38719358863155 35.615537214886125, -82.38727858863867 35.61558221490398, -82.38733158864493 35.61559821491272, -82.38736258865066 35.61559421491507, -82.3873775886532 35.61559421491659, -82.38740858866056 35.615579214916785, -82.38745358867287 35.615548214915094, -82.3875075886947 35.6154642149036, -82.3875535887164 35.61537321488982, -82.38758358872676 35.61533821488587, -82.38762858874206 35.6152872148801, -82.38768258875676 35.61525021487815, -82.38777458877786 35.6152122148799, -82.3878435887903 35.6152052148856, -82.38794958880855 35.61520121489573, -82.3881325888358 35.61522021491837, -82.38846158887914 35.615292214966885, -82.38855458889131 35.61531321498084, -82.38875258891647 35.61536221501111, -82.38901358894557 35.61545321505652, -82.38916658896481 35.61549221508017, -82.3892805889817 35.61550521509453, -82.38948558901635 35.61550021511469, -82.38958558903542 35.615484215121704, -82.3897005890629 35.61542921512238, -82.38997158913577 35.61524821511351, -82.39005758916029 35.61518121510875, -82.39011758917968 35.61512021510259, -82.39026358925094 35.614815215055664, -82.39044358931946 35.614564215023236, -82.39056258936017 35.614428215007855, -82.3906685893946 35.614319214996556, -82.39120058954822 35.61389421496506, -82.39136158959589 35.61375821495396, -82.39140058961053 35.61370521494723, -82.39141958961996 35.61366421494089, -82.39142958962914 35.61361521493198, -82.39142658963543 35.61357121492272, -82.3914015896471 35.61346921489945, -82.39131058966647 35.613246214844686, -82.39128558967992 35.613132214819046, -82.39124458970241 35.61294321477638, -82.39123258970947 35.612884214763135, -82.39119858974657 35.612608214703556, -82.3911945897576 35.61253221468777, -82.39122158977366 35.61245721467524, -82.39125758979152 35.612380214663354, -82.39129658981025 35.612300214651135, -82.39133558983158 35.61220421463562, -82.3913465898376 35.61217721463126, -82.3914345898929 35.61191321458667, -82.39143958989959 35.61187521457948, -82.39154359001306 35.611252214463626, -82.39156459003493 35.61113321444161, -82.39157459005216 35.61103221442216, -82.39156659009257 35.61076221436649, -82.39155859011098 35.61063421433966, -82.39153659012769 35.610502214310586, -82.39148559013748 35.61038421428135, -82.39143359014525 35.61027821425445, -82.39132959014826 35.61014721421709, -82.39114059014588 35.6099602141597, -82.39093459014141 35.60976821409947, -82.39079959013738 35.60965021406156, -82.39069459013405 35.60955921403229, -82.3903715901211 35.60929721394579, -82.39032359012008 35.60925221393175, -82.39031359011855 35.60925121393051, -82.39032059014865 35.609064213893234, -82.39034559023904 35.60850521378226, -82.39035459026928 35.60831921374537, -82.3903695903236 35.60798321367867, -82.39041659048675 35.60697721347913, -82.3904325905411 35.60664221341269, -82.39044359058833 35.60634821335413, -82.39047859072998 35.60546821317897, -82.39048059073546 35.605435213172434, -82.39049759077827 35.605176213121574, -82.39053059078805 35.605148213119286, -82.39073359084294 35.605010213112216, -82.39092359089392 35.604883213105914, -82.39145659103649 35.604531213089395, -82.39162259108075 35.60442221308424, -82.39169959110076 35.60437521308262, -82.39176359111177 35.60437221308859, -82.391958591145 35.60436621310752, -82.39202359115605 35.60436421311377, -82.39218959118446 35.60435821312968, -82.39260459125698 35.60433321316734, -82.39392459148907 35.60424421328517, -82.3940995915209 35.604225213299316, -82.39421959154336 35.60420821330822, -82.39424459154836 35.604203213309816, -82.39441159158304 35.60415721331772, -82.39454959161343 35.60410821332184, -82.39469459164928 35.60403121332117, -82.39486959169527 35.60392121331681, -82.39535759183195 35.603558213293375, -82.3954955918689 35.603467213289086, -82.39566359191144 35.603371213286835, -82.39584659195705 35.60327221328552, -82.39612059202183 35.60314621328822, -82.39640359208686 35.603028213293356, -82.39669359215183 35.602918213300846, -82.39701359222316 35.60279921330966, -82.39747159232068 35.602658213328176, -82.3979655924214 35.602535213353995, -82.39798859242644 35.60252721335473, -82.39848659253009 35.602389213378004, -82.39887959261094 35.6022872133977, -82.3997775927951 35.602056213443326, -82.39999459283747 35.60201421345704, -82.40009959285669 35.60200221346548, -82.40020759287522 35.601998213475746, -82.40037359290267 35.6019982134929, -82.40050759292326 35.602008213508654, -82.40064859294384 35.602026213526855, -82.40083559296943 35.602061213553235, -82.40105559299755 35.60211421358667, -82.40122959301993 35.60215621361305, -82.40175359308701 35.60228321369282, -82.40192859310936 35.60232621371954, -82.40212759311711 35.602489213773204, -82.40216059311837 35.60251621378206, -82.40226759312833 35.60256621380333, -82.40228659312798 35.60258921380987, -82.4023535931326 35.60263121382532, -82.40278059316127 35.602903213924506, -82.40299859317564 35.60304321397541, -82.40335759320126 35.60326221405684, -82.40384859323622 35.60356221416836, -82.40444559328247 35.60390221429891, -82.40481159331082 35.60411121437912, -82.40492459331969 35.60417521440375, -82.40494659332126 35.604188214408616, -82.40527759335241 35.60434121447375, -82.40539659336359 35.60439621449721, -82.40541959336586 35.60440621450158, -82.40548859337241 35.60443821451522, -82.40551159337451 35.60444921451985, -82.40552959337617 35.60445721452333, -82.40558559338166 35.604482214534144, -82.40560459338333 35.60449121453787, -82.40640259347066 35.60478121467902, -82.40711559356438 35.604938214784276, -82.40771959364876 35.60503921486695, -82.40799859368796 35.60508421490489, -82.40888459381391 35.60521821502336, -82.40904559383472 35.605256215047575, -82.4091295938421 35.60529821506483, -82.40919759384634 35.60534421508111, -82.40927359384834 35.60541221510276, -82.40941859384584 35.605584215152696, -82.40964059383315 35.605904215240514, -82.40983859383107 35.60613021530683, -82.4099225938326 35.60621021533176, -82.40999159383462 35.60627121535123, -82.41002159383599 35.60629421535902, -82.41006059383766 35.60632521536929, -82.41009759383975 35.60635121537837, -82.4101975938446 35.60642721540415, -82.41036359385791 35.60651921544001, -82.41063259387951 35.60666721549768, -82.41080459389377 35.60675921553412, -82.41206659400125 35.607416215797535, -82.41233159402303 35.607559215853875, -82.41244459403227 35.60762021587786, -82.41278059405668 35.607822215953554, -82.41296759406914 35.60794221599716, -82.41319359408423 35.608087216049896, -82.4134495940975 35.60827521611449, -82.41360959409715 35.60844921616631, -82.41368759409694 35.60853421619159, -82.41376759409289 35.60864621622262, -82.41421159407065 35.60926621639431, -82.41435959406324 35.60947321645163, -82.41440059406116 35.609530216467405, -82.41452359405504 35.60970221651502, -82.41456459405288 35.60976021653104, -82.41534459401122 35.610866216836044, -82.41571059399195 35.611383216978815, -82.41582959399483 35.61149221701324, -82.41588659399778 35.61153421702759, -82.41597359400517 35.611579217045744, -82.41609059401837 35.61161921706593, -82.41626959404006 35.61167121709491, -82.41692559412608 35.61181721719206, -82.41712659415442 35.61184921721929, -82.41756959422375 35.61187521727023, -82.41815159431701 35.61189521733414, -82.4186305943913 35.611927217389955, -82.4187885944127 35.611958217412564, -82.41897159443602 35.612003217440495, -82.4190255944422 35.61202121744973, -82.41914959445612 35.61206421747121, -82.41964259450154 35.612298217569574, -82.41986559452627 35.612377217608575, -82.42009459455389 35.61244421764581, -82.42029259458015 35.61248621767475, -82.42061559462353 35.61255121772112, -82.42070659463741 35.612559217732176, -82.42104659468863 35.61259221777394, -82.42166559478696 35.61261921784306, -82.42174959480046 35.612621217852116, -82.42196959483618 35.61262621787579, -82.42229559488483 35.61266021791625, -82.42238659489713 35.61267821792934, -82.42265559493316 35.612733217968184, -82.42289859496576 35.612783218003365)))",6529,37,021,003002,370210030021,2199,2199,129,2144,2011,63,14,28,0,28,55,1744,76,1668,1719,1643,36,8,18,0,14,25,1003,910,93
census_2010_blockgroups_view.fid--2dc29038_13ec899ba8f_-2642,"MULTIPOLYGON (((-82.52539362174797 35.54916121560324, -82.52541162177378 35.549012215574834, -82.5254296217996 35.54886421554652, -82.5254556218498 35.54856521548832, -82.52546962187506 35.54841621545948, -82.5257356219164 35.54843421549046, -82.52582762193056 35.54844121550136, -82.52606062196564 35.5484642155299, -82.5262716219956 35.5484972155583, -82.52647862202322 35.548540215588254, -82.52652562202799 35.548560215597135, -82.52677262205302 35.54866421564372, -82.5269806220724 35.548762215684945, -82.52707362208277 35.548795215701254, -82.52714762209088 35.548822215714395, -82.52715362209176 35.548823215715146, -82.5272796221089 35.548847215732984, -82.52751062214513 35.548861215759516, -82.52796762221888 35.548874215809036, -82.5280536222347 35.54886421581586, -82.52819662226048 35.54885021582777, -82.52838062229506 35.548824215841265, -82.52860462233834 35.5487842158561, -82.52927862246834 35.54866521590112, -82.5293356224794 35.54865521590499, -82.52950462251096 35.548632215917586, -82.52970862254628 35.54862221593648, -82.52971562254761 35.54862121593705, -82.53011262261384 35.548618215977164, -82.53025262264094 35.54859321598644, -82.5303416226614 35.548556215988015, -82.53038162267046 35.54854021598894, -82.53053162270733 35.548462215988444, -82.5305526227125 35.54845121598835, -82.53079362276866 35.54834621599178, -82.53095362280392 35.54828921599653, -82.53112062284032 35.54823221600206, -82.53164662295384 35.548061216021296, -82.53220962307734 35.54786521603916, -82.53225162308661 35.547850216040416, -82.53268662318048 35.54770921605644, -82.53282162320956 35.54766521606133, -82.53303962325758 35.547588216068036, -82.53384262343377 35.54730821609349, -82.53409762348882 35.547225216102724, -82.53430662353355 35.54715921611077, -82.53445562356441 35.547119216117984, -82.5345086235488 35.54727821615576, -82.53457462353012 35.547471216201764, -82.53460262352202 35.5475542162215, -82.53475462348696 35.54794621631689, -82.53494562346646 35.54828621640571, -82.53506862345893 35.54846721645514, -82.5352186234499 35.54868821651553, -82.53528162344729 35.54877321653922, -82.53546762343981 35.54902221660895, -82.53584162342507 35.54952221674912, -82.53602962341812 35.549770216818864, -82.53616862341318 35.54995221687015, -82.5362156234104 35.550021216888986, -82.53633062340403 35.55018721693459, -82.53640562340121 35.55028621696247, -82.53650662339746 35.55041921699988, -82.5369906233776 35.551071217182226, -82.53718562336961 35.55133321725554, -82.53722962336792 35.55139221727209, -82.53736462336256 35.55157221732257, -82.53740962336089 35.551632217339346, -82.53758362335574 35.55185321740221, -82.53763462335515 35.55191221741946, -82.53781762335306 35.55212321748113, -82.53823962335709 35.552552217611776, -82.53835962335236 35.55271221765661, -82.53838262335147 35.5527432176653, -82.53844662335032 35.552820217687575, -82.53851962335227 35.55288621770848, -82.53859662335009 35.552983217736106, -82.5386576233433 35.55309321776472, -82.5387376233343 35.553238217802495, -82.5387536233309 35.55327721781206, -82.53881462331972 35.55341621784654, -82.5388786232731 35.55378821792884, -82.53888762324587 35.55397521796785, -82.53887662321961 35.55413421799906, -82.53886062319764 35.55426021802303, -82.5388516231903 35.554298218029885, -82.53879262314624 35.554521218069176, -82.53876862313324 35.5545802180787, -82.5385936230393 35.555002218146676, -82.53843262295244 35.55539321820968, -82.53834862290655 35.55560121824337, -82.53822862284426 35.555877218287215, -82.53814962279853 35.55608921832222, -82.53810162276768 35.556238218347595, -82.53809362276048 35.55627621835451, -82.53808462275057 35.55633121836484, -82.53806462272247 35.55649221839549, -82.53804962268815 35.556699218436094, -82.53805062268337 35.55673121844276, -82.53805262266891 35.556828218462684, -82.53805662264936 35.556959218489766, -82.53808462262978 35.55711721852475, -82.5380936226242 35.55716321853502, -82.5381086226191 35.55721221854649, -82.53818062259263 35.55746221860481, -82.53819362258645 35.5575162186171, -82.53820462258187 35.5575582186268, -82.53824562257053 35.55767621865502, -82.53826462256536 35.55773021866796, -82.53831162255213 35.55786721870062, -82.53834662254286 35.55796521872417, -82.53840062252421 35.55814421876619, -82.53844262250983 35.55828321879872, -82.53845262250663 35.55831521880632, -82.53849362249724 35.55842021883189, -82.53840162248508 35.55840021881835, -82.53380762185543 35.55753921817156, -82.53365462183224 35.557525218152946, -82.53331562178056 35.557495218112095, -82.53319862176285 35.5574842180978, -82.53304762173987 35.55747121807967, -82.53278862170052 35.55744721804824, -82.53229762162577 35.55740421798908, -82.53201462158263 35.55737921795491, -82.53175662154324 35.557357217923936, -82.53107262143885 35.55729821784172, -82.53068362137947 35.557265217795084, -82.52902462112688 35.55711821759484, -82.52898362112055 35.55711521759005, -82.52868062107387 35.55709221755424, -82.52834162102218 35.55706221751336, -82.52758362090685 35.55699521742183, -82.5253126205612 35.556794217147846, -82.52487262049415 35.55675521709476, -82.52455662044608 35.5567272170566, -82.52453762044674 35.55670221704957, -82.52448462044953 35.55662721702884, -82.52442862045724 35.5565162170005, -82.52430762047076 35.55629821694373, -82.52430062047159 35.55628521694036, -82.5242346204806 35.556155216907115, -82.52419262049436 35.556020216875375, -82.52412962051028 35.55584921683414, -82.52409562053082 35.555679216796065, -82.52406462055438 35.55549221675483, -82.52404362057767 35.555318216717296, -82.52403462059554 35.55519221669071, -82.52404562062209 35.55503121665905, -82.5240836206642 35.55479821661552, -82.52414462073055 35.5544322165474, -82.52418062075726 35.554297216523594, -82.52426062081652 35.55399821647096, -82.52428362083344 35.553913216456024, -82.52431362085196 35.55382521644125, -82.52450162099429 35.553102216313434, -82.52457962105319 35.5528032162606, -82.5247036211521 35.5522932161696, -82.52474062118085 35.552146216143484, -82.52494862132875 35.55140821601468, -82.52508062140582 35.551049215955175, -82.52515762145919 35.550785215909364, -82.52524962152191 35.55047621585596, -82.52528362155816 35.55027721581902, -82.52529662157156 35.55020421580548, -82.52530362158608 35.55011721578852, -82.52534762166735 35.54963621569513, -82.52536362169451 35.54947621566424, -82.52536962170532 35.549412215651884, -82.5253866217372 35.54922321561512, -82.52539362174797 35.54916121560324)))",6170,37,021,002000,370210020004,1488,1488,47,1436,759,650,5,9,0,13,52,1182,38,1144,1154,641,492,4,7,0,10,28,735,661,74
census_2010_blockgroups_view.fid--2dc29038_13ec899ba8f_-2641,"MULTIPOLYGON (((-82.54821759919274 35.71987525269599, -82.54823659919823 35.719860252694886, -82.54829459921426 35.719819252692474, -82.54831459921971 35.71980525269174, -82.5483745992364 35.719762252689165, -82.54867959931076 35.719609252689445, -82.54871259931905 35.719591252689185, -82.54894559937682 35.71946825268812, -82.5491285994246 35.719356252684136, -82.54937459949404 35.71917225267205, -82.54958259955545 35.71899925265825, -82.5498045996239 35.71879525263959, -82.54984159963509 35.71876325263685, -82.54998259968353 35.71860125261845, -82.55009759972596 35.71845125259974, -82.55017259975365 35.71835325258752, -82.55021359976867 35.718300252580896, -82.55040759983697 35.71806725255347, -82.55041259983854 35.718062252552976, -82.55048059986464 35.71796725254063, -82.5505785999019 35.717831252523006, -82.55059259990816 35.71780625251941, -82.55072659996641 35.717574252485946, -82.55089560003668 35.71730225244799, -82.55099960007966 35.717136252424886, -82.55104860009986 35.71705825241405, -82.55112760013313 35.716928252395746, -82.55119060015971 35.71682425238107, -82.55123860017976 35.71674625237008, -82.55129860020527 35.716646252355936, -82.55131560021225 35.71661925235221, -82.55139960025336 35.716444252325225, -82.55143860027768 35.71632925230583, -82.55147760030107 35.7162202522876, -82.5515936003057 35.71631425231878, -82.55178260032181 35.716413252358386, -82.5519576003399 35.716484252390856, -82.55203860034997 35.71650625240374, -82.5521626003732 35.716489252413, -82.55224760038894 35.71647925241973, -82.55238860041328 35.716473252433005, -82.55279960050362 35.7163312524465, -82.55300860053929 35.71632525246675, -82.55314360055755 35.716352252486146, -82.55327760056278 35.71646225252239, -82.5533316005581 35.716550252545844, -82.55343260055868 35.71665525257768, -82.55350760056434 35.716699252594346, -82.5536216005679 35.71679825262627, -82.5539186005876 35.7169902526959, -82.55411960059516 35.717157252750674, -82.55424860059983 35.71726525278596, -82.55450460061435 35.71744625284912, -82.55458560062178 35.71748525286541, -82.55473360062777 35.717605252905095, -82.55484160064923 35.71758325291179, -82.55498260067259 35.71758325292628, -82.55507360068539 35.71759825293878, -82.55518460070105 35.71761625295382, -82.55554160074762 35.71769925300751, -82.55578460077604 35.71777625304823, -82.55604860079794 35.71791825310431, -82.55626360081575 35.718034253150094, -82.5563466008207 35.71809125317026, -82.55643860082611 35.718155253192755, -82.55663360084154 35.71826525323534, -82.5567366008468 35.718341253261364, -82.55725360087392 35.71872125339199, -82.55740160087974 35.71884225343191, -82.55779960088447 35.719239253553816, -82.55790760088573 35.71934725358685, -82.5579346008817 35.71940225360087, -82.55800160088086 35.719479253623405, -82.55806360087018 35.71961525365746, -82.55809860086414 35.719691253676636, -82.55820360084631 35.71991925373392, -82.55823860084035 35.71999525375294, -82.5579706007154 35.720514253831, -82.55716860034026 35.7220742540661, -82.55690260021544 35.72259425414453, -82.5565206000364 35.72334025425714, -82.556249599909 35.7238712543374, -82.55601559979374 35.72436425441357, -82.55582659969488 35.72479925448275, -82.55566259960474 35.72520525454843, -82.55550759951184 35.72563825462069, -82.55547659949299 35.725726254635376, -82.55523959934402 35.72643325475499, -82.55537059934196 35.72658725479987, -82.55540059934148 35.72662225481002, -82.55562959933793 35.72689125488849, -82.55576259933505 35.72705225493493, -82.55589259933252 35.72720825498003, -82.55595559932952 35.72729525500428, -82.55607459932358 35.727461255050336, -82.5561305993166 35.72756625507748, -82.55618259931039 35.727662255102416, -82.55623959930328 35.72776925513005, -82.55625259929992 35.72780425513854, -82.55633059928041 35.728014255189365, -82.5563885992518 35.72826125524567, -82.55639459924915 35.728284255250934, -82.55640959923078 35.72841925527996, -82.55642259921459 35.72853725530533, -82.55642659921003 35.72857125531266, -82.5564225992012 35.728624255323055, -82.55640559915727 35.72888925537527, -82.55640459915648 35.72889325537603, -82.55638259913465 35.729010255397505, -82.55635359910859 35.72914725542244, -82.55635459910806 35.729152255423585, -82.55631159907418 35.72932425545414, -82.55628159905028 35.72944625547592, -82.55614559896802 35.72983125554032, -82.55608659893223 35.72999925556841, -82.55603459890068 35.73014625559299, -82.55602459889523 35.73017125559704, -82.55583859878446 35.730686255682755, -82.55577759874765 35.73085825571152, -82.55570159870275 35.731066255746, -82.55547559856801 35.73169325585045, -82.55540059852297 35.73190325588548, -82.55533759848545 35.7320772559144, -82.55514859837334 35.73259825600101, -82.55508659833579 35.73277325603028, -82.55502259829777 35.732950256059716, -82.55497559827023 35.733077256080776, -82.55464159807329 35.73398925623199, -82.55453159800769 35.73429425628282, -82.55448659798266 35.73440725630116, -82.55446559797225 35.734452256308195, -82.55438559793153 35.73462925633594, -82.55428059788701 35.73480325636058, -82.55421059786053 35.73489925637298, -82.55411059782224 35.73503925639116, -82.55410459779955 35.73517925641902, -82.55402959773926 35.735487256474016, -82.55397359769712 35.73569925651147, -82.55394059767171 35.735827256534094, -82.55390459762346 35.73610025658598, -82.55390559757457 35.736416256650436, -82.55395759752506 35.73679125673213, -82.55411459740917 35.73770725693485, -82.55412359740318 35.7377552569456, -82.55418059738513 35.73793325698768, -82.55424959737141 35.738095257027794, -82.55437659735645 35.73832825708831, -82.55447559734502 35.73850825713522, -82.55455259733294 35.73866825717575, -82.55459859732017 35.7388002572073, -82.55459859731984 35.73880225720771, -82.55462059730381 35.73892925723587, -82.55463259728563 35.73905925726362, -82.55463359725724 35.73924325730121, -82.55460959716277 35.73982725741763, -82.55457159707191 35.74037225752474, -82.5545705970691 35.740389257528065, -82.5545405970416 35.740534257554515, -82.55445059697254 35.74088325761625, -82.5544625969522 35.741027257646806, -82.55450059693815 35.74115825767742, -82.55454059692917 35.74125925770212, -82.55457959692637 35.74131925771834, -82.55461959692659 35.74136025773081, -82.55466259692956 35.741387257740776, -82.55470959693464 35.741405257749285, -82.5547245969366 35.74140825775145, -82.55476059694138 35.74141625775677, -82.55486459695697 35.741427257769764, -82.55538459703934 35.74145425782888, -82.55553259706137 35.74147025784737, -82.55566259707852 35.74149925786664, -82.55578559709299 35.741538257887306, -82.55593059710492 35.741616257918075, -82.5561205971134 35.741765257968034, -82.55632159711908 35.74194425802523, -82.55644059712324 35.74204525805804, -82.55679659713567 35.74234725815629, -82.55692659714047 35.74245525819167, -82.55695759714159 35.74248125820012, -82.5570535971455 35.742559258225924, -82.5570855971466 35.742586258234766, -82.5571635971495 35.74265125825601, -82.55724059715241 35.74271525827693, -82.55739059715579 35.74285425832072, -82.55746559715757 35.74292325834254, -82.55742359714903 35.74293325834023, -82.55712459708143 35.74304825833288, -82.5567685969951 35.7432232583318, -82.55658959695138 35.74331325833164, -82.55634559689413 35.74342025832827, -82.55607859683411 35.74352125832135, -82.5557845967709 35.74361325830975, -82.55503059660708 35.74386125828258, -82.5546305965182 35.74400525827062, -82.5539165963594 35.74426325824957, -82.5538995963558 35.744268258248795, -82.55384859634455 35.74428625824718, -82.55383259634094 35.74429225824677, -82.55398159636474 35.74429825826337, -82.55420059639083 35.74436525829963, -82.554301596402 35.744401258317325, -82.55436459640813 35.744429258329575, -82.55444859641267 35.74449025835065, -82.55451159641511 35.744542258367716, -82.55459459641342 35.74464225839662, -82.55472059641528 35.74476525843468, -82.55484759641965 35.74487325846974, -82.55488559642002 35.74491125848141, -82.55497959642099 35.74500625851043, -82.55505659641932 35.745099258537344, -82.5551485964128 35.745240258575556, -82.5552315963997 35.74541325861933, -82.55533659636502 35.74574925869858, -82.55537559636235 35.745808258714646, -82.55549859636152 35.74594625875545, -82.55590159636401 35.746362258881646, -82.55617059636836 35.74662225896233, -82.5563615963741 35.74679025901622, -82.5568025963832 35.74720425914598, -82.5570115963902 35.74738325920406, -82.55708059639485 35.74742725922013, -82.55717759640386 35.747473259239484, -82.55744659643278 35.747575259288006, -82.55746059643448 35.74757925929021, -82.55774159646676 35.747672259338145, -82.55796259649654 35.74771725937007, -82.55827059654156 35.74775725940999, -82.55839759655868 35.7477832594284, -82.55847959656799 35.74781125944253, -82.55853359657203 35.74784325945466, -82.55857459657216 35.74788625946759, -82.55859959656807 35.74793925948097, -82.55860059656237 35.74797725948889, -82.55860159655798 35.74800625949488, -82.55859759655041 35.748051259503626, -82.55859559654634 35.74807525950825, -82.55856259651743 35.74822625953565, -82.55854759650809 35.74827025954302, -82.55852459649307 35.74834225955536, -82.55870559651525 35.74839325958436, -82.55924959658186 35.74854725967184, -82.55943159660414 35.748599259701194, -82.55969559663498 35.74868325974549, -82.55975259664164 35.74870125975505, -82.56000959667388 35.748769259795374, -82.56016059669103 35.748820259821386, -82.5602605967007 35.74886525984082, -82.56046659671851 35.74897125988366, -82.56047159671887 35.748974259884754, -82.56071059673661 35.74911625993839, -82.5607435967392 35.74913525994559, -82.56095259675519 35.74925625999181, -82.56105259676235 35.74931726001455, -82.5610965967655 35.74934426002454, -82.56153759679997 35.74959526012115, -82.56176659681772 35.74972626017143, -82.56208559684192 35.74991226024223, -82.56234859686177 35.7500662603007, -82.56243059686841 35.750111260318306, -82.5625375968771 35.75017026034135, -82.56269959688832 35.75027126037863, -82.56277559689423 35.750315260395446, -82.56309059691769 35.750501260465796, -82.56361459695476 35.750824260585624, -82.56375459696476 35.75091026061759, -82.56380459696813 35.75094226062919, -82.56395459697822 35.75103726066403, -82.56414659699212 35.75115426070768, -82.5642765970001 35.75124226073906, -82.56432959700284 35.751281260752414, -82.56442759700779 35.7513542607774, -82.56460059701303 35.75150626082617, -82.5647475970137 35.75165926087254, -82.56481559701217 35.75174226089642, -82.56486059701125 35.751796260912066, -82.5649595970094 35.751914260946265, -82.56498359700946 35.7519392609539, -82.56505859701 35.75201726097745, -82.56508459701021 35.75204326098549, -82.56510959701036 35.75206926099334, -82.56512159701032 35.75208226099726, -82.56519159701261 35.75214226101661, -82.5652195970136 35.75216626102446, -82.5655825970255 35.75247926112559, -82.56561659702662 35.75250826113505, -82.56562159702666 35.752513261136535, -82.56574159703004 35.75262026117069, -82.56577959703104 35.75265426118153, -82.5658175970295 35.75270526119586, -82.56588159702703 35.75278926121959, -82.56592359701868 35.75288826124408, -82.56593759700974 35.75296126126041, -82.56595059699139 35.753093261288576, -82.56593859693865 35.75342026135394, -82.56591059687172 35.75382126143279, -82.56589559684723 35.75396326146015, -82.56589259684212 35.753993261465936, -82.56585759681191 35.75415026149438, -82.56580059677789 35.754308261520634, -82.56573559674341 35.75446126154512, -82.56572159673567 35.75449526155057, -82.56562859669091 35.75468426157948, -82.56537059657633 35.75514626164698, -82.56528959654283 35.75527526166491, -82.56496359640741 35.75579826173786, -82.56462559626924 35.7563262618105, -82.5645275962278 35.7564882618334, -82.56447659620112 35.75660526185197, -82.56443659616872 35.756771261881674, -82.56444259615027 35.75689626190778, -82.564459596135 35.757013261933366, -82.56449159612586 35.757106261955556, -82.5645545961145 35.75724726199076, -82.56470059609718 35.75751526206046, -82.56483359608599 35.75773026211795, -82.56505059606728 35.75808326221225, -82.56533559604814 35.75851226232893, -82.56521859602087 35.75856226232712, -82.56517959601152 35.75858026232675, -82.56488559593612 35.758751262331295, -82.56477659590794 35.75881626233326, -82.56462859587165 35.75889126233329, -82.56450459584296 35.75894326233104, -82.56443259582718 35.75896726232855, -82.5643775958162 35.758979262325326, -82.56429059579825 35.75900126232077, -82.56417759577624 35.759022262313465, -82.56406359575543 35.75903426230412, -82.56395059573613 35.75903726229308, -82.56353359566566 35.759044262251564, -82.56334159563556 35.75903226222928, -82.5632375956214 35.759012262214505, -82.563107595606 35.75897226219295, -82.56309659560488 35.75896726219074, -82.56291059558673 35.75888526215497, -82.56270959557007 35.75877726211216, -82.56252959555492 35.75868126207402, -82.56239059553795 35.758642262051744, -82.56230559552627 35.75862626203973, -82.56224059551612 35.7586222620322, -82.56211559549509 35.75862326201953, -82.56211259549461 35.75862326201924, -82.56180559543917 35.75865126199325, -82.56157459539622 35.75868026197538, -82.56138659535954 35.75871526196315, -82.56130159534105 35.758743261960035, -82.56123359532428 35.75877826196012, -82.561171595306 35.75882926196412, -82.56111959528855 35.758886261970396, -82.5610695952675 35.75896826198196, -82.56102659524421 35.75907226199863, -82.56089759515957 35.75947926206825, -82.560844595127 35.75963226209397, -82.56083259512083 35.75965926209827, -82.56071859505948 35.759932262142094, -82.56064259502416 35.760078262163965, -82.56055859498771 35.76022326218484, -82.56052959497524 35.76027226219183, -82.56046859495174 35.760358262203056, -82.56042559493666 35.76040926220899, -82.560415594933 35.7604222622106, -82.56032459490307 35.760517262220624, -82.5602595948847 35.76056626222389, -82.56014559485473 35.760637262226595, -82.56007759483812 35.76067126222652, -82.55994459480803 35.760722262223155, -82.55984359478711 35.76074926221828, -82.55982159478233 35.76075626221741, -82.55971259476124 35.76077526221004, -82.55961859474392 35.760786262202565, -82.55958859473826 35.76079026220027, -82.55950459472419 35.76079126219189, -82.55944859471549 35.760787262185296, -82.55938159470571 35.76077826217648, -82.55928059469076 35.76076626216365, -82.55910459466847 35.76072126213636, -82.55869859462135 35.7605892620676, -82.55869659462118 35.76058826206718, -82.55846959459399 35.76052026202991, -82.5584115945872 35.760502262020225, -82.55832359457547 35.76048326200732, -82.55828259456982 35.760475262001464, -82.55791459451723 35.760420261952326, -82.5578775945115 35.7604172619479, -82.55772759448814 35.7604072619304, -82.55742259443893 35.76039726189687, -82.55679159432724 35.76044026184052, -82.55670559431206 35.760446261832904, -82.5549085939943 35.760567261672236, -82.55474059396417 35.76058126165774, -82.55460359394148 35.76058026164341, -82.55452659392914 35.760577261634836, -82.55439259390825 35.760568261619255, -82.55415759387287 35.760544261590105, -82.55398659384791 35.76052226156798, -82.55365559379938 35.76048026152528, -82.55322059373276 35.76044326147293, -82.55305359370456 35.76044526145604, -82.55276959365858 35.760437261425174, -82.55265059363903 35.76043626141265, -82.55196759352557 35.760435261342025, -82.55163059347227 35.76041726130363, -82.55144259344392 35.76039826128034, -82.55123659341277 35.76037826125501, -82.55104259338482 35.760350261229284, -82.5510115933805 35.760345261225055, -82.55092059336768 35.76033026121261, -82.55089059336328 35.760326261208704, -82.55087459336094 35.7603242612067, -82.5507425933407 35.76031326119083, -82.55056759331625 35.76028326116667, -82.55047759330324 35.76027026115476, -82.55014759325572 35.76022326111109, -82.54985759321595 35.760168261069964, -82.54974559320175 35.76014026105271, -82.54954959318086 35.76006426101706, -82.54942059316828 35.760007260992154, -82.54929959315812 35.75994326096667, -82.54928559315718 35.75993426096341, -82.5490255931383 35.75977726090457, -82.54893459313324 35.75971226088201, -82.54886059312867 35.75966226086413, -82.548785593124 35.759612260846204, -82.5486405931157 35.75951026081044, -82.54856859311161 35.759459260792724, -82.54848059310596 35.75940126077181, -82.54821759308923 35.75922726070924, -82.54820859308875 35.75922126070706, -82.54812759308267 35.75917326068893, -82.54804359307644 35.759123260670066, -82.54787959306177 35.75904226063673, -82.54771259304576 35.758966260604005, -82.54758959303324 35.75891526058095, -82.54756859303104 35.75890726057714, -82.54741259301345 35.75885326055002, -82.54714459298009 35.758781260507746, -82.54698359295885 35.758745260483764, -82.5468355929386 35.7587172604628, -82.54666759291456 35.75869226044043, -82.54652659289343 35.75867726042278, -82.54625059284876 35.75866926039273, -82.54594059279664 35.758672260361394, -82.54583159277817 35.75867526035072, -82.54573759276205 35.758678260341604, -82.54550759272179 35.75869126032053, -82.5452365926754 35.75869926029423, -82.54514959266051 35.75870226028586, -82.54493159262312 35.75870926026484, -82.5442785925115 35.75872926020154, -82.54406159247411 35.758737260180794, -82.54402459246786 35.7587382601772, -82.54391359244876 35.75874226016655, -82.54387759244244 35.75874426016316, -82.54374059241908 35.75874826014994, -82.54341059236206 35.75876126011859, -82.54332959234836 35.75876326011058, -82.54319359232477 35.75876926009776, -82.54315959231909 35.75876926009423, -82.54305859230172 35.75877326008463, -82.54302559229589 35.75877526008162, -82.54300659229268 35.75877526007968, -82.5429505922829 35.758778260074486, -82.54293259227981 35.75877926007284, -82.54285259226616 35.75878126006506, -82.54261459222526 35.758790260042325, -82.54253559221159 35.758793260034814, -82.54225259216295 35.75880326000765, -82.54221159215592 35.758805260003776, -82.54184059209295 35.75881325996718, -82.54153659204006 35.75882825993884, -82.54140359201766 35.758830259925574, -82.54112159196967 35.75883725989787, -82.54040059184543 35.75886525982923, -82.54034859183658 35.75886625982404, -82.54023259181653 35.758871259813105, -82.53986459175235 35.75889025977902, -82.53956659170034 35.75890625975151, -82.53936759166413 35.75892625973506, -82.53929759165142 35.758933259729325, -82.53863359152858 35.75901325967714, -82.5383245914699 35.75906025965477, -82.53804459141527 35.75911225963647, -82.53767459134295 35.759181259612355, -82.53728659126598 35.75926125958862, -82.53665359114015 35.75939425955042, -82.53643059109565 35.75944225953715, -82.53607659102569 35.75951325951513, -82.53567459094552 35.75959925949119, -82.53530259087043 35.75968425947007, -82.534754590762 35.75979625943635, -82.53468959074895 35.7598102594325, -82.53412259063538 35.7599342593993, -82.53393959059912 35.75997225938811, -82.53385859058298 35.75998925938326, -82.53360359052988 35.760058259370936, -82.53340059048631 35.76012125936287, -82.53336259047812 35.760133259361375, -82.53322559044742 35.76018425935759, -82.53314759042998 35.76021325935552, -82.53311259042194 35.760227259354714, -82.5329225903761 35.76031925935392, -82.53284859035809 35.76035625935376, -82.53268759031897 35.76043525935321, -82.53257659028964 35.76050525935607, -82.53246359025992 35.760576259358864, -82.53228259020882 35.76071125936763, -82.53210559015372 35.76087625938298, -82.53205659013828 35.76092325938755, -82.53195659010703 35.761017259396304, -82.53174059003248 35.76126625942474, -82.53156658996986 35.761483259450955, -82.53134858988902 35.76177025948689, -82.53112758980986 35.7620432595197, -82.5309455897478 35.76224825954261, -82.53077458969297 35.76241825955962, -82.5305585896269 35.76261225957687, -82.53036358956959 35.762772259589326, -82.53023558953454 35.762861259594246, -82.53016058951383 35.76291425959727, -82.52992558945158 35.76306325960335, -82.52964458937991 35.76322425960709, -82.52945358933182 35.76332925960882, -82.52930158929371 35.763412259609986, -82.5284195890723 35.763893259616964, -82.5283105890452 35.763951259617485, -82.5279845889638 35.76412625961948, -82.52787658893662 35.76418525962032, -82.52775358890592 35.7642512596211, -82.52745958883217 35.764411259623344, -82.52738658881405 35.76445025962374, -82.52726558878334 35.76451825962511, -82.52713358875039 35.76458925962602, -82.52673858865133 35.76480425962894, -82.5266075886183 35.76487625963009, -82.52612658849765 35.765138259633844, -82.52526858828226 35.76560625964059, -82.52468258813563 35.76592325964463, -82.52420158801512 35.76618425964811, -82.52415958800478 35.76620625964829, -82.52403658797381 35.766273259649196, -82.52399558796344 35.76629625964971, -82.52391158794256 35.76634125965024, -82.52366158788 35.766476259651874, -82.52357858785903 35.76652225965264, -82.52345158782732 35.76659025965342, -82.52307358773253 35.76679625965638, -82.52294758770068 35.76686625965753, -82.52258858761056 35.76706225966041, -82.5225835876094 35.767064259660366, -82.52218058750682 35.767293259665365, -82.52191458743557 35.76746725967335, -82.52171358737868 35.76761825968335, -82.5215545873313 35.76775325969437, -82.5215145873192 35.76778825969747, -82.52134158726444 35.76795525971354, -82.52125858723716 35.76804225972268, -82.52120358721916 35.7680992597286, -82.52093958712882 35.768398259762265, -82.52064558702779 35.76873425980026, -82.52043858695505 35.76898025982904, -82.52040458694304 35.76902125983388, -82.5202655868959 35.76917625985109, -82.52017158686408 35.76928025986257, -82.52006658683001 35.769387259873525, -82.52000158680897 35.76945325988022, -82.51998558680414 35.76946725988145, -82.5198205867528 35.76962125989572, -82.5196245866966 35.76977325990647, -82.51962158669576 35.769775259906524, -82.51941858664098 35.769910259913075, -82.51933758662067 35.76995425991371, -82.51922458659192 35.77001825991505, -82.51902058654237 35.77011925991454, -82.51875558648243 35.77022125990797, -82.5184965864264 35.770305259898294, -82.5184045864078 35.770326259893125, -82.51825558637726 35.77036325988527, -82.51807658634269 35.77039425987315, -82.5180435863364 35.770399259870686, -82.51802558633281 35.770403259869646, -82.51794658631827 35.770412259863356, -82.51791458631236 35.77041625986084, -82.51778658628889 35.77043025985048, -82.517697586273 35.77043725984279, -82.51756158624866 35.77044825983094, -82.5172195861899 35.77046125979828, -82.51704558616048 35.77046425978094, -82.51682858612358 35.77046925975961, -82.51657358608054 35.77047325973403, -82.51581158595177 35.77048725965823, -82.5155585859087 35.77049325963338, -82.51483458578657 35.770505259561084, -82.51384458561918 35.77052325946252, -82.51359558557901 35.770515259435214, -82.51326358552741 35.77049225939627, -82.51300258548886 35.770461259363, -82.51267058544238 35.77040525931734, -82.51266858544201 35.770405259317144, -82.51196558535035 35.770243259211576, -82.51154358529723 35.77013325914568, -82.51127058526275 35.770063259103324, -82.5109155852162 35.769983259050356, -82.51061658517509 35.76992825900829, -82.51032758513273 35.7698912589709, -82.51026358512277 35.769887258963514, -82.51002958508585 35.76987425893672, -82.5098295850519 35.76987925891705, -82.50979458506116 35.769782258893656, -82.50971558507457 35.76961125885072, -82.5096355850908 35.769421258803845, -82.50956158510606 35.769244258760125, -82.50951658511033 35.76916825874011, -82.50947058511285 35.76910325872199, -82.50938858511383 35.76900925869447, -82.50922858511377 35.76883825864318, -82.50906358511247 35.7686702585919, -82.50869358511153 35.7682802584743, -82.50842758511091 35.76800025838988, -82.50834358510792 35.76792925836677, -82.5083285851075 35.76791625836253, -82.50826058510162 35.76788125834844, -82.50820458509665 35.767853258336935, -82.50803458507534 35.76780825831021, -82.5079885850678 35.76780725830528, -82.50789358505232 35.767805258295084, -82.50785958504696 35.76780425829131, -82.50777558503006 35.76782325828659, -82.50770958501676 35.767838258282794, -82.50759158498718 35.76790225828363, -82.5074995849583 35.76798925829181, -82.50748158495126 35.76801525829525, -82.50742358492813 35.76810225830698, -82.50741758492498 35.768116258309206, -82.50740958492115 35.76813225831166, -82.50740258491699 35.76815125831482, -82.5073945849105 35.76818525832089, -82.50739058490677 35.76820425832436, -82.50699558484959 35.768150258272634, -82.50648158477365 35.76808925820708, -82.5062835847443 35.768066258181975, -82.5055375846302 35.76800225809197, -82.50524458458635 35.76797125805545, -82.50492458453985 35.76792825801367, -82.50461658449692 35.76787525797102, -82.50379558438782 35.76769925785043, -82.50376758438424 35.76769225784614, -82.50333858432788 35.76759625778229, -82.50296758428087 35.76750225772488, -82.50287958427045 35.76747525771031, -82.5027005842491 35.76742125768089, -82.50242258421801 35.76732425763239, -82.5022335841988 35.76724525759684, -82.50206858418666 35.76714725755987, -82.5019685841834 35.76706125753203, -82.50186358418438 35.76694225749699, -82.50181058418644 35.76687225747729, -82.50147558419987 35.766428257352295, -82.50138358420133 35.766320257320814, -82.50127358419925 35.766216257288335, -82.50091558418508 35.765924257191934, -82.50042258416407 35.765532257061224, -82.49969358412916 35.76497725687309, -82.49954358412263 35.76485925683354, -82.49935458411714 35.76469225678001, -82.49918358411395 35.76453025672942, -82.49903858411346 35.76437825668349, -82.49902558411348 35.7643642566793, -82.49898358411424 35.76431425666477, -82.49889858411535 35.76421625663608, -82.49878758412022 35.764066256594056, -82.49869758412825 35.763918256554675, -82.49862358413883 35.763771256517124, -82.498578584154 35.7636252564828, -82.49855758417165 35.76348925645294, -82.49855658419176 35.763359256426384, -82.49857058421175 35.7632452564046, -82.49857658422157 35.76318825639359, -82.49856858423273 35.76310825637654, -82.49854558423709 35.763055256363344, -82.49849958423954 35.762990256345425, -82.49840058423383 35.76292125632114, -82.4982475842203 35.76284525628983, -82.49813358421727 35.762742256257184, -82.49807258421794 35.76267325623676, -82.49801158421833 35.762605256216695, -82.49793558421645 35.76253625619477, -82.49784858420867 35.762493256177, -82.4977745841985 35.76247925616651, -82.49767558418506 35.76246025615245, -82.49754358416568 35.7624432561354, -82.49748858415764 35.762436256128254, -82.49736558413719 35.76243625611559, -82.49726558411751 35.76245625610934, -82.4970735840754 35.762522256102955, -82.49695358404983 35.7625582560979, -82.49685458403135 35.76257125609036, -82.49676358401607 35.76257225608116, -82.49666758400308 35.762553256067314, -82.49654758399156 35.76249925604397, -82.49622658397705 35.76224925595996, -82.49613158397011 35.76219225593856, -82.49603258395851 35.76216125592203, -82.4958295839282 35.76213925589658, -82.49555458388714 35.7621092558621, -82.49543258386642 35.76211225585018, -82.49522658382564 35.762154255837366, -82.49508958379879 35.76218125582878, -82.49479158374328 35.76221925580574, -82.49468558372509 35.76222325579559, -82.49461658371241 35.762231255790155, -82.49454058370036 35.76222725578148, -82.4944635836882 35.76222325577268, -82.49431158366825 35.76218925575008, -82.49425758366218 35.76217025574066, -82.49410558364596 35.76211225571315, -82.49390658361882 35.762074255684894, -82.49370858358697 35.762067255663, -82.49360958357305 35.7620512556495, -82.49344958355177 35.762017255626134, -82.49311358351655 35.76188425556435, -82.49282358348506 35.761777255512676, -82.49260258346031 35.76170025547412, -82.4922745834294 35.76154825540932, -82.4921525834115 35.761533255393694, -82.49199158338664 35.761521255374646, -82.49196358338146 35.761524255372386, -82.4918255833561 35.761540255361375, -82.49176558334315 35.761559255359046, -82.491686583326 35.7615852553562, -82.49158758329742 35.761663255361874, -82.49135858322227 35.76190225538686, -82.49127258319382 35.76199325539649, -82.49120358316854 35.762082255407485, -82.49113158314397 35.76216325541652, -82.49104058311545 35.76224925542465, -82.49093558308607 35.762326255429485, -82.49079958305104 35.762406255431735, -82.49056358299434 35.7625192554303, -82.49034958294159 35.76262925543057, -82.49017958290061 35.762711255429764, -82.49002958286266 35.76279525543136, -82.48995158284276 35.76284025543253, -82.48971758277808 35.763006255442114, -82.48959058274112 35.76310825544971, -82.48957358273636 35.76312125545067, -82.48952858272229 35.76316325545457, -82.48946458270218 35.763224255460365, -82.48936058266611 35.763345255474285, -82.48930758264733 35.76340925548175, -82.48929758264389 35.763421255483145, -82.48907558256792 35.76367225551134, -82.48889258250077 35.76390825554053, -82.48874558244846 35.764088255561994, -82.48867858242103 35.76419325557645, -82.488673582418 35.764207255578775, -82.48863858239417 35.76432325559873, -82.48860558235961 35.764510255633425, -82.48857058233496 35.76463125565436, -82.48852358230869 35.76475025567377, -82.48845858227895 35.76487225569189, -82.48832858223408 35.76502225570904, -82.48821358219811 35.76513025571908, -82.48810158216867 35.76520025572173, -82.48795058213028 35.76528525572346, -82.48773958207946 35.765387255722445, -82.48751358202595 35.76549025572004, -82.48717358194706 35.7656342557143, -82.48697958189912 35.76573525571478, -82.48658158179913 35.76595325571811, -82.48643058176005 35.766043255720746, -82.48633858173606 35.766099255722736, -82.48620458170043 35.76618525572634, -82.48609158166818 35.766272255732375, -82.48600358164019 35.76635825574082, -82.48589558160204 35.76648825575612, -82.48581358157107 35.76659925577022, -82.48573958154178 35.76670925578501, -82.48570758153059 35.766747255789404, -82.48568158152158 35.76677725579285, -82.48561958150395 35.766824255795946, -82.485517581482 35.76685625579202, -82.4853885814584 35.76687025578147, -82.48525958143689 35.76687125576841, -82.48516058141898 35.76688025575997, -82.48513158141247 35.766891255759234, -82.48507758140026 35.76691225575791, -82.4849125813579 35.76700825576043, -82.48472258130641 35.767136255766886, -82.48447658122906 35.76737125578928, -82.48440658120933 35.7674232557926, -82.48431858118757 35.767469255792925, -82.48420258116144 35.767513255789915, -82.48402758112414 35.767566255782654, -82.48369758105846 35.76763625576277, -82.48358058103652 35.76765225575394, -82.48350858102302 35.76766225574858, -82.48309458094523 35.76772025571763, -82.48290058090981 35.767741255701914, -82.48275758088367 35.7677562556901, -82.48255858084741 35.76777725567391, -82.48232958080452 35.76780825565658, -82.48218758077776 35.76782825564595, -82.48205258079186 35.76759325558419, -82.48194758080308 35.76740925553591, -82.48177558083219 35.767038255442635, -82.48169858084657 35.76686325539905, -82.4816855808489 35.76683425539182, -82.48160858087111 35.76660925533808, -82.48154858089502 35.76639125528759, -82.48151658090475 35.76629425526454, -82.48146458091523 35.766171255234084, -82.48135758093113 35.76595525517913, -82.48131258094025 35.76584825515273, -82.48127258095144 35.765733255125205, -82.48120258098278 35.76545725506176, -82.48118658099055 35.765390255046476, -82.48105658103555 35.76496125494575, -82.4810185810545 35.764799254908844, -82.48089958113788 35.76413525476154, -82.48088758115986 35.763981254728925, -82.48087758120545 35.76367725466599, -82.48085658122508 35.76352825463356, -82.48081758124216 35.763377254598815, -82.4807625812561 35.7632282545628, -82.4806985812649 35.76310325453076, -82.48060058127116 35.762958254491096, -82.48048358127251 35.762824254451765, -82.48027658127313 35.762599254384625, -82.48020058127763 35.76248925435439, -82.48011158128536 35.76234425431565, -82.47997358130199 35.76209025424979, -82.47991258130935 35.76197725422051, -82.47985958131942 35.761856254190384, -82.47976158135204 35.76154125411621, -82.47963258139963 35.76109725401248, -82.47958058141639 35.76093425397395, -82.47955558142885 35.76082725394966, -82.47954458143893 35.76075025393285, -82.47953558146824 35.76055225389163, -82.47952358147575 35.760491253877966, -82.47951558148156 35.7604452538678, -82.47939958150559 35.760166253799014, -82.47937458151371 35.7600872537804, -82.47935558152409 35.76000025376066, -82.47935258153483 35.759928253745734, -82.47936058154643 35.759862253733154, -82.47940358157463 35.7597262537099, -82.47951658163772 35.75944125366355, -82.47957958167088 35.75929525364035, -82.47959858168517 35.75922325362765, -82.4796005816867 35.75921625362649, -82.47965858174678 35.75889125356633, -82.47967158176587 35.758782253545476, -82.4796925817979 35.758598253510264, -82.47970158182888 35.75840925347272, -82.47967558191885 35.75780225334645, -82.47967658195111 35.75759525330453, -82.47966058196575 35.75748425328022, -82.47961758198406 35.7573202532425, -82.4797355820166 35.757237253237754, -82.4799035820729 35.75705425321784, -82.48007258213515 35.75683425319049, -82.4801795821843 35.7566322531605, -82.48055658238121 35.755768253023554, -82.48067158243025 35.75557525299619, -82.48078558248646 35.75533525295915, -82.48083958252805 35.75512525292192, -82.48081258259003 35.75469725283207, -82.4807445826291 35.754373252759166, -82.48074458265337 35.75421725272744, -82.4808525826983 35.75404325270316, -82.48100758274886 35.75388325268658, -82.48116258281988 35.753592252643394, -82.48136458289248 35.753340252613, -82.48141858293069 35.75315225258026, -82.48145858296549 35.75297125254754, -82.48159958304612 35.75260225248703, -82.48158758310308 35.752223252408676, -82.4815865831088 35.75218525240085, -82.48159258316011 35.751861252335544, -82.4815725832339 35.75136525223261, -82.48143758324959 35.7511192521686, -82.48127558327995 35.750751252076995, -82.48102558330329 35.75033325196612, -82.48088058331403 35.750109251905634, -82.48067158333807 35.74973125180709, -82.48056958334446 35.74958125176605, -82.4804895833634 35.74937325171549, -82.48041558337066 35.749247251682185, -82.480252583387 35.74896825160864, -82.4802125833943 35.74887825158615, -82.48018558342233 35.74866925154088, -82.48034058349737 35.74835125149212, -82.48064958360429 35.747993251451234, -82.48107458372598 35.747664251428155, -82.48115558375464 35.74756625141652, -82.48127658378765 35.74748325141209, -82.48141158383581 35.74731725139226, -82.48142458384633 35.74726325138263, -82.48169058393793 35.74695825134804, -82.48174158395537 35.74690025134155, -82.4817415839605 35.74686725133486, -82.48182258399109 35.746757251320794, -82.48184958400743 35.74668025130785, -82.48208458410036 35.74633325126152, -82.48216558414796 35.74611325122512, -82.48229658421592 35.74581625117822, -82.48269258442015 35.7449242510376, -82.48282458448807 35.74462825099101, -82.48297658456666 35.744284250936644, -82.4834355848031 35.743252250774084, -82.48358858488177 35.74290925072006, -82.48277258478493 35.74266025058519, -82.48220258471731 35.74248625049099, -82.48144658458932 35.74250225041625, -82.48024458440574 35.74239925027121, -82.48020758440005 35.74239625026678, -82.48002158437224 35.74237625024352, -82.47939658427876 35.74231025016562, -82.47927858426334 35.742283250147935, -82.4790695842361 35.74223525011665, -82.47900958424682 35.7421022500834, -82.47896158425574 35.74199325005624, -82.47892558426247 35.741911250035784, -82.47889458433329 35.74142224993321, -82.47893958437827 35.74118024988855, -82.47898458442262 35.74094324984495, -82.47918558461924 35.739891249651635, -82.47945258485126 35.73868224943325, -82.4795785850091 35.737800249266826, -82.47961758505767 35.73752924921563, -82.47941958514389 35.73676224903915, -82.47975058529748 35.736126248943926, -82.4800685854159 35.73570324889068, -82.48056658553986 35.735437248887955, -82.48121158571405 35.735005248866656, -82.48193658592294 35.734435248825434, -82.48228958607018 35.73386424874562, -82.48232158608332 35.733813248738564, -82.48273758625334 35.73316324864922, -82.48279058627485 35.733081248638015, -82.48309658637125 35.7327872486098, -82.4837195865489 35.7323092485768, -82.48482958685157 35.731546248536084, -82.48579258712685 35.73080224848409, -82.48647258734685 35.730112248413775, -82.48688258750782 35.729513248334165, -82.48758658776187 35.728629248226916, -82.48823358798076 35.727911248147606, -82.48917458827968 35.726991248057416, -82.49026158857836 35.7262292480145, -82.49098558875849 35.725843248010655, -82.49192258894779 35.725625248062926, -82.49462858940295 35.72558824833442, -82.4948705894387 35.72561724836533, -82.49655458968604 35.72582524858132, -82.49759058983763 35.72595724871501, -82.49824458994591 35.72595924878288, -82.49894359006589 35.72593424884988, -82.49983759024691 35.72572424889934, -82.49983759024613 35.72572924890043, -82.50077659050855 35.725043248857624, -82.50115259061323 35.7247702488408, -82.50277759104729 35.723712248793085, -82.50372159129147 35.723148248775615, -82.50402659137026 35.72296724877026, -82.5047365915495 35.72257124876289, -82.50511359165012 35.72232624875183, -82.50561759178024 35.72202724874299, -82.50611859193711 35.721552248697954, -82.50615559194524 35.72153924869913, -82.50637059199173 35.721470248707305, -82.50661559201566 35.72157824875451, -82.50741659207985 35.72202224892747, -82.50844359218509 35.72244324911908, -82.50919759226896 35.72271024925111, -82.51000359238652 35.722815249355584, -82.51072759249507 35.72289124944574, -82.51113959254131 35.72303424951733, -82.51151759258364 35.723166249583166, -82.51208259262123 35.723529249715234, -82.51216459262658 35.72358224973452, -82.51253759261651 35.72404724986759, -82.51287059260764 35.72446124998619, -82.5133505925542 35.72532025021051, -82.51362559253502 35.72573825032397, -82.51402659257003 35.72594225040684, -82.51427959261237 35.72594025043255, -82.51450459266948 35.72581325042987, -82.51471859273491 35.72562025041261, -82.5152325928437 35.72546925043491, -82.5159645929763 35.72539825049593, -82.51666959311555 35.725256250539715, -82.51676759313469 35.72523725054595, -82.51731059321625 35.7252932506133, -82.51785159332744 35.72515625064129, -82.51838959348808 35.724696250603024, -82.5187665935935 35.72442025058569, -82.51920859368103 35.724329250612826, -82.52010359382622 35.72435225070972, -82.52052859389725 35.72434925075295, -82.52125759407174 35.724005250758125, -82.52184159421978 35.72367625075132, -82.52236459432906 35.723532250775875, -82.52348659450513 35.72359825090506, -82.52433359468354 35.72335625094306, -82.52536259488295 35.72317225101164, -82.5260495950071 35.72310825106946, -82.52663559512784 35.72295725109919, -82.52715859523136 35.72285025113131, -82.52781959532707 35.722941251217954, -82.52846459540412 35.72313625132415, -82.5289835954316 35.72351525145475, -82.52993459545011 35.724415251735984, -82.53084859547393 35.72524125199841, -82.53098059547357 35.72538525204131, -82.53149859547187 35.725951252209924, -82.53197559545904 35.72654525238008, -82.53226659548366 35.72669825244114, -82.53286459556097 35.726841252531905, -82.5333075956385 35.726816252572476, -82.53383159573768 35.72673825261064, -82.53481759589351 35.72679025272285, -82.535640596025 35.72682425281457, -82.53533659605941 35.726276252671695, -82.53463459613936 35.72500825234123, -82.53440359615689 35.72464725224394, -82.53416559617517 35.72427425214344, -82.5342085962017 35.724149252122395, -82.53425859620982 35.724150252127814, -82.53447059624611 35.72414325214815, -82.53494759632342 35.724156252200004, -82.53519859638337 35.72403825220185, -82.53679159672508 35.72354225226509, -82.53759259691388 35.723183252274545, -82.5391265972131 35.72289725237444, -82.53914959721806 35.72289025237531, -82.53975059732959 35.722815252421995, -82.54021759741637 35.72275625245817, -82.54059059746912 35.722816252508835, -82.54074259749065 35.72284025252935, -82.5410675975332 35.72291425257789, -82.5412065975531 35.72293525259653, -82.5413455975754 35.722940252611856, -82.54145059759567 35.72292225261897, -82.54160659763113 35.72286025262247, -82.5421825977723 35.722567252622156, -82.54276559791492 35.722272252622226, -82.54303459798354 35.722118252618586, -82.54320759802559 35.72203225261891, -82.54335859806096 35.721966252621016, -82.54352459810174 35.72188125262081, -82.54370559814748 35.72178025261889, -82.54382859817753 35.721718252618935, -82.54406559823258 35.72161725262285, -82.54418459826476 35.72153725261878, -82.5443205983074 35.721407252606376, -82.54446359834677 35.72130725260066, -82.54471359840586 35.721194252603475, -82.54491159845024 35.72112025260879, -82.54515859850343 35.721042252618396, -82.54641359874675 35.72081825270209, -82.54683259882863 35.72073925272918, -82.54709959888056 35.72069025274666, -82.54725459891243 35.720651252754706, -82.54740159894416 35.72060425276036, -82.54751759897196 35.72054925276111, -82.54766459901391 35.72043625275322, -82.5478845990855 35.720210252729856, -82.54806059914404 35.72002125270949, -82.54819759918696 35.71989125269712, -82.54821759919274 35.71987525269599)))",6320,37,021,002804,370210028043,2086,2086,53,2050,2008,21,3,7,1,10,36,1550,27,1523,1530,1501,15,3,3,1,7,20,902,814,88
census_2010_blockgroups_view.fid--2dc29038_13ec899ba8f_-2640,"MULTIPOLYGON (((-82.55745161872245 35.603395229932126, -82.5574686187273 35.603382229931256, -82.55760461876356 35.603293229927075, -82.5576726187814 35.603250229925315, -82.557960618853 35.60309622992358, -82.5580626188789 35.60303822992223, -82.55808461888448 35.60302522992184, -82.55824461892492 35.602935229919964, -82.55832361894507 35.60289022991896, -82.55855961900484 35.60275622991584, -82.55863961902489 35.60271222991517, -82.55866361903117 35.60269722991456, -82.55873861905029 35.602654229913504, -82.55876361905644 35.602641229913445, -82.55897661910961 35.60252522991171, -82.5594046192162 35.60229522990888, -82.55961661926963 35.602176229906405, -82.5598296193232 35.60205822990425, -82.55995661935496 35.60198922990328, -82.56033661944947 35.60178522990077, -82.56046461948112 35.601717229900096, -82.56059261951332 35.60164622989881, -82.56097861960995 35.601435229895515, -82.56103661962436 35.601404229895174, -82.56110961964202 35.60136822989532, -82.56128061968421 35.60127922989482, -82.56133761969812 35.601250229894724, -82.56178561981145 35.60099722988921, -82.56195461985398 35.60090322988743, -82.5621246198965 35.60081022988597, -82.56263462002367 35.60053422988222, -82.5628056200663 35.60044222988105, -82.56293462006322 35.600601229926674, -82.56328162012005 35.60060622996336, -82.56432262029068 35.6006212300733, -82.56467062034753 35.600627230110256, -82.56467062032131 35.600797230144885, -82.56473562031583 35.60090323017315, -82.5648526203055 35.601096230224435, -82.56522162028253 35.6016432303737, -82.56538662027218 35.60188823044054, -82.56540762027092 35.60191923044904, -82.5654726202671 35.602014230475056, -82.56549462026585 35.602046230483815, -82.56557962026127 35.60216723051718, -82.56583462024743 35.602532230617726, -82.56592062024292 35.602654230651375, -82.5661276202334 35.60293923073068, -82.56623162022862 35.603082230770475, -82.56643662021496 35.60339223085461, -82.5667336202003 35.603807230969636, -82.5668676201938 35.603994231021474, -82.56693162019522 35.6040542310402, -82.56696562019927 35.60406423104576, -82.56695962019073 35.60411323105511, -82.56696462018633 35.604147231062534, -82.56700662018056 35.6042302310838, -82.56705362017651 35.60430723110426, -82.5671326201748 35.604403231131954, -82.56720562017313 35.60449323115772, -82.56725262016951 35.604567231177626, -82.56753462016646 35.60489123127262, -82.56767962016154 35.60507923132571, -82.56770362015979 35.605116231335785, -82.5677876201593 35.605210231363536, -82.56783362015452 35.605291231384776, -82.56784862015091 35.60533023139423, -82.56786362014739 35.605369231403685, -82.567893620119 35.60558623145104, -82.56790762011158 35.605649231465236, -82.56791162010191 35.60571623147928, -82.56774762007292 35.60572823146486, -82.56725861998555 35.605768231422765, -82.56724461998277 35.60577023142177, -82.56709761995427 35.60579723141215, -82.56722961995077 35.60596223145932, -82.56762461994012 35.606457231600665, -82.56775761993687 35.60662223164791, -82.56767061991513 35.60666923164857, -82.56759061989355 35.60672323165127, -82.56726061980355 35.60695123166379, -82.56714561977175 35.60703423166886, -82.56711861976224 35.60706623167269, -82.56708761975125 35.607104231677155, -82.56705861973803 35.607159231685415, -82.56703261972132 35.60723923169905, -82.56691961969504 35.60728823169741, -82.56682161967039 35.6073422316983, -82.56669661963873 35.607413231699915, -82.56629961953355 35.60766823171104, -82.56622561951312 35.6077212317142, -82.56616161949518 35.60776823171724, -82.56609861947943 35.6078022317177, -82.56601961946201 35.607830231715226, -82.56608261941122 35.608228231802784, -82.56557761931045 35.60833823177333, -82.56543261928279 35.608361231763034, -82.56518061923212 35.608418231748814, -82.56503561920267 35.608453231740974, -82.56463861912151 35.608552231720395, -82.56450161909287 35.60859023171402, -82.56440261907123 35.60862423171081, -82.56434461905582 35.608661231712354, -82.56421961902014 35.60875823171927, -82.56409661899082 35.60881623171837, -82.5637986189736 35.608606231645034, -82.56361061896474 35.60846123159623, -82.56332661895644 35.60820923151571, -82.56316461895555 35.60804023146478, -82.56306661895667 35.60792723143161, -82.56299361895772 35.60784223140684, -82.56283461896243 35.60764023134934, -82.56263961897463 35.60735023127032, -82.56239261899248 35.606968231167144, -82.56220061900298 35.60669323109146, -82.56219061900349 35.60667923108753, -82.56214061900485 35.60661623106955, -82.56196861900972 35.60639923100774, -82.56196061900978 35.60639023100507, -82.56189661901028 35.60631823098384, -82.56174461901136 35.6061472309334, -82.56161761901035 35.60601723089392, -82.56150461900941 35.605901230858706, -82.56114861899938 35.60558223075712, -82.56085461898687 35.60534723067917, -82.56068161897716 35.60522323063612, -82.56055361896992 35.60513223060444, -82.56034261895607 35.60499523055486, -82.56023661894908 35.60492623052996, -82.56021161894706 35.604912230524505, -82.55980761891462 35.60468723043719, -82.5597866189129 35.6046752304326, -82.55967161890297 35.60461623040873, -82.55947361888552 35.60451623036808, -82.55923361886373 35.60439923031961, -82.55900861884297 35.60429123027451, -82.55847961878871 35.60407323017576, -82.55826261876639 35.60398423013534, -82.5580226187433 35.603875230088526, -82.55784261872945 35.60377123004887, -82.55769761872179 35.603664230012136, -82.55761161871803 35.603596229989506, -82.55759261871655 35.60358522998526, -82.55745161872245 35.603395229932126)))",6119,37,021,000300,370210003002,694,694,25,680,592,75,0,6,1,6,14,575,19,556,567,496,65,0,3,1,2,8,358,325,33
census_2010_blockgroups_view.fid--2dc29038_13ec899ba8f_-263f,"MULTIPOLYGON (((-82.73696567069561 35.45903221890997, -82.73693967071 35.45890921888219, -82.73692767071671 35.45885221886935, -82.73684267074945 35.45854521879807, -82.73683967075075 35.458533218795274, -82.73678667075706 35.45843421876973, -82.73676567075837 35.45840221876109, -82.73674267075775 35.45838121875441, -82.73668267075591 35.45832821873754, -82.73657267074715 35.458265218713414, -82.73654967074533 35.45825221870845, -82.73651267074212 35.45823321870074, -82.73637067072963 35.45816021867145, -82.73624967071741 35.458108218648384, -82.73616167070836 35.458071218631915, -82.73603267068864 35.45806021861647, -82.73552367060424 35.458058218564084, -82.73538867058528 35.45803521854562, -82.735330670577 35.45802621853787, -82.73518267056025 35.457974218512106, -82.73511967055578 35.45793521849775, -82.73502067054876 35.45787321847496, -82.73487967053796 35.45779021844363, -82.73426967049105 35.457432218308405, -82.73416367048361 35.45736521828384, -82.73415967048341 35.45736221828287, -82.7340526704807 35.45726321825174, -82.73400567048341 35.457194218232836, -82.73399367048876 35.45714621822182, -82.73398367049256 35.45711021821344, -82.73397767050562 35.457018218194186, -82.73400867056263 35.45667821812794, -82.7340376706033 35.45644321808302, -82.73404467062723 35.456294218053394, -82.73409467072054 35.455737217944844, -82.734099670727 35.455700217937846, -82.73410667073465 35.45565721792982, -82.73414067075365 35.45557021791549, -82.73419067077492 35.4554852179033, -82.73433067082571 35.45530521788087, -82.73439067084892 35.4552182178693, -82.73442767086773 35.45513521785611, -82.73443967088072 35.45506321784266, -82.73442767088923 35.45499421782735, -82.73438267090101 35.45486821779714, -82.73427167091972 35.454624217735976, -82.7342156709277 35.45451121770729, -82.7341646709384 35.45438521767635, -82.73413267095006 35.45427421765046, -82.73411067096637 35.4541432176215, -82.73410067098374 35.45401821759497, -82.73410567100514 35.45388321756801, -82.73412967102806 35.45375921754511, -82.7341676710516 35.453646217525986, -82.73421767107966 35.45351721750475, -82.73424667110262 35.4533982174835, -82.73427967116749 35.45300921740753, -82.73430267119159 35.45287621738273, -82.73434567121657 35.45275921736332, -82.7343906712384 35.45266521734872, -82.73446167125783 35.452615217345794, -82.73452467126965 35.4526062173504, -82.73458367127985 35.452604217356026, -82.73465067128855 35.45262021736614, -82.7347486712998 35.45265321738285, -82.73514067133873 35.45282521745794, -82.73538767136172 35.45294421750745, -82.73541967136428 35.45296221751437, -82.73558967137754 35.45306121755191, -82.73570967139015 35.45310921757396, -82.7358036714064 35.45310521758281, -82.73587467142069 35.45308921758674, -82.73597967144845 35.45302121758366, -82.73615167150408 35.452844217565094, -82.7363306715652 35.45263921754156, -82.73635467157783 35.45258221753241, -82.73633967158482 35.45252021751821, -82.73628667158246 35.45247821750419, -82.73620567156941 35.45247521749534, -82.73616767156017 35.45249421749539, -82.73610767154557 35.45252421749532, -82.73591867148546 35.452712217514375, -82.73580367145355 35.452796217519754, -82.7357306714392 35.45281021751516, -82.73565567142865 35.45279821750507, -82.73560767142463 35.45277221749487, -82.73550267141978 35.45268921746724, -82.73508467140768 35.45231221734765, -82.73486867139994 35.452127217287874, -82.7346896713897 35.45199921724345, -82.73453767137633 35.45192121721207, -82.7343726713576 35.45186421718355, -82.73412067132573 35.451798217144415, -82.73400167130633 35.45179521713165, -82.73382567127283 35.451823217119376, -82.73369967124742 35.451852217112396, -82.7336196712288 35.451887217111405, -82.73345567119341 35.451940217105445, -82.73328167116168 35.45195821709134, -82.73317167114627 35.4519392170763, -82.73306567113507 35.451897217056825, -82.73290767110588 35.45191621704459, -82.73283167109062 35.4519332170403, -82.73275167106912 35.451987217043104, -82.73269967104928 35.45206021705268, -82.7326706710297 35.45215721706952, -82.73266667102614 35.452176217073, -82.73261267097408 35.452458217124956, -82.73258067095823 35.45252721713579, -82.7325226709413 35.4525752171397, -82.73244567092311 35.45261021713893, -82.73236867090732 35.45263021713514, -82.73228567089222 35.452638217128246, -82.73219767087761 35.4526382171193, -82.73210267086404 35.452623217106556, -82.73200867085228 35.452598217091854, -82.73181167083354 35.452506217052935, -82.73171267082172 35.452475217036536, -82.73161767080803 35.452461217023924, -82.73153167079413 35.45245921701479, -82.73144567077875 35.452465217007244, -82.7313306707594 35.452467216995906, -82.73122967074397 35.45245821698373, -82.73112367073185 35.452422216965566, -82.73102967072307 35.452377216946765, -82.73094867071816 35.45232121692706, -82.73087367071554 35.452256216906164, -82.73079467071396 35.452180216882674, -82.73043467071089 35.45180821677001, -82.73036367070823 35.451748216750545, -82.73029067070134 35.45171321673594, -82.73025867069641 35.45171121673228, -82.73023167069235 35.451708216728946, -82.73018767068433 35.451713216725445, -82.73014767067696 35.45171721672215, -82.73008367065775 35.45177321672703, -82.73003867063655 35.451863216740804, -82.72996167056995 35.45221621680487, -82.7299456705523 35.45231421682327, -82.72992067053565 35.45239621683743, -82.7298746705193 35.45245321684433, -82.72982367050457 35.452494216847455, -82.72976067048963 35.452523216846934, -82.72968567047549 35.45253421684154, -82.72944667043528 35.45253721681772, -82.729374670421 35.452552216813444, -82.72931867040388 35.45260321681811, -82.72928667038924 35.45266421682727, -82.72928667037176 35.45277921685073, -82.7292926703578 35.452877216871336, -82.7292876703434 35.452966216888925, -82.72923567032433 35.4530342168975, -82.72916867030654 35.45307821689965, -82.72907967028723 35.453107216896406, -82.72885967024148 35.453167216886214, -82.72861367019387 35.45321121687007, -82.72851367016301 35.45330421687879, -82.72844367013735 35.453396216890425, -82.72841067011576 35.453502216908674, -82.72840467010147 35.45358921692588, -82.72841267008917 35.45367821694476, -82.7284436700842 35.45374421696139, -82.72848967008214 35.453808216979134, -82.72852067007877 35.45386421699372, -82.72854167007283 35.4539262170085, -82.72854167006444 35.45398121701973, -82.72851567005192 35.454035217028085, -82.7284656700362 35.45408321703272, -82.72840467002061 35.45411921703382, -82.72833267000527 35.454141217031065, -82.72825466999073 35.45415121702502, -82.72816566997544 35.454154217016566, -82.72788566993303 35.45412721698249, -82.7276386698945 35.454110216953794, -82.72751966987664 35.45409721693901, -82.72741666986323 35.45407321692359, -82.72733766985529 35.45403921690853, -82.72715766984378 35.45391821686554, -82.72711866984142 35.453891216856, -82.72710566984152 35.453876216851675, -82.72707066983997 35.45384821684239, -82.72681166979305 35.453873216820995, -82.7266376697659 35.45386121680081, -82.72616966972654 35.453609216701636, -82.72594466971515 35.453438216643775, -82.72581466972683 35.45322021658604, -82.72585066979399 35.45281921650799, -82.72599966986698 35.45250321645876, -82.72584866991038 35.452054216351804, -82.72558066985096 35.45215121634424, -82.72521966976603 35.45231421634054, -82.72484066969723 35.45235221630958, -82.72447566965923 35.45220321624194, -82.72444966966007 35.45216921623233, -82.72423266966636 35.45189121615348, -82.72412066969612 35.45157421607744, -82.7240756697318 35.45129121601513, -82.7240396697703 35.450999215951946, -82.72409066982794 35.45067721589154, -82.72409166985926 35.450473215850025, -82.72375166985256 35.4501462157486, -82.7234186698566 35.449756215635176, -82.72302966985656 35.44933221550894, -82.7226266698663 35.44882921536525, -82.72251266984928 35.44881621535094, -82.72237566982874 35.448801215333944, -82.72223266977177 35.44901921536378, -82.72217466973878 35.44917221538899, -82.72191466969292 35.449189215365976, -82.72180066969247 35.449068215329596, -82.72169066968034 35.44902721531001, -82.72156566964009 35.449155215323344, -82.72154566959465 35.449431215377544, -82.72146166953694 35.44971821542753, -82.72127066948926 35.44982221542925, -82.72096566944128 35.44980421539437, -82.72068966941167 35.449697215344365, -82.72058366942063 35.44952321529805, -82.72044766941622 35.44940321525972, -82.72049866943728 35.44932121524825, -82.72072366948386 35.449261215259, -82.72077866952709 35.44903721521893, -82.72066566955789 35.44871221514111, -82.72056866957672 35.44848321508456, -82.72049366959772 35.44826421503227, -82.72048566962204 35.44809521499693, -82.72056866964718 35.44802121499033, -82.7207966696862 35.448014215012186, -82.72102966970967 35.44811421505636, -82.72124866973914 35.448160215088144, -82.72142966978083 35.44808421509114, -82.72155766984615 35.447795215045296, -82.72160966990101 35.44749221498883, -82.72158366994675 35.44716421491932, -82.72153866997843 35.44690721486234, -82.72154466998853 35.446847214850685, -82.72155367000275 35.446764214834715, -82.72180167008716 35.4464812148023, -82.72192467013248 35.44631821478168, -82.7218656701739 35.44598221470711, -82.72179567021352 35.44564621463151, -82.721712670225 35.44548021458922, -82.72170167025973 35.44524021453914, -82.7218186703246 35.444943214490586, -82.72203767039042 35.44475021447359, -82.7221306704199 35.44465821446426, -82.72246767047749 35.44464821449669, -82.7226836704806 35.444863214562524, -82.72286067046198 35.44517821464488, -82.72303867047901 35.445261214679974, -82.72334467052318 35.44530521472026, -82.72373967060962 35.44516921473276, -82.72402467068694 35.444973214721976, -82.72415967072757 35.44485421471144, -82.72438167074938 35.44495321475429, -82.72448367071804 35.445270214829314, -82.72447667066656 35.445599214895715, -82.72455167064687 35.44581021494636, -82.72461967061368 35.44610221501288, -82.72468267055683 35.446544215109384, -82.72475067052372 35.44683521517569, -82.72487267049847 35.44713421524904, -82.72508267048705 35.4474382153325, -82.72532267048602 35.4477062154116, -82.72563767050319 35.447937215490896, -82.72578867049658 35.44814521554871, -82.72608867052216 35.44830521561199, -82.72623667055959 35.44822121560995, -82.72638867062223 35.447976215575544, -82.72651867068238 35.4477232155373, -82.72671567074596 35.44752121551618, -82.72737767089447 35.447270215532626, -82.72753367097795 35.44689221547154, -82.72754767104271 35.44648321538955, -82.7273606710542 35.44620421531353, -82.7272746710748 35.445975215258095, -82.72727267111635 35.445700215201825, -82.7273706711697 35.44545721516224, -82.7274246712143 35.445224215120305, -82.7272896712426 35.444891215038666, -82.72718267125671 35.44468121498485, -82.72738467134148 35.44434621493727, -82.72745367141029 35.44397021486759, -82.72755467152653 35.443318214744934, -82.7274226715445 35.443056214678144, -82.72708667152224 35.44283521459873, -82.72698367156012 35.442474214514654, -82.72695667160984 35.44211921443951, -82.72716667170272 35.441739214383475, -82.72716167175466 35.44139321431243, -82.72698767176429 35.441140214243056, -82.72698467180847 35.440847214183016, -82.72716267186063 35.440699214171026, -82.72735067191704 35.4405342141566, -82.72759467197777 35.44040221415458, -82.7275636720037 35.44019821410983, -82.72728967200158 35.43991321402373, -82.7271536719986 35.43978421398355, -82.72707567202731 35.43951121391998, -82.72722667209236 35.43924921388193, -82.72751967217764 35.43900921386293, -82.72776867223719 35.43889021386411, -82.72783867225388 35.43885721386451, -82.72805067230652 35.438743213862885, -82.72837667235817 35.43876021389973, -82.7285946723914 35.43878021392604, -82.72866467242494 35.43863621390383, -82.72857467245575 35.43833621383346, -82.72861567250604 35.438051213779545, -82.7288206725817 35.43777821374479, -82.72904867265473 35.437548213721186, -82.72935667272893 35.437397213721816, -82.72951467277096 35.437294213716996, -82.72957167281048 35.4370972136827, -82.72973267287868 35.43682521364366, -82.73002867295504 35.436647213637535, -82.73035767303435 35.436486213638325, -82.73053667308119 35.43637421363378, -82.73074667317672 35.435976213574065, -82.7308616732493 35.43562621351448, -82.73089067330159 35.43531421345385, -82.7308316733416 35.43498721338115, -82.73070567337827 35.434609213291246, -82.73058267340465 35.43430221321607, -82.73051667339459 35.434296213208114, -82.73047867340317 35.43419821318424, -82.73045267342006 35.43405921315325, -82.7304656734618 35.433799213101594, -82.7304156734733 35.43366921306995, -82.73046667349121 35.43360721306251, -82.73044767351777 35.43341221302078, -82.73044167351911 35.43339721301716, -82.73056767359462 35.43303921295699, -82.73060067360424 35.4330122129549, -82.73082867367788 35.4327772129302, -82.73086467369582 35.432699212918074, -82.73106667375352 35.43254121290638, -82.7312796738243 35.432309212880874, -82.73139267386493 35.43216521286299, -82.73159767392582 35.43199021284827, -82.73178267397105 35.43189521284781, -82.73197067401784 35.43179321284621, -82.73207567404945 35.43170021283796, -82.73214667406845 35.4316532128356, -82.73222167409874 35.43153621281944, -82.73241667414591 35.431440212819815, -82.73332067432459 35.43125421287414, -82.73438867450531 35.431234212979135, -82.7353096746609 35.43121821306981, -82.73686067497651 35.43084021315106, -82.7377406751869 35.43042021315523, -82.73878667545087 35.4298302131417, -82.73969567568582 35.4292802131223, -82.74004867586298 35.42850321299989, -82.74035167604897 35.42761321284939, -82.74077267625592 35.42671421270903, -82.74105167648946 35.42548621248714, -82.74151167671036 35.42453821234074, -82.74179067678067 35.42438121233722, -82.74272367701568 35.42385721232558, -82.74373267723546 35.42351621235901, -82.74430267735195 35.42337421238825, -82.74437067736868 35.42333921238807, -82.74477067740499 35.42353721246921, -82.74495867742384 35.423619212505116, -82.74503067743285 35.42363821251637, -82.74513667744063 35.423703212540424, -82.7452796774532 35.423777212570116, -82.7454326774554 35.423929212616684, -82.74549767745715 35.42398921263555, -82.7455476774603 35.42402321264764, -82.7456226774565 35.42413021267704, -82.74584367745702 35.424368212748206, -82.74603167745735 35.42457121280877, -82.74614667746233 35.424664212839474, -82.74630467746893 35.42479321288187, -82.74654767748228 35.424971212942964, -82.7466756774952 35.42502621296723, -82.74675867749636 35.42510921299262, -82.74701167751928 35.42523521304411, -82.74707767752464 35.42527221305844, -82.74724967754912 35.4252992130815, -82.74736767756401 35.425330213099805, -82.74753367758802 35.42535421312167, -82.74777467762893 35.42534921314528, -82.74800167766485 35.42536121317079, -82.74817867768957 35.42539221319521, -82.748334677714 35.425402213213154, -82.74870567777201 35.42542621325593, -82.74900967782092 35.425437213289186, -82.7492086778602 35.42539721330131, -82.74947767790923 35.425369213323066, -82.74972267795532 35.42533421334093, -82.74990367798631 35.42532821335819, -82.75011067802475 35.42530221337399, -82.75045567808498 35.425283213405315, -82.75106767820557 35.42516021344272, -82.75185767835151 35.42506521350395, -82.75286867851428 35.42510121361444, -82.7551226789026 35.42501421382662, -82.75616767902922 35.425325213996665, -82.75660267904317 35.425709214119415, -82.75692367899393 35.42638321428955, -82.75764167896077 35.42738521456718, -82.7586866790124 35.428188214837526, -82.75960067908188 35.42873121504152, -82.75962467908418 35.428742215046256, -82.76033067915154 35.42907121518537, -82.76182367931021 35.429661215458026, -82.76233067936533 35.42985321554894, -82.76303967941078 35.4303302157185, -82.76345967943722 35.43061521581953, -82.7645136795035 35.43133221607333, -82.76549867952438 35.432271216365265, -82.7663156795925 35.43271721653964, -82.76757667982504 35.43256921663811, -82.76857268001123 35.43243521671237, -82.76936568004105 35.43310621693019, -82.77009868005234 35.433833217153214, -82.77132668017599 35.43436421738684, -82.77142768018616 35.43440721740591, -82.77247768029297 35.43485421760422, -82.77328568036579 35.43525921776923, -82.77398568042214 35.435654217921254, -82.77438768047857 35.43572321797636, -82.77561968063364 35.43605221816916, -82.77638068071103 35.43637621831289, -82.77687468073098 35.43678521844669, -82.77714268071725 35.43716821855214, -82.77766968077336 35.437376218648375, -82.77890868090262 35.43788221887795, -82.77981068095895 35.4384982190957, -82.78046368094604 35.43929721932533, -82.78088568101064 35.43933421937593, -82.78126968107524 35.43933021941429, -82.78166368114493 35.439303219448924, -82.78407868082967 35.44401322065627, -82.78418368066613 35.44520122090937, -82.78410168055159 35.445863221036, -82.78394768040205 35.44667622118615, -82.78401068029062 35.44747622135578, -82.78410168017015 35.448366221546664, -82.78430868013419 35.448828221662076, -82.78463468012146 35.44926822178504, -82.78550167996782 35.45122422227261, -82.78561567988332 35.451903222422786, -82.7854976797874 35.45240322251277, -82.78525267960059 35.453361222683185, -82.78530767950012 35.45408022283547, -82.78555467947193 35.45453522295351, -82.78556867946209 35.454615222971206, -82.78566067940085 35.45511722308311, -82.7858226793056 35.45591922326321, -82.7858736791736 35.456840223456304, -82.78626467914819 35.45743422361745, -82.78675267920045 35.457625223706245, -82.78767067929769 35.4579902238744, -82.78800667929514 35.45837422398701, -82.78880967940073 35.458559224106686, -82.78956567943789 35.459141224302606, -82.78995267937745 35.45996122450943, -82.79025567933135 35.46059422466955, -82.79079167929378 35.46142622489396, -82.79137267925323 35.46232722513717, -82.79230167928831 35.46311222539213, -82.79295167932281 35.46359622555728, -82.79328167934031 35.46384222564107, -82.79392667933465 35.46458422585839, -82.79441767933305 35.46513122602011, -82.7948046791938 35.466467226332185, -82.79484767907776 35.46727522650149, -82.79476667896833 35.46790422662152, -82.79440567869568 35.46929722686895, -82.79566167888194 35.46944822702795, -82.79724567908846 35.46982522726665, -82.79836367923404 35.470092227435245, -82.80026367948342 35.47053322771911, -82.7992796792399 35.471055227725216, -82.79796067885583 35.47213122781017, -82.79585967792427 35.47594222837337, -82.79538067771459 35.476793228498146, -82.79514867753898 35.477690228657465, -82.79490267735233 35.47864522882719, -82.79426867698783 35.48034122910854, -82.79397067683385 35.481024229217546, -82.79348867644995 35.483013229574176, -82.79318467617425 35.48448722984392, -82.79263867596588 35.485256229945065, -82.79174967563416 35.486458230099565, -82.79115467542017 35.48721023019227, -82.79082467524627 35.48798923031753, -82.79028567502422 35.48885523043921, -82.78885467451553 35.49062423065401, -82.78776967401103 35.49274323097558, -82.78725867377754 35.4937142311215, -82.78673767361761 35.49419323116601, -82.78564167332588 35.49490723119977, -82.78602367322357 35.495993231460325, -82.78643467296443 35.498138231940075, -82.78582067275208 35.498858232024254, -82.78463067240784 35.4998132320976, -82.78455567235093 35.50010423214921, -82.78419567215164 35.501015232298336, -82.78416667213529 35.50109123231094, -82.78339267177472 35.50260623254092, -82.78280367148062 35.50388823274238, -82.78256867132941 35.50462123286795, -82.78307067130237 35.505346233067165, -82.78401467136243 35.50598223329339, -82.78476267141949 35.50642523346025, -82.78508767132973 35.50736723368566, -82.78468367108589 35.50852123387989, -82.78460767104023 35.50873723391613, -82.7837986706607 35.51033823416017, -82.7837936706582 35.510349234161936, -82.78313667033292 35.5117602343827, -82.78203766992425 35.513235234571326, -82.78057466949532 35.51444523466879, -82.78008466932417 35.51503023473799, -82.77969066918644 35.515501234793824, -82.77959366901005 35.51654923499776, -82.77952966894567 35.51690023506281, -82.77881766884579 35.516777234965005, -82.77668166854578 35.516411234671914, -82.77597066844592 35.51628923457433, -82.77596666844735 35.51627523457113, -82.7759576684518 35.516236234562214, -82.77595466845331 35.516223234559256, -82.7755716684165 35.516046234484016, -82.77524866837787 35.51594723443076, -82.77497366833967 35.51589723439249, -82.77461766828364 35.51587523435159, -82.77443566825558 35.51586023432991, -82.77434166824185 35.51584823431793, -82.77416666822195 35.51578723428753, -82.7740326682082 35.51573123426241, -82.77390566819516 35.51567823423858, -82.77353566815289 35.51555123417485, -82.77325966812879 35.51540823411753, -82.77297166809414 35.51532023407005, -82.7725946680463 35.515222234011546, -82.77232566801852 35.515111233961456, -82.77194366797559 35.514975233894624, -82.77162766793678 35.514885233844005, -82.7711026678584 35.51482523377808, -82.77091466783803 35.51475323374415, -82.7707336678212 35.514666233707906, -82.77058566781415 35.51455123366929, -82.77039066781363 35.514342233606726, -82.7700556678084 35.51401123350489, -82.76962466778184 35.513715233400475, -82.76940966774693 35.51370923337726, -82.76914066770556 35.51368623334505, -82.76898666768466 35.51365523332306, -82.7686536676675 35.51340423323774, -82.76840866765495 35.51321923317495, -82.76797166761735 35.512989233083395, -82.76785766760925 35.51291823305728, -82.76780466762746 35.51274123301569, -82.76771666763297 35.51260923297974, -82.76760266763047 35.5125012329461, -82.7673066676099 35.51231323287754, -82.76711266759237 35.51221623283789, -82.76699866758209 35.5121592328146, -82.76693066757599 35.51212523280069, -82.7667156675535 35.51203823276093, -82.76665466754926 35.51199923274679, -82.76654766754177 35.511931232722, -82.76633466751098 35.511901232694065, -82.76631166751122 35.51187423268616, -82.76628266751258 35.5118342326751, -82.76622466751243 35.511771232656265, -82.7661566675346 35.511552232604664, -82.76607466753535 35.511458232577155, -82.76601166752975 35.51142623256417, -82.7659926675281 35.51141623256016, -82.76598566753063 35.5113922325545, -82.7659456675381 35.51129923253151, -82.76589866754466 35.51120523250748, -82.76587866755258 35.511132232490525, -82.76589466756319 35.51108023248162, -82.76595866757827 35.511051232482195, -82.76596666759347 35.510960232464456, -82.76596366760873 35.51085723244317, -82.76598566762668 35.51076423242641, -82.76592866763255 35.510663232399985, -82.76566866760822 35.51053923234807, -82.76552766759004 35.510504232326596, -82.76538066757385 35.510450232300514, -82.76525066760216 35.51012323222049, -82.76523066770524 35.509427232076426, -82.76514766769407 35.50941023206451, -82.76459866762563 35.509259231977616, -82.76426166758432 35.509162231923355, -82.7637346675197 35.509010231838474, -82.76348466749127 35.50892423179536, -82.7631456674554 35.50878923173317, -82.76291966743037 35.50870623169316, -82.76265366739928 35.50862023164841, -82.7623366673633 35.50851023159358, -82.76184566731021 35.50832223150501, -82.76142166726399 35.50816223142906, -82.76117066723675 35.50806723138401, -82.76096366721616 35.507976231344294, -82.76072866719412 35.507864231297404, -82.76051766717258 35.50777523125773, -82.76049966717065 35.50776823125443, -82.76038366715785 35.5077252312338, -82.76004466711865 35.507612231176054, -82.75996266710912 35.50758523116215, -82.75985366709753 35.507542231142295, -82.7595156670663 35.50737823107425, -82.7587506669992 35.506983230915495, -82.75873766699817 35.50697623091274, -82.75843466697016 35.506829230851835, -82.75831766695862 35.50677723082917, -82.75817866694511 35.506714230802196, -82.7580726669346 35.506667230781694, -82.75780366690569 35.506563230732965, -82.75775466689979 35.50654823072499, -82.75773266689711 35.50654223072151, -82.75760766688086 35.50651223070258, -82.75747766686162 35.50649623068598, -82.75746766686011 35.506495230684784, -82.7573626668439 35.506487230672384, -82.75722366682135 35.50648223065725, -82.757047666792 35.50648323063939, -82.756946666775 35.506484230629276, -82.75690766676803 35.50648723062589, -82.75681066675067 35.506495230617645, -82.75670966673188 35.506508230609974, -82.75661966671368 35.50652923060501, -82.75646166667936 35.50658123059942, -82.75645066667693 35.506585230599185, -82.75629466664012 35.50665623059771, -82.7561566666055 35.50673223059908, -82.75598266655858 35.50684923060519, -82.75560066644944 35.507147230626934, -82.75532666637379 35.507343230638924, -82.75525166635308 35.50739723064223, -82.75501666629083 35.50754823064901, -82.75494666627435 35.50757923064825, -82.75493766627261 35.507581230647624, -82.75490766626639 35.50758923064622, -82.75486466625723 35.50760223064452, -82.7548166662486 35.50760623064038, -82.75478666624313 35.50760923063795, -82.7547076662309 35.507603230628625, -82.75460966621866 35.50757623061316, -82.7545746662149 35.507563230606884, -82.7544026661957 35.50750123057667, -82.754267666179 35.50746323055511, -82.75394766613715 35.50738823050713, -82.75378366611564 35.50735023048257, -82.75373766611038 35.50733423047468, -82.75327366605788 35.50717223039418, -82.75324366605444 35.50716223038903, -82.75309766603742 35.50711423036432, -82.75274566599806 35.506988230302646, -82.75208966592336 35.506762230189516, -82.75191866590485 35.50669723015878, -82.75188266590112 35.506682230151974, -82.7517506658873 35.50662923012767, -82.75142766585313 35.50650023006834, -82.75132266584177 35.50646023004947, -82.75100866580753 35.506342229993294, -82.7509036657953 35.50630722997537, -82.75058566575822 35.50620422992188, -82.75043266573908 35.50616222989766, -82.75037666573215 35.50614722988891, -82.74977466565333 35.506006229798636, -82.7496306656339 35.50597622977774, -82.74954766562163 35.505966229767225, -82.74945166560614 35.505963229756794, -82.74937566559284 35.50596722974985, -82.74926966557294 35.505982229742116, -82.74914066554811 35.506004229733364, -82.74898866551582 35.50604922972699, -82.74887466549168 35.50608322972229, -82.74884266548622 35.50608422971924, -82.74877166547395 35.50608722971262, -82.74866166545608 35.50608422970074, -82.74859966544761 35.50607222969191, -82.74850766543669 35.50604322967659, -82.74848366543391 35.50603522967252, -82.74837066542348 35.50598022964978, -82.74820466541117 35.50588022961237, -82.748028665396 35.50578722957539, -82.74800866539412 35.50577822957154, -82.74785666537964 35.50570722954155, -82.7477016653635 35.505644229512775, -82.74758766535238 35.505592229490496, -82.74750466534306 35.50556322947615, -82.74737966532786 35.50552622945579, -82.7466536652354 35.50534022934367, -82.74639666520295 35.50527222930349, -82.74632066519335 35.50525222929171, -82.74616266517297 35.50521322926756, -82.74585366513602 35.50511822921662, -82.74562966511009 35.50504422917867, -82.7454816650911 35.50500722915599, -82.74544266508546 35.505001229150764, -82.74498066501958 35.50492922908878, -82.74483666499974 35.50490222906856, -82.74468366498002 35.504864229045154, -82.74453266496191 35.50481822902036, -82.74436666494364 35.50475722899096, -82.74420566492715 35.5046892289606, -82.74406566491274 35.50463122893448, -82.74394166490161 35.50456922890917, -82.74383666489403 35.50450422888513, -82.74382666489339 35.50449722888267, -82.7437256648885 35.50441922885643, -82.74343766487922 35.504166228775425, -82.74339566487791 35.5041292287636, -82.74333666487402 35.504090228749675, -82.7431686648618 35.503987228711395, -82.74303966485124 35.50391622868375, -82.74261866481922 35.50366722858995, -82.74255866481451 35.503632228576684, -82.74236866479784 35.50353422853729, -82.74184066474635 35.503296228434735, -82.74170666473444 35.50322822840712, -82.74158766472554 35.503156228380256, -82.74146566471855 35.503069228350085, -82.74137566471636 35.50298622832398, -82.74129266471192 35.50292422830279, -82.74120066470434 35.50287422828323, -82.74104166468486 35.50282822825759, -82.74081466465525 35.502774228223316, -82.74054166461698 35.50272722818582, -82.74035566459034 35.50269922816115, -82.74019666456753 35.50267522814002, -82.73973766450042 35.5026142280806, -82.73953066446944 35.50259122805474, -82.73939266444894 35.502575228037365, -82.73908766440076 35.502558228002755, -82.73868566433472 35.5025522279604, -82.73838666428468 35.50255422793028, -82.73810566423754 35.50255622790192, -82.73757866414377 35.50259522785605, -82.73678566400585 35.50263422778287, -82.73643366394379 35.502656227751366, -82.73495866368079 35.50277022762384, -82.73435666357341 35.50281722757184, -82.73401066350638 35.50287822754888, -82.73384866347303 35.50292022754086, -82.7338276634686 35.50292622753997, -82.73361066342271 35.50299022753087, -82.73310166331451 35.50314322750999, -82.73296566328442 35.503192227506084, -82.73286266326133 35.50323122750348, -82.73275166323823 35.50326122749827, -82.7327906632648 35.503130227475566, -82.73280366327323 35.50308922746852, -82.73283066330967 35.502880227428676, -82.73281866333161 35.502723227395435, -82.73280866335082 35.50258722736665, -82.73279566337351 35.50242422733208, -82.73278666338811 35.50231922730977, -82.73272166350021 35.50151522713918, -82.73270066353756 35.50124822708255, -82.73269866354079 35.501225227077654, -82.73269266354977 35.50115922706359, -82.73269166355298 35.50113722705898, -82.73269066355407 35.50112922705727, -82.73268866355724 35.501106227052375, -82.73268866355828 35.50109922705096, -82.73265066362138 35.500645226954504, -82.73258366373744 35.499813226778, -82.73256966377784 35.4995342267196, -82.732569663791 35.499447226701925, -82.73257966380956 35.49933722668052, -82.73258866381934 35.49928322667042, -82.73259766382817 35.499235226661526, -82.73262666385106 35.499117226640436, -82.73266666387664 35.49899322661923, -82.73273366390904 35.49885422659772, -82.73280166393756 35.49874222658182, -82.73295166399168 35.498551226558305, -82.73311266404494 35.498378226539465, -82.73342366414552 35.49805922650621, -82.73441766446591 35.497045226401006, -82.7346546645439 35.49679422637402, -82.73518966471532 35.49625522631881, -82.73563766486005 35.495796226271, -82.7363756650983 35.495041226192534, -82.73645066512243 35.49496522618464, -82.73665066518618 35.494766226164494, -82.73667666519471 35.4947382261615, -82.73675066521882 35.49466122615336, -82.73683066524515 35.49457622614415, -82.73698566529544 35.494416226127406, -82.73715966535144 35.49423922610911, -82.73731666540269 35.49407522609172, -82.73747466545603 35.493898226071764, -82.73759466549969 35.49374322605249, -82.73765566552352 35.4936532260403, -82.73770466554241 35.493583226031014, -82.73778266557602 35.49344822601145, -82.7378276655969 35.493361225998335, -82.73787966562213 35.49325222598146, -82.73795166565705 35.493102225958225, -82.73798466567523 35.493019225944636, -82.73801666569621 35.492917225927116, -82.73805366571992 35.492802225907454, -82.73805966572363 35.49278422590443, -82.73811066575874 35.49261022587407, -82.73828066587458 35.4920372257746, -82.73833766591329 35.49184622574148, -82.73844666598733 35.49148022567797, -82.73877666620953 35.490386225488635, -82.73888666628356 35.49002122542544, -82.7389056662967 35.48995622541418, -82.73896366633568 35.48976422538086, -82.73898366634882 35.48970022536989, -82.73902366637711 35.48955822534508, -82.73906966640898 35.48940022531754, -82.73914966646261 35.489136225271885, -82.7391926664911 35.48899622524769, -82.73921566650702 35.48891722523392, -82.73928766655466 35.4886842251938, -82.7393116665706 35.48860622518032, -82.73933066658407 35.48853822516837, -82.73943466665466 35.488189225107874, -82.73972666685191 35.48721722493947, -82.73981066690817 35.48694022489155, -82.73993666699275 35.48652422481961, -82.73999166703017 35.48633922478754, -82.74012266711917 35.48589922471116, -82.7401576671422 35.48578622469166, -82.74021366717972 35.485602224659885, -82.74022566718811 35.48556022465257, -82.74024666720291 35.485486224639594, -82.7403496672732 35.48513822457914, -82.74038466729665 35.48502322455929, -82.74045866734753 35.48477022451522, -82.74050066737584 35.48463122449124, -82.7406036674524 35.48424222442246, -82.74065666749716 35.484006224379655, -82.74071366754463 35.48375822433495, -82.74071466754596 35.48375022433342, -82.74074366757495 35.48359222430417, -82.74078666761683 35.4833652242623, -82.74082566766116 35.483117224215654, -82.74085166768963 35.4829592241861, -82.74085866769784 35.48291322417747, -82.74091266777535 35.48246422409141, -82.74091266777697 35.482454224089366, -82.74095566786033 35.48195522399195, -82.7409576678686 35.48190322398159, -82.74097466793455 35.481490223899094, -82.7409836680012 35.48106322381294, -82.74097966802061 35.48093222378584, -82.7409686680791 35.48053722370414, -82.74096266809521 35.48042522368072, -82.7409596681037 35.48036622366834, -82.74095066812902 35.48019022363152, -82.74094766813745 35.480132223619464, -82.740945668142 35.48010022361272, -82.74093966815522 35.480007223593056, -82.74093866815971 35.47997622358663, -82.74093266817772 35.479852223560734, -82.74092366820413 35.47966922352252, -82.74092366820626 35.479655223519714, -82.74092266820809 35.479642223516905, -82.74091466823151 35.47948022348309, -82.74090966824947 35.47935722345748, -82.74088866831333 35.478916223365445, -82.74082666850506 35.477593223089286, -82.74080666856891 35.47715322299747, -82.74079466860739 35.47688822294226, -82.74078066864608 35.476619222885965, -82.74078066864779 35.47660822288367, -82.74070266888405 35.47497622254289, -82.74067766896293 35.474432222429385, -82.74067266897913 35.474320222406114, -82.74062966911156 35.47340622221529, -82.74062166913235 35.47326122218495, -82.74061766914701 35.47316122216411, -82.74059766920963 35.47272922207396, -82.74059366922113 35.47264922205722, -82.74058166925576 35.47240922200712, -82.74057866926752 35.472329221990464, -82.74057466927923 35.47224822197357, -82.74056866929594 35.47213222194928, -82.74054366938203 35.471541221826186, -82.74053566941073 35.47134422178519, -82.74053166942285 35.47126022176763, -82.74051966945905 35.47101022171543, -82.7405156694711 35.470927221698155, -82.74050566949728 35.470744221659785, -82.74049466952974 35.470520221612944, -82.74047566955552 35.47033022157228, -82.74045666957267 35.47019722154328, -82.74044866958016 35.47013922153061, -82.74041666959317 35.47001922150289, -82.74039466960187 35.46993822148409, -82.7403446696178 35.46977922144658, -82.74032266962536 35.469706221429384, -82.74019766964585 35.469435221361415, -82.74002366966374 35.469128221281025, -82.74001166966485 35.469108221275725, -82.73988166967568 35.468895221219036, -82.73982566968031 35.46880422119473, -82.73980266968194 35.46876822118506, -82.73959566969722 35.46844222109745, -82.73956366970006 35.468389221083356, -82.73948766970676 35.46826222104967, -82.73942466971181 35.46816022102243, -82.73923666972726 35.46785422094079, -82.73917466973236 35.467753220913906, -82.73912866973593 35.467679220894105, -82.73902366974464 35.46750822084851, -82.73899166974707 35.46745722083487, -82.73894666975087 35.46738322081514, -82.73863766977607 35.46688122068124, -82.73824266980857 35.46623722050954, -82.73770966985063 35.465380220280394, -82.73769266985211 35.46535222027299, -82.73740466987668 35.464877220146654, -82.73736466987978 35.464813220129514, -82.7372476698895 35.46462222007858, -82.73720866989264 35.464559220061766, -82.73719166989395 35.46453222005456, -82.73714166989791 35.46445122003294, -82.73712566989944 35.464424220025734, -82.73695266991334 35.46414421995105, -82.73660166994175 35.4635752197991, -82.73658066994335 35.46354221979029, -82.73643466995517 35.463305219726976, -82.73626266996928 35.46302521965234, -82.73607666998461 35.46272221957155, -82.73594666999675 35.46250021951305, -82.73588467001316 35.462325219471026, -82.73587367002237 35.46225321945515, -82.73585967003517 35.4621542194336, -82.73587267005286 35.46205221941409, -82.73589467007392 35.46193821939307, -82.73591567008813 35.46186821938095, -82.7359346701009 35.46180521937009, -82.73601567014077 35.46163221934305, -82.73641467032462 35.46086221922679, -82.7367046704565 35.46031421914468, -82.73683567051752 35.460057219105686, -82.73690867055582 35.459886219078285, -82.73691667055958 35.45987021907584, -82.73696567059423 35.45969621904537, -82.73699967062232 35.45954921901887, -82.73700767064608 35.45940221898972, -82.73699867066982 35.459237218955124, -82.73699167067537 35.45919321894546, -82.73697267069142 35.459067218917774, -82.73696567069561 35.45903221890997)))",6556,37,021,002401,370210024013,1445,1445,53,1414,1362,14,7,10,0,21,31,1177,33,1144,1156,1121,8,6,7,0,14,21,740,620,120
census_2010_blockgroups_view.fid--2dc29038_13ec899ba8f_-263e,"MULTIPOLYGON (((-82.5747076197894 35.61507223408235, -82.57478561983561 35.61485623404641, -82.57488061984942 35.6148692340588, -82.57505661985863 35.614999234103365, -82.57521261986854 35.615103234140584, -82.57568361993326 35.61519123420686, -82.57577961994346 35.61522823422424, -82.5760336199706 35.61532623427036, -82.576092619977 35.615348234280916, -82.57625561999436 35.61541123431043, -82.5762726199972 35.6154112343122, -82.57633662000782 35.61541123431877, -82.57644962002877 35.61539723432754, -82.57661962005989 35.615378234341115, -82.57673562005957 35.615505234378944, -82.57681362005948 35.6155902344042, -82.57699362007398 35.61569023444311, -82.57775561992817 35.61745823488137, -82.57833661981682 35.61880723521571, -82.57954161970402 35.620838235753126, -82.57973861968571 35.62116923584077, -82.5798546196748 35.62136523589262, -82.58063661960156 35.62268323624132, -82.58210961960707 35.62423523670875, -82.58276561964459 35.62469923687062, -82.58388061979059 35.62495423703717, -82.5852876199749 35.6252752372471, -82.58669562015945 35.62559623745712, -82.58691862018865 35.625647237490426, -82.58705262022035 35.625586237491774, -82.5883456205265 35.62499423750412, -82.58959462082225 35.624422237515994, -82.59038362100901 35.62406123752354, -82.59101262113272 35.623937237562885, -82.5935206216258 35.623442237719686, -82.59502262192127 35.62314523781358, -82.59602762211888 35.622947237876446, -82.59673762225844 35.62280723792095, -82.59692862228438 35.62284523794829, -82.59766862238459 35.622993238054455, -82.59816962245245 35.62309323812624, -82.59867162252033 35.623194238198415, -82.59923762259703 35.623307238279615, -82.59943362260852 35.6234442383276, -82.6002376226554 35.624007238525, -82.6005656226637 35.62430723861967, -82.60093062267131 35.6246512387273, -82.60117762267654 35.624884238800064, -82.6017886226892 35.62546123898036, -82.60183762269023 35.625507238994764, -82.60184362267623 35.62560423901515, -82.60185362265301 35.62576623904921, -82.60186562262876 35.62593623908503, -82.60188862258137 35.62626823915501, -82.60191462251575 35.62672223925021, -82.6019926223183 35.6280872395362, -82.60201962225271 35.62854223963168, -82.60119462174417 35.63095124003761, -82.60082562151614 35.63203224021988, -82.60075462145905 35.63232624027246, -82.600583621321 35.633037240399695, -82.60041162118281 35.63374824052683, -82.60003062087655 35.63532324080847, -82.59988562073029 35.63611524095491, -82.59946962031138 35.6383832413741, -82.59933662017689 35.63911224150897, -82.59915461989219 35.64076224182631, -82.5991466198796 35.64083524184035, -82.59913861986709 35.64090724185423, -82.59890261984084 35.640823241812875, -82.59829661977352 35.64060624170639, -82.59800061971752 35.64065024168494, -82.59750261963556 35.64064524163274, -82.5971326195843 35.6405782415811, -82.59707961957703 35.640568241573575, -82.59702361956835 35.64056424156694, -82.5967286195228 35.64054124153197, -82.596577619497 35.64054624151748, -82.59608861941308 35.640563241470645, -82.59591561937977 35.64059224145881, -82.59585761936872 35.640601241454725, -82.59568661933604 35.64062924144276, -82.5956306193252 35.64063924143911, -82.5955916193177 35.64064524143633, -82.5954546192897 35.64067924142911, -82.59509561921288 35.640790241414855, -82.59446961910241 35.64083224135902, -82.59426361907227 35.640805241332366, -82.59422661906797 35.64079324132621, -82.59406961904932 35.6407452413002, -82.59390861903609 35.64065724126581, -82.59385461902953 35.64064124125694, -82.59361861900734 35.64053124121031, -82.59336261898001 35.640432241163836, -82.5932286189628 35.64039924114338, -82.59303961894327 35.64032224110821, -82.59237961886144 35.64014124100348, -82.59231261885543 35.640108240989946, -82.5921776188364 35.640086240971506, -82.59194861879743 35.640092240949194, -82.59180061876015 35.64017424095072, -82.59176061873721 35.640279240968006, -82.59173361871579 35.640389240987595, -82.59161961865632 35.640652241029436, -82.5915386186377 35.640685241027874, -82.59143761863358 35.64060324100077, -82.59139761863545 35.64054824098544, -82.59136961864098 35.64048224096909, -82.59132961864113 35.64043824095605, -82.59128261865615 35.64029024092112, -82.59128661867189 35.6401922409016, -82.59130861874188 35.6397622408162, -82.59128861875462 35.63965824079304, -82.5910466188068 35.6390592406461, -82.59091161880548 35.6389222406044, -82.59067661879442 35.63874024054318, -82.59035261876684 35.63857024047524, -82.59001661874153 35.638372240400365, -82.58981461871984 35.63829524036395, -82.58961261870132 35.63819724032314, -82.58947061868453 35.63815324029963, -82.58930261866092 35.63812524027665, -82.58919461863952 35.63814724027008, -82.58914061862545 35.638180240271225, -82.58908761860819 35.638235240277, -82.58906061859183 35.638312240289885, -82.58905361857283 35.638428240312734, -82.58911461847879 35.63910324045655, -82.5891076184742 35.63912524046026, -82.58889961840988 35.63931824047817, -82.58879161838514 35.639362240476004, -82.58871061836834 35.6393842404722, -82.5885426183413 35.63937824045376, -82.58825961831269 35.63925824040018, -82.58803061829337 35.63913724035201, -82.58780161827906 35.6389832402971, -82.5877206182825 35.63887324026637, -82.58761961829288 35.63869724022019, -82.58753261828863 35.638631240197704, -82.58744461828077 35.63858724017977, -82.5873106182643 35.638549240158234, -82.58722961825772 35.63850524014099, -82.5871756182504 35.638494240133184, -82.58705461824215 35.63841724010507, -82.58698661825457 35.63826324006674, -82.5867716182494 35.63806524000429, -82.5866576182389 35.63801023998136, -82.58661661823727 35.63797723997043, -82.58654961822948 35.637955239959034, -82.5864956182254 35.63792323994703, -82.58609161817783 35.63779623987961, -82.58588961814773 35.63777423985438, -82.58568761811418 35.637774239833576, -82.58539161805982 35.63780723980985, -82.58512861800834 35.637857239793036, -82.58500161799066 35.63783523977547, -82.58493361797936 35.637835239768535, -82.58467761792662 35.63790123975564, -82.58457061790114 35.63795123975486, -82.58451661789066 35.63796123975132, -82.5842946178401 35.638049239746415, -82.5839846177666 35.638192239743695, -82.58393061775665 35.63819823973933, -82.58370861770283 35.6383082397389, -82.58364161768489 35.638352239740975, -82.58356761766915 35.638374239737836, -82.5833516176163 35.638484239738105, -82.58312361756748 35.63855523972913, -82.58301561753939 35.63862123973137, -82.5830066175368 35.63862823973196, -82.58294861751804 35.63868723973795, -82.58291461748854 35.638841239765846, -82.5828746174752 35.6388852397707, -82.58284061744841 35.63902223979515, -82.5827266173836 35.63931923984392, -82.5823696172513 35.63979223990351, -82.58218161719383 35.63996223991879, -82.58208661716961 35.640017239920255, -82.5819116171362 35.640045239907984, -82.58176361711578 35.64001723988705, -82.58152161710012 35.6398582398298, -82.58139361709758 35.639737239791984, -82.5812786171039 35.639572239746535, -82.5811776171177 35.63937423969584, -82.58108361711376 35.63929823967066, -82.58098261710374 35.63925423965142, -82.58093561710103 35.63922123963984, -82.58076061707702 35.63918823961509, -82.58069361707099 35.63915523960148, -82.58065561706319 35.63916523959965, -82.58061261705413 35.63917723959761, -82.5805586170401 35.639210239598775, -82.5804916170265 35.63922623959517, -82.58043261701174 35.63925823959568, -82.58039061700119 35.63928123959597, -82.58021661695534 35.63939123960049, -82.57995961688718 35.63955623960768, -82.57987861687126 35.63957223960264, -82.57982461685717 35.63960523960375, -82.57974461683884 35.63963823960232, -82.57957661680483 35.63967723959297, -82.57952561679612 35.639679239588105, -82.57944861678267 35.63968323958104, -82.57927361675713 35.63966023955836, -82.57922161675233 35.639635239547964, -82.57920561675067 35.63962823954486, -82.57906361673547 35.6395742395192, -82.57901061672956 35.6395552395099, -82.57889561671712 35.639512239489406, -82.57873461670397 35.63942423945483, -82.57848561667855 35.63932023940814, -82.57846561667607 35.63931523940507, -82.57841861667002 35.63930323939773, -82.57813561664152 35.63918323934422, -82.57785261661074 35.639078239293724, -82.5774626165636 35.63896323923022, -82.57736761655028 35.63894723921726, -82.57731361654658 35.63891323920471, -82.57723361653652 35.638892239192245, -82.57717961653277 35.638858239179775, -82.57703161651744 35.6387982391523, -82.57686261650635 35.638688239112525, -82.5768226165056 35.63865023910068, -82.57674161650658 35.63855623907323, -82.57671461651057 35.638501239059266, -82.57662061651352 35.638381239025186, -82.57656661650955 35.63834823901286, -82.57653961651526 35.63828223899668, -82.5764536165147 35.63819323896972, -82.57629061651389 35.63802323891832, -82.57621661651115 35.63796123889812, -82.57627161652535 35.63792823889702, -82.5763376165334 35.63794723890767, -82.57623461653576 35.63782123887142, -82.57617161652718 35.637809238862474, -82.5754886165273 35.63707223864222, -82.57556461654701 35.637026238640686, -82.57544261654789 35.636889238600254, -82.57532561654845 35.63675923856176, -82.57527761654886 35.636705238545844, -82.57521661654367 35.63667323853309, -82.57524061655917 35.63659823852023, -82.57524461656332 35.63657623851618, -82.57530161661255 35.6363182384695, -82.5753016166184 35.636280238461715, -82.57530161663382 35.63618023844141, -82.57530061666971 35.635946238393636, -82.57530061673 35.63555523831399, -82.57531661678037 35.635246238252776, -82.57531861678457 35.63522123824783, -82.57533661680455 35.635111238227275, -82.57537361682445 35.63502223821297, -82.57538361683002 35.63499623820869, -82.57544661685846 35.634880238191535, -82.57552261688679 35.63477823817862, -82.57560261691617 35.63467423816564, -82.575667616943 35.63457023815117, -82.57570261696534 35.63446323813297, -82.57572661698985 35.63433023810833, -82.57574061701203 35.63420123808353, -82.57576061705086 35.63397123803872, -82.57578761709927 35.63368623798346, -82.5758096171392 35.63345123793792, -82.57581661715047 35.63338523792515, -82.57587561723128 35.63292523783756, -82.57590261726257 35.63275123780493, -82.57591761727855 35.63266423778878, -82.57594561730532 35.63252023776233, -82.57600361735958 35.63223123770944, -82.57604161739982 35.63201123766852, -82.57604661740932 35.63195523765762, -82.57606961744473 35.63175023761824, -82.57608561748333 35.63151723757254, -82.57611261755854 35.63105823748178, -82.57611161758724 35.63087123744358, -82.57608561762022 35.630629237391666, -82.57604961765716 35.63035123733138, -82.57602961767066 35.63024223730706, -82.57601161768349 35.63013923728428, -82.57596561770352 35.62996023724312, -82.57591361771979 35.62979823720472, -82.57586661772811 35.62969423717877, -82.57581961773552 35.629595237153744, -82.57567961775767 35.62930023707932, -82.57567461775857 35.62928923707653, -82.5756266177634 35.62920623705472, -82.57558061776808 35.629126237033674, -82.57552661776977 35.62905723701412, -82.57546461777147 35.628979236991796, -82.57530161776843 35.628823236943326, -82.57526161777032 35.62876823692798, -82.5752186177749 35.62869223690809, -82.57520461778122 35.62863623689531, -82.57519361778678 35.628588236884376, -82.57519561780445 35.62847523686163, -82.5751976178073 35.6284592368585, -82.57520761782351 35.62836523684037, -82.57521161782873 35.62833523683472, -82.57521461786044 35.628133236793865, -82.5752086178673 35.62808223678289, -82.57519961788014 35.62798923676306, -82.57519261788994 35.62791823674785, -82.57515661791243 35.6277332367065, -82.5751346179274 35.62761223667957, -82.57511461795252 35.62742823664004, -82.57508361797805 35.62722923659635, -82.57507361799932 35.627080236565014, -82.57508261801918 35.626961236541696, -82.57509261804044 35.62683423651687, -82.57510361806244 35.62670323649127, -82.57510361806416 35.626692236489035, -82.57510561806936 35.62666023648272, -82.57510761807131 35.62665023648091, -82.57513161811794 35.626373236426986, -82.57515461815065 35.626186236391234, -82.57519261820285 35.62588823633451, -82.57527361828141 35.6254662362569, -82.575327618317 35.62529323622725, -82.5753846183465 35.62516323620658, -82.57546961838145 35.62502823618781, -82.57557561842026 35.6248912361709, -82.57558361842328 35.62488023616946, -82.57587761852787 35.62451823612593, -82.57595661855575 35.62442323611469, -82.57609861860529 35.6242542360949, -82.57619261863911 35.62413623608052, -82.57627061866692 35.624040236069014, -82.57639361871011 35.623892236051525, -82.57643461872469 35.623842236045554, -82.57690061888854 35.62328123597918, -82.5769286188977 35.623252235976125, -82.57704261893443 35.62313723596439, -82.57711661895581 35.62307823596003, -82.57717261897214 35.62303223595644, -82.57718761897634 35.62302123595573, -82.57732161901075 35.6229422359534, -82.57736161901944 35.622929235954864, -82.57743061903413 35.62290823595764, -82.57739661904094 35.62282723593767, -82.5772966190614 35.62258723587855, -82.57726361906825 35.622507235858926, -82.57721561907765 35.6223942358309, -82.5771536190905 35.62224423579406, -82.57708061910795 35.62205223574738, -82.57706561911156 35.62201223573778, -82.57703661911805 35.6219392357199, -82.5769116191454 35.62162723564352, -82.57687161915432 35.62152623561881, -82.57665661919272 35.62104523549883, -82.5764966192177 35.62071023541412, -82.57641361923093 35.62053523537004, -82.5763576192417 35.62040523533778, -82.57631861924948 35.62031223531482, -82.57626461926452 35.620156235277506, -82.57623761927974 35.62002923524887, -82.57619761931433 35.61976123519019, -82.5761626193464 35.61951523513652, -82.57609361938474 35.619192235063636, -82.57593761944968 35.61860323492773, -82.57572261953428 35.617822234746576, -82.57570561954118 35.61775923473207, -82.57559761957008 35.61745523465903, -82.57549761959334 35.617196234596015, -82.57538461961956 35.6169042345249, -82.5753756196215 35.616882234519544, -82.57534961962668 35.616820234504274, -82.57522661965173 35.616525234431506, -82.57510461967364 35.616251234363205, -82.57497861969408 35.61598323429573, -82.57486661970994 35.615759234238546, -82.5748446197119 35.615723234229, -82.57473661972139 35.61554523418168, -82.57461661972503 35.61539223413814, -82.5747076197894 35.61507223408235)))",6252,37,021,001500,370210015001,2158,2158,192,2091,1894,61,10,29,3,94,67,1741,124,1617,1708,1565,45,9,23,3,63,33,1099,975,124
census_2010_blockgroups_view.fid--2dc29038_13ec899ba8f_-263d,"MULTIPOLYGON (((-82.57230560981851 35.67709224646444, -82.57250960985567 35.677071246481134, -82.57258860987082 35.677058246486666, -82.57271860989565 35.67703724649572, -82.57297360994828 35.67697124650847, -82.57305260996432 35.67695224651278, -82.5734146100428 35.676834246526, -82.57363561008736 35.6767832465384, -82.57369461009705 35.67678424654462, -82.57389361012935 35.67678924656615, -82.57390661013149 35.67678924656749, -82.57427361018895 35.676812246609906, -82.57454161023026 35.67683324664176, -82.57475361026296 35.67685024666707, -82.57502261030352 35.67687724670027, -82.57506561030984 35.67688224670571, -82.57529161034542 35.67689524673156, -82.57537861035912 35.67690024674154, -82.57559861039556 35.67690124676439, -82.57582561042258 35.676970246801844, -82.57608561045352 35.67705024684488, -82.57603061043832 35.6770892468471, -82.57586761039293 35.677207246854366, -82.57581361037782 35.67724724685693, -82.5756866103426 35.67733824686249, -82.57548961028841 35.677477246870545, -82.57495461014055 35.67785824689298, -82.57454461002924 35.678137246907625, -82.57451461002103 35.678158246908865, -82.57429960996194 35.67830924691743, -82.57419060993175 35.678387246922114, -82.57386560984196 35.67861824693578, -82.573814609828 35.6786542469378, -82.57365160978203 35.67877624694591, -82.57355560975195 35.67886724695455, -82.57348160972764 35.67894524696282, -82.57339360969858 35.679038246972695, -82.57317560961567 35.67934024701174, -82.57293960951925 35.67971024706282, -82.57269360941807 35.68010024711692, -82.57266360940562 35.680148247123626, -82.57264960939946 35.6801732471273, -82.57252860934426 35.68040024716101, -82.57248860932587 35.680476247172436, -82.57244960932081 35.68046724716661, -82.57228660929295 35.680472247150846, -82.57211760926242 35.680487247136526, -82.57192360922204 35.68054024712729, -82.57164860916313 35.6806252471163, -82.57149360912977 35.68067424711031, -82.57144160911865 35.680690247108224, -82.57056560892883 35.68097624707631, -82.57025660886183 35.68107724706507, -82.5698856087819 35.68119524705089, -82.56923860864107 35.68141024702816, -82.56919160863063 35.68142724702673, -82.56893760857348 35.68152424702032, -82.56871860852266 35.68161724701676, -82.56839960844697 35.68176324701373, -82.56818060839502 35.681864247011674, -82.56783660830739 35.68206124701639, -82.56775860828762 35.68210524701732, -82.56763660825617 35.68217724701947, -82.56732460817265 35.682382247029054, -82.56706460810018 35.682571247040784, -82.56682760803204 35.68275724705428, -82.56636460789026 35.68317624709195, -82.56632160787676 35.68321724709588, -82.56586660773235 35.68366224713968, -82.56566160766766 35.683860247158925, -82.56520460752255 35.6843072472029, -82.56505060747337 35.68445924721793, -82.56499560745578 35.68451424722351, -82.56484560740871 35.68465724723718, -82.56479660739349 35.68470324724148, -82.56472260736989 35.684776247248735, -82.56435960725373 35.685137247284906, -82.56423960721503 35.68525824729718, -82.56418560721207 35.685219247283726, -82.5641426072071 35.68520524727646, -82.56382660717038 35.685103247223125, -82.563721607158 35.68507024720555, -82.56364460714883 35.68504624719278, -82.56361660714552 35.68503824718821, -82.56342660712627 35.684958247152416, -82.5634226071257 35.68495724715176, -82.5633456071156 35.68494024714043, -82.56323160710063 35.68491424712337, -82.5631836070936 35.68490824711716, -82.56291260705301 35.684879247083465, -82.56269360701819 35.68486924705883, -82.56252960699203 35.68486224704053, -82.56246260697219 35.684918247045026, -82.5624346069637 35.684943247047215, -82.5623156069238 35.68507324706146, -82.56230160691443 35.68511924706944, -82.5622936069084 35.68514924707464, -82.5622966069001 35.68520624708662, -82.56229860689223 35.68525924709766, -82.56233460687794 35.685390247128005, -82.56240360686559 35.685544247166405, -82.56243060686378 35.68558524717755, -82.56250260685839 35.68569724720778, -82.56267060683555 35.686025247291845, -82.56273160681694 35.686211247336026, -82.5627496068094 35.68627924735181, -82.5627696068008 35.686356247369474, -82.56280460676476 35.686627247428255, -82.56277760675069 35.686689247438146, -82.56276260674606 35.68670324743944, -82.56275360674333 35.686711247440144, -82.56273460673762 35.68672724744143, -82.56267460671872 35.686785247447006, -82.56210560653963 35.68733124749962, -82.5620256065148 35.687406247506686, -82.56202460651424 35.687408247506966, -82.56201160651027 35.68742024750806, -82.56182960645194 35.68760124752623, -82.56160660638075 35.6878222475483, -82.56159760637804 35.68783024754899, -82.56114460623402 35.68827424759272, -82.56090060615608 35.68851624761691, -82.56066960608207 35.68874624763992, -82.56064360607401 35.688770247642196, -82.56056860605013 35.688844247649506, -82.56054460604213 35.68887024765232, -82.56045060601339 35.68895524766003, -82.560432606008 35.68897024766114, -82.56028560596322 35.689102247672935, -82.56008560590534 35.68926124768469, -82.5600456058936 35.689294247687286, -82.55996460587144 35.68935024769035, -82.55976760581763 35.689486247697744, -82.55971360580398 35.68951624769832, -82.55948760574623 35.68964724770177, -82.55937460571882 35.68970324770151, -82.55934560571166 35.68971824770152, -82.55921660568012 35.68978324770157, -82.55890260560798 35.68991224769545, -82.55861560554602 35.69000424768465, -82.55856060553428 35.69002124768244, -82.5585446055307 35.69002724768206, -82.55839460550003 35.690064247674115, -82.55833960548857 35.69007924767146, -82.55820060546007 35.69011424766432, -82.5581796054556 35.69012024766333, -82.55777760537855 35.69018624763546, -82.5576696053578 35.69020424762795, -82.55763660535189 35.69020724762519, -82.55730460529182 35.69023924759751, -82.55714460526434 35.69024424758209, -82.55700860524101 35.69024924756907, -82.55650060516055 35.6902232475115, -82.55644660515208 35.690220247505295, -82.5558256050646 35.69011824742061, -82.55567960504644 35.69007924739763, -82.55536860500729 35.68999824734909, -82.55520760498929 35.68994124732096, -82.55511060497855 35.689906247303846, -82.55488760495403 35.68982524726439, -82.55482460494838 35.68979424725156, -82.55473260494006 35.68974924723295, -82.55449860491882 35.68963524718559, -82.55447760491718 35.689623247181025, -82.55423160489839 35.68948024712657, -82.55397260488293 35.689302247063715, -82.55377660487476 35.6891442470113, -82.55370060487157 35.689083246991125, -82.55356760486944 35.68895424695117, -82.55338560486639 35.68877824689653, -82.55337760486617 35.68877124689427, -82.55326060486429 35.68865724685903, -82.55282260486067 35.68821024672294, -82.55263860485924 35.6880222466657, -82.55244960485747 35.6878302466072, -82.55188360485205 35.687257246432274, -82.55172360485047 35.687095246382746, -82.5516956048502 35.6870672463742, -82.55152060484816 35.68689224632056, -82.55147460484766 35.6868462463064, -82.55127660484114 35.68667524625124, -82.55105560482905 35.68651624619608, -82.55093160481896 35.68644824616949, -82.55073860480313 35.68634324612824, -82.55071360480038 35.686334246123856, -82.55056460478399 35.68628024609746, -82.55044460477066 35.6862372460764, -82.55011060472829 35.68615224602472, -82.550108604728 35.686152246024484, -82.54995460470506 35.68613524600522, -82.54976860467737 35.68611424598179, -82.54954960464049 35.68611724595982, -82.54926960459333 35.6861212459318, -82.5488646045214 35.686151245896205, -82.54833360442849 35.686181245847656, -82.54819560440421 35.686190245835284, -82.547929604357 35.686209245811725, -82.54781560433699 35.68621624580148, -82.54761060430063 35.68623124578341, -82.54747360427682 35.68623824577066, -82.54736060425705 35.686244245760264, -82.54719660422847 35.68625324574523, -82.54602260402123 35.68633124564028, -82.54501460384398 35.68639424554925, -82.54404860367394 35.68645624546248, -82.54309460350578 35.68651824537683, -82.54277560344998 35.686536245347604, -82.54239760338378 35.68655824531315, -82.54199160331103 35.68659224527836, -82.54190960329638 35.68659924527133, -82.54150960322299 35.68664424523926, -82.54099360312313 35.68673524520462, -82.54071360306706 35.68679724518843, -82.5404726030186 35.68685124517461, -82.54035560299374 35.68688624516968, -82.53994360290613 35.6870102451525, -82.53988560289373 35.68702824515021, -82.53961360283475 35.68711724514028, -82.53951860281435 35.68714724513661, -82.53923460275311 35.687238245125926, -82.53914060273267 35.687269245122586, -82.53858660261318 35.68744624510153, -82.53856660260877 35.68745324510089, -82.53821660253045 35.687583245091304, -82.53790460245787 35.687718245086664, -82.53757160237403 35.68790224508992, -82.53723960228193 35.68814124510431, -82.5370786022325 35.688287245117436, -82.53699960220797 35.6883612451244, -82.53676360212512 35.68864324515746, -82.53670660210204 35.68873124516955, -82.53646460200487 35.689099245219545, -82.5360336018315 35.68975724530903, -82.53590660178624 35.68991324532778, -82.53577460174495 35.69003824533964, -82.53565160171028 35.69013024534571, -82.5356126016991 35.69016024534771, -82.53534260163146 35.69030824535005, -82.53526560161382 35.69033924534849, -82.53500660155449 35.690444245343095, -82.53471060149504 35.69051124532631, -82.53470660149436 35.6905112453259, -82.53450860145801 35.69053324530995, -82.53418960140628 35.69052524527548, -82.5338326013528 35.69048724523106, -82.53337760128832 35.69041524516946, -82.53320560126366 35.690390245146666, -82.53296160122854 35.6903552451144, -82.53280960120661 35.69033424509452, -82.53238360114656 35.690264245036374, -82.53214560111323 35.69022424500368, -82.53209360110581 35.690216244996684, -82.53143060101085 35.6901182449085, -82.53119260097681 35.69008324487681, -82.53094660094166 35.690046244843955, -82.53020960083606 35.68993724474586, -82.52996460080097 35.68990124471336, -82.5298446007839 35.68988224469713, -82.5294866007328 35.6898282446492, -82.52936760071569 35.689811244633546, -82.5292526006992 35.68979424461827, -82.52917160068765 35.689782244607436, -82.5285836006026 35.689700244530194, -82.52851060059203 35.689690244520676, -82.52838760057365 35.68967724450529, -82.52805460052375 35.68964224446395, -82.52790860049998 35.68963924444826, -82.52764260045636 35.68963524442002, -82.52705660035343 35.689671244366956, -82.52652860025219 35.68975924433057, -82.526478600242 35.68977124432782, -82.52601460014618 35.689892244304666, -82.5259826001395 35.6899012443032, -82.5258026000997 35.68996524429767, -82.52536560000264 35.69012324428481, -82.52516959995921 35.690193244278866, -82.52495959991255 35.69026924427278, -82.52485159988844 35.69030924426977, -82.52452759981608 35.690429244260784, -82.5244205997919 35.69047024425814, -82.52438559978421 35.69048224425694, -82.52428259976129 35.690520244254074, -82.52424859975348 35.69053424425344, -82.52408659971732 35.690594244248985, -82.52340759956539 35.69084724423054, -82.52291059944609 35.691084244227575, -82.52257959935895 35.69129224423583, -82.52228359927354 35.69152624425296, -82.5216435990747 35.692124244308744, -82.52159759906061 35.69216624431255, -82.52146059901798 35.692294244324444, -82.52141559900389 35.69233724432858, -82.52138459899423 35.69236624433132, -82.52128959896436 35.69245724434007, -82.52091259884556 35.6928202443751, -82.52078759880602 35.69294124438681, -82.52064559876277 35.69306824439807, -82.52058759874497 35.69312124440294, -82.52032159866701 35.6933392444198, -82.52020159863407 35.69342324442452, -82.52004659859129 35.69353324443094, -82.5198295985367 35.693653244433044, -82.51964759849076 35.693755244435074, -82.51942259843769 35.69385624443243, -82.5192065983904 35.693930244425225, -82.51914859837821 35.693946244422506, -82.51894459833484 35.694007244413875, -82.51891059832788 35.69401624441226, -82.51878559830236 35.69404724440568, -82.51868259828106 35.69407424440055, -82.51840859822846 35.694120244381715, -82.51840459822758 35.69412124438149, -82.51828159820504 35.694135244371665, -82.51813759817864 35.69415124436014, -82.51778359811732 35.694167244326835, -82.51746459806557 35.694159244292365, -82.51745359806375 35.694159244291235, -82.51705059800271 35.69412124424201, -82.51695859799025 35.69410324422882, -82.51683659797368 35.69407924421138, -82.51667459795169 35.69404724418822, -82.5162075978911 35.69393824411789, -82.51580859784107 35.6938332440554, -82.51507059774725 35.693647243941506, -82.51452159767744 35.693509243856894, -82.51427859764674 35.69344724381924, -82.51348859754646 35.69324724369712, -82.5133555975293 35.693215243676974, -82.51279659745742 35.69308024359185, -82.51254959742258 35.69304024355829, -82.51222459737076 35.69302624352199, -82.51192559731636 35.69305724349747, -82.51163959725884 35.6931222434812, -82.5114165972094 35.69320224347457, -82.51062159702192 35.69356024346544, -82.51029659694515 35.69370724346194, -82.50992059685734 35.69387124345653, -82.50975059681849 35.693940243453085, -82.50962559678999 35.693990243450386, -82.50960359678521 35.69399724344952, -82.50930359672081 35.6940912434377, -82.5092785967158 35.69409724343642, -82.50898959665614 35.69417224342188, -82.50867859659462 35.69423624340285, -82.50831859652773 35.69428224337512, -82.50795959646454 35.69430524334278, -82.50780559643864 35.69430724332734, -82.50763659641005 35.694311243310764, -82.50730859635817 35.69429424327352, -82.50721259634295 35.6942892432626, -82.50698459630864 35.69426624323445, -82.50661659625302 35.69423124318943, -82.50607559617261 35.69417024312119, -82.50601759616406 35.694163243113785, -82.50576559612674 35.69413424308199, -82.50569659611666 35.694125243073, -82.5053835960703 35.69408924303347, -82.50527159605366 35.69407624301925, -82.5048475959879 35.694046242969485, -82.50445359591949 35.69406624293293, -82.5044435959176 35.69406724293207, -82.50427759588622 35.69409224292005, -82.50413459585815 35.69412024291103, -82.50410259586255 35.69405724289494, -82.50400759586469 35.693941242861555, -82.50392059585893 35.69388524284119, -82.50382759584681 35.69386424282729, -82.50376959583681 35.69386624282176, -82.50368659581929 35.69389024281804, -82.5035695957892 35.693959242820036, -82.50341659574684 35.69406924282668, -82.50324359569821 35.69419724283492, -82.50311659566249 35.694292242841115, -82.50302859563705 35.694362242846324, -82.50274559556121 35.69454824285498, -82.50250859550671 35.694646242850496, -82.502425595489 35.69467124284704, -82.50231159546964 35.69467424283591, -82.50217859545052 35.69465524281834, -82.50195459542385 35.69458724278143, -82.50154559538042 35.69442924270717, -82.50129159535422 35.694326242660004, -82.5010055953236 35.69421724260835, -82.50070559528899 35.6941192425575, -82.50051059526353 35.69407424252828, -82.50031359523463 35.69405024250306, -82.500174595209 35.694066242492, -82.50013759520208 35.69407124248923, -82.5000545951846 35.69409524248555, -82.49987359514016 35.694188242485794, -82.49959459506583 35.69436924249387, -82.4994725950369 35.69442524249273, -82.4993435950125 35.694444242483286, -82.49916959498924 35.69440824245799, -82.49901659496874 35.694376242435744, -82.49873159493043 35.69431824239458, -82.49856059490806 35.69427924236901, -82.49844559489281 35.694254242352045, -82.49841059488872 35.69424324234624, -82.49812059485411 35.694156242298675, -82.49803259484352 35.69413024228427, -82.49777759481756 35.694024242236466, -82.49738959477658 35.69387324216571, -82.49727559476487 35.693826242144446, -82.49699559473595 35.693713242092635, -82.49669759470517 35.69359224203727, -82.4963115946651 35.69343724196595, -82.49605259464025 35.693320241915416, -82.49581759461918 35.693204241867626, -82.49562559460202 35.69310924182852, -82.49552859459256 35.693066241809774, -82.49548859458854 35.69304924180218, -82.49538859457822 35.69300924178371, -82.49533559457264 35.69298824177404, -82.49522959456097 35.69295024175536, -82.49504959453786 35.69290624172784, -82.49495359452484 35.69288724171414, -82.49480559450458 35.69285924169317, -82.49447759445994 35.6927962416465, -82.49439759444887 35.692782241635435, -82.4939835943906 35.69271424157893, -82.49385259437408 35.692681241558745, -82.49375159436273 35.692646241541226, -82.49366059435332 35.69260924152431, -82.49344159433325 35.69250424148037, -82.49322859431514 35.692392241435634, -82.49319159431202 35.6923732414279, -82.49304859429805 35.69231024140038, -82.49284859427767 35.69222724136288, -82.49280159427282 35.69220824135421, -82.49276959426953 35.692195241348244, -82.49266359425953 35.6921462413274, -82.49265059425834 35.69214024132477, -82.49261959425573 35.69212324131813, -82.49254059424932 35.69208024130119, -82.49245659424236 35.692035241283406, -82.49237959423513 35.69199924126812, -82.49230659423091 35.6919482412503, -82.49223359422656 35.6918982412326, -82.49219359422426 35.69187024122275, -82.49209359422014 35.69178924119595, -82.49205759421929 35.69175624118556, -82.49196859421728 35.691674241159674, -82.49184059421741 35.69153624111842, -82.49166459421183 35.691383241069104, -82.49156859421026 35.691290241040306, -82.49154559421007 35.69126724103329, -82.49145459420599 35.69119624100951, -82.49139159420227 35.691152240994, -82.49136259420057 35.69113224098698, -82.49122059418752 35.69106424095847, -82.49119259418386 35.69105824095442, -82.49110759417238 35.69104124094216, -82.49080359412316 35.69103324090917, -82.49054659408077 35.69103124088231, -82.49053259407843 35.69103124088093, -82.4903755940515 35.69103724086588, -82.49031259404175 35.69103224085838, -82.49027859403655 35.69102924085428, -82.49017659402105 35.69102024084196, -82.49014259401578 35.69101824083803, -82.48993959398452 35.69100224081388, -82.48969059395282 35.690940240775575, -82.48958659394177 35.69090024075674, -82.48941959392783 35.69081124072149, -82.48911659390025 35.69066424066028, -82.48901759389078 35.69061924064089, -82.48886159387581 35.690549240610615, -82.48858659385061 35.69041724055542, -82.48835459383191 35.6902892405055, -82.48811659381377 35.69015124045291, -82.48781259378791 35.68999224038917, -82.48668659370094 35.68934724014198, -82.48652759368781 35.68926124010807, -82.48632759366427 35.689199240074856, -82.48622059365012 35.6891762400591, -82.48612759363522 35.68917224004874, -82.48588159359242 35.68918524002599, -82.48576159357097 35.68919524001571, -82.48559859354175 35.68920924000176, -82.48494859342291 35.689280239949156, -82.48456459335044 35.68933623992098, -82.48441259332186 35.68935823990979, -82.4841875932794 35.68939123989339, -82.48398059324276 35.68940623987503, -82.48395659323893 35.6894052398724, -82.48386759322456 35.689402239862574, -82.48380759321793 35.689381239852125, -82.48374159321033 35.689359239840876, -82.48373259320995 35.68935223983851, -82.48366159320682 35.6892962398198, -82.48359959320888 35.689216239797204, -82.48357459321143 35.689173239785866, -82.48353459321542 35.68910423976764, -82.48352259321655 35.689084239762416, -82.48350159322166 35.689029239749026, -82.4834635932305 35.688931239725186, -82.4834075932408 35.68880423969358, -82.483375593247 35.68873023967522, -82.48335359325092 35.688681239662955, -82.48330959325898 35.68858223963826, -82.48328959326327 35.6885332396263, -82.48327059326768 35.688484239614375, -82.4832545932715 35.68844223960413, -82.48320659328306 35.68831623957352, -82.48319159328692 35.688275239563644, -82.48310859330707 35.68805623951052, -82.48303559332604 35.68785523946218, -82.48284759337605 35.687331239336146, -82.48274359340438 35.687036239265474, -82.48268359341827 35.686882239227906, -82.4825825934468 35.686590239158136, -82.48249359347177 35.68633323909667, -82.48244659348214 35.68621623906804, -82.48242559348544 35.686172239056916, -82.48238159349255 35.686079239033425, -82.4822845934976 35.68594223899556, -82.48218459349812 35.68583223896293, -82.48204159349493 35.68569923892112, -82.48192659349463 35.68557823888462, -82.48181159349767 35.6854352388437, -82.48176459350086 35.68536423882444, -82.48173359350298 35.685317238811685, -82.48162159351934 35.68509123875418, -82.48155859353949 35.684894238707585, -82.4814865935761 35.684580238636286, -82.48142359360136 35.68434923858282, -82.48138459361093 35.68424623855783, -82.48132359362043 35.68411923852568, -82.48126759362643 35.684020238499805, -82.48117459362973 35.683899238465614, -82.48108459363496 35.68376923842986, -82.48083859364618 35.68343323833614, -82.48064559366038 35.68313423825545, -82.48059559366581 35.68304523823222, -82.48056059367165 35.68297023821336, -82.48051359368732 35.68281923817777, -82.48051059369872 35.682742238161815, -82.48052059372267 35.682598238133544, -82.4805295937336 35.68253723812206, -82.48053859374298 35.682486238112574, -82.48054759376448 35.68235723808732, -82.48054759378306 35.68223723806293, -82.48053759379822 35.68212823803972, -82.48046359385442 35.68168623794215, -82.48043559387902 35.68149723790082, -82.48042259389058 35.681408237881435, -82.4804205938912 35.681402237879986, -82.48040359389967 35.68132923786337, -82.48036359390649 35.681242237841566, -82.48030559391087 35.68115223781728, -82.48030059391071 35.681147237815736, -82.48022759390788 35.681087237795985, -82.48021659390749 35.681078237792995, -82.48008359389425 35.681021237767744, -82.4796675938463 35.68088523769722, -82.47942659381835 35.680807237656474, -82.479166593789 35.680718237611636, -82.47896859376574 35.680656237578575, -82.47873959374046 35.6805742375383, -82.47857759372181 35.68052123751087, -82.47797359365457 35.680308237405306, -82.47782759363824 35.680257237379855, -82.47768459361963 35.680224237358395, -82.4775535936011 35.680203237340635, -82.47741459357965 35.68019323732433, -82.47739259357579 35.680194237322254, -82.47731959356352 35.680195237314905, -82.47727159355533 35.68019723731038, -82.4771005935246 35.68021223729577, -82.47709059352263 35.680214237295196, -82.4770295935108 35.68022523729113, -82.47676059345797 35.68027823727421, -82.47661159343028 35.68029723726272, -82.47643759340102 35.68030023724535, -82.47613659335614 35.68026723720768, -82.47610459335195 35.68026023720297, -82.47594559333021 35.68023023718042, -82.4757195932968 35.68020323715168, -82.47560359327936 35.68019223713753, -82.475220593217 35.680184237096356, -82.47508159319523 35.680176237080445, -82.47496459317824 35.68016023706511, -82.4748435931627 35.68013123704677, -82.4745655931327 35.68002723699691, -82.4741235930886 35.67983823691299, -82.47402859307986 35.67979323689404, -82.47392959307173 35.6797392368728, -82.47383059306465 35.679679236850475, -82.47362259305089 35.67954523680178, -82.47354059304698 35.67948223678049, -82.47347959304147 35.679452236768135, -82.47324659302042 35.679339236721084, -82.47290959298647 35.67919723665744, -82.47262059295483 35.679092236606365, -82.47221359291035 35.678943236534124, -82.47213859290174 35.678918236521305, -82.4718765928713 35.67883423647716, -82.4716105928362 35.678776236437976, -82.4712535927905 35.67868823638334, -82.47108259277282 35.678619236351636, -82.47087059275735 35.678492236303995, -82.47075559275264 35.6783992362732, -82.47072659275229 35.67837023626435, -82.47036059274686 35.67801323615401, -82.46981559274363 35.677450235983315, -82.46967359274656 35.67727923593392, -82.46955759274684 35.67715323589629, -82.46949759274477 35.67710223587974, -82.46927459273671 35.676915235818754, -82.46884459271274 35.676609235712206, -82.46859559269521 35.67645623565539, -82.46846859268506 35.67638523562795, -82.46829059266655 35.67631423559505, -82.46807159264124 35.6762432355581, -82.46775959260326 35.67615423550788, -82.46756159257845 35.67610223547683, -82.4674265925589 35.67608423545935, -82.46731359253914 35.67609023544888, -82.46717959251326 35.67611423543995, -82.46704859248432 35.67616023543576, -82.46684859243757 35.6762482354331, -82.46667759239854 35.67631723542954, -82.46651659236294 35.67637523542467, -82.46632059232692 35.67639723540897, -82.46617559230546 35.67638123539077, -82.46606059228988 35.67635823537429, -82.46596359227675 35.67633923536043, -82.46535259220295 35.6761612352613, -82.46514759217746 35.67610623522898, -82.4649945921594 35.676059235203645, -82.46491159215572 35.67599423518188, -82.46490859216162 35.67595223517301, -82.46490659216431 35.67593323516887, -82.46492959217503 35.6758882351621, -82.46499759219392 35.6758392351592, -82.46507959221113 35.67581623516301, -82.46521959223354 35.67582123517842, -82.46543259226439 35.67585023520625, -82.46557859228828 35.67585223522167, -82.4657175923127 35.6758432352342, -82.465795592328 35.67582823523914, -82.46592359235258 35.67580623524791, -82.46615159239792 35.67575723526144, -82.46631659243232 35.6757122352692, -82.46644159246088 35.675662235272, -82.46652359248706 35.67558023526376, -82.46657959251012 35.67549123525139, -82.46660959252876 35.67540323523664, -82.46660959254903 35.67527223520997, -82.4665935925629 35.67516523518656, -82.46658259257948 35.675046235161204, -82.46662659260214 35.6749472351456, -82.4667095926284 35.67486623513773, -82.46684359266666 35.67476323513056, -82.46694059269804 35.674664235120474, -82.46698859272428 35.674546235101374, -82.46701659274653 35.67443223508105, -82.46705559277306 35.67430223505866, -82.4671045927991 35.67418723504029, -82.46717759282912 35.67407123502423, -82.46722859285494 35.67395923500669, -82.46723559287399 35.67384323498381, -82.46719559288518 35.67372823495634, -82.46712459289371 35.67359723492233, -82.46706859290623 35.6734562348879, -82.46705859292085 35.67335123486556, -82.46708659294562 35.67322123484197, -82.4671565929778 35.67308823482215, -82.46726359301223 35.67298023481118, -82.46735359303909 35.67290323480484, -82.4674195930588 35.672846234799984, -82.46759459310864 35.67271223479076, -82.46776259314804 35.6726372347929, -82.46792359317928 35.67260823480355, -82.46805959319838 35.67263023482202, -82.46818059321333 35.67266323484124, -82.46831559323431 35.672672234856975, -82.46841359325428 35.67264823486223, -82.46842359325717 35.67264023486158, -82.4685375932884 35.672561234857255, -82.4685955933107 35.67247923484658, -82.4686655933433 35.67234323482612, -82.46869259335304 35.67230923482193, -82.46882859342358 35.671999234772905, -82.46886259344589 35.671891234754476, -82.46890159348833 35.671659234711285, -82.46890659352478 35.67142923466499, -82.46892259354465 35.67131723464394, -82.4689465935636 35.67122123462687, -82.46899959358872 35.67111523461077, -82.46906459361765 35.670998234593654, -82.46916759365608 35.67086023457618, -82.46927759369562 35.6707222345595, -82.46933859371626 35.67065423455193, -82.46948959376148 35.67052423454103, -82.46963359380153 35.670419234534506, -82.46999159387597 35.67032223455167, -82.47046759397702 35.6701792345716, -82.47064459401449 35.670127234579276, -82.47081359405237 35.670063234583694, -82.47089959407364 35.67001823458344, -82.47100259410057 35.66995423458095, -82.47112659413428 35.669869234576495, -82.47124259416218 35.66981323457707, -82.4713945941913 35.669788234587585, -82.47154359421278 35.66980923460726, -82.47166859422663 35.66985323462907, -82.47197859424851 35.67004423469984, -82.47208759425814 35.67009923472224, -82.47211859426079 35.67011523472874, -82.47228359428317 35.670147234752285, -82.4724635943132 35.67014623477057, -82.47283659437984 35.67011523480265, -82.47311659442803 35.6701042348293, -82.47334659446878 35.670087234849554, -82.4735375945095 35.67002923485746, -82.4737005945487 35.66995023485815, -82.47384759458889 35.66984823485254, -82.47386959459621 35.669824234849976, -82.47394559462124 35.66974423484148, -82.47405159466186 35.66959523482209, -82.47414759470192 35.66943923480025, -82.47424459473436 35.66933323478875, -82.47425159473681 35.669325234787806, -82.47426159473983 35.669316234786976, -82.47431859475638 35.6692702347835, -82.47433859476203 35.66925523478253, -82.47434659476407 35.66925023478234, -82.47448459480007 35.669166234779404, -82.47467359484253 35.66909423478421, -82.4747235948524 35.66908423478737, -82.47481559487058 35.66906523479304, -82.4748395948747 35.669064234795286, -82.47495559489431 35.66906123480664, -82.47508559491368 35.669076234823024, -82.47523059493305 35.66910623484414, -82.47539759495822 35.66912223486456, -82.47549759497784 35.66910323487106, -82.47558159499533 35.66908023487494, -82.47568059502113 35.669019234872756, -82.4757875950549 35.66891623486281, -82.47586359508395 35.668809234848865, -82.47593959511545 35.6686872348319, -82.47598559514093 35.66857223481325, -82.47612259522442 35.66817923474739, -82.47617659524977 35.66807323473147, -82.47626059528024 35.66796623471833, -82.47635159530769 35.66788623471138, -82.47648159534297 35.66779823470695, -82.47662659537647 35.66773723470944, -82.47680959541557 35.6676802347167, -82.47698459545173 35.66763423472536, -82.47724459550496 35.667569234738956, -82.47744259554655 35.66751223474775, -82.47761059558516 35.66744323475103, -82.47773259561542 35.6673782347504, -82.47781659563874 35.667317234746626, -82.47790059566573 35.66723323473817, -82.47799959570328 35.66709623472049, -82.47813159575416 35.666909234696064, -82.47815359576273 35.66687723469183, -82.4782325957896 35.666788234681874, -82.47841159584146 35.66664523467121, -82.47871259592102 35.66645323466314, -82.47903859600292 35.666273234660096, -82.4791125960261 35.66620323465355, -82.47914459604053 35.666144234644854, -82.47914959604398 35.66612723464185, -82.47928359606819 35.666114234652994, -82.47936259608706 35.666077234653635, -82.47952759613345 35.6659542346456, -82.47971959619107 35.665787234631445, -82.47988259623891 35.665653234620954, -82.48001159628213 35.6655122346056, -82.48010159631623 35.665388234589585, -82.48018559635271 35.66524223456855, -82.4802185963687 35.665174234558094, -82.48043859647389 35.66473023449043, -82.48054959652382 35.664526234460396, -82.48065659656842 35.664352234436066, -82.48098059669097 35.663908234379086, -82.48114159674604 35.66372423435822, -82.48125359678721 35.66357823434012, -82.48130259681919 35.66342423431377, -82.48130159684008 35.66328823428605, -82.48124059684505 35.66319023425981, -82.48112959684967 35.66304123421807, -82.48107659686448 35.66288923418172, -82.48107559688653 35.662745234152304, -82.48112559692179 35.662571234122055, -82.48119859696659 35.66235923408646, -82.48127259701927 35.66209823404097, -82.48134959704961 35.661984234025766, -82.48142559706754 35.66195023402667, -82.48149559708241 35.66192923402955, -82.48158659709736 35.661930234039204, -82.4817145971105 35.661982234062954, -82.48191359711909 35.66214023411555, -82.4820425971223 35.66225823415282, -82.48211559712404 35.66232523417397, -82.48222259712998 35.66240123420047, -82.48231859714079 35.66243423421707, -82.48245559716335 35.66243523423138, -82.48256659718727 35.6624002342357, -82.48281159724486 35.66229023423855, -82.48295059727981 35.662213234237214, -82.48311059731533 35.6621552342419, -82.48328859734879 35.66213023425515, -82.48340659737013 35.66211823426486, -82.48372059742677 35.662089234291244, -82.483858597454 35.66206123429981, -82.48404459749501 35.661995234305486, -82.48421259753667 35.66190623430472, -82.48434759757264 35.661818234300725, -82.4844285976076 35.66167923428082, -82.48444359763748 35.66150223424632, -82.48444859766134 35.661353234216534, -82.48445159767236 35.66128523420298, -82.48447159769164 35.66118223418412, -82.48449959770477 35.661127234175794, -82.48455559772175 35.66107723417139, -82.4846245977377 35.66104823417263, -82.48473459775713 35.661040234182344, -82.48492259778351 35.66107123420799, -82.48513559780301 35.66117423425092, -82.48539959783005 35.66128223430006, -82.4862585979146 35.66165723446478, -82.48643459792464 35.661781234508204, -82.4866035979274 35.6619442345587, -82.48675159792558 35.66211523460873, -82.48687159792543 35.66224423464734, -82.48708359794624 35.66233723468808, -82.48748659798316 35.66253123476908, -82.48781959801691 35.662670234831616, -82.48801259803828 35.662739234865505, -82.48823959806691 35.66279723490073, -82.48858759811093 35.662886234954634, -82.48882959814468 35.66292723498795, -82.48900959815956 35.66302423502617, -82.48914159816852 35.66310823505684, -82.48920959816353 35.663213235085244, -82.4893045981394 35.66347123514748, -82.48937259813415 35.66357823517624, -82.48937959813416 35.66358523517843, -82.48940059813451 35.66360623518487, -82.48940859813467 35.66361323518704, -82.48951159813662 35.663711235217626, -82.489537598138 35.66373023522415, -82.48968759814636 35.66383723526137, -82.48990859816722 35.66393923530489, -82.49000259817865 35.663966235320125, -82.49017159819903 35.664015235347435, -82.49022659820581 35.664031235356404, -82.4904325982331 35.664075235386505, -82.49060059825528 35.66411223541137, -82.49091559829829 35.66417223545603, -82.49121659833489 35.664258235504505, -82.49123259833685 35.66426323550718, -82.49146659836107 35.664357235550426, -82.49163259836574 35.66450523559762, -82.49184459837919 35.66464623564814, -82.49187459838092 35.66466723565546, -82.49196559838575 35.6647332356783, -82.49239059844457 35.6648092357375, -82.49282559850666 35.66487423579554, -82.49315259854747 35.66496123584688, -82.4932505985606 35.66498123586108, -82.49337059857685 35.665005235878304, -82.49348759859255 35.665029235895204, -82.4937265986264 35.665066235927384, -82.49387759864699 35.665095235948854, -82.49396159865049 35.66516323597131, -82.49402559865061 35.66523123599175, -82.49409659863484 35.66540923603527, -82.4943515986286 35.665723236125395, -82.49456259862151 35.66599523620246, -82.49473159862158 35.66617623625672, -82.49490359862747 35.666322236304154, -82.49505359863542 35.66643223634195, -82.49523659865771 35.66648423637136, -82.49540459868349 35.66649823639147, -82.49560759873273 35.666397236391866, -82.49590959879032 35.666349236413225, -82.49611159881023 35.666437236451955, -82.49628159882097 35.6665502364924, -82.49634159882407 35.666594236507535, -82.49642059882822 35.66665223652743, -82.49662759885608 35.66669423655733, -82.49683459888828 35.66670823658149, -82.49711259894136 35.66666323660095, -82.49763759904823 35.666535236629024, -82.49768959905873 35.666523236631946, -82.4979645991098 35.66648823665311, -82.49829459916488 35.66648623668674, -82.4985355992109 35.66644723670359, -82.49888959928548 35.66634523671922, -82.49920059936127 35.6661882367194, -82.4992205993662 35.66617823671941, -82.49950959943979 35.66601223671535, -82.49966459948116 35.66591123671081, -82.4997965995165 35.66582423670667, -82.49981559952143 35.66581323670637, -82.50000759958155 35.665630236688926, -82.50013159962376 35.66549023667326, -82.50013659962524 35.665486236672955, -82.50021759965841 35.66535823665521, -82.50022459966134 35.665347236653695, -82.50039559972912 35.6650922366194, -82.50063459979754 35.6649062366062, -82.50085959985006 35.66480823660937, -82.50099859988238 35.664748236611494, -82.50134359995383 35.664656236628346, -82.5018366000482 35.66457523666265, -82.50208260009317 35.66454823668245, -82.50222260012085 35.664520236691146, -82.50235160015174 35.66445823669182, -82.50252460019887 35.66433923668545, -82.50278360027554 35.66412123666779, -82.50299760033508 35.66396623665829, -82.50317960038184 35.66385923665528, -82.5032156003902 35.66384323665569, -82.50338660042951 35.66377323665903, -82.50357960047693 35.66367323665855, -82.50376360052495 35.66356023665451, -82.50397060058096 35.66342023664733, -82.5039976005882 35.66340223664645, -82.50406360060691 35.663352236643085, -82.50425260065961 35.66321423663445, -82.50434460068492 35.66314923663073, -82.50443960071091 35.66308323662704, -82.504486600724 35.66304923662502, -82.50462960076295 35.662950236619565, -82.50467760077609 35.66291723661777, -82.5047536007969 35.66286423661482, -82.5049426008476 35.66273923660885, -82.5051846009087 35.66260323660614, -82.50554760099263 35.66245023661236, -82.50571160102402 35.66242323662375, -82.50587760105387 35.662408236637795, -82.50593460106397 35.66240423664282, -82.50617460110247 35.66241323666942, -82.50639060113474 35.66243623669629, -82.50657360116394 35.66244423671676, -82.50675560119561 35.66243423673351, -82.5069896012389 35.662405236751674, -82.50728960130374 35.66230823676282, -82.50757960137072 35.662186236767866, -82.50837460157022 35.66174923676078, -82.5093076018073 35.66121723674856, -82.50951060185726 35.661112236748096, -82.50952560186072 35.66110623674843, -82.50973260190696 35.6610292367541, -82.50993360194722 35.66098423676564, -82.5103696020307 35.66091223679583, -82.51052160206292 35.66086723680233, -82.51069160210135 35.660801236806414, -82.51079160212676 35.660744236805115, -82.51110560220637 35.660566236801166, -82.51148760229363 35.66041223680924, -82.51161060231941 35.660377236814725, -82.51183860236702 35.66031423682539, -82.51260460253131 35.6600742368554, -82.51293660260467 35.65995623686561, -82.51319960265845 35.65989023687922, -82.51339860269798 35.659848236891186, -82.51344060270516 35.65984723689532, -82.51346260270816 35.659851236898355, -82.51351560271355 35.659873236908325, -82.513572602717 35.659912236922125, -82.51358360271637 35.65992823692649, -82.51365160271291 35.660023236952824, -82.5136846027019 35.66013023697798, -82.51374160270088 35.66019823699769, -82.51377860270217 35.66022923700784, -82.51386160270718 35.66028623702794, -82.51395760271535 35.660336237048, -82.51400460271992 35.66035723705713, -82.51413060273197 35.66041423708176, -82.5142296027392 35.660474237104125, -82.51431260273803 35.660570237132205, -82.5144716027322 35.660779237191086, -82.5145696027364 35.660857237217066, -82.51468560274564 35.66092223724222, -82.51480760275851 35.660970237264515, -82.51490260276962 35.661000237280454, -82.51501960278753 35.661010237294555, -82.51512360280474 35.661010237305284, -82.51529460283652 35.66098823731828, -82.5154266028646 35.66094823732381, -82.51566860291426 35.66088723733634, -82.51588960295709 35.66084723735086, -82.51590260295957 35.66084523735181, -82.51613560300174 35.660822237371114, -82.51630860303118 35.66081823738811, -82.51644860304928 35.66085123740921, -82.51658460306133 35.66091923743706, -82.51665460306569 35.66096623745386, -82.51702260308613 35.66122923754523, -82.51727060310549 35.66137023759948, -82.51752660313379 35.66146223764455, -82.51767960315237 35.661506237669286, -82.517863603177 35.66154423769596, -82.51803060320431 35.66154723771375, -82.51822660323985 35.661528237730096, -82.51839960327491 35.6614872377395, -82.51848660329395 35.66145723774232, -82.51860160332144 35.66140323774326, -82.51875560336474 35.66128823773566, -82.51887060340634 35.66114223771778, -82.51911360349871 35.66080623767442, -82.51934460358581 35.66049023763386, -82.51946260362709 35.66035023761754, -82.51957460365993 35.660258237610364, -82.51967860368549 35.66020423761004, -82.51980360371078 35.66017423761679, -82.51995860373876 35.66016023762995, -82.52007460375687 35.66016823764353, -82.52024060377923 35.66020123766733, -82.52032760378721 35.660243237684796, -82.52037160379115 35.66026523769386, -82.52064660380933 35.66044323775832, -82.52080460382516 35.66051023778821, -82.520979603853 35.66051823780792, -82.52105060386877 35.66049223780994, -82.52105960387074 35.66048923781026, -82.52112760388745 35.66045423781014, -82.52117760390236 35.66041123780647, -82.5212326039271 35.66031023779164, -82.52129260395611 35.66018723777271, -82.52135560399886 35.65997823773667, -82.52143260404245 35.65977923770412, -82.52145260405202 35.6597382376978, -82.52159960412169 35.65944523765336, -82.52165760414401 35.659363237642594, -82.5216976041564 35.65932623763919, -82.52174860416842 35.65930323763975, -82.52179960417841 35.659293237643034, -82.52186060418829 35.65929523764973, -82.52194160419843 35.65931623766229, -82.52214260421947 35.659396237699276, -82.5223266042374 35.65947823773489, -82.52250260425586 35.65954723776702, -82.52257960426577 35.659566237778876, -82.52264460427668 35.659565237785344, -82.52269860428706 35.65955623778904, -82.52277460430675 35.659510237787494, -82.52281260432122 35.659457237780636, -82.52284960434038 35.65937323776735, -82.52286360435079 35.659321237758235, -82.5228766043597 35.65927723775056, -82.52292160438667 35.6591512377296, -82.5229386044015 35.65907323771545, -82.52296760442135 35.65897623769873, -82.52301860444423 35.658883237685, -82.52309860446414 35.65884023768449, -82.52315360447388 35.658836237689336, -82.52322960448721 35.658831237696134, -82.52340860451416 35.658849237718286, -82.5236156045374 35.658921237754186, -82.5238076045525 35.659030237796166, -82.52386360455652 35.65906423780884, -82.5240336045688 35.65916723784729, -82.52435060457921 35.659440237935485, -82.52451960458674 35.65957323797994, -82.52458260459076 35.65961523799503, -82.52462560459554 35.65963023800242, -82.52471760461302 35.65961623800905, -82.5247886046302 35.659581238009245, -82.52483160464645 35.65952223800167, -82.52488260467182 35.65941323798479, -82.5249076046923 35.659307237965734, -82.52492760471617 35.659174237940725, -82.52495260473842 35.65905723791953, -82.52505560479405 35.6588072378792, -82.52511960481789 35.6587222378685, -82.52518160483363 35.6586872378678, -82.52529160485746 35.65865123787173, -82.52533060486434 35.658648237875155, -82.52542160488028 35.658643237883524, -82.52557260490347 35.658655237901485, -82.5257826049329 35.658690237930195, -82.52602460496163 35.65876423797019, -82.52607260496607 35.65878723797978, -82.52630660498748 35.65890023802691, -82.52639960499599 35.658945238045604, -82.52656760501483 35.65900323807479, -82.52670560503152 35.659044238097266, -82.52681960504736 35.659064238113075, -82.5269586050683 35.659078238130206, -82.52706060508443 35.65908323814175, -82.52732160512561 35.65909723817154, -82.5277406051917 35.65911923821906, -82.5278256052051 35.659124238228834, -82.52813660525196 35.6591552382672, -82.52834460528189 35.659185238294704, -82.52872160533033 35.65927623835202, -82.52896760535701 35.659368238396006, -82.52916360537833 35.65944123843104, -82.52934760539276 35.65954523847122, -82.52968360541921 35.65973523854438, -82.5300356054501 35.65991323861687, -82.5300996054557 35.65994623863018, -82.53029560547846 35.66000923866316, -82.53050960550225 35.66008523870066, -82.53085760554664 35.66017223875421, -82.53093560555756 35.66018523876487, -82.53096560556257 35.66018523876792, -82.53107860558296 35.660174238777316, -82.53120160561394 35.66010623877618, -82.5313036056433 35.66002623877035, -82.53144660568432 35.65991423876226, -82.53157360572325 35.65979823875177, -82.53165260574512 35.659742238748514, -82.53174160576599 35.65970223874951, -82.53180360577932 35.65968323875206, -82.53190660579982 35.659661238758154, -82.53206560582915 35.65964223877061, -82.53214460584597 35.65961823877391, -82.53216260585177 35.6596002387721, -82.53219460586173 35.65957023876927, -82.53222260587606 35.65950723875928, -82.53228160592712 35.659240238711085, -82.53235760596117 35.65910123869055, -82.53246560600157 35.658956238672204, -82.53250360601412 35.65891523866773, -82.53251760601884 35.65890023866612, -82.53262560605637 35.65877323865138, -82.53265960608167 35.65864623862903, -82.53268360610686 35.6585092386036, -82.53269160612393 35.65840723858373, -82.53272160614475 35.65830423856588, -82.53275160615983 35.65823923855566, -82.53281360618004 35.65817523854902, -82.53288460619797 35.65813523854822, -82.53297060621304 35.65813023855603, -82.5329956062169 35.65813223855899, -82.53310660623391 35.65814123857225, -82.53324360625147 35.658175238593316, -82.53333760626579 35.658183238604586, -82.5334056062786 35.658173238609514, -82.53347760629494 35.65814523861127, -82.53353660631038 35.65810823860977, -82.5336206063347 35.658041238604774, -82.53367960635933 35.65794523859137, -82.53382160641212 35.65775623856751, -82.53399660647102 35.657563238546246, -82.5341046065005 35.65748823854208, -82.53427260654315 35.65739323854001, -82.53465960663428 35.65721923854439, -82.53481560667035 35.65715323854703, -82.53492660669487 35.657114238550506, -82.5350556067211 35.6570832385575, -82.53516560674116 35.657071238566346, -82.53534460677199 35.657064238583395, -82.53566960682475 35.65707223861844, -82.53568460682706 35.6570732386202, -82.5358846068607 35.65707023864017, -82.53607160689036 35.65707923866125, -82.53619560690832 35.65709623867747, -82.53629960692052 35.65712923869488, -82.53637260692706 35.65716523870971, -82.53644560693186 35.65721323872696, -82.53651160693367 35.65727223874578, -82.53658160693806 35.657319238762554, -82.53662460694441 35.65732423876804, -82.5366806069526 35.657331238775186, -82.53672160696061 35.657323238777735, -82.53677760697322 35.65730223877927, -82.53681560698296 35.65728023877869, -82.53685260699423 35.657246238775606, -82.53687260700333 35.657209238770115, -82.53688460701257 35.65716223876175, -82.53688460702931 35.65705423873985, -82.53692160706218 35.65688123870839, -82.53696860708905 35.65675723868799, -82.53704460712463 35.65660923866565, -82.53710760714577 35.65654023865817, -82.53714960716505 35.65646023864615, -82.53717560718297 35.65637223863089, -82.53720460720805 35.65624123860729, -82.53723260721918 35.656199238601616, -82.53726360722813 35.656174238599704, -82.53727660723193 35.656164238598954, -82.53734360724646 35.656142238601376, -82.53768360730454 35.65613123863411, -82.53775360732568 35.65607023862892, -82.53781360735239 35.65596123861301, -82.53784860737535 35.65585023859392, -82.53789960740141 35.65573623857598, -82.53794960741763 35.655685238570776, -82.5381336074552 35.655640238580546, -82.53838060749757 35.65563123860412, -82.53853660752382 35.65562923861979, -82.53877860756725 35.65560823864033, -82.53889260759371 35.65555923864213, -82.53898960761865 35.6555022386405, -82.53909060765243 35.65539223862849, -82.53916160768333 35.65526823861053, -82.53923660771825 35.65512223858854, -82.53930560775348 35.65496923856449, -82.53942760779164 35.654853238553535, -82.53957060782099 35.65481723856081, -82.53966160783298 35.65483723857428, -82.53974860783757 35.65490123859624, -82.53981960783257 35.65500923862551, -82.53984960781276 35.65517023866143, -82.53981960778368 35.655326238690094, -82.53971660771963 35.655630238741395, -82.53969760769803 35.655749238763605, -82.53971060767743 35.65589623879488, -82.53971960766854 35.65596423880969, -82.53973960764851 35.656115238842496, -82.53975560762409 35.65629023887975, -82.53978260760142 35.65646623891831, -82.53984660759227 35.65659423895101, -82.54021760759923 35.656948239061244, -82.54033060760392 35.657039239091354, -82.54040260760867 35.65708623910837, -82.54043660761393 35.65708823911221, -82.54044360761448 35.657092239113744, -82.54050160762678 35.657075239116274, -82.54055060763895 35.657049239115985, -82.54059160765408 35.656995239109236, -82.5406016076622 35.656953239101746, -82.54059760766572 35.65692623909582, -82.5409726077503 35.65678223910514, -82.54116560778463 35.65676723912185, -82.54121360779305 35.65676423912631, -82.54138460782039 35.65677123914527, -82.54163260786665 35.656738239164014, -82.54179460789422 35.65673423917989, -82.54195560791803 35.65675323920034, -82.54220960795908 35.65676023922789, -82.54244660799621 35.65677523925533, -82.54260760801627 35.656818239280675, -82.54273460803076 35.65686123930249, -82.54281660804399 35.65686323931133, -82.54290260805982 35.656853239318146, -82.54293260806703 35.65683923931834, -82.54309460810502 35.6567672393204, -82.54321160813157 35.656721239323055, -82.5433656081576 35.65671823933831, -82.54344960816603 35.656754239354285, -82.54347460816388 35.6567952393652, -82.54348560816288 35.65681323936996, -82.54349460815232 35.6568912393868, -82.54349660815059 35.65690423938958, -82.54350360812926 35.657050239420016, -82.54353660811353 35.65718723945134, -82.54353660811323 35.657189239451746, -82.54356860810373 35.65728523947464, -82.54358360809901 35.65733223948571, -82.54358860809704 35.65735023948992, -82.54364660807602 35.65754823953613, -82.54366660806902 35.657615239551795, -82.54369060806103 35.657693239570186, -82.54372660803867 35.65787623961115, -82.54373460801342 35.658048239647016, -82.54372260797982 35.658253239687475, -82.5437036079494 35.65842923972133, -82.54365860791602 35.658597239750925, -82.54356660784418 35.65896323981595, -82.5435816078237 35.6591122398478, -82.54362060781659 35.659200239869726, -82.5436886078184 35.65926123988914, -82.54377260782418 35.65931423990865, -82.54390960784109 35.65935223993048, -82.5440626078671 35.65934823994544, -82.54414660787808 35.65936723995786, -82.544192607881 35.659398239968944, -82.54418460787501 35.65942823997424, -82.54416960786713 35.659463239979765, -82.54413160785366 35.65950923998522, -82.5440776078401 35.65953923998585, -82.54402460782896 35.659554239983386, -82.54394860781682 35.65955123997496, -82.54386460780638 35.65952823996172, -82.5437876077931 35.65953123995437, -82.5436276077706 35.65950523993264, -82.54345960775149 35.65944823990369, -82.54326960773294 35.65936423986699, -82.54323860774028 35.659283239847404, -82.54318560776791 35.65904723979385, -82.54317760779485 35.65886423975586, -82.5431546078134 35.6587192397239, -82.54308560781725 35.65862023969668, -82.54294860780229 35.65857023967238, -82.54284160778262 35.658582239663836, -82.54264360774025 35.65864323965583, -82.54246060770045 35.6587042396495, -82.54224660765085 35.65879523964597, -82.54181160753484 35.659078239658804, -82.54166660748906 35.65921923967253, -82.54162160747275 35.65927623967955, -82.54159060745461 35.659360239693456, -82.54156760743376 35.65947023971348, -82.54152160740604 35.65960023973522, -82.54143860736346 35.65978723976477, -82.54142260732115 35.6600432398152, -82.54133860728905 35.66016123983066, -82.54123260726075 35.660230239833716, -82.54107160722232 35.6603062398326, -82.54085060717196 35.660394239827774, -82.54069760714366 35.66041323981592, -82.54042360710157 35.66039023978304, -82.54022460706045 35.66044323977336, -82.5400796070215 35.66053923977795, -82.53995060698074 35.660664239790094, -82.53990460696018 35.6607482398025, -82.53986660693246 35.660886239826674, -82.53986660691427 35.66100423985071, -82.53981260688295 35.661149239874696, -82.53973660686029 35.661214239880096, -82.5396376068321 35.66129023988535, -82.53946960679112 35.66137423988511, -82.53933260676018 35.661427239881846, -82.53914960672442 35.66146223987016, -82.53896660669109 35.66148123985516, -82.53883660666237 35.66152723985111, -82.53870660661899 35.66166823986646, -82.5385386065458 35.6619612399088, -82.53848560652514 35.662038239919035, -82.53837060649546 35.66210623992106, -82.53824160647162 35.66212223991101, -82.53812660644662 35.6621602399069, -82.5379896064056 35.66227823991682, -82.53787560636913 35.66239223992832, -82.53782960633846 35.6625412399539, -82.53782960630478 35.66275923999831, -82.53787560629242 35.66288824002929, -82.53792860626821 35.663102240078295, -82.53798160623568 35.663369240138074, -82.53797460620211 35.66357924018013, -82.53789760616394 35.66374324020562, -82.53780660612996 35.663865240221014, -82.53770360609927 35.66395324022833, -82.53764660608226 35.66400224023248, -82.53724960597151 35.66429224025061, -82.53708160593001 35.66438024025131, -82.5368906058901 35.66443324024241, -82.5367616058645 35.66446024023464, -82.53656260582848 35.664479240218014, -82.53641060580381 35.66447524020151, -82.53631160578678 35.66447924019215, -82.53621960576565 35.66451724019044, -82.53610560573377 35.66460124019583, -82.53605960571774 35.66465524020204, -82.53600560569932 35.66471624020888, -82.53591460565949 35.66487624023209, -82.53585360562698 35.66502124025536, -82.53579260559142 35.66518524028247, -82.53573860557013 35.66526524029316, -82.53568560555313 35.66531824029857, -82.53562460553526 35.665368240302364, -82.53556360551927 35.66540624030387, -82.53549460550305 35.665437240303085, -82.53542660548881 35.66545624029994, -82.53533660547298 35.6654622402919, -82.53522760545533 35.66545924028002, -82.53511360543743 35.66545224026692, -82.5349606054127 35.66544824025045, -82.53486160539327 35.66546724024403, -82.5347856053771 35.66549024024093, -82.53470860535906 35.66552424023988, -82.53464760534061 35.66557824024458, -82.53460260532307 35.66564324025324, -82.53458660531095 35.66570424026396, -82.53457960528922 35.665837240290315, -82.53460260527487 35.66595524031672, -82.53463260524384 35.66618824036723, -82.5346176052212 35.66631824039217, -82.53459460520791 35.666379240402165, -82.53455660519343 35.666432240409115, -82.53450260517441 35.66649724041672, -82.53443460515378 35.66655824042218, -82.53428960511374 35.66666124042816, -82.534167605084 35.666722240428015, -82.53407560506352 35.666756240425464, -82.5340066050502 35.66676824042081, -82.53392360503469 35.6667792404145, -82.53382360501813 35.66677924040422, -82.53357960498408 35.6667372403706, -82.53348060496992 35.66672224035738, -82.53342760496115 35.66672224035193, -82.53338860495343 35.66673024034955, -82.53335860494782 35.66673424034721, -82.53327460492928 35.666764240344676, -82.53321460491308 35.66680424034667, -82.53321060491197 35.66680724034688, -82.53310460488007 35.6668992403547, -82.53300760485354 35.6669672403585, -82.53300460485254 35.66697024035879, -82.53292360483123 35.66702124036084, -82.53282660480862 35.66706324035946, -82.53263060477067 35.667098240346384, -82.53239760472906 35.66711724032622, -82.53230660471131 35.667134240320344, -82.53224960469886 35.6671532403184, -82.53222460469307 35.66716324031781, -82.53211360466409 35.66723224032044, -82.53207760465101 35.6672782403261, -82.53205860464256 35.667312240331086, -82.5320576046412 35.66732024033254, -82.53205560463694 35.667345240337504, -82.53205560463662 35.66734724033789, -82.53205560463421 35.66736324034117, -82.53205460463074 35.66738424034534, -82.53206660462799 35.66741524035284, -82.53207160462742 35.667424240355196, -82.5320736046273 35.66742724035598, -82.53208560462599 35.6674482403615, -82.5320886046261 35.66745124036244, -82.53211460462714 35.667472240369335, -82.53215760463088 35.66749424037826, -82.5322476046423 35.6675172403922, -82.532303604651 35.66752024039862, -82.53280160472885 35.66755224045638, -82.53299360475734 35.66757424048063, -82.53299560475747 35.667575240481035, -82.53322160478854 35.66761724051283, -82.5335246048276 35.66769024055892, -82.53418760490979 35.66787124066403, -82.53420560491216 35.6678752406667, -82.53448760494923 35.66793824070851, -82.53488960500334 35.66802024076654, -82.53520260504415 35.668092240813515, -82.53556360509295 35.6681642408652, -82.5358626051349 35.66821424090616, -82.53639260520521 35.66832924098417, -82.53696860527397 35.66850324107889, -82.53718060530052 35.66855924111211, -82.5374846053387 35.66863924115972, -82.53801960540639 35.66877624124263, -82.53816860542618 35.6688082412645, -82.53823160543448 35.66882224127388, -82.53845060546787 35.668841241300235, -82.53869260550695 35.66884824132657, -82.53869960550799 35.66884924132751, -82.53934560561804 35.66883124139032, -82.53963860566783 35.668824241419046, -82.53981360569445 35.668840241440286, -82.54000560572157 35.668871241466334, -82.54014560574014 35.66890124148694, -82.54026260575509 35.66893024150487, -82.54063160580223 35.669022241561535, -82.54077360581977 35.66906124158411, -82.54096060584291 35.66911224161375, -82.54124560587393 35.66921824166466, -82.54151260590012 35.669335241715956, -82.54194960594012 35.669546241803864, -82.54208060594661 35.66964524183753, -82.54213960594959 35.66968924185256, -82.54226060594654 35.66983924189559, -82.54231660593753 35.66995724192533, -82.54238960591387 35.67018924198008, -82.54247060588355 35.67047224204601, -82.5425386058505 35.67075924211141, -82.54259860583157 35.6709462421557, -82.54269960581404 35.67116824221129, -82.54285060580155 35.671411242276235, -82.54292360579235 35.671549242311926, -82.542968605784 35.67165124233732, -82.54302260576891 35.67180724237457, -82.54308260575503 35.671961242412124, -82.54313060574866 35.672054242436, -82.54315560574503 35.67210424244875, -82.54328160573428 35.67230924250342, -82.54342260573051 35.672485242553826, -82.54358760573247 35.6726502426044, -82.5437056057369 35.67274824263649, -82.54382360574331 35.67283324266592, -82.54396260575363 35.672916242697106, -82.54410760576334 35.67300924273098, -82.54425660577127 35.67311824276849, -82.54432260577349 35.6731742427867, -82.54448060577866 35.67331124283084, -82.54472960578534 35.67353524290205, -82.54493760578771 35.67374324296582, -82.54526660578244 35.674131243078676, -82.54532060577965 35.674207243099744, -82.54538660579868 35.674155243095896, -82.54552660583877 35.67404624308813, -82.54558360585565 35.67399824308422, -82.54564960587484 35.67394524308026, -82.54571260589312 35.67389424307631, -82.54583660592849 35.67379924306978, -82.54596760596313 35.67371524306617, -82.54616360600939 35.673627243068424, -82.54623060602418 35.67360324307038, -82.54657760610007 35.673485243082105, -82.5477586063555 35.67310224312566, -82.54807360642135 35.67301524314039, -82.5481746064409 35.67299724314715, -82.54828760646257 35.67297824315486, -82.54851360650314 35.672959243174354, -82.54875360654037 35.672976243202484, -82.54884960655369 35.67299324321577, -82.54904060658009 35.67302724324238, -82.5493546066181 35.67311924329341, -82.54963460664527 35.673244243347725, -82.54969360664941 35.673281243361316, -82.54985260666008 35.67338324339846, -82.55007360667076 35.673551243455364, -82.55056660669439 35.67392824358289, -82.55093460671554 35.674187243673536, -82.55121060673511 35.67435724373654, -82.55161560676623 35.674591243825844, -82.5518096067824 35.674695243866964, -82.55194160679453 35.674758243893436, -82.5519826067983 35.67477824390169, -82.55210660681246 35.67482024392297, -82.55227160683427 35.67485624394733, -82.5524766068665 35.67486824397088, -82.55275060691469 35.67485124399559, -82.55279460692226 35.67484924399978, -82.5528246069275 35.674847244002365, -82.55306660696985 35.674834244024645, -82.5531016069758 35.67483324402804, -82.55323560699829 35.67483124404148, -82.55334260701474 35.67484024405428, -82.55345660703239 35.674848244067654, -82.55369460706513 35.67489224410113, -82.5539116070924 35.67494924413507, -82.55415160711995 35.67502924417607, -82.5544066071452 35.67514024422488, -82.55456960715587 35.67524624426324, -82.55494260717485 35.67552424435823, -82.5551076071822 35.67565424440171, -82.55519660718612 35.67572424442509, -82.55546460719789 35.67593624449587, -82.55549860719847 35.67596924450604, -82.5555476071993 35.67601624452065, -82.55560960721643 35.67597224451816, -82.55578560726072 35.675875244516504, -82.55595760730063 35.675802244519275, -82.55598760730723 35.67579124452016, -82.55616060734512 35.675732244525996, -82.55637760739123 35.675667244535035, -82.55684260748815 35.67554024455705, -82.55709160754316 35.67545224456474, -82.55727660758673 35.67536924456688, -82.55739060761557 35.675305244565614, -82.55743660762711 35.67528024456525, -82.55760860766944 35.67519124456482, -82.55775760770462 35.675123244566336, -82.55783860772297 35.67509224456834, -82.55788360773303 35.67507524456949, -82.55805560776798 35.67503424457885, -82.55809360777552 35.675026244581176, -82.55821660779937 35.67500424458935, -82.55836860782632 35.67499324460275, -82.55854960785665 35.67499124462094, -82.5587366078849 35.67501024464411, -82.55888060790555 35.67503124466315, -82.55914260794292 35.675071244698245, -82.55936460797467 35.67510424472793, -82.55946060798838 35.67511924474079, -82.55953560799851 35.67513424475156, -82.55974860802752 35.67517524478182, -82.56002860806814 35.6752132448184, -82.56015860808705 35.675231244835395, -82.56025260810141 35.6752392448467, -82.56052460814306 35.67526224487939, -82.56061660815708 35.67527024489049, -82.56104760822703 35.675281244937096, -82.56130560826819 35.67529224496587, -82.56134560827454 35.67529424497043, -82.56161960831751 35.67531124500209, -82.56168160832732 35.675314245009055, -82.56174060833655 35.675318245015895, -82.56187060835823 35.6753172450291, -82.56189060836162 35.675317245031195, -82.56193360836916 35.675314245034976, -82.56197760837718 35.67531024503875, -82.56210860840025 35.67530124505033, -82.562111608401 35.67530024505046, -82.56215660840907 35.67529624505424, -82.56238560845064 35.675273245073114, -82.56273260851343 35.67524024510221, -82.5630756085749 35.67521124513155, -82.56330660861622 35.67519224515143, -82.56340460863346 35.67518624516031, -82.56354660865729 35.6751852451747, -82.56368960868113 35.67518424518927, -82.5638066086998 35.675189245202255, -82.56426560876933 35.675233245258475, -82.56450560880555 35.675257245288044, -82.56509360889505 35.675310245359334, -82.56528560892424 35.675328245382794, -82.56557360896541 35.6753712454212, -82.56580460899924 35.67540124545105, -82.56614660904854 35.675449245496054, -82.56635260907551 35.6754962455268, -82.56643660908325 35.67553724554378, -82.5665266090892 35.67559524556489, -82.56661160909371 35.67565724558623, -82.5667116090966 35.675746245614654, -82.56675260909692 35.675788245627395, -82.56681560909747 35.675852245646944, -82.56711960910418 35.67613624573609, -82.56717960910467 35.67619724575471, -82.56728560910562 35.676305245787596, -82.56739760910807 35.67641024582046, -82.56740960910834 35.67642124582396, -82.56750760910899 35.67652224585463, -82.56765160910528 35.67670124590591, -82.56773660909666 35.67684824594455, -82.56777660909283 35.676916245962495, -82.56792560905316 35.67733324606276, -82.56799560903832 35.67750424610479, -82.56808960903126 35.67765124614437, -82.56816960903095 35.677739246170525, -82.56825560903305 35.67781824619553, -82.56826960903336 35.67783124619958, -82.56839860904228 35.67791224622931, -82.56854860905604 35.67798424625944, -82.56866960906925 35.67802924628107, -82.56881860908858 35.67806424630351, -82.5691166091341 35.67809024633948, -82.56926660916015 35.6780832463535, -82.56948960920107 35.678058246371386, -82.56965760923654 35.678009246378686, -82.56970160924571 35.67799724638078, -82.56995260930155 35.67790624638802, -82.57045960941859 35.677694246397095, -82.5707646094891 35.67756624640238, -82.57081960950202 35.67754124640296, -82.57094760953221 35.67748424640451, -82.57147060965303 35.67726524641373, -82.57177960972061 35.67715924642393, -82.57191660974799 35.67713024643215, -82.57195960975642 35.67712224643497, -82.57217860979665 35.67709724645242, -82.57230560981851 35.67709224646444)))",6465,37,021,002703,370210027031,1862,1862,27,1814,1789,5,5,6,0,9,48,1480,16,1464,1447,1426,5,5,6,0,5,33,880,780,100
census_2010_blockgroups_view.fid--2dc29038_13ec899ba8f_-263c,"MULTIPOLYGON (((-82.20598457295841 35.52336117751752, -82.20795157331472 35.52314917767725, -82.21043357376584 35.522872177876785, -82.21356057433648 35.522509178125425, -82.21511257461651 35.52234917825287, -82.21919257535407 35.521921178586354, -82.22098057568012 35.52171517872882, -82.22130457573925 35.52167717875443, -82.22617257662705 35.521116179142155, -82.22918357717639 35.520768179381704, -82.23034857738797 35.520640179475734, -82.23055157741986 35.520650179498666, -82.23279757782834 35.52039917967909, -82.232907577977 35.51955117951853, -82.23300457812083 35.51872117936029, -82.2332095783001 35.51777717919, -82.23346757852711 35.51657917897377, -82.23347457853319 35.516547178968, -82.23347657861959 35.51598817885494, -82.23347857879523 35.51485017862444, -82.23346557903567 35.51327517830391, -82.2333985791202 35.51265517817133, -82.23338757916511 35.51235117810858, -82.23335857926725 35.5116571779649, -82.23281157944437 35.50992217755694, -82.23210357953083 35.50860417721692, -82.23178457956958 35.50801117706395, -82.23165857957275 35.50785617701951, -82.23099057953961 35.50735717684963, -82.23110257962993 35.506890176766504, -82.23115557967218 35.506672176727776, -82.23111057967266 35.506621176712805, -82.23063157963917 35.50632717660391, -82.23024857959007 35.50623617654599, -82.2296515794924 35.50623217648381, -82.22956057947749 35.50623217647439, -82.22910957943233 35.50604317638959, -82.22815957935504 35.50552917618768, -82.2272335793252 35.504733175931, -82.22658757934532 35.50391217569814, -82.22637857935192 35.503646175622684, -82.22600257937694 35.50308117546952, -82.2257385793949 35.50268217536147, -82.225341579428 35.50204317519111, -82.22508257948886 35.50137117502823, -82.22497957955144 35.500854174912895, -82.22445257949875 35.500633174813764, -82.22435257948861 35.50059217479516, -82.22404057947976 35.5003161747071, -82.224032579509 35.500117174665995, -82.22407957956112 35.49982917461245, -82.22429157979488 35.49853717437251, -82.22539658024287 35.49680817413584, -82.22563558034322 35.496411174079945, -82.22915558181737 35.49059617326386, -82.23157258283119 35.48659217270102, -82.23327858354608 35.4837691723045, -82.23357158366153 35.483332172246016, -82.23589858466114 35.47932217167279, -82.23793758552866 35.47586217118127, -82.23810558560045 35.47557517114034, -82.24008858645625 35.47213017064609, -82.24256958749838 35.46800617006543, -82.2436685880987 35.46527616962507, -82.24474058844227 35.46418816951486, -82.25061859032625 35.4582211689097, -82.25395959065378 35.459669169546736, -82.25782259104011 35.461294170273185, -82.26159459136858 35.46319917104716, -82.26320159150765 35.46401617137791, -82.26683459182398 35.465851172123465, -82.26664759173627 35.46622217217941, -82.26660959171859 35.466296172190496, -82.26652359167821 35.466467172216284, -82.2664525916462 35.466599172235824, -82.26624159155016 35.46699817229498, -82.26617159151822 35.4671311723148, -82.26585759139158 35.467619172381426, -82.26574859134087 35.4678321724134, -82.26603159136754 35.46796217246887, -82.26689759144948 35.46835717263801, -82.26704259146301 35.468424172666396, -82.26832059158097 35.46902617291985, -82.27236159195337 35.47093417372215, -82.27419459212139 35.47180617408741, -82.27506259220577 35.472187174253875, -82.27521759222473 35.4722301742785, -82.2757135922695 35.4724701743782, -82.27818459249113 35.473677174876975, -82.2784205925122 35.47379317492475, -82.28096559274043 35.4750361754384, -82.28102059274539 35.475063175449584, -82.28787459336012 35.47841217683324, -82.28827059339535 35.47860717691351, -82.29478559397526 35.48182017823492, -82.29899159434456 35.48392817909486, -82.30303459470639 35.485910179912494, -82.30352659475048 35.48615118001191, -82.30401859479782 35.48637118010713, -82.30436259483162 35.486520180172725, -82.3049875948867 35.486832180300226, -82.30505659489327 35.486863180313605, -82.30704059507023 35.48784018071577, -82.3081685951731 35.48838118094151, -82.30819359517528 35.48839318094649, -82.30857559520943 35.488581181023875, -82.30935359527933 35.488961181181, -82.30959559530106 35.48907918122974, -82.31062359539254 35.48958618143827, -82.31548959582841 35.491971182422354, -82.31573359585069 35.49208818247122, -82.31820559607753 35.493265182964095, -82.31897659614667 35.493642183119825, -82.31917759616475 35.49374018316038, -82.31978059621889 35.49403518328221, -82.319982596237 35.49413418332301, -82.32070259630179 35.494485183468264, -82.32082659631305 35.4945451834932, -82.32273759648453 35.495480183879394, -82.32336059654126 35.4957791840041, -82.32420759661845 35.49618618417372, -82.32443959663956 35.496297184220104, -82.3251375967031 35.496633184360036, -82.32537059672433 35.49674518440667, -82.32520659664978 35.49705418445249, -82.32506259661069 35.497154184458054, -82.32501059659646 35.49719118446019, -82.32498259657768 35.497283184475975, -82.3248145965218 35.497466184495835, -82.32487059648874 35.49774118455736, -82.32547159648828 35.498389184750614, -82.3254865964883 35.498405184755384, -82.32545859640639 35.49890818485464, -82.3255115963959 35.49903318488543, -82.32567359636501 35.49940818497812, -82.32572759635448 35.499534185009296, -82.32581159618098 35.5007531852653, -82.32582359607518 35.50145418540873, -82.32560259600761 35.50165618542704, -82.32467059579345 35.50204918541096, -82.32424359572119 35.50206118536953, -82.32391659563189 35.50229118538257, -82.32379959554434 35.50273518546059, -82.323727595506 35.50290718548811, -82.32319959538077 35.503155185484125, -82.32237059520405 35.503415185451615, -82.32136059499754 35.503675185400525, -82.32051559482983 35.50385918535097, -82.31944759464629 35.50390718525102, -82.31817859444172 35.503876185114166, -82.31778359437425 35.503891185076576, -82.31754859433259 35.50391018505635, -82.31697159421526 35.50405418502614, -82.3167275941634 35.504130185016464, -82.31614959407034 35.50411518495403, -82.31562759398936 35.50408218489363, -82.31528959393522 35.50407118485668, -82.3151795939176 35.50406818484476, -82.31476759384931 35.504070184802764, -82.31404159366689 35.5044781848109, -82.31401459365858 35.50450318481319, -82.3135595935161 35.50494118485525, -82.31343259343595 35.505326184920335, -82.31335959335348 35.505784185005695, -82.31357659327102 35.506553185184075, -82.31366459323752 35.50686518525646, -82.31377459323058 35.507028185300776, -82.31380259320261 35.507240185346674, -82.31488659312181 35.508928185800656, -82.31535559309268 35.50962018598931, -82.31560759304087 35.51022718613835, -82.31608759292996 35.51146318643848, -82.31666959282026 35.51280018676958, -82.31706459275111 35.51367318698736, -82.31784159270123 35.51483018730206, -82.3182155926862 35.515329187441715, -82.31875459266512 35.51604418764226, -82.31882759266827 35.51610118766133, -82.31968359270586 35.51677518788612, -82.32091659278967 35.5175521881706, -82.32131859283834 35.5176671882353, -82.32226859295302 35.51794018838838, -82.32234659296238 35.51796318840106, -82.32398959321237 35.51810018859788, -82.32512159341141 35.51802018869806, -82.3269695938149 35.51738018875829, -82.3289695942308 35.51682118885052, -82.33070559455778 35.516558188975694, -82.33133259467539 35.51646618902145, -82.3329195949703 35.51625118914102, -82.33340459505055 35.516250189190735, -82.33342359505005 35.51627318919732, -82.33347859505075 35.51632818921413, -82.33366659505836 35.5164801892644, -82.33371259506008 35.516518189276766, -82.33376559506242 35.51656018929076, -82.33380459506108 35.516610189304906, -82.33385759506218 35.516660189320476, -82.33391059506114 35.516724189338916, -82.333994595056 35.51684718937249, -82.33401059505407 35.516877189380274, -82.33413259504121 35.51709118943624, -82.33421659503762 35.517205189468, -82.33430759503806 35.5173001894967, -82.33441459503376 35.51744218953652, -82.3345055950277 35.517579189573624, -82.33455159501717 35.51769718960229, -82.33456659500253 35.51780818962638, -82.33455959498386 35.517922189648786, -82.3345425949651 35.51802618966816, -82.33450559493915 35.51815518969057, -82.33443759490676 35.51829218971133, -82.33436859487485 35.518426189731436, -82.3342315948174 35.51865218976322, -82.33407859475119 35.518918189801425, -82.33396459469782 35.519143189835376, -82.33391059466953 35.519269189855414, -82.33387259464376 35.51939518987706, -82.33384959461895 35.51953218990248, -82.33384959459195 35.51970818993821, -82.33384959459022 35.519719189940496, -82.33385059454098 35.52004019000573, -82.33387259451091 35.52025919005245, -82.33388759449083 35.52040619008378, -82.33390359448052 35.520490190102464, -82.33393359447378 35.52056619012103, -82.33393359447268 35.520573190122406, -82.33396459446534 35.520654190142, -82.33407159445129 35.52086019019489, -82.33412459444084 35.520985190225666, -82.33415459442865 35.52109619025131, -82.3341625944148 35.52119519027215, -82.334147594394 35.52131419029482, -82.33410959436851 35.52143919031628, -82.33398759430023 35.52175219036728, -82.3338195942108 35.52215319043134, -82.33375859417546 35.522317190458324, -82.3336745941217 35.52257619050225, -82.333628594096 35.52269419052152, -82.33356759406884 35.52280519053778, -82.33349159404106 35.522904190550044, -82.33328559397347 35.52312219057303, -82.33295759386718 35.52346119060816, -82.33285759383828 35.52354219061424, -82.332751593808 35.523625190620244, -82.33253559375277 35.52375219062383, -82.33244559373094 35.523797190623704, -82.33234659370714 35.523846190623466, -82.33226459368454 35.52390519062694, -82.33218659366244 35.5239651906312, -82.33211059363816 35.52404119063873, -82.33203459361039 35.52414019065098, -82.3319505935795 35.52425119066488, -82.331858593549 35.52435019067549, -82.33176659351794 35.524453190687005, -82.33166759348805 35.524541190694634, -82.33166759348744 35.52454519069545, -82.33140859341138 35.524762190712856, -82.33133259338878 35.52482719071827, -82.33126359336566 35.52490319072657, -82.33121759334453 35.52499119073964, -82.33117959332247 35.52509419075671, -82.33114859329858 35.525216190778295, -82.33108059324849 35.52546819082243, -82.33103459322217 35.525590190842465, -82.33098759319721 35.5257021908603, -82.33092059317102 35.5258001908733, -82.3308435931449 35.52588719088306, -82.33073759311269 35.52598319089161, -82.33059959307339 35.526090190899176, -82.33043959302948 35.526204190905844, -82.33029459299097 35.52629919091016, -82.33024159297744 35.52633019091104, -82.33013459295036 35.52639119091237, -82.32998959291639 35.526456190910714, -82.3298525928857 35.52650919090735, -82.32968459284967 35.526563190901065, -82.32913459273422 35.52672319087692, -82.3289975927064 35.5267571908697, -82.32884459267642 35.5267881908603, -82.32870759265144 35.52680319084922, -82.32855559262578 35.526807190834425, -82.32842559260553 35.52679919081942, -82.32828759258447 35.52678819080299, -82.3281735925663 35.526784190790444, -82.32814359256135 35.52678419078737, -82.3279375925209 35.52682619077466, -82.32771559247071 35.52691419076975, -82.32754059242257 35.52703919077709, -82.32740259237454 35.52720319079612, -82.32738059231622 35.52755819086591, -82.32732659229507 35.52763819087659, -82.3271965922523 35.527776190891295, -82.32688059217183 35.52796019089613, -82.32674659214176 35.528012190892944, -82.32658659211121 35.52803919088187, -82.32630459206361 35.528046190854276, -82.3261215920309 35.52806219083871, -82.3260065920038 35.52811519083761, -82.32587759197374 35.52817219083589, -82.32577759194244 35.528268190845104, -82.32557159189608 35.52834819084018, -82.32546559186923 35.52840919084161, -82.32538859184771 35.528466190845265, -82.32533559183196 35.52851219084912, -82.32524359180093 35.5286151908606, -82.32523659179114 35.52867119087122, -82.32523659176637 35.528832190903884, -82.32530459175044 35.52900819094663, -82.32527459172677 35.52913019096828, -82.32524059171509 35.529169190972745, -82.32509859175173 35.52877919087892, -82.32493859168854 35.529018190910996, -82.32477659162548 35.52925419094226, -82.32460259155705 35.52951219097672, -82.32454159153085 35.52961719099175, -82.32449859150736 35.529723191008785, -82.32448959150018 35.529760191015356, -82.32444159146237 35.52995419104984, -82.3244335914579 35.529975191053275, -82.3244165914479 35.530021191060825, -82.32436759142816 35.53009719107121, -82.32427759139883 35.53019119108104, -82.32416959136492 35.5302961910912, -82.32411859134938 35.530342191095315, -82.32404659132735 35.530408191101294, -82.32398659130905 35.530462191106096, -82.32394559129652 35.53050019110957, -82.32384759126725 35.53058519111669, -82.32381859125911 35.530607191118165, -82.3237335912347 35.530674191123055, -82.32368059121927 35.53071719112635, -82.32357559119392 35.53077019112633, -82.3234685911698 35.53081219112384, -82.32344559116535 35.530816191122256, -82.32335859114824 35.53083419111694, -82.32333959114494 35.53083519111519, -82.32324459112867 35.53083919110631, -82.32310759110649 35.530836191091595, -82.32284959106742 35.530813191060325, -82.3226485910368 35.53079719103642, -82.32264759103658 35.530797191036314, -82.32253059101731 35.530797191024305, -82.32245459100336 35.53080619101829, -82.32234459098186 35.53082819101145, -82.32221359095303 35.530875191007496, -82.3218935908777 35.531021191004136, -82.32176359084869 35.5310701910007, -82.3216425908236 35.531103190994976, -82.32143259078404 35.53113519097993, -82.32122059074491 35.53116219096358, -82.32113459072814 35.53117919095812, -82.32099659069985 35.53121519095128, -82.32086759067134 35.5312621909475, -82.32078559065191 35.53130019094686, -82.32071659063637 35.53132719094522, -82.32066359062549 35.53134119094259, -82.32063659061977 35.53134919094143, -82.32055159060356 35.531363190935515, -82.32047059058947 35.531368190928184, -82.32027859056028 35.5313521909052, -82.31997659051417 35.53132719086901, -82.31991259050443 35.53132219086144, -82.31973059047786 35.53130019083822, -82.3195405904522 35.53126319081117, -82.31949759044801 35.531244190802965, -82.31941459043958 35.5312101907875, -82.31926259042896 35.53111619075277, -82.3191045904167 35.531026190718244, -82.31891959039761 35.53095219068424, -82.31870459037012 35.53090019065159, -82.3184505903367 35.530845190614215, -82.31832459032285 35.53080019059208, -82.31823459031564 35.530750190572746, -82.31815559031097 35.53069619055366, -82.31803359030381 35.530612190524025, -82.31790059029088 35.53055319049841, -82.31775059027252 35.53051219047466, -82.31771359026764 35.53050419046924, -82.31750959023933 35.53046919044116, -82.31750359023846 35.530468190440274, -82.31730459020864 35.53044919041593, -82.31705559016704 35.53045219039092, -82.31686859013527 35.53045819037291, -82.31665659009906 35.53046619035275, -82.3166245900938 35.53046619034946, -82.31653159007809 35.530468190340265, -82.31650059007285 35.53046919033738, -82.3162505900307 35.53047519031279, -82.31603758999657 35.53046819028943, -82.31603658999646 35.530468190289376, -82.31562558993362 35.53043619024063, -82.31545958990654 35.53043419022317, -82.31532158988001 35.53045819021372, -82.3152105898571 35.53048819020847, -82.31489858978887 35.53059719019845, -82.31468458974358 35.53066219018963, -82.31458858972306 35.53069219018581, -82.31441758968934 35.53072819017557, -82.31426758966226 35.530743190163136, -82.31423158965636 35.53074319015938, -82.3141475896426 35.53074219015057, -82.31406958963143 35.530731190140344, -82.31402458962496 35.53072519013452, -82.31390558960959 35.53069719011655, -82.31372158958924 35.53063219008444, -82.31360758957752 35.530586190063374, -82.31352558956895 35.530554190048456, -82.31346058956329 35.53052119003501, -82.31318958953919 35.53038718997999, -82.31305858952639 35.530330189954945, -82.31302058952238 35.530315189948, -82.31298758951891 35.53030318994213, -82.3128775895053 35.53027318992473, -82.31213958940667 35.53012318981838, -82.31185858936988 35.530061189776895, -82.31159858933667 35.52999818973735, -82.31139558931055 35.52995018970677, -82.31127258929277 35.52993418969085, -82.31115858927429 35.52993218967866, -82.3111205892672 35.529937189675785, -82.3110655892571 35.529944189671525, -82.31105258925461 35.529946189670596, -82.31085258921529 35.52998718965841, -82.31078658920227 35.53000118965441, -82.31075558919623 35.53000718965246, -82.3107015891856 35.53001818964908, -82.31066458917905 35.53002118964588, -82.31063458917346 35.53002518964365, -82.31058958916533 35.53003018963999, -82.31036758913156 35.53001118961329, -82.3103495891288 35.530010189611254, -82.31030158912195 35.530003189604855, -82.3100985890974 35.52994518957226, -82.30959658903909 35.52978618948835, -82.30943958902088 35.52973618946201, -82.30933958900778 35.52971418944729, -82.30933858900619 35.52972318944897, -82.30931658899259 35.529788189459936, -82.30927458897607 35.52985018946814, -82.3091905889448 35.52996318948248, -82.30898958886979 35.53023518951697, -82.30890558883587 35.53036518953466, -82.30883158880035 35.53051718955797, -82.30877758876798 35.5306691895832, -82.30876058875674 35.53072418959267, -82.30867758869955 35.53100618964128, -82.30865758868605 35.53107318965288, -82.30860158864449 35.5312821896895, -82.30858358863063 35.531353189702, -82.30856158860959 35.53146618972272, -82.30853958858818 35.53158218974396, -82.30847858852106 35.53195218981279, -82.30845658849007 35.532130189846576, -82.30844258846943 35.5322491898693, -82.30837158833911 35.53301919001817, -82.30836558832854 35.53308119003022, -82.30834858821689 35.53378819017188, -82.30834058820088 35.533883190190274, -82.30830358817174 35.534033190216974, -82.30830258817029 35.53404119021849, -82.30824858814324 35.53415919023686, -82.30816458811091 35.53427919025253, -82.30799858805146 35.53448719027768, -82.30794658802856 35.53458019029122, -82.30791458800938 35.53467019030616, -82.30791058800678 35.534683190308414, -82.30790558799775 35.53473619031858, -82.30790158798938 35.534786190328376, -82.3079115879706 35.53491919035639, -82.30791558796444 35.53496319036574, -82.3079325879463 35.535099190395044, -82.30800258787443 35.53564019051199, -82.30801158786598 35.535705190526095, -82.30803458785223 35.53581919055162, -82.30809358782376 35.53606719060802, -82.30812858779329 35.53630219065927, -82.30818458777235 35.53649819070486, -82.30826158774414 35.536764190766725, -82.3085015875738 35.538127191067964, -82.30851158750929 35.53855619115604, -82.30851358749744 35.538635191172226, -82.30854058743462 35.53907219126372, -82.30856558741108 35.53925119130258, -82.30858958738877 35.53942219133974, -82.30865758735085 35.53974119141145, -82.30866158734835 35.539761191416034, -82.30868758733469 35.5398781914424, -82.30890758730027 35.54033719155818, -82.30894658725698 35.540659191627505, -82.30895358720086 35.54103119170371, -82.30898758718641 35.54116119173357, -82.30899458718467 35.5411801917381, -82.30900358718247 35.541204191743944, -82.30900758717834 35.5412351917506, -82.30901558717487 35.541266191757764, -82.30914858715755 35.541521191823186, -82.30922758715593 35.54161619185064, -82.30937058715323 35.54178719190002, -82.30962458716077 35.54201019197145, -82.30967058716197 35.54205119198443, -82.31035158721762 35.54241919212918, -82.310751587229 35.54277419224241, -82.31094858722376 35.54301919231241, -82.31105658722089 35.54315319235066, -82.3112945872126 35.54346219243792, -82.31138058720944 35.54357419246947, -82.31138758720756 35.54359419247431, -82.31152858717489 35.543957192562445, -82.31154158716163 35.544057192584035, -82.31156258713997 35.54422019261927, -82.31157958712268 35.54435019264745, -82.31158958711667 35.54440019265862, -82.31167758706749 35.54481319275148, -82.31171258705434 35.54493619278006, -82.31176458703578 35.54511219282107, -82.3118195870155 35.54530319286548, -82.31187958699745 35.54548419290836, -82.31193058698224 35.54563719294477, -82.31195958694067 35.545938193008766, -82.31191658689711 35.54617519305245, -82.31188558688443 35.54622419305922, -82.31178558684277 35.546387193081934, -82.31158058675405 35.54674319313305, -82.31131858664013 35.54720219319927, -82.31113358654571 35.54761719326443, -82.31115958651826 35.54782319330887, -82.31149258644533 35.548652193511394, -82.31165958640511 35.54909219361787, -82.31175358637685 35.54937619368517, -82.31185858634593 35.54968919375944, -82.31209458629087 35.55029919390755, -82.31217158628048 35.550449193945845, -82.31222158627355 35.550547193970914, -82.31230358626227 35.5507081940121, -82.3123845862558 35.55083719404656, -82.31244458625115 35.55093119407183, -82.3127155862976 35.5509201940975, -82.31339458637144 35.55116819421768, -82.31380558641908 35.55129919428655, -82.31406758644775 35.55139319433263, -82.3146455865245 35.55151419441667, -82.31487458654293 35.551640194465804, -82.31510958655457 35.55181619452578, -82.31525158656537 35.551898194557026, -82.31623258666284 35.552316194742815, -82.31699958672321 35.55274519490885, -82.3172285867382 35.55289319496246, -82.31771258678414 35.55311319505689, -82.317913586797 35.55324519510443, -82.31808858679801 35.55342619515918, -82.31840558681297 35.55366819524088, -82.31909758686368 35.55408019539573, -82.31971658692436 35.554349195514035, -82.3201745869779 35.55449219559018, -82.32076558705262 35.554640195681074, -82.32135058713732 35.55471719575692, -82.32176258720779 35.55470119579613, -82.32224558729021 35.5546841958424, -82.32285758738948 35.55469519590762, -82.32307858743447 35.554640195919184, -82.32342258751916 35.554459195917886, -82.32361758756824 35.5543491959156, -82.32418858768717 35.55418919594196, -82.32421658769246 35.55418519594403, -82.32430358770866 35.55417319595051, -82.32453158774116 35.554206195980726, -82.32467258776785 35.55418419599076, -82.32533858792283 35.55389219600001, -82.3259035880381 35.55374919602921, -82.32606458806714 35.553733196042494, -82.32671058816017 35.553821196126876, -82.32690558818145 35.55389219616137, -82.32718758821781 35.55395819620376, -82.3276655882594 35.5542001963021, -82.32799558828017 35.55441919638051, -82.32818358829587 35.55451819641992, -82.32829158829854 35.55461719645111, -82.32842558828588 35.55484219651058, -82.32848658827814 35.55495819654041, -82.32863458822982 35.555430196651464, -82.32895758817725 35.556117196824175, -82.32912558813456 35.556574196934136, -82.32925358809207 35.556986197031016, -82.32948158807059 35.55737019713234, -82.32965758806832 35.55757319719176, -82.32995958808165 35.55781019727086, -82.33004758807506 35.55794719730775, -82.33025558804663 35.558354197411774, -82.33044458803552 35.558629197487036, -82.33061858803627 35.5588101975417, -82.33081458802967 35.559063197613206, -82.33102958804056 35.5592221976676, -82.3316015881139 35.559359197754354, -82.33169558812942 35.559359197764074, -82.33183058814713 35.55938919778399, -82.33197058816549 35.55942019780472, -82.33230058819291 35.559595197874216, -82.33256958821275 35.5597551979343, -82.33275158823429 35.55981019796423, -82.33352958834422 35.559930198068656, -82.33393858839756 35.56002219812946, -82.33452158848272 35.5600941982041, -82.33478058850855 35.56020419825308, -82.33542158858495 35.56039519835778, -82.3362915886603 35.56083819853729, -82.33655058868027 35.56098619859398, -82.33688658871634 35.56111219865422, -82.33820658891187 35.56125719881946, -82.33926658908747 35.56125319892772, -82.33975458916211 35.56129219898593, -82.33993858918262 35.5613561990179, -82.34033458922217 35.561524199092716, -82.34068558927233 35.56157419913903, -82.34481058987251 35.56210019967039, -82.34447658978226 35.562328199682284, -82.34388858958458 35.56298019975413, -82.34324058938599 35.56357419980795, -82.34317258936336 35.56364819981598, -82.34282758924701 35.564033199858656, -82.342788589223 35.5641471998778, -82.34281058919674 35.56434119991943, -82.34282958909307 35.56503420006204, -82.3428705889754 35.565841200230125, -82.34312758887212 35.5667862004484, -82.34328658880024 35.56742220059388, -82.34326658875243 35.56771120065041, -82.34314958866797 35.56813320072406, -82.34279658851506 35.56874720081249, -82.34274658849633 35.56881520082107, -82.34269458847639 35.56888820083049, -82.34253958841691 35.569108200859205, -82.34248858839706 35.569182200869, -82.34198258831364 35.56918120081666, -82.34153958826668 35.56901120073655, -82.34138258824832 35.5689622007104, -82.34100758820392 35.568848200648766, -82.34047458814558 35.568656200554855, -82.33913958786572 35.56904120049558, -82.33819558767307 35.5692792004467, -82.33810358764836 35.56934120044982, -82.33777058755805 35.56957020046202, -82.3376345875211 35.56966420046707, -82.33754358749617 35.5697282004707, -82.33723558739183 35.570075200509464, -82.33700858731486 35.57033120053802, -82.33665358711875 35.571222200682314, -82.33661558706692 35.571517200738334, -82.33647858694674 35.57215020085268, -82.33625158685881 35.572477200895705, -82.33568858664029 35.57329120100294, -82.33510958651411 35.573489200983516, -82.33433258637791 35.573540200913875, -82.33354558622648 35.573679200861, -82.33302958608236 35.57406120088539, -82.33270258594318 35.57461320096384, -82.33236558579554 35.575209201050036, -82.33213858570811 35.57553320109246, -82.33182158560132 35.575886201131475, -82.33163158554716 35.57603320114172, -82.33123258544725 35.57625420114552, -82.33077858527456 35.57688720122724, -82.33042358517551 35.57714920124389, -82.32961958495048 35.57774720128242, -82.32854358458124 35.57898820142352, -82.32824858447995 35.57932920146232, -82.32784758427731 35.580213201600515, -82.32713258406984 35.58079220164431, -82.32704158404326 35.5808672016502, -82.32619058378803 35.58161020171334, -82.32562858366596 35.581800201694, -82.3250865835493 35.581976201673896, -82.32343158326947 35.58201820151197, -82.32220158304516 35.582156201413284, -82.321394582877 35.58238220137595, -82.32053658276622 35.58218220124699, -82.31825758247219 35.58164920090402, -82.31766958236305 35.58172720085936, -82.317342582302 35.58177320083506, -82.31612758207267 35.581959200747555, -82.31591258204104 35.58193420072034, -82.31532558195406 35.581870200646854, -82.31543658201839 35.58157220059786, -82.31547958204271 35.58146020057952, -82.31562958212946 35.58105920051362, -82.31653958265524 35.57862620011357, -82.31684358283057 35.57781519998034, -82.31667258282516 35.57766719993271, -82.31647758285652 35.57725519982896, -82.31617558283975 35.57704119975443, -82.31588458281897 35.57686419968854, -82.31462758272932 35.57610119940426, -82.31451558272374 35.57601719937563, -82.31433258271464 35.57588019932894, -82.31422458270933 35.57579919930139, -82.31407658269683 35.57572219927054, -82.31390658267232 35.57569919924835, -82.31371958264526 35.57567419922399, -82.31355158262109 35.57565119920209, -82.31344958260505 35.57564619919055, -82.31321258256945 35.57562319916146, -82.31302658254195 35.57560219913804, -82.31280158250101 35.57562719911994, -82.31263358247257 35.57563219910357, -82.31257958246333 35.57563419909848, -82.31248058244816 35.575626199086635, -82.31225958241352 35.575614199061434, -82.31204858237935 35.57561019903886, -82.3120255823756 35.57561019903652, -82.31185658234983 35.57559619901626, -82.31155258230801 35.57554219897399, -82.31133158227767 35.57550219894319, -82.31113658224723 35.57549119892085, -82.31111358224214 35.57549919892002, -82.31094758220583 35.57555719891474, -82.31085458218787 35.57557419890864, -82.31067958216155 35.57555719888711, -82.31086658215682 35.57578819895328, -82.31117058214926 35.57616219906047, -82.31136558213306 35.57647519914411, -82.31137658212859 35.57651619915355, -82.31145258209658 35.576805199220026, -82.31141358207873 35.576879199231, -82.31139258206886 35.57692019923719, -82.31128658202402 35.57709719926219, -82.3112435820057 35.57717019927256, -82.31124758199805 35.57722419928393, -82.31126758197946 35.577366199314845, -82.31129958196388 35.57750119934552, -82.31134358194703 35.57765719938169, -82.31136058194231 35.57770619939333, -82.31139458193218 35.577808199417575, -82.31139758192406 35.57786419942928, -82.31136158191606 35.57787719942821, -82.31130858189849 35.57793419943426, -82.31119458186554 35.578026199441226, -82.31114658184688 35.57809519945032, -82.3110855818267 35.57816119945744, -82.31104658181296 35.57820819946289, -82.31100858179971 35.57825319946812, -82.3109695817855 35.57830419947445, -82.31092658177182 35.578346199478524, -82.31082858174105 35.578441199487706, -82.31078658172667 35.5784891994931, -82.3107405817114 35.578539199498536, -82.31070058169719 35.578588199504416, -82.31066258168373 35.57863519951002, -82.31063058167199 35.57867719951523, -82.3105665816499 35.57875119952359, -82.31053058163675 35.57879819952951, -82.3104535816114 35.57888019953822, -82.31028658154796 35.57911219956804, -82.31015658150982 35.57922019957656, -82.30997958147756 35.57924019956241, -82.30999058149378 35.57914719954469, -82.31002158151392 35.579049199527994, -82.31001358152469 35.57897119951133, -82.30994458156552 35.578633199435586, -82.30990358158155 35.57848519940132, -82.3099095815963 35.57839619938396, -82.30992258161051 35.57831819936942, -82.3099245816236 35.57823519935284, -82.30990958162685 35.578198199343724, -82.30987858162652 35.578167199334246, -82.30981158162018 35.57813619932105, -82.30975458161004 35.578141199316214, -82.30966758158695 35.57819819931881, -82.30963758157021 35.57827419933114, -82.30961758156027 35.57831719933777, -82.30959658154944 35.578365199345384, -82.30956758153778 35.57840919935135, -82.30950058151114 35.57851019936491, -82.30946058149686 35.578560199370955, -82.30938258146796 35.57866419938399, -82.30934158145273 35.57871919939092, -82.30929558143654 35.578774199397365, -82.30924758142045 35.57882719940315, -82.30919958140436 35.57888019940896, -82.30910758137301 35.578985199420835, -82.30906258135734 35.57903819942693, -82.30896858132462 35.57915019943998, -82.30892758130874 35.579209199447774, -82.30889058129304 35.579271199456436, -82.30882158126313 35.57939119947379, -82.30879058124874 35.57945119948278, -82.30876758123532 35.579513199492936, -82.3087355812133 35.579622199511775, -82.3087135812011 35.57967719952064, -82.30865858117443 35.579791199538164, -82.30863058116105 35.57984819954682, -82.3086045811483 35.57990319955524, -82.30855858112379 35.580012199572664, -82.30853158111148 35.58006319958018, -82.3084945810991 35.580104199584696, -82.30845458109191 35.580108199581375, -82.3082945810113 35.5804591996362, -82.30808058093592 35.58071819966667, -82.30792058088626 35.58086919968086, -82.3078095808354 35.58108019971222, -82.30780358083251 35.581092199714014, -82.30753358076265 35.58125619971951, -82.30716758067382 35.5814401997192, -82.30666258056354 35.58161419970244, -82.30663958053995 35.58174219972599, -82.3066525805259 35.58184719974862, -82.30667558050202 35.58202719978755, -82.30651858044516 35.58222719981193, -82.3062835803982 35.58228019979851, -82.30625458039552 35.58226619979268, -82.30604158037599 35.58216519975018, -82.30597558035248 35.58224719976003, -82.30583958030887 35.58238419977385, -82.30569458026541 35.58251019978452, -82.30566958025966 35.582521199784104, -82.30553458022743 35.58258519978322, -82.3053235801786 35.58267619977996, -82.30512158012645 35.582798199783866, -82.30502758010678 35.58282519977965, -82.30486058007641 35.58284319976612, -82.3046935800478 35.58285019975035, -82.30456458002689 35.58284719973644, -82.30435857999494 35.58283419971252, -82.30419257997339 35.58279619968777, -82.30411057996267 35.582778199675666, -82.30394757994216 35.58273619965028, -82.30380257992273 35.58270719962952, -82.30368557990465 35.5826991996158, -82.30321757983306 35.5826631995603, -82.30307457980834 35.58267019954703, -82.30298657979306 35.58267519953893, -82.3026905797454 35.58266719950682, -82.30250357971195 35.582684199491005, -82.30241657969275 35.58271519948831, -82.30235357967672 35.58275219948929, -82.30231557966151 35.58281019949718, -82.30230057965078 35.58286319950637, -82.30230157963862 35.58294319952273, -82.30231857962472 35.58305119954636, -82.30236957960331 35.583244199590816, -82.30241557957662 35.583466199640604, -82.3024775795325 35.583818199718486, -82.30249857951812 35.58393419974409, -82.30254457949648 35.58412319978721, -82.3025855794821 35.584260199819234, -82.30262257946455 35.5844131998541, -82.30262857946158 35.58443919985996, -82.30264657945216 35.58451919987807, -82.30265257944903 35.58454619988419, -82.30258157945032 35.58446219985983, -82.3022195794668 35.58396819972226, -82.30209057947175 35.583798199674455, -82.30196557947244 35.5836601996336, -82.30186657947027 35.58356819960474, -82.30154557946368 35.58326819951074, -82.30135757945628 35.58311519946036, -82.30126557944804 35.583070199441714, -82.30118757944028 35.58303719942704, -82.30110157943034 35.583009199412444, -82.3010025794165 35.582993199399056, -82.30063757935977 35.58297019935673, -82.30058057935291 35.58295419934764, -82.30052657934827 35.58292619933635, -82.30049257934826 35.58289019932552, -82.30046557935093 35.58284419931348, -82.30045057935769 35.58278419929969, -82.30042857937518 35.58264719926968, -82.30040857938192 35.58258219925445, -82.30037457938744 35.582510199236346, -82.30032357938904 35.58244519921781, -82.30026457938855 35.582385199199656, -82.3001835793853 35.582320199178056, -82.30004557937659 35.582229199145424, -82.29990157936287 35.58216419911741, -82.29977257934895 35.58211619909436, -82.2995415793216 35.582046199056364, -82.2994815793153 35.58202319904551, -82.29942157931063 35.58198919903242, -82.29936757930851 35.58194519901787, -82.29929757931345 35.58183819898895, -82.29923857932648 35.581691198953116, -82.29920257932777 35.58164419893984, -82.29915957932592 35.58161019892849, -82.29908757931898 35.581578198914606, -82.29903857931322 35.58156319890648, -82.29897357930278 35.58156119889946, -82.29895157929916 35.581561198897134, -82.29887957928584 35.58157019889153, -82.29870457925057 35.581612198882034, -82.2979205790842 35.58185119884971, -82.29784857906992 35.581867198845536, -82.29778957905889 35.58187519884109, -82.29776157905505 35.5818701988372, -82.29752757899254 35.582025198844505, -82.2973745789514 35.58212819884964, -82.29722057891236 35.582216198851626, -82.29710257888436 35.58227119885063, -82.29698257885919 35.58230619884536, -82.29683857883158 35.58233119883567, -82.29682557882913 35.58233319883467, -82.2967605788183 35.582334198828235, -82.29662657879548 35.582338198815194, -82.29648057877121 35.582339198800376, -82.29643057876295 35.582339198795225, -82.29636357875178 35.5823401987885, -82.29628357873888 35.58233819877987, -82.29623457873102 35.58233719877458, -82.29605057870124 35.58233319875484, -82.2958475786721 35.58230519872822, -82.29557057863424 35.58225419868933, -82.29536257860248 35.58223719866445, -82.29516757857576 35.58220219863728, -82.29513957857185 35.58219719863334, -82.29486557853856 35.58212019858951, -82.2945275784988 35.58201619853359, -82.29426957846759 35.58194319849214, -82.29408757844153 35.581917198468155, -82.29390557840985 35.58192819845164, -82.2937065783717 35.581962198437964, -82.2932215782733 35.58208119841218, -82.2930645782401 35.582128198405535, -82.2929335782066 35.58220519840763, -82.29286057818148 35.58229019841736, -82.292775578144 35.58244219843941, -82.2926365780577 35.58285219850833, -82.29257957802011 35.583035198539584, -82.29255157800142 35.583126198555135, -82.2924905779566 35.583351198594535, -82.29245957791917 35.5835601986337, -82.29245557788067 35.583805198683024, -82.29244657785266 35.58397719871697, -82.29241657782973 35.584093198737406, -82.29240357781975 35.58414419874649, -82.29227257775862 35.58440019878488, -82.29223157773933 35.584481198797064, -82.29211657769542 35.58464219881785, -82.29199557765156 35.584797198836895, -82.29190557761524 35.58493619885584, -82.29184257758607 35.58505819887409, -82.29176257753934 35.58527519890982, -82.29171557751137 35.58540619893157, -82.2916535774778 35.5855571989558, -82.29163257746941 35.58558919896017, -82.29158057744785 35.58567319897184, -82.29146257741397 35.58576619897851, -82.29141457740239 35.585790198978415, -82.2912085773517 35.58589819897912, -82.29060557720582 35.58619819897783, -82.29043357716417 35.586284198977594, -82.2903365771403 35.586335198977906, -82.29017457710067 35.586419198978305, -82.2900825770778 35.586468198978714, -82.2898115770141 35.58659119897577, -82.28966957698466 35.58663019896909, -82.28960257697057 35.58665019896614, -82.28949257694885 35.58667319895948, -82.28944757692257 35.58679519897965, -82.28942657690999 35.58685419898943, -82.28919457686536 35.58689519897381, -82.28911257685924 35.58684719895566, -82.28899957685066 35.5867821989308, -82.28893857683885 35.58679319892674, -82.28875757680363 35.58682819891517, -82.28869757679188 35.58684019891142, -82.28840457673499 35.58689519889237, -82.2882495767048 35.586925198882554, -82.28789857663486 35.58700319886215, -82.28782157662047 35.587014198856416, -82.28752757656488 35.58706019883547, -82.28723457650919 35.58710719881479, -82.28679257642567 35.58717619878321, -82.28607957629335 35.58727119872904, -82.28599557627977 35.58726919871994, -82.28597257627595 35.58726919871757, -82.28590757627374 35.58721419869972, -82.2857795762691 35.58710819866507, -82.28448157621794 35.58605219831704, -82.28189557611621 35.583949197623895, -82.28067457606815 35.58295619729656, -82.27178657569449 35.575884194945964, -82.27114857566755 35.57537719477742, -82.26724257550441 35.572262193743036, -82.26652957547473 35.57169319355412, -82.26590957545326 35.5711701933842, -82.26586757545141 35.57113719337326, -82.26473357540495 35.570227193071695, -82.26473257540495 35.57022619307148, -82.26040857522807 35.56675419192171, -82.25911157516536 35.56577519158948, -82.25849857513566 35.565313191432594, -82.25483757495826 35.56255319049568, -82.25472457495415 35.562459190464935, -82.25469457495308 35.56243419045676, -82.25372057491803 35.56162119019155, -82.25243457484532 35.560719189876096, -82.25148057479414 35.56003218963853, -82.25085057474712 35.559664189498974, -82.24982457462787 35.55934118932775, -82.24940857457304 35.55925218926684, -82.24800057440127 35.5588621890427, -82.2448885740218 35.55799818854678, -82.24476457400675 35.5579631885269, -82.2435335738567 35.55762118833069, -82.24219657369369 35.55725018811768, -82.24110757356084 35.5569481879442, -82.23922157330014 35.55662418768416, -82.23372757254045 35.55568218692699, -82.23203657230505 35.55540318669614, -82.22908457189385 35.554917186293316, -82.22706157161367 35.55457318601507, -82.22617457149532 35.55439318588722, -82.21996857066715 35.55313818499309, -82.21112456976563 35.54954418335305, -82.21102756975588 35.549504183334946, -82.21081756973491 35.54941618329549, -82.21065256971809 35.54934918326484, -82.2101835696764 35.54911918316998, -82.20680756932613 35.54778818255219, -82.2020875689373 35.54527318155598, -82.20130456887173 35.54486318139216, -82.19948056871951 35.54390418100988, -82.19886256866432 35.54360318088512, -82.19867956864965 35.54350318084601, -82.19827656861675 35.5432861807605, -82.1981695686083 35.54322718073748, -82.19794656859004 35.54310718069026, -82.19695956850867 35.5425821804821, -82.19626156844998 35.54221818033641, -82.19512656835632 35.54161518009722, -82.19455356830862 35.54131317997702, -82.19240756813038 35.54018017952622, -82.19160756806386 35.53975817935825, -82.19098156801621 35.53939917922092, -82.18864756782173 35.53817117873155, -82.18634156762965 35.53695717824787, -82.18615656761297 35.536868178210796, -82.1845365674793 35.53600717786942, -82.18449256747559 35.53598417786015, -82.18435256746403 35.535910177830715, -82.18400056743464 35.53572517775708, -82.17633056679547 35.53169117614914, -82.17492156667814 35.53095017585387, -82.17156256639835 35.52918317514966, -82.17130056637643 35.52904617509489, -82.16955656622997 35.52813617473082, -82.16900556618535 35.527838174613706, -82.16913556620959 35.52782017462341, -82.16952656628197 35.52776717465299, -82.16965756630614 35.52775017466306, -82.16970456631496 35.5277431746665, -82.16984956634194 35.527723174677384, -82.16989756635066 35.52771717468109, -82.1699535663612 35.527709174685235, -82.17012556639266 35.52768817469873, -82.17018256640317 35.52768117470315, -82.17021856640984 35.52767617470584, -82.17032956642974 35.52766517471512, -82.1703665664365 35.52766117471808, -82.17066856649218 35.527622174741296, -82.17090356653544 35.527592174759505, -82.17116156658295 35.52755917477932, -82.17123456659642 35.52754917478485, -82.17125356659996 35.52754717478639, -82.17189056671639 35.52747117483669, -82.17646656755278 35.52692717519821, -82.17670456759626 35.52689917521707, -82.17799156783262 35.52673917531733, -82.17808556784982 35.52672717532458, -82.17836956790195 35.52669217534675, -82.17846356791907 35.52668117535421, -82.17846456791933 35.52668117535435, -82.1786505679536 35.52665717536861, -82.17921156805649 35.52658817541242, -82.17939856809076 35.52656517542708, -82.1796295681333 35.52653617544498, -82.18032356826043 35.52645117549932, -82.1805555683029 35.52642317551754, -82.18426356898327 35.525966175807135, -82.18562956923407 35.52579717591371, -82.19574457109024 35.52455017670346, -82.20023657191616 35.523986177052016, -82.20598457295841 35.52336117751752)))",6391,37,021,003205,370210032051,1525,1525,26,1503,1486,2,4,8,1,2,22,1226,11,1215,1213,1201,0,2,7,1,2,13,1015,673,342
census_2010_blockgroups_view.fid--2dc29038_13ec899ba8f_-263b,"MULTIPOLYGON (((-82.84633966515136 35.6144482618133, -82.84683866519147 35.614730261922034, -82.84746266524168 35.615082262057776, -82.84851666526822 35.61605726236493, -82.84921666531025 35.61654526253623, -82.84943666532357 35.61669826258998, -82.85051866546365 35.616964262755076, -82.85076366548964 35.61706126280004, -82.8510836655448 35.61705126283078, -82.85158366562374 35.617081262888014, -82.85174466561196 35.617333262956016, -82.8515956654961 35.61792526306173, -82.85158366544351 35.61825526312789, -82.85160566537523 35.61872326322578, -82.85160066529905 35.61921426332559, -82.85177566525195 35.61971126344503, -82.85176466519927 35.620042263511465, -82.8517216651663 35.62021026354144, -82.85176166514564 35.620388263581845, -82.85175866512411 35.62052526360958, -82.85173666511129 35.62058526361953, -82.85165966498538 35.62132126376213, -82.85177966489717 35.622026263918336, -82.85168966480335 35.62253926401394, -82.85153966476696 35.62261226401358, -82.8515116647502 35.62269126402675, -82.85144366468819 35.62302126408725, -82.85143066465776 35.62320526412346, -82.85136366461316 35.623422264161, -82.85130466457306 35.62361926419516, -82.8512736645361 35.62382626423431, -82.8512606645008 35.62404226427705, -82.85117666445636 35.624240264308966, -82.85114866443767 35.6243312643247, -82.85114766438113 35.624698264399505, -82.85118166433533 35.625033264471476, -82.851092664283 35.625277264512235, -82.850993664232 35.62550126454782, -82.85090866419525 35.62564826456915, -82.85078266414811 35.625818264591054, -82.85073266411962 35.62594926461269, -82.85072266409423 35.62610326464313, -82.85066966405908 35.626274264672574, -82.85063366403558 35.62638826469219, -82.85057966399066 35.62662226473447, -82.8505566639342 35.626964264802, -82.85051566387473 35.627307264867866, -82.85053766386365 35.6274032648898, -82.85073166381216 35.62794926502115, -82.8507606637792 35.62819526507438, -82.85092466376932 35.628438265140794, -82.85122266375113 35.628881265261846, -82.85169666373359 35.62951126543915, -82.85212066368054 35.63031826564739, -82.85187466358869 35.63064826568962, -82.85131266335476 35.63155926581822, -82.8509626631499 35.63251126597683, -82.85094766314116 35.63255226598365, -82.85095766299783 35.633495266177384, -82.85143266287528 35.63481026649472, -82.85214466282311 35.635924266795215, -82.85290466285358 35.63655326700158, -82.85369366292967 35.63691626715658, -82.85472966311038 35.636868267252865, -82.85598266335823 35.63661826733004, -82.85702866362979 35.63599026730888, -82.8581926639137 35.63540926730937, -82.85888366403664 35.63536126737033, -82.85958366414125 35.63544226745859, -82.86036366428787 35.63533726751697, -82.86153766452263 35.63508726758613, -82.86194266460033 35.63502226761428, -82.862691664744 35.634902267666455, -82.86392566497642 35.63473326775835, -82.86481366515355 35.63454726781122, -82.8650106651914 35.63451526782484, -82.86523866516379 35.63494326793566, -82.86547566506583 35.63583826814281, -82.8655076650393 35.63604626818858, -82.86553466501724 35.63621926822669, -82.86557466498456 35.63647526828306, -82.86559366498298 35.63650626829142, -82.8658906649592 35.63698426841948, -82.86643366498934 35.63737926855582, -82.86658066499766 35.63748526859256, -82.86696266501905 35.63776226868827, -82.86699166502082 35.63778226869528, -82.86702566502265 35.63780726870386, -82.86707066502282 35.63785526871828, -82.86709566502287 35.63788226872638, -82.86745066502444 35.638258268839564, -82.86769766498018 35.63881526897866, -82.86773766490123 35.63937226909663, -82.86793466488348 35.6397022691842, -82.86821166487906 35.64003226927999, -82.86829766481267 35.64055826939628, -82.8683206647956 35.64069426942643, -82.86839966473438 35.64117826953347, -82.86868666471194 35.64163726965666, -82.86902166471457 35.64198426976184, -82.86913066464234 35.642573269893425, -82.86895366449238 35.643356270035284, -82.86866866432578 35.64413027016426, -82.86845166418661 35.644799270278796, -82.86851566414212 35.64515827035866, -82.86931066418117 35.645769270565, -82.87102766434614 35.6465652709035, -82.87157666432898 35.64727427110456, -82.87162866432622 35.64734927112523, -82.87184666430997 35.6476922712177, -82.8729946643618 35.64860427152163, -82.87353066426518 35.64981627182426, -82.87380766425095 35.65021027193315, -82.87437566422194 35.65101727215627, -82.87457566419317 35.65142227225949, -82.87457566414957 35.65170527231734, -82.87449766409561 35.65197127236377, -82.87443766407091 35.652067272377224, -82.87413266397502 35.652358272405465, -82.87384666386147 35.65278627246361, -82.87376866373425 35.65352827260727, -82.87364066360385 35.65423727273909, -82.87332566343692 35.65498027285867, -82.8730496632927 35.655617272960576, -82.87294366325177 35.65576827298058, -82.87261466308337 35.65650527309751, -82.87263266302774 35.65688627317721, -82.87229066289184 35.65739827324681, -82.8728376628762 35.658095273445305, -82.87301666289608 35.65816027347695, -82.87359766284615 35.659117273732036, -82.87362466284159 35.659176273746866, -82.87392066284055 35.65950527384441, -82.87440266285617 35.65992827398022, -82.87446366285823 35.65998127399733, -82.874847662882 35.660244274090395, -82.8755446628793 35.66102027432044, -82.87576966288697 35.66121527438333, -82.87659066294795 35.66171227456902, -82.87762866303433 35.66228027479148, -82.8775126629886 35.6624512748145, -82.87635966259633 35.66374627496108, -82.87631666256713 35.66388927498596, -82.87604066239757 35.664691275121584, -82.87605066236661 35.66490327516595, -82.87592766230654 35.66516027520589, -82.87607866228284 35.66547827528634, -82.87614066225463 35.66572927534398, -82.87633766222787 35.6661172754435, -82.87671366226208 35.66630427552019, -82.87658266222324 35.66641427552928, -82.87705066226548 35.66664827562501, -82.87709566226872 35.66667627563538, -82.87794166234396 35.667108275810335, -82.87821666235442 35.66733927588576, -82.87830566232913 35.66760027594821, -82.87864666233503 35.667933276051244, -82.87904166236551 35.66816427613886, -82.87929866233814 35.668622276258844, -82.8808306625279 35.669055276504324, -82.88376066278882 35.670547277109485, -82.88609466298277 35.6718262776101, -82.886962663047 35.67235327780673, -82.88766866309565 35.67280527797151, -82.88776766304682 35.67323027806858, -82.88732866288481 35.67380527814107, -82.88684666274906 35.674163278164826, -82.88619266256755 35.674631278193495, -82.8858916624453 35.675098278258154, -82.88563066227599 35.67591427839818, -82.88532566212349 35.67657327850168, -82.8847256619282 35.6771892785661, -82.88406066174687 35.67764427859097, -82.8837146616248 35.678060278640565, -82.88365266159492 35.67818727866022, -82.88344466149516 35.678609278725126, -82.88301166133088 35.67920527880261, -82.88240466115522 35.67968627883872, -82.88185766100436 35.68007127886133, -82.88152066091537 35.680283278870185, -82.88093166075967 35.680654278885626, -82.88018366058762 35.68095827887108, -82.87984166051477 35.6810592788567, -82.87903266035687 35.68120527880366, -82.87881566030842 35.68128427879757, -82.87861366025085 35.68143827880831, -82.8777386600189 35.68199327883206, -82.877588659979 35.68208927883636, -82.87747765993551 35.68225127885806, -82.87727565988398 35.68236627886088, -82.87702665981355 35.68255227887341, -82.87686665978208 35.68258327886333, -82.87667465972538 35.68274227887608, -82.87648465968792 35.68277927886421, -82.8761736596146 35.68291727886053, -82.87575465951338 35.68311927885886, -82.87525165940778 35.68325827883574, -82.87452365922951 35.68362427883595, -82.8741956591101 35.684043278887984, -82.8739406590087 35.68442427893972, -82.87390365898348 35.68454827896126, -82.87384365892424 35.684867279020295, -82.87370065884214 35.68524527908287, -82.87342665868856 35.68594427919765, -82.87339065866827 35.686037279213004, -82.8730826585868 35.68623127922106, -82.8729356585371 35.68639427923939, -82.87275065848084 35.6865582792539, -82.87247965840575 35.68675127926558, -82.8724146583655 35.6869422792979, -82.8719656582156 35.687427279351034, -82.87190465816184 35.68771027940268, -82.87167865806248 35.68810927946101, -82.8715646579991 35.688397279508244, -82.87101165782683 35.688914279557146, -82.87063265774104 35.68905927954798, -82.86989665760949 35.689113279483514, -82.869454657557 35.6889742794098, -82.86909965752021 35.68882727934338, -82.86890265748151 35.688864279330716, -82.86870865745293 35.688839279305725, -82.8684276574091 35.68881827927264, -82.86823665737158 35.68885427926044, -82.86803665734183 35.68883027923502, -82.86784365731317 35.68880627921032, -82.86772365729723 35.6887792791925, -82.86757365727165 35.68878227917775, -82.86752565726212 35.68879227917484, -82.86723365719165 35.68893227917356, -82.86614765689963 35.68964827920854, -82.86577865681255 35.68981227920423, -82.86554465676751 35.68985027918798, -82.86527565670697 35.68995127918107, -82.8650476566434 35.690116279191386, -82.8648216565713 35.690338279213634, -82.86459665649869 35.690565279236964, -82.86429565641764 35.69076427924672, -82.86414765636852 35.6909222792638, -82.86380265628001 35.691122279269344, -82.86345665619586 35.69129227926863, -82.86309565612822 35.69133927924124, -82.8623796559623 35.691638279228904, -82.86146065574648 35.69204027921679, -82.86104065562618 35.692365279240214, -82.86020465543844 35.692675279217795, -82.86004865540441 35.69272727921243, -82.85970765533726 35.69279227919077, -82.85858265510814 35.69305727912957, -82.85740765487424 35.693299279058486, -82.8568246547617 35.69339627901856, -82.85662765464183 35.69396027911362, -82.85654865450664 35.69475127926714, -82.85625365436407 35.69535627936053, -82.85613065433574 35.695406279358174, -82.85601665428584 35.69560627938736, -82.85577465422696 35.69572527938686, -82.85560165419302 35.69575827937584, -82.8554636541428 35.69593427939765, -82.85497965402446 35.696176279397456, -82.85473965396086 35.696328279403915, -82.85450765386886 35.69667327945065, -82.85409765374186 35.69705227948604, -82.85405665372834 35.69709527949057, -82.85389265367314 35.697275279510556, -82.85391365363446 35.697549279568754, -82.85391865363147 35.697574279574354, -82.85410265353548 35.6983962797612, -82.85419165345216 35.69903327990046, -82.85404165340788 35.699158279910655, -82.85406265339529 35.699262279934025, -82.85409865339285 35.699317279948964, -82.85400365335882 35.69943527996336, -82.85391265333574 35.69948627996444, -82.85368665329119 35.69952927995011, -82.85346465326175 35.69947927991703, -82.85282865312604 35.69966927989069, -82.85259365304961 35.699910279915805, -82.85243065300924 35.699995279916436, -82.8522906529852 35.69999927990293, -82.85189965290927 35.70006727987667, -82.8514456528268 35.70010927983869, -82.85081165269543 35.70027327980719, -82.85077665268525 35.70030127980932, -82.85074065267455 35.700331279811756, -82.85060365264242 35.70039127980997, -82.85046365261408 35.70042327980221, -82.85032665258119 35.70048727980122, -82.8501206525199 35.70066127981557, -82.85002865248389 35.700795279833585, -82.84981365242356 35.70095327984379, -82.84967765238656 35.701045279848614, -82.8495086523403 35.701162279855176, -82.84927665223032 35.70162327992563, -82.84918265219207 35.70176927994582, -82.84915565217275 35.70186527996264, -82.84901165213265 35.701969279969155, -82.84884065209386 35.70203527996509, -82.84869565206468 35.70206727995677, -82.8485686520465 35.702047279939634, -82.84816265198644 35.70199627988758, -82.84798265195533 35.70200227987031, -82.84792165195594 35.701932279849764, -82.84758165192993 35.70173227977403, -82.84708065186501 35.70160927969746, -82.84665165179618 35.701590279649594, -82.84628965175955 35.7014352795808, -82.84617665175776 35.70132327954632, -82.8459516517584 35.70107527947254, -82.84584265175444 35.70098327944258, -82.84544565170636 35.70086427937754, -82.84526865168442 35.70081427934915, -82.84508765165748 35.7007922793261, -82.84483665162712 35.700717279284994, -82.84455365158261 35.700698279252066, -82.84404165153383 35.70045927915075, -82.84365465149942 35.70026227907077, -82.84299165144074 35.69992327893353, -82.84284265142374 35.6998722789078, -82.84262965140417 35.6997682788647, -82.84243965140227 35.69957427880557, -82.8423266514134 35.69937927875412, -82.84220965142237 35.699194278704354, -82.84200765147196 35.698653278573076, -82.84197865156268 35.698033278443404, -82.84181565160462 35.697584278334894, -82.8417536516243 35.697389278288746, -82.84169065164443 35.69719027824159, -82.84159965168524 35.69682727815805, -82.84159365170642 35.696683278128084, -82.8415526517207 35.69654627809585, -82.8410316517187 35.695993277929425, -82.8407376516896 35.69586327787267, -82.84066365169895 35.69572227783632, -82.8404456516743 35.695645277798235, -82.84017865165391 35.695488277738704, -82.83975665160204 35.695366277670544, -82.83967965159043 35.69535827766097, -82.83963665162061 35.695116277607106, -82.83942565163937 35.69476527751378, -82.83937965165813 35.694593277473935, -82.83925165169953 35.69418627737763, -82.83903665173585 35.69371727725969, -82.83866265179643 35.692918277058084, -82.83865865179733 35.69290827705566, -82.83841165191606 35.69186927681804, -82.83835265192397 35.69175427678847, -82.83831265191515 35.69176827678725, -82.83789865182152 35.691926276777075, -82.83741465174157 35.691919276725976, -82.83637065161774 35.691590276551665, -82.83573365150865 35.69160627648963, -82.83542365144974 35.69165227646721, -82.8344416512633 35.691796276395955, -82.83425165116647 35.69221827646258, -82.83419265109735 35.692602276535034, -82.83419065109503 35.69261527653745, -82.83350265098449 35.69258627646101, -82.83326865095538 35.69252027642348, -82.83325665095396 35.69251727642168, -82.83261265086885 35.69237027632561, -82.83243565085331 35.692279276288865, -82.8321116508629 35.69186527617099, -82.83195365084498 35.69181027614354, -82.8313556507767 35.691604276040124, -82.8311796507647 35.69149127599898, -82.83082465071514 35.691427275949515, -82.83047865065572 35.69143727591608, -82.8302806506262 35.69141427589098, -82.82939665049345 35.6913162757803, -82.8291796505014 35.691029275699414, -82.8289766504858 35.69091027565432, -82.82869265045153 35.69082427560759, -82.8283246504035 35.69073627555184, -82.82771165032702 35.69056727545449, -82.82735565026586 35.690578275420144, -82.82695665020238 35.690557275374985, -82.82642965011702 35.69053927531726, -82.82634765010837 35.69050627530212, -82.82602565011666 35.69010327518675, -82.82563065016265 35.689376274997734, -82.82527465018757 35.68882827484923, -82.82456365011845 35.688505274710295, -82.82376465001231 35.68832727459202, -82.82285564985409 35.688367274506895, -82.82213464969144 35.688640274488726, -82.82141464956982 35.688648274416494, -82.8204766494566 35.68836527426244, -82.82002564941398 35.68815227417265, -82.81952564934485 35.68805827410216, -82.81912364928884 35.68798627404615, -82.81890764925143 35.68799427402568, -82.8186426492011 35.68803327400651, -82.81832564914176 35.688074273982274, -82.81798564907214 35.688157273964364, -82.81777364901853 35.688275273966774, -82.81769364899837 35.688319273967515, -82.81742164892728 35.68848527397352, -82.81715264884626 35.68871927399375, -82.81683664876192 35.68892327400297, -82.81644364867022 35.6890922739972, -82.81613064860089 35.68920227398751, -82.81588964855959 35.68920927396419, -82.81585864855329 35.68921627396246, -82.81525264847079 35.689094273875426, -82.8145436483974 35.688801273742776, -82.81453064839587 35.68879727374067, -82.81366464833611 35.68824527353905, -82.81303964830116 35.687794273382806, -82.81188464811302 35.68776227325781, -82.81098364797302 35.6876932731512, -82.80987764781015 35.68755027300851, -82.80960164776069 35.68757227298475, -82.80910564769394 35.687467272912414, -82.80868464766596 35.68719227281301, -82.80823664761883 35.68701227273032, -82.80806764761516 35.68685227268032, -82.80805364761073 35.68686627268174, -82.80783364761693 35.68658727260216, -82.80690464760099 35.68568327232216, -82.8064076475136 35.68571127227693, -82.8058826473902 35.68594227227019, -82.80512764724652 35.68605627221609, -82.80461164713329 35.686231272198874, -82.80401464693685 35.686858272265646, -82.80389064688207 35.68707927229806, -82.80348364675248 35.687478272337735, -82.80328964669884 35.687616272346055, -82.80303964665269 35.68764427232613, -82.80294164663339 35.68766327231993, -82.8027306465953 35.68768127230198, -82.80201564648834 35.68760027221208, -82.80058964617139 35.68811027216987, -82.79998164605814 35.68818527212284, -82.79926664591385 35.68834627208233, -82.79899064581453 35.68869127212449, -82.79780064553742 35.689198272105834, -82.79758764548968 35.68927727210019, -82.79760864549083 35.68929227210537, -82.79772764547269 35.68953927216799, -82.79776764546696 35.68961927218844, -82.79783864541524 35.69003227228012, -82.79778764536029 35.69033327233628, -82.79774764528634 35.69076927242124, -82.79782764525315 35.69107127249117, -82.79763364515955 35.691468272552335, -82.79748664507233 35.69187427262013, -82.797411645008 35.69221027268103, -82.79715064492441 35.69246927270717, -82.79710564490996 35.69251427271171, -82.79678864481842 35.69276427273022, -82.79584064461572 35.69305127269153, -82.79537264436163 35.694191272876346, -82.79513864428408 35.6944402729032, -82.79468964415254 35.694807272932, -82.7946266440784 35.695219273009656, -82.79479664401332 35.695825273150845, -82.79382264377747 35.6962992731477, -82.79349664369411 35.69648627315248, -82.79322564362205 35.696660273160184, -82.79256764350457 35.696708273102395, -82.79232564344254 35.69684827310618, -82.79207264338812 35.69692727309628, -82.790879643167 35.69706827300261, -82.79050764313348 35.696882272926494, -82.79013264310015 35.696692272849255, -82.78966864305396 35.69648927276013, -82.789016642989 35.696204272634965, -82.78858664295521 35.69595727254034, -82.78797564280764 35.69625227253788, -82.78749164270239 35.6964092725203, -82.78706164259471 35.69664227252367, -82.78672864249593 35.696921272546554, -82.78608364230526 35.697459272590145, -82.78586764222837 35.69772327262185, -82.78558564214912 35.697931272635365, -82.78526664208167 35.69802327262143, -82.78499464203207 35.698050272599026, -82.78435764192118 35.69807927253952, -82.78365264179841 35.698111272473696, -82.78266364159536 35.69835627242216, -82.78259664157864 35.69839227242267, -82.7824526415376 35.69850227243032, -82.78202964135166 35.69924927253941, -82.78181064132163 35.699206272508185, -82.78154764128763 35.69914227246813, -82.78074164115263 35.699144272385766, -82.7800746410899 35.698828272252754, -82.77908664095683 35.69862127210904, -82.77852064085248 35.698684272063836, -82.77743564062955 35.698954272007555, -82.77535264010064 35.70012627203296, -82.77525064007335 35.70019327203614, -82.77514164004678 35.70024727203603, -82.77505164002655 35.7002812720337, -82.77493564000284 35.70030927202748, -82.77483163998292 35.700325272020116, -82.77469463995976 35.70032727200639, -82.77461763994785 35.70032127199733, -82.77449463993045 35.70030027198037, -82.77438763991755 35.70026827196288, -82.774285639907 35.70022627194378, -82.77419363990002 35.70017227192338, -82.7729586397937 35.69952427166418, -82.77279663978342 35.69941527162531, -82.77006463949557 35.69832327112187, -82.76941063942631 35.698064271001854, -82.76923963935805 35.698321271036725, -82.76916063932424 35.698455271055984, -82.7680726390313 35.69917527109122, -82.76618863856193 35.7001772711024, -82.76416063828314 35.69978927081484, -82.76402163823205 35.6999702708375, -82.76381563815897 35.70022027086746, -82.76362963809355 35.70044327089388, -82.76347563803851 35.700633270916846, -82.7620156377496 35.700925270826495, -82.76077663750746 35.701153270745785, -82.76052863745657 35.701214270732784, -82.75991363733024 35.70136727070081, -82.75978463730743 35.70137527068914, -82.75953063726291 35.701389270665956, -82.7594846372472 35.701441270671864, -82.7594446372336 35.70148627067693, -82.75944363723323 35.701487270677106, -82.75938663721415 35.701549270683834, -82.75938463721378 35.701549270683635, -82.75906263714805 35.70162727066652, -82.75895563712606 35.70165327066087, -82.75870563706926 35.70175127065512, -82.7584366369826 35.70202127068264, -82.7580026368621 35.70233227070151, -82.7576416367617 35.70259227071754, -82.75730463665633 35.70291027074781, -82.75702163656321 35.70320727077936, -82.7569406365429 35.703251270779994, -82.7568186365227 35.70325027076735, -82.7567446365129 35.70323327075621, -82.75660363650603 35.70312527071972, -82.75644263651992 35.70286127064931, -82.75636163652358 35.70275027061831, -82.75621963651007 35.70268427059021, -82.75609863649396 35.70265727057233, -82.75598363647035 35.70268627056644, -82.75566763639226 35.70285027056743, -82.75549163634608 35.70295927057161, -82.75515063627222 35.70306827055887, -82.75493963622647 35.70313627055101, -82.75443363610931 35.70334827054238, -82.75407863601741 35.70355927054898, -82.75404063601572 35.70352927053887, -82.75395363601184 35.703460270515954, -82.75393363601249 35.70343427050852, -82.75390463601349 35.70339627049779, -82.75375463596716 35.70353427051055, -82.75348363588719 35.70375927052869, -82.75320263579962 35.70402227055348, -82.75316063578626 35.70406327055752, -82.75277663567198 35.70438827058438, -82.75238563555153 35.70474527061712, -82.752245635501 35.70492127063865, -82.75216963545431 35.70514127067578, -82.75203663537913 35.70548427073207, -82.7519506353132 35.705818270791454, -82.751823635246 35.706116270839196, -82.75168963520038 35.706267270856245, -82.75166263519236 35.70628927085803, -82.75151563514872 35.706413270868175, -82.75127563510057 35.70646527085417, -82.7510616350717 35.70642127082325, -82.75082263505554 35.70626727076723, -82.75065263504418 35.7061572707273, -82.7505216350352 35.70607327069671, -82.75012763500239 35.705860270612696, -82.74995063498741 35.705765270575135, -82.74974563498469 35.70556127051248, -82.74960263499975 35.705309270446314, -82.74954963500542 35.70521527042167, -82.74933663505264 35.70467927029039, -82.74914563511155 35.704091270150755, -82.74903063515687 35.703673270053734, -82.74901363516378 35.70361027003906, -82.7489116352244 35.70310726992589, -82.74877263522089 35.7029792698855, -82.7486666352079 35.70294926986847, -82.74860463520015 35.70293226985865, -82.74833963515302 35.70295126983525, -82.7482266351244 35.70301426983659, -82.74812963509967 35.70306926983783, -82.74808463508248 35.70313226984606, -82.74803563506363 35.70320126985516, -82.74803763503222 35.7034062698971, -82.74806663502429 35.703489269917114, -82.74810363501456 35.70359226994188, -82.74828963499947 35.70389127002203, -82.74833563497475 35.70410127006964, -82.7483286349492 35.704259270101105, -82.74821963491138 35.70438627011585, -82.74810263488159 35.70445227011733, -82.7480796348756 35.70446627011782, -82.74786663483178 35.70452027010696, -82.74773563480724 35.70453727009696, -82.74755263477299 35.7045612700831, -82.74729463472441 35.70459627006375, -82.74700263467507 35.704600270034554, -82.74692863466248 35.70460227002731, -82.7468196346449 35.70459827001532, -82.74651063459532 35.70458526998095, -82.74643063458326 35.704576269970836, -82.74626463455837 35.70455826995013, -82.74589863449735 35.70455726991235, -82.74566463444722 35.70462926990302, -82.74551263440213 35.70475726991352, -82.74538463435908 35.70489726992896, -82.74529363432832 35.70499826994021, -82.74510363427082 35.705165269954726, -82.74509263426752 35.705174269955535, -82.74499663424686 35.70520426995176, -82.7448876342233 35.70523926994766, -82.74468563419316 35.705216269922225, -82.74466363419106 35.70520626991796, -82.74456063418101 35.70515926989772, -82.74455163418017 35.705155269896025, -82.7444336341734 35.705071269866735, -82.74440363418299 35.704977269844456, -82.74436663419449 35.7048622698172, -82.74436863423637 35.70459326976249, -82.74440663428457 35.70432226971111, -82.74440463429875 35.704228269691704, -82.74440263431929 35.70409326966391, -82.74436763433077 35.70398126963749, -82.74434663433867 35.703907269620224, -82.74425563435638 35.703694269567386, -82.74418463436709 35.703548269530316, -82.74413763437444 35.70344926950528, -82.74402263439426 35.70319726944204, -82.74390763441836 35.70291626937293, -82.74381363443237 35.70272426932405, -82.74372463445108 35.70250626927042, -82.743694634469 35.70235826923709, -82.74367563448389 35.70224126921124, -82.7436746344851 35.70223226920932, -82.7436826345059 35.70210626918446, -82.74367463454008 35.70187626913668, -82.74365863455331 35.70177326911405, -82.74365063456024 35.70172026910242, -82.74364163456069 35.70170726909885, -82.74358563456363 35.70162726907675, -82.74352363456364 35.70156026905668, -82.74350763456239 35.70155126905325, -82.7434476345575 35.701518269040314, -82.74335963454752 35.701487269024945, -82.74329463453884 35.70147326901548, -82.74327663453636 35.701470269012965, -82.74319163452245 35.70146826900384, -82.743098634506 35.7014742689955, -82.7428266344538 35.7015182689765, -82.7428226344531 35.701518268976116, -82.74266963442483 35.70153626896409, -82.74266563442409 35.70153626896363, -82.74251363439943 35.70153226894724, -82.742298634369 35.70149626891776, -82.74207863433877 35.70145426888661, -82.7420176343303 35.701443268878094, -82.74177863429571 35.701409268846625, -82.741577634264 35.701397268823506, -82.74139263423228 35.70140226880551, -82.74115463418808 35.70143126878705, -82.74082463412513 35.7014822687635, -82.74055963407753 35.70150426874074, -82.74039363404935 35.70150726872436, -82.7403096340364 35.70150026871427, -82.74021063402095 35.70149326870261, -82.74003663400025 35.70143926867374, -82.7399236339877 35.70139826865377, -82.73982463398104 35.70133426863059, -82.73976863397891 35.70128726861521, -82.73972463397726 35.70125026860313, -82.73964763398052 35.70114626857403, -82.73958863398548 35.7010502685484, -82.73953863399421 35.700939268520614, -82.73951763402319 35.70072926847555, -82.73953463404379 35.70061426845388, -82.73954063404832 35.70059126844975, -82.73963363411035 35.70029026839788, -82.73967063413771 35.70015326837377, -82.7396766341588 35.70002326834785, -82.73967263416192 35.69999826834229, -82.73965963417402 35.69990626832221, -82.73962763418605 35.699793268295856, -82.73952463419069 35.69965226825647, -82.73939863419959 35.699458268203955, -82.73929063420209 35.69932526816567, -82.7391616341975 35.699215268130025, -82.73913263419533 35.69919826812353, -82.73905363418926 35.699152268106054, -82.73894763417631 35.699121268088845, -82.73880163415328 35.699112268072, -82.7386596341267 35.69913126806127, -82.73844563408234 35.69918726805072, -82.73820963403341 35.699249268039146, -82.73810363401232 35.699271268032774, -82.73799663399426 35.69927226802194, -82.73790163398088 35.699256268008995, -82.73778563396844 35.69921126798782, -82.73770863396327 35.69916126796974, -82.73764863396275 35.699100267951124, -82.73760563396573 35.69903426793324, -82.73758663397072 35.69898126792045, -82.73758063397239 35.69896426791641, -82.73756663397963 35.69890226790227, -82.73756163399717 35.69878326787746, -82.73759963406681 35.69837326779773, -82.73759963407433 35.69832426778773, -82.73760163408613 35.69825026777285, -82.73759163410703 35.69810426774199, -82.73758363412281 35.69799326771856, -82.73758163412367 35.6979852677167, -82.73756963413202 35.69791826770185, -82.73750763416537 35.69763526763768, -82.73748763417603 35.69754426761707, -82.73748263417914 35.69751926761143, -82.73747963418128 35.697502267607696, -82.73747063418726 35.69745326759675, -82.73746763418923 35.697437267593145, -82.73745163420028 35.69734826757337, -82.73744363421226 35.69726226755493, -82.73744163422153 35.69720026754218, -82.73743863423782 35.69709126751961, -82.73745963426539 35.69693526748991, -82.73749963429877 35.69676226745868, -82.73754563432618 35.69663526743749, -82.73759863435414 35.69651126741769, -82.73765563438386 35.69638026739671, -82.73769663440396 35.6962942673834, -82.73778363444707 35.69610926735462, -82.7378036344568 35.69606726734811, -82.737929634522 35.695781267302664, -82.7379966345652 35.69557426726734, -82.73800263457173 35.69553826726055, -82.73801263458249 35.695479267249574, -82.73801963460069 35.6953692672278, -82.73801763460555 35.6953352672207, -82.73801363461908 35.69524326720149, -82.73800963462197 35.695220267196355, -82.73799563463399 35.695127267175984, -82.73793063465214 35.69493926713097, -82.73790863465595 35.69489126711888, -82.73788963465925 35.694849267108395, -82.73786563466514 35.694785267092826, -82.73785263466786 35.69475326708496, -82.73782163467446 35.694677267066275, -82.73781563467621 35.69465926706202, -82.73780663467967 35.69462726705453, -82.73779263468441 35.69458126704373, -82.73778963468575 35.694569267040926, -82.73777563470313 35.694441267013396, -82.73777063470956 35.694394267003254, -82.73776563471617 35.69434626699302, -82.73777563473796 35.694216266967516, -82.73780763478975 35.693915266909315, -82.73780963479206 35.69390226690689, -82.73784463485335 35.69354326683721, -82.73791463492978 35.69312326675872, -82.73795863495847 35.69298526673505, -82.73807263502346 35.692687266685944, -82.73814463505849 35.692538266662964, -82.73814863506102 35.69252626666091, -82.7382036350941 35.69237126663492, -82.73825563513385 35.69217026659924, -82.73826463515198 35.692062266578176, -82.73828863517979 35.69190826654916, -82.73830963520318 35.691779266524996, -82.73831063523997 35.691542266476745, -82.73828863525104 35.69144626645486, -82.73825563526881 35.691295266420695, -82.73824563528585 35.69117426639496, -82.73819863532158 35.69089226633263, -82.73817063533957 35.69074526629974, -82.73811263537893 35.69042726622892, -82.737980635454 35.68979826608696, -82.73783263553503 35.689113265931994, -82.73771563559929 35.688570265809176, -82.73766763562769 35.688334265756026, -82.73764663565136 35.688158265718016, -82.73764263567578 35.687995265684364, -82.73768663575723 35.68751526559093, -82.73770263580363 35.68723226553477, -82.73769363582898 35.68705826549832, -82.7376686358493 35.686899265463296, -82.73765763585442 35.68685426545299, -82.73761763587335 35.686688265415, -82.73753463589556 35.68645426535873, -82.73745963591281 35.68626126531165, -82.73738163593548 35.68603026525652, -82.73726863596414 35.685722265182065, -82.73719863598143 35.68553426513655, -82.73699163603399 35.6849702650002, -82.7369866360353 35.68495626499685, -82.7369316360474 35.68481826496293, -82.7369136360492 35.684787264954814, -82.73680963606064 35.684600264905974, -82.73665963606629 35.68440126484994, -82.73645063606027 35.68421426479034, -82.73637563605811 35.684147264768924, -82.73611763604637 35.683944264701005, -82.73588863603426 35.68377526464305, -82.73528363600563 35.683306264485175, -82.7351056359985 35.68316026443714, -82.73496163599509 35.683026264395004, -82.73484063599611 35.68288926435466, -82.73475663599949 35.68277626432299, -82.73472963600067 35.68273926431267, -82.73461663601098 35.68255026426244, -82.73454363602579 35.682375264219296, -82.73449163604427 35.68219926417798, -82.73447263605684 35.682097264155246, -82.73445663607589 35.6819562641248, -82.7344566360814 35.68192026411749, -82.73445963610675 35.681759264084945, -82.73448763614299 35.68155426404603, -82.73452663617444 35.68139326401713, -82.73453763618258 35.68135226400993, -82.7345886362104 35.681227263989584, -82.73462263622856 35.68114626397653, -82.73471763626989 35.68098126395265, -82.73473363627642 35.680956263949184, -82.73492063634627 35.680705263917176, -82.73522863645663 35.68032326387086, -82.73540463651919 35.6801082638451, -82.7356516366079 35.6798002638076, -82.73573663663812 35.67969626379512, -82.73595963671619 35.67943126376393, -82.73612563677572 35.67922526373894, -82.73624663682236 35.679053263716234, -82.73634763686643 35.67887726369074, -82.73635663687165 35.678853263686754, -82.73650463695256 35.678488263627486, -82.73686263715486 35.67756426347567, -82.73686463715568 35.67756126347527, -82.7369006371802 35.67744126345453, -82.73692963720364 35.677320263432755, -82.73694863723556 35.67713426339676, -82.73695363726722 35.676934263356465, -82.73695463736405 35.67630726322864, -82.73696263743075 35.67588326314292, -82.73696463749876 35.67544426305354, -82.73697463761498 35.674702262903146, -82.7369746376302 35.67460326288296, -82.73697563766324 35.674390262839594, -82.7369936377547 35.67381626272435, -82.73701563778958 35.67361426268538, -82.73706363783322 35.673383262643135, -82.73712263787212 35.67319426261068, -82.73714863788982 35.673108262595726, -82.73734463801846 35.67248626248893, -82.73746163809543 35.67211326242485, -82.73760163819632 35.67161026233662, -82.73760263819763 35.67160326233529, -82.73763463822971 35.671429262303064, -82.73766763827057 35.671200262259745, -82.73766763828836 35.67108526223621, -82.73780963831061 35.671094262252694, -82.73795363833216 35.671110262270744, -82.7380326383438 35.67112026228084, -82.73811363835598 35.67112926229099, -82.73861363842737 35.67120726235825, -82.73880763845514 35.67123726238426, -82.73909263849575 35.67128226242275, -82.73914263850297 35.671289262429255, -82.73923463851621 35.67130326244158, -82.73929463852575 35.67130626244834, -82.73934663853395 35.67130926245435, -82.73939863854211 35.67131226246028, -82.73951163855793 35.67133226247596, -82.73968163858169 35.67136226249952, -82.73999963862153 35.671448262549696, -82.74002263862424 35.67145526255352, -82.74015663863861 35.67150726257788, -82.74050763867618 35.67164326264165, -82.74061363868398 35.67170726266557, -82.74071463868962 35.67178026269086, -82.74080863869277 35.671861262717016, -82.74086663869471 35.67191126273324, -82.74095163869869 35.671977262755384, -82.74110163871252 35.672050262785696, -82.74121863872558 35.672092262806295, -82.7413306387395 35.672123262824115, -82.74172063878484 35.67225126289029, -82.74188663880197 35.67232026292144, -82.74216563882737 35.672457262977936, -82.74244663885665 35.6725712630301, -82.74272063888687 35.672672263078816, -82.74287263890399 35.672725263105235, -82.74301463891999 35.67277526313007, -82.74318563893807 35.672843263161454, -82.74332663894883 35.67292626319293, -82.74351163895746 35.673070263241236, -82.743521638957 35.67308426324514, -82.7435686389551 35.67314726326284, -82.74358563894593 35.673225263280465, -82.7435946389323 35.67332326330144, -82.74359263892154 35.673391263315075, -82.74363163888043 35.67370026338213, -82.74363363887828 35.67371626338561, -82.74366863886988 35.673808263407984, -82.74368763886672 35.6738492634183, -82.74370763886375 35.67389026342866, -82.7437566388595 35.67397126345024, -82.74377463885786 35.67400126345823, -82.74380563885063 35.67408126347778, -82.7438796388439 35.674205263510686, -82.74397063883924 35.67433426354634, -82.74404163883531 35.67443626357445, -82.74405063883448 35.67445126357837, -82.7441006388297 35.67453626360092, -82.74411863882831 35.67456526360861, -82.74416163881182 35.67471826364428, -82.74420263880626 35.674799263664994, -82.74420763880515 35.67481126366797, -82.74424663879748 35.67490326369078, -82.74425663879532 35.67492826369688, -82.74427863878005 35.67505126372423, -82.74429363876497 35.67516526374904, -82.74431963874943 35.67529426377804, -82.74433663873026 35.67543726380899, -82.74434863871848 35.67552626382834, -82.74444163869188 35.67579926389364, -82.74450763868452 35.6759182639247, -82.74465363866618 35.67619526399621, -82.74472163865386 35.676349264034585, -82.74483963863817 35.67657826409346, -82.74485163863677 35.67660026409916, -82.74489863863246 35.67667926412015, -82.74499363863336 35.676776264149716, -82.74508963863786 35.676851264174864, -82.74510263863826 35.676862264178446, -82.74528663865192 35.67697326421995, -82.74554963867004 35.67714026428108, -82.745720638682 35.67724726432044, -82.74574963868403 35.67726626432727, -82.74618963870688 35.67759426443944, -82.7462116387088 35.677605264443926, -82.74627863871463 35.67764026445797, -82.74634863872508 35.67764826446678, -82.74640463873578 35.677639264470635, -82.7464466387436 35.67763426447399, -82.74654363876373 35.67760826447859, -82.74678063881771 35.67751526448399, -82.7468796388399 35.67747826448663, -82.74708963888895 35.67738726448958, -82.74733363894353 35.67729726449625, -82.74746263897138 35.6772562645011, -82.74755263898834 35.677244264507884, -82.74767663900809 35.67725026452188, -82.74777563902104 35.67727326453674, -82.74790963903436 35.677332264562494, -82.7479196390352 35.677337264564606, -82.74806363904817 35.677409264594054, -82.74821963905943 35.67750526462969, -82.74825363906113 35.67753126463843, -82.7486186391663 35.67724426461738, -82.74881963922878 35.67705626459963, -82.74900963928658 35.67688726458462, -82.74932563938752 35.67657426455318, -82.7496016394685 35.6763482645354, -82.74984563953323 35.67619226452859, -82.75001463957442 35.67610826452886, -82.7507276397221 35.675922264564086, -82.75109863980501 35.67578626457439, -82.7512206398288 35.67576426458242, -82.75157063988463 35.6757812646218, -82.75187363993521 35.675781264652876, -82.75200763996685 35.675721264654484, -82.75214264000572 35.675615264646694, -82.75222364003538 35.67551026463354, -82.75232464006204 35.67544626463085, -82.75251964010255 35.675395264640464, -82.75293064017019 35.675401264683806, -82.75326064024203 35.67529226469551, -82.75346964029241 35.67519226469654, -82.75386664039674 35.67494526468686, -82.75416364047747 35.674743264676145, -82.75463964061107 35.67439226465333, -82.75486464067393 35.67422826464294, -82.75551164084386 35.67382626462734, -82.75584864092977 35.67363426462275, -82.75619164101315 35.67346426462319, -82.75656164108935 35.67337126464225, -82.75701264116456 35.67337126468859, -82.7570866411948 35.67325526467248, -82.75714264121127 35.673209264668806, -82.75718864122452 35.67317326466617, -82.7572826412394 35.673178264676864, -82.75747164126342 35.67322726470625, -82.75761864128687 35.67323426472272, -82.75771364130541 35.67321726472906, -82.75783464135023 35.673057264708824, -82.75791564138476 35.672921264689414, -82.75799664143976 35.672652264642764, -82.75804364146371 35.67254726462621, -82.75811164148776 35.672465264616385, -82.75823964152359 35.67237126461038, -82.75844564157265 35.672276264612115, -82.758468641578 35.67226626461244, -82.75863664162212 35.67216226460855, -82.75869764164135 35.67210326460272, -82.75881864168898 35.67192526457876, -82.75908164175402 35.67178826457778, -82.75918864178878 35.671678264566296, -82.75935764182871 35.6716022645682, -82.75966764187791 35.6716192646034, -82.76065664208038 35.67137726465558, -82.7608356421131 35.67135826467002, -82.76103464214944 35.67133826468634, -82.76131064219443 35.67134526471614, -82.76166764227867 35.67118526472013, -82.76168464228351 35.67117226471924, -82.76188264233909 35.67102626470971, -82.76189664234357 35.67101226470828, -82.76205864239454 35.67085726469331, -82.76218664245354 35.6706132646566, -82.76224064247442 35.67053626464648, -82.7623416425011 35.67047226464379, -82.76240664252002 35.67042026463986, -82.76257764256925 35.67028626463003, -82.76260064257441 35.670277264630556, -82.76262164257977 35.670265264630224, -82.76267264259108 35.670247264631776, -82.76282564262617 35.6701852646349, -82.76282564262632 35.67018426463461, -82.76300164267325 35.67007026462942, -82.7631096427124 35.669933264612574, -82.76324964277276 35.669693264577994, -82.76336164282061 35.66950426455085, -82.76341264284252 35.66941726453832, -82.76345264286354 35.66932426452347, -82.76341264287139 35.66923026450021, -82.76337864288514 35.66910426447094, -82.76338564289627 35.66903926445842, -82.76344664292372 35.66892726444186, -82.76345364293662 35.66885126442702, -82.76330564295013 35.6686032643612, -82.76317764294552 35.66849426432579, -82.76315064295038 35.668433264310636, -82.76314364295848 35.6683732642976, -82.76320464298551 35.66826426428163, -82.76340664305174 35.668053264259306, -82.76359564312293 35.66779626422628, -82.76376364319516 35.667509264184865, -82.76398664332618 35.666900264083495, -82.76398864332735 35.66689526408266, -82.7641006433792 35.66668026405027, -82.7643706434954 35.666218263983644, -82.76443764353117 35.666059263958076, -82.76444464354229 35.66599426394552, -82.76443764355581 35.6658992639254, -82.76435064359522 35.66554926384503, -82.76433764362879 35.6653172637964, -82.76439764367329 35.665093263756816, -82.76440464369053 35.66498926373636, -82.76437764370984 35.66483426370184, -82.76429064372324 35.66465326365603, -82.76429064373438 35.6645812636413, -82.76438464377638 35.664410263616034, -82.76447864380299 35.664339263611225, -82.76458664382855 35.66429026361234, -82.76466064385114 35.66422426360639, -82.7647146438763 35.66411926359051, -82.76477564393203 35.66382326353638, -82.7649176440082 35.66348326348154, -82.76491064401532 35.66342926346978, -82.76485064403089 35.66326326342977, -82.76483664407428 35.662966263367736, -82.76474964411372 35.66261626328735, -82.76466264414829 35.662297263213325, -82.76462864417898 35.66206126316167, -82.76463464420468 35.66190126312956, -82.76468964424531 35.66169726309363, -82.76484464432009 35.661379263044566, -82.76506664440907 35.661042262998585, -82.76520164446629 35.660817262966496, -82.76530264449721 35.660726262958256, -82.76541764452857 35.66064726295395, -82.76543964453275 35.66064426295563, -82.76554464455214 35.66063226296395, -82.76581464459885 35.66062126298942, -82.76591564462939 35.66053226298153, -82.76654864486603 35.65968226287305, -82.7667846449479 35.65940626284092, -82.7668846449845 35.6592772628248, -82.76698664502142 35.65914826280896, -82.76713464507151 35.65898326279047, -82.76718864509651 35.65887926277478, -82.76726964514044 35.65868226274292, -82.76733664516841 35.65857326272748, -82.76755264525109 35.658270262687815, -82.76763364529273 35.65808826265896, -82.7677276453323 35.65793326263701, -82.76779464537887 35.6577032625969, -82.76780264542916 35.65738526253282, -82.76796364551613 35.65699526246973, -82.76814764560733 35.656602262408384, -82.76823964565277 35.65640726237802, -82.76828464567915 35.65628426235758, -82.76840864575041 35.65595626230333, -82.76840964575554 35.6559242622969, -82.76841564577701 35.65579126227036, -82.76838864580198 35.655600262228596, -82.76834164582213 35.655418262186586, -82.7682746458302 35.65529326215419, -82.76826164583181 35.65526826214783, -82.76825464585419 35.655115262115835, -82.76826564588133 35.654951262083465, -82.76826764588765 35.65491226207579, -82.76834864593326 35.654704262041584, -82.76842264596252 35.654594262026734, -82.76855064600001 35.65448926201842, -82.76872564604362 35.65439626201743, -82.76885364608442 35.65427026200477, -82.76903564616292 35.653957261959576, -82.76903564618588 35.65380826192918, -82.76900864621959 35.65356026187575, -82.76902264626428 35.65328526182107, -82.76911064633711 35.65290726175298, -82.76917564637782 35.65271326171998, -82.76937364650126 35.65212626162053, -82.76965664663388 35.65157226153643, -82.76967964666291 35.65140826150528, -82.76968964667479 35.65134226149289, -82.76971064676476 35.65078026138034, -82.76967764686982 35.6500622612304, -82.7696846469263 35.64970326115781, -82.76970464693734 35.64965326114971, -82.76986664697343 35.649594261154235, -82.76992664699452 35.64952226114571, -82.76994064701123 35.64942926112819, -82.76994064708306 35.648962261032814, -82.76997464716756 35.6484502609318, -82.77000164720226 35.648254260894575, -82.77017664730334 35.647787260817175, -82.77019764733505 35.64760426078203, -82.77019664736855 35.64738526073722, -82.77012964740052 35.64710526067317, -82.77015064743955 35.64687426062816, -82.77019064747334 35.64669826059636, -82.77027164752245 35.6464672605575, -82.77037964758095 35.64620426051494, -82.77050764764384 35.6459342604729, -82.77056164769087 35.645687260428005, -82.77062264772893 35.64550626039736, -82.77066664775306 35.645397260379646, -82.77070364777273 35.64530926036547, -82.77082464783038 35.64506626032823, -82.77087164786022 35.644923260303855, -82.77095964792983 35.64456626024002, -82.77113464800468 35.64427026019751, -82.7711606480242 35.64417126018001, -82.7711676480379 35.64409026016416, -82.77120864805347 35.64403326015671, -82.7713096480745 35.6440062601616, -82.77144464810044 35.64398426017101, -82.77152464811806 35.64395626017345, -82.77157164813079 35.64392426017178, -82.7716256481543 35.64383026015806, -82.7716126481808 35.64364426011878, -82.77169364821818 35.64348926009548, -82.77183464826877 35.643313260073974, -82.77183764826974 35.64331026007373, -82.77194264830355 35.6432042600628, -82.77203264832937 35.643134260057764, -82.77207764834209 35.64310026005541, -82.77224564838541 35.64300126005248, -82.77234664841731 35.642903260042814, -82.77246764846323 35.64273626002117, -82.77252164849429 35.64259325999746, -82.77252964850156 35.642554259990334, -82.77254164851254 35.642496259979765, -82.77255164854556 35.64229225993912, -82.77257564862583 35.64179725984052, -82.77260964864166 35.64173125983058, -82.77261664864449 35.64172025982899, -82.77266364866152 35.641660259821634, -82.77281164870317 35.64155025981429, -82.77293264873263 35.641490259814475, -82.77301364875703 35.64141925980832, -82.77305464877482 35.64134825979804, -82.77306164881004 35.64112725975361, -82.77308164881994 35.64108425974691, -82.77324964886427 35.640978259742504, -82.77345764892829 35.640788259725056, -82.77347164898225 35.640452259657856, -82.7735016489984 35.640380259646264, -82.77351864900722 35.640341259640024, -82.77360664903469 35.64025825963207, -82.77397064911891 35.64010625963841, -82.77399464912344 35.64010225964006, -82.77423964916996 35.64006625965782, -82.77443464920796 35.64003025967043, -82.7744746492165 35.640018259672104, -82.77469664926869 35.639920259674916, -82.77483164930646 35.63982125966854, -82.77532964947807 35.639246259602224, -82.77543864951534 35.63912225958805, -82.775976649693 35.63855125952673, -82.7761316497401 35.63841325951444, -82.77658264984585 35.63821525952019, -82.77679164991626 35.63798425949453, -82.77692564996391 35.637820259474786, -82.7773306501497 35.637052259359486, -82.77757265025438 35.63663425929901, -82.77776765032758 35.63637025926509, -82.77785565035146 35.6363102592619, -82.77810465040996 35.636200259264896, -82.77818565043604 35.63611825925654, -82.77822565045979 35.63600725923798, -82.77834365055631 35.63550825914816, -82.77836065057002 35.63543725913542, -82.77848865062953 35.63518925909792, -82.77858965066149 35.63509125908826, -82.7787646507042 35.63500325908827, -82.77919565079145 35.63490425911218, -82.77928265081273 35.63486025911215, -82.77940365084923 35.63475425910291, -82.77946465087261 35.63466825909166, -82.77949165090008 35.634519259063985, -82.77949265090203 35.63450725906161, -82.77950565094469 35.63424425900924, -82.77966065104171 35.63378225893084, -82.77976865109848 35.633530258890474, -82.77976765112469 35.63335825885532, -82.7797346511351 35.63325525883088, -82.77966065114299 35.63312325879635, -82.77962665115076 35.63303625877509, -82.77962765117968 35.63284925873703, -82.77966765121168 35.63268425870746, -82.77974865124719 35.632541258686565, -82.7798966512965 35.63238125866914, -82.78003765133604 35.63227725866231, -82.78021265137711 35.6322002586645, -82.78041465141925 35.632145258674, -82.78058965146097 35.63206425867538, -82.78074465150974 35.63191525866085, -82.7808116515371 35.63181025864631, -82.78085265157348 35.631618258611326, -82.78097365161891 35.63145425859018, -82.78112865167046 35.63128725857204, -82.7811886517006 35.63115625855142, -82.78120965172013 35.631052258532335, -82.78120265175187 35.63083825848792, -82.78126965178858 35.6306722584609, -82.7815666519073 35.6302222583995, -82.78163365194297 35.63006325837395, -82.78165365196644 35.62993225834928, -82.78166765200169 35.62971825830702, -82.78176165206058 35.62943725825922, -82.78187665210437 35.62927725823839, -82.78194365214695 35.62907325820359, -82.7823746522898 35.62861225815367, -82.78240565230169 35.62856825814792, -82.78250365233929 35.62843025812971, -82.78264865239227 35.62824325810648, -82.78279365243759 35.628106258093354, -82.78297765247649 35.62805325810142, -82.78307665249939 35.62801125810294, -82.783137652519 35.627950258096725, -82.78321365255813 35.62777825806941, -82.78328965260599 35.62754925803046, -82.78332765263818 35.62738125800008, -82.78336665268635 35.62711025794875, -82.78349565278704 35.626595257856856, -82.78361065283549 35.62640525782982, -82.78393865294377 35.62605725779242, -82.78410665299641 35.625897257776955, -82.78432765307784 35.62560725774036, -82.78476265321324 35.6251992577017, -82.78563765339678 35.624955257741526, -82.7863126536219 35.62422425766155, -82.78647165366854 35.62409325765104, -82.78670765371888 35.624022257660755, -82.78698365377159 35.62397925768026, -82.78742065384621 35.6239682577228, -82.78753865387026 35.62394025772917, -82.78758265387913 35.62393025773167, -82.7879256539451 35.623873257755186, -82.78816165398193 35.6238902577828, -82.78855865403041 35.624006257847135, -82.7886586540471 35.624006257857395, -82.78895465411503 35.62388525786309, -82.78910965414346 35.623869257875675, -82.78953365421171 35.623885257922375, -82.78983065426374 35.623869257949536, -82.79003865431031 35.62379225795513, -82.79041565440355 35.62359525795355, -82.7908056545067 35.623348257943064, -82.79108665457606 35.62320225794209, -82.79118165459943 35.623153257941794, -82.79127765462302 35.62310425794167, -82.79154665468623 35.622985257944904, -82.79203165478009 35.62290125797748, -82.79242265485338 35.6228492580069, -82.79254565487622 35.62283425801652, -82.7933916550339 35.62272725808129, -82.79382665512408 35.62261325810255, -82.79422265521248 35.62246825811356, -82.79562665548626 35.622212258205145, -82.79604665555452 35.62222425825068, -82.79629065562874 35.62200625823112, -82.79638165566855 35.62184625820778, -82.79654965578389 35.621278258109015, -82.79682465591539 35.62072125802349, -82.79699965599396 35.62040025797584, -82.79722865607961 35.62009125793631, -82.7973586561431 35.61982025789426, -82.79757265625442 35.61932825781572, -82.79767865629418 35.619184257797194, -82.79775565631893 35.61910725778931, -82.79803765638637 35.618974257791066, -82.79901365659688 35.61866525782798, -82.79947965669179 35.618554257853084, -82.79969365674211 35.61845925785559, -82.79987665678617 35.61837125785636, -82.80002865683264 35.61823425784394, -82.80011265686602 35.61810825782681, -82.80026865692693 35.61788125779643, -82.80042265697308 35.6177482577851, -82.80061865701845 35.617666257788436, -82.80083365705582 35.617656257808456, -82.8012166571324 35.61757425783087, -82.8020786573265 35.61724725785248, -82.80267765746608 35.61699025786139, -82.80311465756353 35.616831257873606, -82.8035596576742 35.61659425787081, -82.80370665771571 35.61648425786341, -82.8037946577437 35.61639725785471, -82.80397365781447 35.61613125781871, -82.80341865772748 35.61609425775428, -82.80182165743773 35.616244257621325, -82.80179765744741 35.61615525760071, -82.80162965751616 35.6155252574549, -82.8020826576609 35.615075257409444, -82.80223265766739 35.61519625744944, -82.80234365765877 35.61537325749691, -82.80304465782774 35.61503525749976, -82.80356465795529 35.61477025749892, -82.8039866580763 35.61444125747494, -82.80430265820692 35.61393425740384, -82.80462465830286 35.61366025738086, -82.80501465838773 35.61353125739447, -82.8054226584124 35.61381425749401, -82.80557665837239 35.614242257597176, -82.8060956584096 35.61456425771609, -82.80625065842415 35.614638257747096, -82.80694165848848 35.61497025788567, -82.80833965864485 35.61547225813132, -82.80877865856341 35.61648025838219, -82.80927465847154 35.617617258665156, -82.8095096584281 35.61815525879904, -82.80961765837199 35.61863825890876, -82.80923765791975 35.62116825938646, -82.80959765740411 35.6249152601884, -82.80961665737857 35.62510226022853, -82.80972465736664 35.62529726027948, -82.80985965735837 35.62549726033414, -82.81023565737794 35.62577926043027, -82.81054265736505 35.6261962605468, -82.81109665734026 35.626960260759574, -82.8113056573604 35.62705626080058, -82.8115696573857 35.62717826085264, -82.81209265745701 35.6272832609276, -82.81260565751528 35.62746126101647, -82.81308965754526 35.627792261133685, -82.81357265760613 35.62792126120949, -82.81442065777506 35.62774426126022, -82.81528965797463 35.62739026127694, -82.81560165804719 35.627257261281784, -82.81606865815564 35.62705926128917, -82.81683865835599 35.62659226127266, -82.81805165867887 35.625810261237255, -82.8186246588834 35.62510226115129, -82.81880265895151 35.624852261118534, -82.81933565911974 35.62433726106795, -82.81956665920919 35.62400626102405, -82.81995065929557 35.623861261033696, -82.82196165976501 35.62299326106248, -82.82408066013666 35.62287826125597, -82.82613866047647 35.62290526147227, -82.82689866065508 35.62256926148147, -82.82715566075579 35.622193261431065, -82.82745966084629 35.62193426140925, -82.82745866087859 35.621723261366085, -82.82748266094801 35.62129726128154, -82.8285316612322 35.62058826124413, -82.829284661425 35.620152261232214, -82.82928166141014 35.62024626125106, -82.82988766151993 35.6201902613017, -82.82995866154688 35.62009226128894, -82.83007066159402 35.61990726126265, -82.83120166182177 35.619655261327026, -82.83199166196728 35.61956726138991, -82.83216166199044 35.61960126141428, -82.83278266210249 35.61954726146685, -82.8339816622218 35.620075261697465, -82.83469166225177 35.620652261887976, -82.83479266222783 35.620918261952696, -82.83514066224464 35.6211872620433, -82.83518666224853 35.62121226205305, -82.83539166227698 35.62125026208185, -82.83550866229322 35.621271262098105, -82.83569466232096 35.621293262121696, -82.83582166234824 35.62125426212668, -82.83639066246909 35.62108626215065, -82.83687566264234 35.62048626207772, -82.83701166269071 35.620319262057606, -82.8371906627392 35.620198262051204, -82.83719566276838 35.62001326201388, -82.83720266278286 35.61992726199703, -82.8372136627897 35.61989426199143, -82.83789366292157 35.61977526203678, -82.83821266299435 35.61964926204367, -82.8384786630547 35.619545262049726, -82.83887466314508 35.61938826205816, -82.8389216631556 35.619370262059284, -82.83911166319909 35.61929426206321, -82.83912866320289 35.61928826206377, -82.84008166342589 35.61887326207657, -82.84082266362987 35.61835126204575, -82.8408966636476 35.61831626204625, -82.8415166637947 35.61803326205191, -82.8416876638353 35.61795526205344, -82.842177663974 35.617585262028, -82.8425426640656 35.617386262024795, -82.84311766420961 35.61707426201989, -82.84403366438312 35.61694126208646, -82.84463766452257 35.61669026209706, -82.84514566471756 35.61597326200264, -82.84533866479148 35.61570226196699, -82.84535166479998 35.61566126195994, -82.84540166483258 35.61550326193278, -82.84553066491472 35.61510826186531, -82.8458356650797 35.61436626174492, -82.84593866509586 35.61437326175697, -82.8462436651436 35.614394261792455, -82.84624866514399 35.61439726179355, -82.84633966515136 35.6144482618133)))",6475,37,021,002603,370210026032,1423,1423,34,1409,1379,8,14,3,0,5,14,1090,18,1072,1079,1057,6,9,3,0,4,11,677,572,105
census_2010_blockgroups_view.fid--2dc29038_13ec899ba8f_-263a,"MULTIPOLYGON (((-82.4799566282224 35.45789119238281, -82.479960628213 35.457957192396634, -82.47996062819536 35.45807219241997, -82.47996262817273 35.45822219245073, -82.47995262813008 35.45849019250409, -82.47994562810983 35.458615192528875, -82.47993662808061 35.45879619256468, -82.47993462807622 35.45882219256976, -82.47993062806367 35.45890019258525, -82.47992962805935 35.45892719259062, -82.47991962802999 35.45910819262637, -82.47990062797282 35.45946119269618, -82.47989162794225 35.4596511927339, -82.47988362791307 35.459833192770056, -82.47987862788698 35.45999819280303, -82.47987362785942 35.46017219283789, -82.47987962783952 35.46030919286642, -82.4799116278166 35.46049319290711, -82.47991962781165 35.460534192916185, -82.47994562779728 35.46065619294373, -82.47997462778724 35.460753192966415, -82.47998262778478 35.46077819297227, -82.48000562777614 35.460859192991045, -82.48012062774984 35.46115519306308, -82.48018462774067 35.46128419309582, -82.48031562772167 35.46155019316333, -82.48047062770819 35.46180519323106, -82.48057962770356 35.461953193272336, -82.48066562769809 35.462082193307324, -82.48076562769195 35.46223019334773, -82.48085962768852 35.462354193382495, -82.48096562768043 35.462521193427314, -82.48106462767481 35.46266519346676, -82.48119562766769 35.46285319351836, -82.48129762766355 35.46299019355669, -82.48138162765902 35.463111193589896, -82.4817416276392 35.46362919373212, -82.48177262763576 35.463685193746656, -82.48189662762269 35.463904193803835, -82.48195162760933 35.464051193839396, -82.48202662758577 35.464286193894814, -82.48206662755904 35.46450419394326, -82.48208662753717 35.46466819397867, -82.4821096274849 35.46503419405537, -82.48210762745381 35.46523519409604, -82.4821116274304 35.46539219412841, -82.48212362740122 35.46559619417105, -82.48212562738375 35.46571219419487, -82.48212762737417 35.46577719420825, -82.48214362734504 35.46598419425199, -82.48214462731563 35.46617719429137, -82.48215262728958 35.4663561943286, -82.48215262728174 35.4664071943389, -82.48215362726162 35.466540194366075, -82.48216762723406 35.46673519440715, -82.48217062722841 35.46677519441559, -82.48217262719794 35.466976194456635, -82.4821946270876 35.46772019461008, -82.48219762707373 35.46781419462955, -82.48220762705272 35.46796219466067, -82.48220862703958 35.46804919467842, -82.48221062701978 35.4681801947053, -82.48221062701901 35.46818519470628, -82.4822376269623 35.468585194790364, -82.48223762696053 35.46859619479262, -82.48223762693955 35.468733194820466, -82.482236626929 35.46880119483418, -82.48225362687162 35.469194194915815, -82.48226162684507 35.4693761949536, -82.48227762681691 35.46957719499612, -82.48234662676266 35.470006195090384, -82.48238162674285 35.47017319512793, -82.48240862673387 35.470261195148574, -82.48250962670645 35.47054919521753, -82.48254162669764 35.47064119523951, -82.48256562669245 35.47070119525413, -82.48260662668388 35.47080119527869, -82.48268462666987 35.4709771953224, -82.48245962661801 35.4710721953187, -82.48227862657626 35.471149195315746, -82.48208762652473 35.47127919532261, -82.48195962648758 35.471383195330624, -82.48186062645652 35.47147919534, -82.4817946264355 35.47154519534668, -82.4817016264019 35.4716641953613, -82.48164762638253 35.471732195369604, -82.48148662632435 35.47193819539496, -82.48143362630502 35.47200719540359, -82.48134962626568 35.47217319542866, -82.48127162622903 35.47232819545219, -82.48098662614203 35.472588195475836, -82.48098462614122 35.47259119547627, -82.48083362610045 35.47269419548168, -82.48071862606946 35.47277219548578, -82.48066962605104 35.47283919549436, -82.48058962602103 35.47294919550851, -82.48050162592634 35.47347219560581, -82.4804906259137 35.473542195618954, -82.48048262588925 35.473693195648764, -82.48047962588127 35.473742195658396, -82.480470625857 35.47389119568776, -82.48046862584901 35.47394119569778, -82.48046662584515 35.473964195702244, -82.48046262583362 35.474035195716255, -82.48046262582984 35.47405919572113, -82.48045562580793 35.474195195748074, -82.48046662572837 35.4747261958571, -82.48046762572255 35.4747651958652, -82.48082562566017 35.47555919606325, -82.4812036256184 35.47624019624044, -82.48137062560522 35.476506196311654, -82.48158062558888 35.47684019640103, -82.48169462556957 35.47708919646337, -82.48178462555762 35.47726419650817, -82.48203362552442 35.477749196632274, -82.48205462552136 35.477792196643215, -82.48214462550918 35.47796919668842, -82.48216262550652 35.47800619669782, -82.48218262550375 35.47804519670773, -82.48221262549708 35.478121196726306, -82.4822286254938 35.478160196735814, -82.48226762548556 35.47825619675936, -82.4822816254771 35.47832619677503, -82.48228262547666 35.478330196775914, -82.48229762546127 35.47844719680127, -82.48230062544057 35.478585196829634, -82.48228962539817 35.47885019688236, -82.48228862539325 35.47888119688861, -82.48227962536954 35.47902619691708, -82.48227262535181 35.47913419693839, -82.48226962533987 35.4792091969533, -82.4822686253302 35.47927119696582, -82.48227262531225 35.47939219699086, -82.48229662528612 35.479589197033334, -82.48232362527446 35.47969419705746, -82.48234362526914 35.47975019707086, -82.48236462526394 35.4798071970846, -82.48241762525562 35.47991819711265, -82.48243762525237 35.47996119712341, -82.48250062524261 35.48009319715671, -82.48252162523936 35.48013719716781, -82.48269662521177 35.48050619726078, -82.4827766251914 35.480725197313454, -82.48280462517016 35.480894197350715, -82.48281062515161 35.48102119737714, -82.48280762512547 35.48118819741078, -82.48275462499714 35.48196919756414, -82.48272162493981 35.48230719762943, -82.48262062482519 35.48294619774894, -82.48260962480452 35.48306919777286, -82.48260662479017 35.483159197790826, -82.48260962477765 35.483244197808425, -82.48261962476433 35.483342197829344, -82.48265762474489 35.48351019786748, -82.48278862471078 35.48387419795484, -82.48281962469783 35.483992197982026, -82.48283662468708 35.484080198001664, -82.48284062467454 35.484166198019544, -82.48283162465871 35.48426019803772, -82.48280062463566 35.48437619805816, -82.48275462461234 35.48447919807438, -82.48271062459439 35.48454919808405, -82.48268662458453 35.48458719808939, -82.48261062455708 35.48468419810131, -82.48239762448777 35.484906198124555, -82.48218862442327 35.48510119814273, -82.48211562440098 35.48516819814895, -82.48180062430774 35.4854361981711, -82.48174662429196 35.48548119817472, -82.48152562422632 35.48567019819042, -82.48109962410184 35.4860221982183, -82.48087562403302 35.486229198237446, -82.48062162395333 35.48647519826139, -82.48044762389725 35.48665319827969, -82.48023662382916 35.48686919830197, -82.4800896237822 35.48701719831698, -82.48003562376567 35.48706619832145, -82.4800116237587 35.487086198323006, -82.47993862373697 35.487149198328375, -82.47991562372981 35.48717119833042, -82.47979662369393 35.48727619833954, -82.47978962369176 35.487283198340336, -82.47944962358626 35.487604198370796, -82.4793346235504 35.487714198381276, -82.4790076235066 35.48764619833388, -82.47881062348038 35.48760519830544, -82.47802062336768 35.487487198200384, -82.4776916233206 35.48743919815681, -82.47765462331535 35.48743319815183, -82.47754662329997 35.48741719813747, -82.47751062329475 35.48741219813278, -82.47716862324513 35.48736619808838, -82.47705262322863 35.48734919807302, -82.47589262306275 35.487179197919446, -82.4756816230331 35.48714419789072, -82.47526262297423 35.487076197833886, -82.47522562296889 35.48707119782908, -82.4747926229064 35.487011197772496, -82.47466462288837 35.486991197755344, -82.47433462284152 35.486940197711064, -82.4739456227876 35.486872197657405, -82.47363462274895 35.486788197608405, -82.47338162271875 35.48671219756703, -82.47308062268684 35.48659519751235, -82.4730266226819 35.4865691975015, -82.4727786226586 35.48645419745274, -82.47251662263493 35.48632519739965, -82.47232562261786 35.48623019736073, -82.47195562257997 35.486078197291896, -82.47193662257801 35.4860701972883, -82.47160262254211 35.48594419722843, -82.47118262249224 35.48581619715936, -82.47075662243691 35.48571719709553, -82.47012862236228 35.48552619699232, -82.47011962236155 35.48552119699035, -82.46980862233646 35.48534919692351, -82.46956962231842 35.48520919687054, -82.46948162231136 35.485160196851545, -82.46941362230591 35.485122196836826, -82.46931962229706 35.48507819681825, -82.46922062228596 35.48504419680116, -82.46920662228426 35.48504019679893, -82.4691106222722 35.485015196784, -82.46898962225568 35.48499219676692, -82.46898362225484 35.48499119676609, -82.46884762223482 35.484975196748906, -82.46870762221316 35.48496519673249, -82.46862162219985 35.48495919672247, -82.46861862219934 35.48495919672211, -82.46849962218042 35.48495419670897, -82.46845862217394 35.48495219670433, -82.46833662215452 35.484947196690804, -82.46829662214807 35.48494619668649, -82.46827862214525 35.484945196684436, -82.46822562213697 35.484942196678425, -82.46820862213416 35.48494219667669, -82.46791562208786 35.484928196643764, -82.4678046220702 35.48492319663141, -82.46769962205366 35.48491819661957, -82.46727762198636 35.48490119657283, -82.46703862194818 35.48489219654653, -82.46674662190163 35.484881196514316, -82.46653062186722 35.484872196490265, -82.4658826217638 35.484847196418826, -82.46579162174925 35.48484419640877, -82.46566762172951 35.48483919639508, -82.46546762169775 35.484830196372776, -82.46525162166037 35.48484119635287, -82.46520562165135 35.484850196349925, -82.46509762162998 35.4848731963435, -82.46498162160478 35.48491219633956, -82.46480662156436 35.484987196336846, -82.46406062137376 35.48542519634939, -82.46397262135154 35.48547519635047, -82.46370262128292 35.48563119635452, -82.46357262124963 35.48570819635683, -82.46338062120061 35.485820196359924, -82.462806621054 35.48615719636947, -82.4626156210051 35.48627019637289, -82.462575620995 35.48629319637342, -82.46245762096474 35.48636319637558, -82.4624186209546 35.486387196376434, -82.46214562088463 35.48654919638137, -82.46170462077144 35.48681119638935, -82.46150562072413 35.48690519638805, -82.4613366206866 35.48696719638333, -82.4612976206789 35.48697519638094, -82.4610956206386 35.487020196369336, -82.46098662061888 35.48703119636042, -82.46092162060708 35.48703819635517, -82.46050262053409 35.48706219631708, -82.46024662048944 35.4870771962939, -82.46003062045088 35.48709519627529, -82.45987562042068 35.48712519626554, -82.45973862038993 35.487178196262285, -82.45963662036449 35.48723419626321, -82.4595256203306 35.487335196272326, -82.45942962029555 35.48746019628788, -82.45934962026388 35.487580196304066, -82.4592926202404 35.4876721963169, -82.45928162023566 35.48769119631962, -82.45917062019275 35.487851196340785, -82.45905962015358 35.48798619635684, -82.45899762013269 35.48805619636465, -82.45894262011394 35.488119196371855, -82.45890962010276 35.488156196376, -82.45880962006815 35.488274196389725, -82.45878062005737 35.48831319639466, -82.45866562001244 35.48848219641724, -82.45858661998126 35.48860019643305, -82.45839461989998 35.488923196479035, -82.45793761969503 35.48976619660346, -82.4578696196637 35.489897196623104, -82.45776461961489 35.49010219665405, -82.45763161954976 35.49038319669751, -82.45748661947788 35.49069519674605, -82.45747961947478 35.49070819674794, -82.45738961943262 35.49088619677488, -82.45726461937939 35.49109819680509, -82.45715561934 35.491237196822205, -82.45703661930112 35.491362196835354, -82.45681961923728 35.49154419685011, -82.45681361923539 35.49155019685071, -82.45659261917598 35.49169919685836, -82.4565166191581 35.49173419685771, -82.45639961913055 35.491787196856436, -82.45635961912231 35.49179819685456, -82.45612361907229 35.49186919684476, -82.45586861902008 35.491935196831996, -82.45583161901237 35.49194519683026, -82.45570361898675 35.491974196823016, -82.45568461898284 35.49197919682211, -82.45551261894843 35.49201819681235, -82.45528561890272 35.49207119679979, -82.45494361883425 35.49214919678053, -82.45479861880277 35.492197196775514, -82.45476061879332 35.49221819677584, -82.45468761877517 35.492257196776265, -82.45464061876353 35.49228319677669, -82.45454961873843 35.49234819678058, -82.45449961872342 35.492392196784415, -82.45444861870806 35.49243719678831, -82.45434761867439 35.49254819680053, -82.45421361862488 35.49272619682292, -82.45408961857571 35.49291319684825, -82.4538056184644 35.49333219690425, -82.45361061839141 35.49359819693827, -82.45359961838709 35.493614196940385, -82.45351161835507 35.49372819695457, -82.45341561832224 35.493838196967076, -82.45329761828488 35.49395419697852, -82.4530016181976 35.494204196998936, -82.45295561818386 35.49424419700238, -82.4523376180022 35.49476219704419, -82.45218161795384 35.494909197058114, -82.4520536179101 35.49505619707478, -82.45190961785335 35.49527119710367, -82.45176261779031 35.49552319713984, -82.45164661774683 35.49568119716005, -82.45151361770202 35.49583019717672, -82.45143561767826 35.495901197183095, -82.4513736176594 35.49595719718812, -82.45126661762832 35.4960441971948, -82.4511836176041 35.49611219720012, -82.45110761758191 35.496175197205154, -82.45092861753186 35.496308197213835, -82.45084261750769 35.49637319721815, -82.45082061750172 35.49638819721897, -82.45075761748382 35.49643719722247, -82.45073661747789 35.496453197223545, -82.45065361745431 35.49651719722801, -82.4506136174428 35.49654919723043, -82.45041761738344 35.496725197246114, -82.45034061735971 35.49679619725261, -82.45016261730423 35.49696619726887, -82.44963161713795 35.497477197318254, -82.44960161712837 35.49750719732129, -82.44945761708266 35.4976501973355, -82.44933461704173 35.49778419735013, -82.44919161699042 35.49796419737204, -82.44912061696213 35.49807219738671, -82.44905461693556 35.498174197400644, -82.44895161689199 35.49834719742521, -82.4488316168437 35.4985321974505, -82.44871361679918 35.49869519747158, -82.44860061676167 35.498818197484994, -82.44848661672847 35.49891119749213, -82.44840661670723 35.49896319749448, -82.44838461670135 35.498978197495326, -82.4482626166724 35.49903519749435, -82.44806761663013 35.499100197487586, -82.4479856166134 35.49912119748336, -82.44796861661001 35.499125197482456, -82.44784961658536 35.49915719747676, -82.44767161654799 35.499209197469035, -82.4475646165242 35.49924819746599, -82.4474606164986 35.49930319746648, -82.44748461652618 35.49914919743766, -82.44750661655965 35.49895519740053, -82.44751161656643 35.49891619739305, -82.44751361659266 35.49874719735893, -82.44750061661206 35.498607197329214, -82.44749861661475 35.49858719732492, -82.44741661664803 35.4982821972545, -82.4472766166772 35.49794119717085, -82.44727061667871 35.49792519716698, -82.44713361670263 35.49762119709115, -82.44691361674023 35.49713919697059, -82.44682561675097 35.49697419692801, -82.44628461681684 35.49596219666691, -82.44620961682189 35.49584819663604, -82.44605561682637 35.49565319658061, -82.44588061682873 35.49544919652115, -82.44572061683245 35.495252196464726, -82.44566561683489 35.495177196443834, -82.44563161683664 35.495129196430575, -82.44555461684432 35.4949961963957, -82.4454826168591 35.49482219635292, -82.44543661688392 35.49461119630534, -82.44542761689736 35.49451319628455, -82.44541361691684 35.49437119625419, -82.44539661696727 35.49402419618192, -82.44538761699654 35.493824196140395, -82.44538361700566 35.49376019612699, -82.44532861712713 35.49290919594846, -82.44532561715903 35.492698195905184, -82.44533861718234 35.492560195878475, -82.44534161718715 35.49253219587305, -82.44538161721736 35.492378195845944, -82.44547061726169 35.49218519581582, -82.44552561728159 35.492115195807294, -82.44554961729037 35.49208319580322, -82.44558461730308 35.49203819579769, -82.44562761731693 35.49199419579315, -82.44565561732574 35.49196719579057, -82.44581061737499 35.49181319577517, -82.44582661738015 35.49179719577353, -82.44593661741433 35.491693195763695, -82.44598161742815 35.491651195759744, -82.44612061747341 35.49150619574451, -82.44621561750768 35.491385195729706, -82.44630261754187 35.491256195712495, -82.44630461754251 35.49125419571228, -82.44642061759357 35.49104619568193, -82.44650161763167 35.49088519565749, -82.44661561768517 35.49065919562326, -82.44666061771508 35.49051319559818, -82.44667061773724 35.49037919557198, -82.44667161773758 35.49037819557185, -82.44666761775346 35.49027019554951, -82.4466526177616 35.490201195534, -82.44664461776594 35.490164195525615, -82.44663961776882 35.49014019552025, -82.44661161777675 35.490058195500765, -82.44659961778018 35.490023195492384, -82.44659561778151 35.49001019548931, -82.44649861778997 35.48985019544686, -82.44637661779498 35.48968619540104, -82.44630261779679 35.489594195374785, -82.44622361780328 35.489467195340815, -82.44611761781206 35.48929519529498, -82.44601061782433 35.48910019524441, -82.4459656178325 35.488998195219025, -82.44593261784406 35.48888719519314, -82.4459206178611 35.48876319516668, -82.44593061788886 35.48859319513313, -82.44597061794236 35.48828719507508, -82.44602661799564 35.488000195022515, -82.44610061805207 35.487712194971586, -82.44615261808568 35.48754919494383, -82.44617061809693 35.487495194934645, -82.4462986181559 35.48724919489783, -82.44647961822955 35.48696419485845, -82.4464896182338 35.48694719485606, -82.44652061824672 35.48689619484885, -82.44653161825097 35.48688019484674, -82.44656161826624 35.4868131948362, -82.44660061828652 35.4867231948219, -82.44661561829392 35.486691194816956, -82.4467026183505 35.48641619476996, -82.44674161838488 35.48623419473701, -82.44674161838537 35.486230194736216, -82.44678561841798 35.48606519470723, -82.44679361842459 35.48603119470111, -82.44681961844437 35.485930194683256, -82.44682961845102 35.485897194677584, -82.4468366184567 35.48586819467242, -82.44685961847385 35.48578119465705, -82.44686761847942 35.48575319465219, -82.44696661854807 35.485412194593046, -82.44701461857657 35.48527819457076, -82.44702161858041 35.48526119456801, -82.44722761868837 35.48477919449123, -82.44731161873098 35.484592194461854, -82.4473716187632 35.48444619443827, -82.44740361878452 35.484342194420485, -82.44742161880136 35.48425119440382, -82.44742761881513 35.484168194387564, -82.44741161883425 35.484026194357135, -82.44736561885202 35.48386119431883, -82.44734461885724 35.48380419430512, -82.44721161889035 35.48344519421853, -82.44716861890231 35.483320194188714, -82.44712461891423 35.483195194158775, -82.44699561894994 35.482823194069965, -82.44698461895334 35.48278919406193, -82.44696161896368 35.482697194040895, -82.44689661895461 35.482686194031956, -82.44680261894139 35.48267119401926, -82.4467256189314 35.48265319400766, -82.44670661892906 35.482647194004535, -82.44664461892167 35.48262919399452, -82.44658361891437 35.48261119398461, -82.44647661890411 35.48256219396371, -82.44637461889634 35.48250319394123, -82.44629261889104 35.482449193921795, -82.44620361888909 35.48236619389583, -82.44611761889051 35.48226419386632, -82.44605361889427 35.48217019384065, -82.44588261890495 35.481916193771504, -82.44553661892354 35.481422193635574, -82.44545961892952 35.481300193602934, -82.44532361894262 35.481068193541795, -82.44484161899288 35.48022019332008, -82.4448336189937 35.48020619331636, -82.4447216190026 35.480027193268526, -82.44458961900968 35.47983919321679, -82.44444961901425 35.479658193165704, -82.44439461901395 35.47960119314844, -82.44437661900939 35.479611193148614, -82.44432361899553 35.47964419314992, -82.44430661899099 35.47965519315036, -82.44400961891463 35.47983319315604, -82.44362961881518 35.480072193165654, -82.44336961874703 35.480236193172274, -82.44292761862886 35.48053019318668, -82.44165461828352 35.48140919323463, -82.44100161810614 35.48186219325972, -82.44099861810702 35.48185319325759, -82.44097161814307 35.48158919320119, -82.44097361818635 35.48130919314444, -82.44097761824185 35.4809511930721, -82.44066261824206 35.48061019297053, -82.44055461824766 35.48045719292841, -82.44039961831818 35.47983019278506, -82.44039661831862 35.47982419278356, -82.44026561834646 35.47950119270452, -82.44016061835607 35.47932519265791, -82.43985561838403 35.47881419252282, -82.43984261839364 35.478737192505896, -82.43986961843356 35.47850619246174, -82.43987461843642 35.47849319245959, -82.44007761853284 35.47808319239717, -82.44021161860894 35.47773119233935, -82.44034561865807 35.477555192317325, -82.4404336186962 35.47740119229504, -82.44050061873426 35.47722519226617, -82.44050061875119 35.477115192243865, -82.44046061875808 35.4770271922218, -82.44029961875992 35.47684119216759, -82.44009061877428 35.47652219208125, -82.43976161877835 35.47614119197012, -82.43962061878003 35.47597819192253, -82.43949261878748 35.47579119187143, -82.43947961879371 35.475736191858914, -82.43935861880242 35.47554919180848, -82.43926361880187 35.47545019177862, -82.43921761880013 35.475412191766225, -82.43911961875271 35.47561619179756, -82.43898761870476 35.47578619181861, -82.43848861854644 35.47628119186799, -82.43822261846398 35.476532191891664, -82.43808761842197 35.47666019190385, -82.43793561837248 35.4768191919205, -82.43785061834114 35.47693219193475, -82.43778561831255 35.477048191951646, -82.43767361824928 35.477340191999524, -82.43759861821648 35.477473192018834, -82.43746161817144 35.477619192034396, -82.43729261812604 35.47773319204027, -82.4368296180137 35.47796619204008, -82.43668361797519 35.478060192044204, -82.4365786179417 35.47816519205476, -82.43649561790332 35.47832619207895, -82.43638961781988 35.47875619215552, -82.4363016177475 35.47913319222307, -82.43614761768906 35.47934819225094, -82.43608661764605 35.47956319228834, -82.43605661756526 35.48005719238561, -82.43601161753674 35.480195192409056, -82.43600661753298 35.48021419241237, -82.43593461750646 35.480309192424286, -82.43578261746589 35.48041019242923, -82.43538961737403 35.480585192424456, -82.43517661732429 35.480680192421936, -82.43500361727678 35.48080319242914, -82.43479361720952 35.48101519245069, -82.43478061720651 35.4810211924506, -82.43472461720215 35.480989192438294, -82.43449661718455 35.4808581923883, -82.4343016171695 35.48074619234556, -82.43411861715701 35.4806301923032, -82.43397661714825 35.48053419226915, -82.43386161714272 35.48044619223944, -82.43368861713557 35.48030619219326, -82.43353561712912 35.48018319215253, -82.43348161712451 35.48015519214132, -82.43343461711926 35.48013919213327, -82.43341561711642 35.48013719213088, -82.43338961711285 35.48013219212725, -82.43333961710444 35.480133192122324, -82.4333356171038 35.480133192121876, -82.43327861709247 35.48014519211847, -82.43310261705561 35.48019619211074, -82.43302561703936 35.48021919210758, -82.43279761699134 35.48028619209778, -82.43235961690078 35.480404192076776, -82.43209061684519 35.480477192063965, -82.43172161677045 35.48056719204449, -82.4312396166769 35.4806571920133, -82.43072461657937 35.48073819197689, -82.43032661650346 35.48080419194946, -82.42994261643011 35.480868191923065, -82.42969861638393 35.48090619190578, -82.42964461637398 35.480913191901664, -82.42945061633873 35.48093419188596, -82.42907661627044 35.48097619185612, -82.42887161623344 35.48099619183918, -82.42867861619847 35.481016191823464, -82.42848761619467 35.480835191767056, -82.42838561619145 35.48074619173854, -82.42830861619085 35.4806671917145, -82.42824661619461 35.480575191689525, -82.42820761620024 35.48049719166962, -82.42819261620735 35.48043419165529, -82.42818561621704 35.48036419164038, -82.4282036162474 35.48018519160583, -82.42823561627573 35.480035191578715, -82.42827261630268 35.479899191554836, -82.42828361631553 35.47982719154138, -82.42828661632849 35.479746191525166, -82.42827661639322 35.47931319143622, -82.42828061642173 35.47913119139966, -82.42831061646464 35.47888419135256, -82.42834861650081 35.478689191316775, -82.42836761652958 35.47852219128485, -82.42837161655676 35.478349191250146, -82.4283646165723 35.478240191227215, -82.4283466165805 35.47816719121058, -82.42831061658538 35.47809719119262, -82.42825661658756 35.47802419117223, -82.42810061658929 35.47784519111995, -82.42800361659306 35.47771619108378, -82.42794061659747 35.47761919105755, -82.42789761660353 35.47753319103575, -82.4278606166111 35.47744419101385, -82.42776561664597 35.47711419093705, -82.42760361672207 35.47644319078411, -82.42752261677867 35.47598719068321, -82.42750361681172 35.47575119063334, -82.42749661685806 35.475441190569576, -82.42748561688097 35.47528019053575, -82.42741261695137 35.47474219041896, -82.42733461700807 35.47428819031878, -82.4273366170282 35.4741591902927, -82.42736561704552 35.47407719027907, -82.42741261706325 35.47401219027068, -82.42746961707958 35.47396719026738, -82.42752561709317 35.47393919026744, -82.42761461711122 35.473917190272076, -82.42785861715268 35.47391019029565, -82.42809261719319 35.473898190317236, -82.4281706172082 35.47388419032243, -82.42822061722171 35.473850190320654, -82.42823861722974 35.47381719031578, -82.42824261723636 35.47377819030829, -82.42822661723862 35.473746190300105, -82.4281846172355 35.47372119029072, -82.42809861722608 35.47369019027562, -82.42783961719569 35.47360919023259, -82.42772461718462 35.47355719021022, -82.42765961718105 35.473510190194034, -82.42761261718049 35.473463190179615, -82.42756761718621 35.47337719015757, -82.42751361719557 35.47325819012788, -82.42745561720021 35.47316519010307, -82.42723461720678 35.47288419002325, -82.42715561720634 35.47280218999844, -82.42710261720754 35.472737189979824, -82.42708861721292 35.47268718996827, -82.42708361722154 35.472625189955146, -82.42710661723684 35.472550189942275, -82.42714861725821 35.47245618992747, -82.42719561728576 35.4723271899061, -82.42720561730323 35.47222418988614, -82.42719661731705 35.47212418986494, -82.42717161732435 35.47204918984715, -82.42711061732629 35.47197118982507, -82.42696461732211 35.47184118978368, -82.42669961730715 35.47165318971833, -82.42630461726723 35.471487189644, -82.4260846172435 35.47140518960477, -82.42590961722728 35.47132218957004, -82.42577761721934 35.4712321895382, -82.42567361721437 35.47115218951128, -82.42558161721327 35.47106018948315, -82.4255016172144 35.47096618945586, -82.42541961721805 35.47085418942467, -82.42529761723168 35.47063418936747, -82.42520061723647 35.470498189329895, -82.42515061724109 35.470414189307675, -82.42511761724357 35.47036218929378, -82.42507761724401 35.47031618928027, -82.42513261725705 35.47029018928068, -82.42524661728008 35.47026318928685, -82.4257316173783 35.47014518931267, -82.42635561743718 35.47043318943521, -82.42709161755401 35.470465189517164, -82.42721961759966 35.47030518949776, -82.42795561792006 35.469009189310114, -82.42891561820625 35.46817718923952, -82.42969961850497 35.46707318909563, -82.43027561880616 35.465729188881696, -82.43227561934766 35.46435318880734, -82.4351236200244 35.463009188826376, -82.43687862033573 35.46287018897818, -82.43842662057175 35.46300018916331, -82.4385246205853 35.46301718917685, -82.43858562059768 35.46300218917998, -82.43865462060926 35.46300118918686, -82.43876562062694 35.463005189199066, -82.43882362063917 35.46298818920159, -82.43892562065776 35.46297718920986, -82.4389976206735 35.462952189212075, -82.43907262068849 35.462935189216395, -82.43920962072694 35.462832189209465, -82.43935562076331 35.462752189208224, -82.4394666207931 35.4626771892043, -82.43957662082123 35.4626121892024, -82.43971462086246 35.462492189192155, -82.43992662093765 35.46223018916068, -82.43997862095605 35.46216618915301, -82.44032762105482 35.46189818913434, -82.44040362107351 35.46185818913403, -82.44050462109419 35.46183218913915, -82.44058962110886 35.461828189147035, -82.44061762111414 35.46182418914907, -82.44070962113125 35.461811189155846, -82.44076662114111 35.46180818916104, -82.44080462114638 35.46181518916642, -82.44085262115449 35.461814189171115, -82.44091462117086 35.461774189169354, -82.44107762121499 35.4616621891634, -82.44111762122421 35.461645189164, -82.4412376212541 35.46157918916287, -82.44129962127514 35.461509189155, -82.44144562131862 35.46138218914425, -82.44282062155165 35.461345189277644, -82.44446862181427 35.46140918945971, -82.44475662186679 35.4613771894827, -82.44557262202862 35.4612011895306, -82.44594062219004 35.46054518943505, -82.44606862233127 35.4597611892889, -82.44621262242616 35.459297189209344, -82.44654862259942 35.458529189087734, -82.44742862281105 35.45809718909023, -82.44820462296859 35.45790618913105, -82.4484686230222 35.45784118914486, -82.44952762330311 35.457150189113044, -82.44989262339973 35.45691318910229, -82.4512526237348 35.45619318909547, -82.4520046239278 35.455745189081505, -82.45262862405309 35.45560118911628, -82.45334862415754 35.45569618920929, -82.45371662423308 35.455600189227546, -82.4537246242359 35.45559018922636, -82.45392462430426 35.45536018920013, -82.45390862439221 35.45476818907816, -82.45389262448741 35.45412918894672, -82.4541326245885 35.45372818888979, -82.45438862475581 35.45291218875027, -82.4550766251096 35.451344188502155, -82.45522762524085 35.45065018837659, -82.45530062530325 35.45032118831727, -82.4557486254804 35.44964818822641, -82.45682062568704 35.449456188297276, -82.45842062593692 35.449552188480745, -82.45962062601036 35.450368188769595, -82.4607406261197 35.45086418898516, -82.46110862617559 35.45089618902944, -82.46181262631897 35.45072018906581, -82.46312462665112 35.449968189047446, -82.46405262694654 35.44904018895396, -82.4648396270983 35.44889918900599, -82.46584462729186 35.44872018907259, -82.46741262775937 35.447360188956885, -82.46793562790462 35.446976188932425, -82.46793862790533 35.44697518893253, -82.4684686280522 35.446588188908215, -82.46890962817444 35.44626618888793, -82.46945862832668 35.4458641888625, -82.46970362839481 35.44568418885109, -82.47014862851795 35.44536018883076, -82.47133362871345 35.44536318895283, -82.47652562956996 35.44537818948784, -82.47661462958467 35.44537818949699, -82.4769866294448 35.44669418980257, -82.47707462941179 35.44700518987483, -82.47733862931226 35.44794119009207, -82.47740962928577 35.44819119015017, -82.47742762927928 35.44825319016462, -82.47744162927357 35.44830519017662, -82.47770162917554 35.44922719039066, -82.47776262915302 35.449440190440214, -82.47785362911331 35.449798190522294, -82.47788762909138 35.449978190562355, -82.47793462904262 35.45034719064219, -82.47794562901439 35.4505431906831, -82.4779496289789 35.450780190731784, -82.47794062894403 35.45099819077508, -82.47785362874004 35.452237191018035, -82.4778056286262 35.452929191153764, -82.47779562859317 35.45313419119437, -82.47779462857548 35.45324819121751, -82.47778062856999 35.453269191220286, -82.47780362853442 35.45352619127501, -82.47781162852426 35.453601191291, -82.47782262851786 35.45365519130306, -82.47784462850649 35.45375319132522, -82.47788762848867 35.45391619136279, -82.47792962847784 35.45403219139073, -82.47793962847524 35.454060191397396, -82.4779826284682 35.45415219142046, -82.4780116284635 35.4542141914361, -82.47810662845151 35.454395191482554, -82.47825762843827 35.454645191548906, -82.47832662843287 35.45475519157833, -82.47943862834663 35.45652019205102, -82.47949362834258 35.456606192074155, -82.4796526283277 35.45687519214512, -82.47973162831659 35.457033192185285, -82.47977362830885 35.45712919220913, -82.47980262830325 35.4571971922259, -82.47983162829607 35.45727519224473, -82.47985562829004 35.45734019226042, -82.47989462827536 35.45747819229246, -82.4799236282589 35.45761719232371, -82.47994062824387 35.45773419234927, -82.47994962823677 35.45779019236156, -82.4799566282224 35.45789119238281)))",6402,37,021,003202,370210032023,2238,2238,49,2211,2022,124,14,35,7,9,27,1698,29,1669,1686,1547,104,9,19,4,3,12,915,833,82
census_2010_blockgroups_view.fid--2dc29038_13ec899ba8f_-2639,"MULTIPOLYGON (((-82.65503862194704 35.68770425713666, -82.65505762195231 35.68769125713589, -82.65515162197859 35.68762225713149, -82.65528162201483 35.68752825712575, -82.65549162207273 35.687379257116916, -82.65560662210427 35.68729925711244, -82.65581962216308 35.68714825710354, -82.65583462216718 35.68713825710304, -82.65631662229846 35.68680825708537, -82.65646262233918 35.68670225707872, -82.6565256223566 35.686657257076064, -82.65667662239795 35.68655225707018, -82.65676962242331 35.68648825706669, -82.65680862243445 35.68645825706456, -82.65704762250161 35.68628125705306, -82.65720062254393 35.68617225704664, -82.65726662256206 35.68612625704399, -82.65733962258007 35.686088257043714, -82.65729362254243 35.686282257078574, -82.65728562253506 35.68632125708567, -82.65714262242798 35.68686025718084, -82.6571296224176 35.6869132571903, -82.65708662238903 35.68705225721427, -82.65702662234948 35.687243257247026, -82.65700862233558 35.68731425725962, -82.65697462230766 35.68745825728544, -82.65677462221329 35.68785325734543, -82.65664362216212 35.68804325737077, -82.65654862212484 35.68818225738936, -82.6564846221012 35.688266257399846, -82.6564376220836 35.688329257407844, -82.65637362205767 35.68842825742153, -82.65636662205455 35.68844125742342, -82.65611362197144 35.688706257451415, -82.6559616219239 35.68885025746518, -82.65595362192111 35.68885925746618, -82.65583062187932 35.68899725748158, -82.65581962187497 35.68901325748376, -82.65579562186535 35.68905025748888, -82.65578462186186 35.689060257489714, -82.65577162185758 35.6890742574913, -82.65574262184809 35.689104257494364, -82.65569562182718 35.689189257506875, -82.6556786218192 35.68922225751188, -82.65559462177835 35.68939625753874, -82.65553262174365 35.689554257564595, -82.65552662173998 35.68957125756742, -82.65548162171214 35.689703257589684, -82.6554616216986 35.68976925760111, -82.65540362165834 35.68996725763548, -82.65538462164479 35.69003425764721, -82.65534962162072 35.690152257667634, -82.65525762156757 35.690397257708135, -82.6552216215506 35.69046825771888, -82.65511762151304 35.690599257734895, -82.65506562149407 35.6906662577432, -82.65496662146327 35.690758257751796, -82.65459462134325 35.69113425779019, -82.6545236213161 35.69123325780309, -82.6544406212828 35.69135925782027, -82.65433362122778 35.691600257858354, -82.65426362117516 35.691865257905235, -82.65419462111936 35.69215225795658, -82.65417862111074 35.69219025796271, -82.65410962107248 35.69236325799088, -82.65406962104606 35.69249125801282, -82.65395562098226 35.69278125806025, -82.65390862095605 35.69290025807966, -82.65390362095341 35.69291225808158, -82.65386062092765 35.69303225810164, -82.65374862086706 35.693304258145574, -82.65372862085597 35.69335425815377, -82.6536846208369 35.6934302581647, -82.65356862078683 35.69362925819333, -82.65353962077285 35.693688258202364, -82.65349562075133 35.69378025821658, -82.65328362066376 35.694118258263735, -82.65318462062108 35.69428725828804, -82.65310662058431 35.694441258311365, -82.65309662058036 35.6944562583135, -82.65302162054789 35.69458525833196, -82.65295562051666 35.69471625835192, -82.65290762049327 35.69481625836731, -82.6527816204258 35.69511725841574, -82.65272862039899 35.69523325843394, -82.65270362038414 35.69530225844541, -82.65261562033125 35.695549258486686, -82.652486620241 35.69599425856423, -82.65241162017462 35.69634325862766, -82.65237762014054 35.69652725866161, -82.6523286200789 35.69687325872712, -82.65230762002975 35.69716825878514, -82.65229361999656 35.69736825882445, -82.6522806199752 35.69749225884836, -82.65228361992718 35.697806258912706, -82.65228361992672 35.69780925891344, -82.65230561990764 35.69795625894552, -82.65230861990523 35.69797525894971, -82.6523546198928 35.69810525898097, -82.65241761988287 35.698237259014384, -82.65249661987576 35.698368259049204, -82.65250061987537 35.69837525905098, -82.65256461987411 35.698452259073264, -82.65259161987302 35.69848825908345, -82.65263561987545 35.69852025909442, -82.65269761987838 35.69856825911063, -82.65273361988109 35.69858925911859, -82.65283461988854 35.69865025914141, -82.6529736199042 35.698698259165546, -82.65309761992143 35.69872125918293, -82.6531116199233 35.69872425918502, -82.65323261994149 35.69873625919994, -82.65324261994306 35.69873725920115, -82.65336461996071 35.69875425921721, -82.65340761996814 35.698753259221384, -82.65368662001659 35.698740259247394, -82.65382262004005 35.69873525926035, -82.65408362008627 35.69871725928353, -82.65424062011614 35.69869325929483, -82.65440162014414 35.698685259309705, -82.65452362016482 35.69868325932182, -82.65456562017184 35.69868325932615, -82.65469662019117 35.69869925934289, -82.65479962020429 35.69872525935879, -82.65482862020808 35.6987322593632, -82.65493162021693 35.698786259384896, -82.65500362022043 35.698841259403444, -82.65507762022081 35.69891825942669, -82.65515562021697 35.69902725945701, -82.6552306202086 35.69916225949225, -82.65523462020828 35.699168259493845, -82.65529862019731 35.699308259529, -82.65565262014609 35.70002125971074, -82.65581262012688 35.70031825978776, -82.65600662009788 35.70071425988844, -82.65606862008482 35.700866259925796, -82.65613262007123 35.70102325996439, -82.65613962004922 35.701173259995684, -82.65612662000267 35.70146026005284, -82.6561246199983 35.70148626005791, -82.65611361997777 35.70160726008152, -82.65600961991422 35.701906260131764, -82.65598961990158 35.70196626014198, -82.65598261987765 35.70211326017123, -82.65596461984876 35.70228126020363, -82.65597361977679 35.70275626030142, -82.65599961975856 35.70290226033383, -82.65608261975187 35.70303526036941, -82.65619561975656 35.70312626039965, -82.65620561975733 35.703132260401865, -82.65630061976479 35.70318626042261, -82.65658261979058 35.703323260479614, -82.65659761979184 35.7033312604828, -82.65674961980471 35.70341226051496, -82.65691761981873 35.703502260550515, -82.65706561981746 35.70367026060005, -82.6571306198159 35.70375026062303, -82.65723961981323 35.70388526066175, -82.65730061981009 35.70397126068553, -82.65740261979676 35.704167260735964, -82.65744161979183 35.70424126075513, -82.65753961977045 35.70448526081486, -82.65757061975555 35.704615260844626, -82.65757261974227 35.704703260862765, -82.65754561972116 35.7048102608818, -82.6574876196959 35.70491126089644, -82.65740161966602 35.70501226090822, -82.6573676196535 35.70505626091364, -82.65728161962144 35.705171260928275, -82.65720961959131 35.70528826094469, -82.65719661958236 35.705332260952346, -82.6571866195751 35.70536826095862, -82.65718661957399 35.70537526096005, -82.65718661956431 35.705438260972905, -82.6572086195573 35.705507260989236, -82.65722261955283 35.705551260999634, -82.65723361954919 35.70558626100791, -82.65727961954194 35.70568326103245, -82.65733461953324 35.70579826106152, -82.65748961951833 35.70606226113133, -82.65751761951557 35.706110261143934, -82.65756861951257 35.70618426116428, -82.65762861950897 35.706272261188396, -82.65768961950431 35.706368261214294, -82.65779461950925 35.706449261241566, -82.65799861952661 35.70655726128461, -82.6581616195388 35.706654261321106, -82.65866461957943 35.70693326142982, -82.65920461962966 35.70719026153768, -82.65938061964812 35.70726026157005, -82.65977561969338 35.70739326163781, -82.6603976197707 35.70756426173664, -82.66079761982047 35.70767326179996, -82.6609456198399 35.707707261822165, -82.661114619866 35.707720261842184, -82.66116861987486 35.70772126184802, -82.66123961988635 35.70772326185565, -82.66138061990661 35.707744261874446, -82.6615276199244 35.70778826189854, -82.66177261994414 35.70792426195151, -82.66186861995354 35.70796726197009, -82.66196561996685 35.70798526198377, -82.66211861999096 35.70799426200129, -82.66228362001831 35.70799526201847, -82.66254762006554 35.70797426204137, -82.66264962008616 35.70795126204715, -82.66279962011983 35.707895262051224, -82.66304762018854 35.707717262040404, -82.66310662020616 35.70766726203629, -82.66362562036026 35.707230262000536, -82.66373362039685 35.707110261987225, -82.66402262049147 35.70680926195554, -82.66407762051074 35.70674426194796, -82.6643466206049 35.70642526191057, -82.66442762063245 35.706334261900345, -82.6649076207823 35.705882261857596, -82.66497162080677 35.70579326184597, -82.66506762083915 35.70568726183426, -82.66530962093093 35.705354261791236, -82.66554262101481 35.70506326175587, -82.66575662108077 35.70486726173794, -82.66602062114816 35.704715261734044, -82.66623762119448 35.704650261743126, -82.6662616211989 35.704647261745, -82.6663566212167 35.70463426175217, -82.66645762123142 35.704648261765335, -82.66654462124005 35.704686261782086, -82.66661962124498 35.70473526179982, -82.66692662125767 35.70498426188211, -82.66703962126593 35.705052261907646, -82.6670856212698 35.70507726191745, -82.66712362127203 35.705103261926624, -82.667163621275 35.705127261935615, -82.6674686213053 35.7052602619941, -82.66759662132327 35.70528226201176, -82.6678096213597 35.705276262032534, -82.66801662140183 35.70522626204356, -82.66824562145537 35.70512726204688, -82.66850962151703 35.70501326205077, -82.66889962160926 35.70483726205504, -82.6689536216219 35.7048132620557, -82.66896062162213 35.70481926205764, -82.66898262162256 35.70484026206422, -82.66899062162275 35.70484726206642, -82.66927462162909 35.70511326214987, -82.66943862162553 35.70531326220753, -82.66961662164228 35.705396262242786, -82.6699856216924 35.70547026229581, -82.67021962172106 35.705537262333486, -82.67037162173334 35.70562126236624, -82.67046862174121 35.70567526238727, -82.67050062174377 35.70569326239424, -82.6708436217765 35.70585126246174, -82.67104062180022 35.70591026249401, -82.67123662182989 35.70592926251805, -82.67141162186314 35.70590326253071, -82.6717046219318 35.70577526253479, -82.67186762196576 35.70573126254255, -82.67201362199161 35.70572126255554, -82.67222762202208 35.70575526258449, -82.67242062203981 35.705848262623306, -82.67254762204612 35.70594426265594, -82.67265862204331 35.70608226269546, -82.67277662204934 35.70617026272553, -82.67288562205998 35.70621926274677, -82.67343862215047 35.706230262805896, -82.67380762221941 35.70618226283403, -82.67435962232612 35.70608726287139, -82.67483162241425 35.70602626290754, -82.67520962247924 35.706013262943706, -82.67545662252037 35.706013262969215, -82.6756186225474 35.70601326298585, -82.67615462263184 35.70604526304747, -82.67649562268835 35.7060472630829, -82.67690562276378 35.70600126311572, -82.67720262281561 35.70598626314323, -82.67729062283107 35.70598126315118, -82.67743162285424 35.70598326316611, -82.67764562288919 35.70598826318915, -82.67782462291453 35.70601726321345, -82.6779656229305 35.70606626323797, -82.67810262293729 35.70617026327323, -82.67813062292832 35.706258263294096, -82.67811162291093 35.706350263310895, -82.67808262290075 35.70638526331504, -82.67798562286568 35.70650726332993, -82.67758962274368 35.706869263363025, -82.67747662270723 35.706983263374696, -82.67745562268347 35.70711426339926, -82.67744862263075 35.707447263466456, -82.6774176225967 35.70763426350134, -82.67733262257097 35.70770926350798, -82.6772206225463 35.70774826350437, -82.67656962244288 35.70771526343065, -82.67635662240357 35.70773926341362, -82.67621962237209 35.70779526341104, -82.67614662234539 35.70788926342268, -82.67613062232839 35.707982263440016, -82.67615462231896 35.70806926346016, -82.67634562230147 35.708388263544855, -82.67642462230407 35.70845626356687, -82.67648462230626 35.70850726358347, -82.6766206223151 35.708596263615625, -82.6770706223644 35.70876326369591, -82.67746262239324 35.70899926378439, -82.67762062239171 35.709179263837356, -82.67766362238376 35.70927726386173, -82.67766362237079 35.7093612638788, -82.67759862234725 35.709443263888886, -82.67745862231376 35.70950926388796, -82.67719362226599 35.70953226386541, -82.67683362220927 35.70951126382407, -82.6763056221326 35.70943726375466, -82.67588762207565 35.709355263695066, -82.67576462205447 35.70935926368313, -82.6756136220193 35.70942426368088, -82.67551362198598 35.70953126369241, -82.67548662196792 35.70961926370752, -82.67550562195439 35.7097272637316, -82.6756466219456 35.70993626378874, -82.67587862195612 35.71011826384962, -82.67681062207546 35.710351263992976, -82.67724062212619 35.71048726406498, -82.67747662215176 35.7105762641074, -82.67759962215943 35.71065926413693, -82.67764562215181 35.710758264161896, -82.67762262213144 35.7108652641814, -82.67753862210151 35.71096826419372, -82.6773946220644 35.711053264196245, -82.67712162201 35.71111026417984, -82.67677762194737 35.711144264151336, -82.67636462187653 35.71115726411157, -82.67595462180937 35.71114926406771, -82.6756196217533 35.71115126403369, -82.67540562170778 35.711214264024505, -82.67526262167502 35.71127226402163, -82.67518162164592 35.71137326403385, -82.67518662163049 35.711478264055785, -82.67520762162118 35.71156126407486, -82.67532362160878 35.71176626412864, -82.67549162160296 35.71198526419059, -82.6757736215994 35.71231226428627, -82.67604662161432 35.71251026435471, -82.676226621634 35.71257726438687, -82.67655962168777 35.71258826442337, -82.67690862175276 35.71254426445031, -82.67713362179673 35.712502264464895, -82.67781962193042 35.71237726450995, -82.6781926219976 35.712345264541746, -82.6786736220818 35.71231926458592, -82.67930462218177 35.71235326465782, -82.67983562225596 35.712446264731376, -82.68029062231612 35.71254726479877, -82.68074262237465 35.71265626486745, -82.681002622401 35.712766264916624, -82.68110562240338 35.71286226494676, -82.68113962238904 35.71299126497661, -82.68111562237165 35.71307826499189, -82.68087862230087 35.71328026500867, -82.68056962222659 35.71342726500688, -82.68038762216877 35.7136052650245, -82.68034562213688 35.71376626505299, -82.68040362211562 35.713966265099764, -82.68059062211432 35.71417626516182, -82.68088062212745 35.714404265238144, -82.68116262214657 35.71458426530386, -82.68127762214834 35.71469726533869, -82.68130562213706 35.71480026536259, -82.68128762211656 35.71491326538382, -82.68124862209936 35.714982265393864, -82.68111762206519 35.715062265396725, -82.68084262201201 35.71510926537797, -82.68046462195045 35.71510026533727, -82.67978462185668 35.71497326524145, -82.67929162180216 35.71479426515426, -82.67901962177802 35.71465726509829, -82.67891362176343 35.714637265083304, -82.67871862172369 35.71468326507266, -82.67853262168352 35.71474326506578, -82.6783656216362 35.71486926507437, -82.67822462158816 35.71502726509204, -82.6781846215513 35.715223265127946, -82.67812762151145 35.715419265162, -82.67799862146909 35.71555426517628, -82.67775962141621 35.715638265168835, -82.67733562133319 35.71571826514154, -82.67686262124393 35.71578526510649, -82.67673862122041 35.71580326509746, -82.67651262116928 35.71589026509191, -82.6764266211383 35.71599826510512, -82.67643262111699 35.71614226513508, -82.67657962112004 35.71628126517854, -82.67688762114724 35.71643726524199, -82.67742962121348 35.71659326532962, -82.67796562127378 35.71678126542308, -82.67833162131869 35.716885265481956, -82.6787626213832 35.716933265536014, -82.67906662142468 35.716992265579336, -82.67930662145335 35.717066265619145, -82.67959162146816 35.71727726569147, -82.68032262148725 35.717942265902295, -82.68073462150079 35.71829826601729, -82.6811026215112 35.71862826612245, -82.68116862150937 35.71871126614612, -82.68119062149924 35.718800266166575, -82.68115462148346 35.718863266175696, -82.68105762145824 35.71892226617781, -82.68090262142074 35.71899726617711, -82.68071862138417 35.71903526616593, -82.68053862135203 35.71904926615023, -82.6803256213226 35.719010266120435, -82.68012062130255 35.71891826608063, -82.67992862129437 35.71876426602942, -82.67977262128606 35.71865026599013, -82.67960362126716 35.7185902659605, -82.6793006212228 35.71855026592121, -82.67906362118602 35.71853226589313, -82.67884962114621 35.71855926587664, -82.67864562110432 35.71861026586605, -82.67848262106737 35.71867326586208, -82.67836362103225 35.71877226587011, -82.67828562099385 35.71893626589551, -82.67827462096679 35.71909926592759, -82.67829962094588 35.719261265963205, -82.67839962092407 35.71951026602424, -82.67854062092034 35.71968626607463, -82.6787736209294 35.719879266138015, -82.67899862094309 35.72003326619252, -82.67977862100648 35.72046426636064, -82.68010862103226 35.72065326643323, -82.6803066210383 35.72082726648907, -82.6803956210283 35.720988266531016, -82.68037862099547 35.72118226656886, -82.6802956209635 35.721299266584126, -82.68016662092555 35.72140526659253, -82.67999062088853 35.72145526658461, -82.67976462084724 35.72147826656603, -82.67954962081558 35.72145126653837, -82.67921662077875 35.721330266479505, -82.67881662073712 35.72116826640534, -82.67842562068844 35.72106126634326, -82.67807762063693 35.72101926629891, -82.67776562058589 35.72101326626556, -82.6774436205243 35.721064266242855, -82.67723362047069 35.72118426624576, -82.67711162042424 35.72135326626768, -82.6771206203979 35.72153326630526, -82.67720662039562 35.72164026633597, -82.67734962040912 35.721707266364305, -82.67769062045134 35.72180226641879, -82.67864562058118 35.721992266555745, -82.68008062079164 35.72217826674133, -82.68032762082481 35.72223026677729, -82.68046262084282 35.72225926679714, -82.68069562087115 35.72232726683499, -82.68078062087704 35.722381266854725, -82.68083462087267 35.72246726687777, -82.6808656208593 35.7225872669055, -82.68079362080807 35.72284026694965, -82.68070062077993 35.722922266956836, -82.68059862075381 35.72298126695833, -82.6804616207249 35.723020266952204, -82.68015962067277 35.72303226692358, -82.67978662061101 35.72302926688468, -82.67868262045904 35.72282126672864, -82.67841162041734 35.72279926669626, -82.67812162036165 35.72284626667601, -82.67790362030766 35.7229602666769, -82.67763762023178 35.723164266691036, -82.67742462016531 35.723364266709915, -82.67637061981164 35.72451426683606, -82.6762426197729 35.724626266845775, -82.67621661975683 35.7247022668586, -82.6762346197481 35.72477826687589, -82.67633761975851 35.72482226689552, -82.6769806198623 35.7248442669661, -82.67721261989838 35.72486126699346, -82.67745261993231 35.72490026702608, -82.67756261994387 35.724944267046425, -82.67763261994425 35.72501726706847, -82.67763861992282 35.72516226709869, -82.67751161988431 35.72527426710848, -82.67732061984222 35.72534026710221, -82.6770926197931 35.72541226709346, -82.67607461960233 35.72554826701649, -82.67590461956217 35.72562426701445, -82.67580761952529 35.7257582670318, -82.6757486194517 35.7261702671098, -82.67570161941771 35.726339267139394, -82.67567761941312 35.72634326713782, -82.675605619399 35.726356267133006, -82.67558861939561 35.72636026713204, -82.67558261939446 35.72636126713162, -82.67484261924946 35.72650126708412, -82.67438461916252 35.72656926705084, -82.6739536190905 35.72657026700668, -82.67341561901488 35.726479266932756, -82.67183661882792 35.72598626666974, -82.67089761870595 35.7257622665275, -82.6703266186125 35.72575126646653, -82.66979161852208 35.72575926641305, -82.66952961846597 35.72583926640242, -82.66938561842267 35.725964266413094, -82.66931661840158 35.726026266418614, -82.66915161833415 35.726284266454314, -82.66909661827113 35.72663226651961, -82.66912061822528 35.72695426658776, -82.66920361812271 35.727706266749585, -82.66923861804763 35.728229266859884, -82.66911761783697 35.72946026709851, -82.669194617814 35.72969126715346, -82.66936261779534 35.72999326723237, -82.66992461778545 35.73066226742664, -82.67051861782028 35.73107726757238, -82.67119761788086 35.7314172677116, -82.67156461791222 35.73161026778867, -82.67200161795715 35.73179026787032, -82.67329161811213 35.732179268082426, -82.67438261823179 35.732581268276704, -82.67519561830993 35.73295226843597, -82.67542361833539 35.733033268475985, -82.67603161840984 35.73320726857404, -82.6765456184676 35.7333882686639, -82.67697461850969 35.733578268746705, -82.67736561854133 35.73379526883127, -82.67766061855346 35.73403426891036, -82.6777926185367 35.73428526897512, -82.67779361850697 35.73447826901455, -82.67774761848509 35.73457026902858, -82.67762761845233 35.734652269032985, -82.67701761831985 35.73485126901078, -82.67629661819646 35.734871268940694, -82.67551561806799 35.73486026885804, -82.67476561794874 35.73482226877315, -82.67387561781607 35.73472026866077, -82.67303161768064 35.73468626856695, -82.6727836176402 35.734680268540245, -82.67237661757376 35.73467126849648, -82.67217261753704 35.73468826847896, -82.67196861749584 35.734735268467546, -82.67146161737834 35.73494826845882, -82.67103861727789 35.7351412684547, -82.67080861723284 35.735184268439724, -82.67047461718118 35.73515826840012, -82.66997461711482 35.73504826832623, -82.66902661700001 35.73476926817171, -82.66874461696301 35.73470426812941, -82.66855461693278 35.73469526810807, -82.66840461690028 35.7347432681024, -82.66818561684231 35.73488226810825, -82.66801461678232 35.73508526813203, -82.66790461674093 35.735234268151096, -82.66783861670203 35.735414268181025, -82.66781361666615 35.735619268220184, -82.66785861663837 35.735847268271336, -82.66807861660533 35.7362972683858, -82.66809961660309 35.73633426839544, -82.66812661658892 35.73645526842292, -82.66814361657995 35.73653126844019, -82.66814261653909 35.736794268493696, -82.66811261650979 35.7369512685226, -82.6680816164791 35.73711626855306, -82.66808161647849 35.73712026855394, -82.66805461645767 35.73722526857252, -82.66802461643137 35.73736326859757, -82.6679336163551 35.73775726866855, -82.6680796163318 35.73806526874637, -82.66721561613093 35.738432268732325, -82.66674761603188 35.73856726871166, -82.66669161601367 35.738625268717776, -82.66598361595612 35.73823426856512, -82.66582361594277 35.738148268531155, -82.66575761593738 35.73811226851697, -82.66535261590592 35.73787926842783, -82.66534761590549 35.73787626842669, -82.66519361589242 35.737795268394294, -82.66490161586742 35.737642268333076, -82.66486661586453 35.737623268325606, -82.66451161583555 35.737428268249296, -82.66440961582711 35.7373722682274, -82.66405761579632 35.73719226815445, -82.66389161578265 35.73710226811895, -82.66371161576768 35.737005268080665, -82.66356861575616 35.73692526804966, -82.66336361573961 35.7368112680053, -82.66299661571159 35.73659726792389, -82.66273061569264 35.736433267863056, -82.66260261568414 35.736350267832954, -82.66230761566422 35.73616126776405, -82.6619426156367 35.73594626768262, -82.66162961561065 35.73577726761598, -82.6614406155934 35.73568526757778, -82.66137661558756 35.73565426756488, -82.66087061553836 35.73542726746648, -82.66036861548642 35.73522226737304, -82.65983761543457 35.734985267270034, -82.65972761542346 35.73493826724914, -82.65957761540857 35.73487326722041, -82.65934261538487 35.73477326717587, -82.65881161533055 35.734552267076104, -82.65854261530367 35.734436267024805, -82.65805661525538 35.7342252669317, -82.657751615225 35.734093266873415, -82.65739961519161 35.73392926680383, -82.65693761515199 35.73368826670706, -82.65662461512288 35.73353926664454, -82.6565006151111 35.73348126661988, -82.65614161507563 35.73332426655088, -82.65609161507072 35.73330226654131, -82.6559416150559 35.733236266512414, -82.65589161505099 35.73321426650275, -82.6554496150075 35.73301926641754, -82.65506561497355 35.73282526633845, -82.65470361494418 35.73262526626036, -82.65460561493667 35.73256826623873, -82.65427361491122 35.732375266165164, -82.6534086148424 35.73188826597681, -82.6528586147946 35.7316052658625, -82.65258261477054 35.7314632658052, -82.65227261474104 35.73132026574411, -82.65196561470621 35.731214265690916, -82.65171261467667 35.73113326564835, -82.6513206146286 35.73102126558514, -82.65069961456527 35.73076226546841, -82.65056361455123 35.73070626544305, -82.65015161451416 35.73050226535901, -82.64991361449633 35.73036126530578, -82.64979561448747 35.730291265279384, -82.64948061446768 35.73008026520392, -82.64944861446591 35.73005726519596, -82.64896661443821 35.72971726507701, -82.64883961443066 35.72962926504601, -82.6485886144156 35.72945626498494, -82.64797161438327 35.7290012648286, -82.64771961437702 35.72877026475566, -82.64754961437839 35.72857826469897, -82.64740861438607 35.728377264643456, -82.64728161439842 35.72816026458613, -82.64725361440235 35.728105264572015, -82.64717161441452 35.72793826452963, -82.6470706144357 35.727692264469006, -82.64702461445746 35.727502264425574, -82.64702161447173 35.72740726440587, -82.64701961447768 35.72736626439731, -82.64701961448297 35.7273322643904, -82.64702561449728 35.72724626437347, -82.64702961450404 35.72720726436596, -82.64703661451786 35.72712526434993, -82.64710561456988 35.72686326430362, -82.64724061464081 35.72655026425374, -82.64754761479476 35.7258862641499, -82.64772761490342 35.72537826406488, -82.64794061501632 35.72487826398491, -82.64812861510292 35.72452126393146, -82.64834961520273 35.724114263871215, -82.64851661527483 35.72382826383014, -82.64856461529486 35.7237502638191, -82.6487136153565 35.72351226378599, -82.64884261540718 35.72332426376094, -82.64902761546337 35.72316026374649, -82.64919661551832 35.722987263728676, -82.649450615594 35.72277126371077, -82.649790615701 35.722446263679565, -82.64992761574877 35.72228526366077, -82.65001361578315 35.722155263643145, -82.65015561584433 35.7219132636084, -82.65020261587311 35.72177726358549, -82.6502636159301 35.72147526353021, -82.65026361594246 35.72139526351388, -82.65024061595719 35.72127526348705, -82.6502036159662 35.7211772634633, -82.64999961597381 35.72090826338743, -82.64951061596989 35.72040726323496, -82.64920161595809 35.72015026315076, -82.6489346159461 35.719940263080446, -82.64865361593007 35.719741263011045, -82.64842261591316 35.71960226295888, -82.64816761588871 35.71948526290879, -82.64788361585595 35.71939126286037, -82.64758561581486 35.719336262818494, -82.64695761572347 35.71925026273636, -82.64670761568846 35.719207262701836, -82.64641161564919 35.71914226265818, -82.64596461559461 35.71901426258613, -82.64549861553854 35.71887426250961, -82.645112615493 35.71875326244518, -82.64476361544685 35.71867526239335, -82.64455861541613 35.71865326236778, -82.64441061539243 35.71864726235135, -82.64425661536538 35.71865626233732, -82.64404661532603 35.71868426232138, -82.64278961507672 35.71894226224469, -82.64256161503145 35.7189892622308, -82.64214761495397 35.71904426219933, -82.64135961481061 35.7191222621342, -82.64119561477926 35.71914826212259, -82.6410286147451 35.71918926211383, -82.6404146146114 35.71939226209194, -82.64022961457263 35.71944326208336, -82.63999561452792 35.71948026206682, -82.63972061447645 35.71951726204607, -82.63935461441272 35.719535262011995, -82.63905761436182 35.71954426198329, -82.63842261425293 35.71956426192201, -82.6368166139775 35.71961526176712, -82.63652061392789 35.71961726173707, -82.63645961391754 35.71961826173099, -82.63619861387652 35.71960226170087, -82.63595161384039 35.71957026166898, -82.63589061383225 35.71955726166003, -82.63570361380722 35.719517261632625, -82.63499861371955 35.71932526152094, -82.63430561363506 35.71912526140881, -82.6338796135829 35.71900326134017, -82.63352161354115 35.71888826127982, -82.63307861349148 35.718732261202405, -82.63224261340096 35.71841726105215, -82.63150461332154 35.71813626091895, -82.63084461324792 35.71790126080317, -82.63036361318997 35.71775826072444, -82.63024961317551 35.7177292607068, -82.62989061312963 35.71763926065152, -82.62963461309732 35.71757226061149, -82.6288916130033 35.717380260495894, -82.62852961295678 35.71729126044049, -82.62808661290084 35.7171762603715, -82.62804461289572 35.7171642603647, -82.62766561284964 35.71705426030326, -82.62750861283038 35.71700926027796, -82.62728861280516 35.71693526024021, -82.62705561277998 35.716847260198286, -82.62661061273553 35.71665626011361, -82.62656261273152 35.71663026010331, -82.62644561272197 35.716566260078274, -82.62622261270567 35.71643126002777, -82.62616461270208 35.71639226001384, -82.6261226126997 35.71636226000342, -82.62609161269751 35.71634325999633, -82.62606161269555 35.716323259989146, -82.6259856126908 35.716272259970985, -82.62548061269435 35.71570625980367, -82.62478361271337 35.71483325955398, -82.62411861272408 35.71404825932561, -82.62346161273196 35.71329025910344, -82.6234396127323 35.71326425909589, -82.62334761273262 35.713163259065844, -82.62300461273401 35.71278525895345, -82.62293461273414 35.71270925893081, -82.62289261273499 35.71265825891617, -82.62258761274052 35.71229425881052, -82.62247861276218 35.712037258746925, -82.62239361277906 35.71183625869729, -82.62223861282291 35.71138625858953, -82.62215461284656 35.71114325853135, -82.6221356128517 35.71108925851841, -82.62184761294766 35.71015925829924, -82.62176061297437 35.70989325823608, -82.62159261302682 35.70937325811283, -82.62141161301216 35.709273258073786, -82.62176961312439 35.70893325804139, -82.62201061319982 35.7087052580197, -82.62192961319369 35.70865725800164, -82.6218526131878 35.70861225798449, -82.62181161318468 35.708588257975386, -82.62118861311815 35.70834825786234, -82.61986061305805 35.70730725751353, -82.61919661301668 35.70686025735419, -82.6187236130011 35.706452257222345, -82.61828861302132 35.70585325705545, -82.61809861307228 35.70531925692711, -82.61786161320751 35.70419025667265, -82.61741161332895 35.70292025636762, -82.61722861340765 35.70221425620485, -82.61690061346165 35.70151225602803, -82.61682461346852 35.701386255994585, -82.61669761348115 35.70116825593705, -82.61648061349554 35.700841255848054, -82.61537461351497 35.69952525546617, -82.6146956135306 35.69869325522673, -82.61435261359499 35.69790725503124, -82.61423161370263 35.69708125485047, -82.61432961381949 35.69643125472816, -82.61433661387194 35.6960992546612, -82.6143366139227 35.69577125459439, -82.61433661394447 35.6956302545656, -82.6147146141495 35.69471125441728, -82.61478861417787 35.694607254403685, -82.61486261420629 35.69450325439008, -82.61532261437429 35.693912254317006, -82.61592461455733 35.693376254269744, -82.61694361486667 35.69247225419038, -82.61830261528281 35.69124425407993, -82.61912261554733 35.69041525399537, -82.61934461566453 35.689896253912416, -82.61936161574596 35.68938825381071, -82.61936861577446 35.68921125377537, -82.61924561586915 35.688466253610926, -82.61916161592175 35.688035253514464, -82.61907661597424 35.68760425341788, -82.6190046160191 35.68723625333544, -82.61844261618498 35.68555725293556, -82.61830861629939 35.6846732527416, -82.61827761632667 35.68446325269565, -82.61803361639684 35.68374625252446, -82.61800461640556 35.68365825250349, -82.61777061641023 35.683376252422, -82.61726561639075 35.68295825228485, -82.61580561630275 35.68195525193037, -82.6153446162908 35.681536251797546, -82.61492761628627 35.68111625166908, -82.61454861631067 35.680550251514745, -82.61437461632772 35.680252251436116, -82.61407061635718 35.67973425129926, -82.61371261646329 35.67866225104408, -82.61342961661038 35.67740525075892, -82.6133916166306 35.677233250719915, -82.61326361675731 35.67627525051155, -82.61325061687765 35.67548225034867, -82.61335761702122 35.674668250193776, -82.61341861707366 35.6743942501443, -82.61372661733509 35.673033249898644, -82.61394661752871 35.67201724971424, -82.61418661765894 35.67143224961974, -82.6143106177093 35.67124024959338, -82.61464161784262 35.67073324952406, -82.61532061805339 35.67010024946495, -82.61579361817884 35.66979724945185, -82.61648661834184 35.66948824946013, -82.61718561848919 35.669287249491035, -82.61923861885373 35.66913924967203, -82.62102361915679 35.66910024984761, -82.6211986191923 35.66905924985726, -82.62158161930789 35.668723249828126, -82.62225261953472 35.66797724974518, -82.62266361970399 35.66732424965432, -82.62279261975658 35.66712224962644, -82.62341961998428 35.666323249528084, -82.62461762043876 35.66467124931461, -82.6247736204702 35.664635249323354, -82.62524262056468 35.664529249349975, -82.62539962059604 35.66449524935911, -82.62546162060748 35.66448824936417, -82.62564862064146 35.66446924937949, -82.62571162065287 35.66446324938471, -82.62587062068202 35.66444624939759, -82.62624862074824 35.66442424943197, -82.62655162079778 35.66443024946435, -82.62682762083182 35.664507249508375, -82.62699562084185 35.66462324954926, -82.62708362083195 35.6647822495907, -82.62716362081471 35.664980249639285, -82.6273116208173 35.66512324968363, -82.62741962083453 35.66512824969578, -82.62758162086392 35.6651122497092, -82.62776962091638 35.664975249700554, -82.62789062095437 35.66485924968939, -82.62805962101295 35.664662249666605, -82.62811862103062 35.664611249662315, -82.62829562108283 35.664464249650514, -82.62853062114236 35.66433224964781, -82.62917062127241 35.664179249682356, -82.62948062134699 35.6640302496839, -82.6296086213887 35.66389824967016, -82.62975662144031 35.663723249649735, -82.63004662156159 35.6632502495831, -82.6304106217052 35.662712249510896, -82.63055262176789 35.66245924947397, -82.63070062181541 35.66231124945899, -82.63085562185309 35.66223424945931, -82.6310436218868 35.6622182494753, -82.631219621911 35.662251249500144, -82.63140762192361 35.662372249544106, -82.63162262193246 35.66254724960179, -82.63189862189601 35.66308124973905, -82.63198562182396 35.66364124986213, -82.63208662180934 35.663845249914026, -82.63223462181455 35.66397124995498, -82.63240262183325 35.6640312499845, -82.63267262187466 35.66405425001684, -82.63306962194919 35.6639992500465, -82.6333596220135 35.66389525005509, -82.63362862208297 35.66373525005014, -82.63377062212844 35.663593250035795, -82.63386462216545 35.66345525001729, -82.63393862218531 35.663406250014994, -82.63399962218364 35.66348325003693, -82.63412662217173 35.663697250093605, -82.63416762214634 35.66390625014044, -82.63417662213442 35.66399325015904, -82.6342006221052 35.66420825020529, -82.63418062207637 35.66437325023688, -82.63408562201475 35.66467025028765, -82.63389762194629 35.66491125031744, -82.63379662190397 35.665076250340746, -82.6337486218671 35.66526325037387, -82.63377562184542 35.6654332504113, -82.6336816217897 35.66569225045437, -82.63363462175327 35.665878250487495, -82.63366762173668 35.66602125052002, -82.63383562174324 35.666159250565435, -82.6339976217651 35.66619225058876, -82.63417262180282 35.66613725059562, -82.63430662183434 35.66607725059709, -82.63435862184643 35.666055250597985, -82.63436062184368 35.66607525060226, -82.63436862183559 35.666136250615516, -82.6343716218328 35.66615725062009, -82.63437562182807 35.666192250627624, -82.63437862182472 35.66621725063313, -82.63439662181565 35.66629525065082, -82.63440462181158 35.666330250658746, -82.63442062180603 35.666383250671174, -82.63452762177971 35.666669250740554, -82.63453062177919 35.66667625074221, -82.63459762176869 35.66681625077763, -82.63463962175754 35.66693425080604, -82.6346786217393 35.66709425084262, -82.63468462172051 35.66722225086933, -82.63468162170363 35.6673282508906, -82.63466362166764 35.6675422509324, -82.63463362162996 35.667754250972465, -82.6346336216293 35.66775825097331, -82.63458762158969 35.66796525101076, -82.63455362156795 35.66806925102845, -82.63453762155899 35.66811025103517, -82.63450862154244 35.6681862510477, -82.63450562154095 35.66819225104864, -82.63440962149184 35.66840725108253, -82.63439562148551 35.66843325108639, -82.6343566214666 35.66851325109875, -82.63418162138288 35.66886725115283, -82.6341166213552 35.668976251168374, -82.63406162133474 35.66904925117761, -82.6340486213298 35.66906725117996, -82.6339876213112 35.66912225118494, -82.63392562129336 35.66917125118853, -82.63384962127392 35.669215251189655, -82.63365762122802 35.66930525118827, -82.6335756212067 35.66935525119002, -82.63350762118525 35.669420251196286, -82.63346362116788 35.669485251205, -82.63342662114559 35.66959025122264, -82.63341262112651 35.66969825124319, -82.63343462110852 35.66983825127396, -82.63348062109299 35.66998925130943, -82.6336596210394 35.67052925143793, -82.63369162103014 35.67062325146034, -82.63384262097938 35.671115251576126, -82.6338816209655 35.671247251607085, -82.63393462094648 35.67142725164922, -82.63399362092267 35.671645251699616, -82.63400162091986 35.67167225170601, -82.63401162090453 35.67178225172947, -82.63432362092341 35.67199625180516, -82.63449462093148 35.67212825184964, -82.63464362093532 35.67226425189265, -82.63498562095502 35.6725052519769, -82.63508262095849 35.67258725200362, -82.63511262095749 35.67262625201464, -82.6351526209536 35.67269425203262, -82.6351896209434 35.672800252058074, -82.63522262092991 35.67292325208653, -82.63524962092528 35.67298225210125, -82.63545962088996 35.67343725221558, -82.63549962086861 35.67361925225679, -82.63558962083519 35.67393225232986, -82.63574362080388 35.67430125242095, -82.63581462079189 35.67445525245961, -82.63593262076472 35.67475825253347, -82.6361026207152 35.67526225265364, -82.63614562069813 35.67541925269009, -82.63618662069204 35.675503252711366, -82.63626262069587 35.67556025273079, -82.63633862070148 35.675606252748054, -82.63643762071456 35.67562825276272, -82.63656162073578 35.675624252774625, -82.63659662074191 35.675622252777835, -82.63667462075905 35.67559525278037, -82.63675962077774 35.67556625278309, -82.63708962085178 35.67544225279183, -82.63741362092718 35.67530325279677, -82.63764662098298 35.67519325279834, -82.63779462102232 35.675098252794136, -82.63806462110153 35.67487625277667, -82.63826262115468 35.67474525277037, -82.63850662121715 35.67460425276672, -82.63850862121758 35.67460325276671, -82.63876862127603 35.67450525277343, -82.63913162135486 35.67438625278653, -82.63957562144687 35.674269252808294, -82.63976862148485 35.67423125282038, -82.64006862154001 35.67419725284427, -82.64022562156681 35.67419325285964, -82.64029862157928 35.67419125286672, -82.64055362162622 35.67416225288703, -82.64061362163709 35.67415625289197, -82.64080962167652 35.6741122529032, -82.64098562171431 35.67405725291011, -82.64118162175737 35.67399025291656, -82.64149562182864 35.67386725292377, -82.6415356218375 35.673852252924775, -82.64180862189677 35.67376325293476, -82.64183162190179 35.67375525293547, -82.64196062192778 35.673726252942835, -82.64210162195295 35.673715252955134, -82.64219262196842 35.67371325296406, -82.64221262197161 35.67371425296627, -82.64228762198334 35.67371925297504, -82.64266362202909 35.6738282530359, -82.64284762205014 35.673890253067476, -82.6430816220786 35.67395825310533, -82.64339362211824 35.674038253153704, -82.64340262211918 35.674041253155266, -82.6437886221672 35.67414725321652, -82.64392862218214 35.674201253241925, -82.64410062219888 35.674278253275325, -82.64435262222122 35.67440525332708, -82.64449462223297 35.674482253357404, -82.64467362224894 35.674572253394174, -82.64468962225047 35.67457925339721, -82.64488362226963 35.674664253434514, -82.64503262228644 35.67471625346042, -82.64543962233701 35.67482825352511, -82.6457466223768 35.674901253571555, -82.64594962240146 35.67496025360439, -82.64609062241382 35.67503225363356, -82.64622562242255 35.67512125366559, -82.64633862242532 35.67522525369839, -82.64641562241613 35.67536825373548, -82.64669462236438 35.67600425389379, -82.64681462233746 35.67630825396812, -82.64682462233522 35.676333253974185, -82.64693662231379 35.676592254038574, -82.64700062230476 35.676720254071235, -82.64708762229812 35.67685725410805, -82.64719162229507 35.67698925414565, -82.6473506222925 35.677177254200295, -82.64736662229225 35.67719625420588, -82.6474166222913 35.67725625422327, -82.64742162229135 35.67726125422478, -82.64742862228975 35.67727925422917, -82.64745762228247 35.67735725424804, -82.64747062226802 35.67746525427133, -82.64746062225039 35.67756825429134, -82.6474556222305 35.67769225431615, -82.64745562222875 35.67770325431836, -82.64747262221225 35.6778282543456, -82.64750862219974 35.67794825437377, -82.64757162218895 35.6780862544083, -82.64761562218348 35.678169254429775, -82.64767862217573 35.67828725446031, -82.64783562216785 35.678507254521264, -82.64807662216167 35.67880725460718, -82.64827362215523 35.67906125467922, -82.64841662214789 35.67926325473506, -82.64846862213713 35.67938925476618, -82.64847562212083 35.67950225478987, -82.64845262209383 35.67965225481809, -82.6483496219951 35.68018025491516, -82.64830862194042 35.680490254974096, -82.64829962191189 35.680665255008826, -82.64829662190199 35.680726255021035, -82.64830662188031 35.680877255052806, -82.64832562185796 35.68104225508833, -82.64837262184247 35.68119325512403, -82.6484706218264 35.681403255176875, -82.64853162181366 35.681551255213314, -82.64856362180677 35.68163025523273, -82.64860962178746 35.68180525527312, -82.64861562178116 35.681852255283246, -82.64863862175966 35.68201625531909, -82.64865362173792 35.68217325535261, -82.64867562164618 35.68279125548091, -82.64867562164571 35.68279425548151, -82.64871062163063 35.68292925551263, -82.64877862162112 35.683064255547144, -82.64879062161994 35.68308525555261, -82.6488986216085 35.68327525560246, -82.64902662159741 35.683485255658425, -82.64904362159625 35.68351125566548, -82.6491286215903 35.68364125570072, -82.64921362158226 35.68378525573878, -82.64941362157457 35.68405025581339, -82.64962562156163 35.68436325589901, -82.64981962154971 35.68464925597727, -82.6498826215463 35.68473925600209, -82.64997762154128 35.684874256039365, -82.65009962153904 35.68502025608167, -82.65019762153958 35.685122256112564, -82.65023862154007 35.685163256125115, -82.65039562154513 35.685300256169135, -82.65053662155248 35.68540425620489, -82.65067862156334 35.68548725623635, -82.65068062156351 35.6854882562368, -82.65095362158262 35.68565925629976, -82.65125962159937 35.68588025637626, -82.6518206216277 35.68630225651998, -82.65213362164602 35.6865212565968, -82.65216862164753 35.68654925660612, -82.6523896216575 35.68672225666409, -82.65256262166038 35.68689025671608, -82.652624621661 35.68695325673526, -82.65262962166109 35.686958256736894, -82.65274262165613 35.68711225677987, -82.65281962164794 35.68724825681548, -82.65284762164502 35.687297256828366, -82.65292362163174 35.687465256870475, -82.65298262161355 35.68764625691341, -82.65301062159539 35.68779425694643, -82.65303162152414 35.688278257047294, -82.65303262152385 35.68828125704798, -82.65303962150672 35.68839925707276, -82.65307862149082 35.68854425710631, -82.65312662148816 35.6886132571253, -82.65354162157303 35.68851125714716, -82.65365262159555 35.688485257153324, -82.65382362163399 35.68842125715785, -82.65399962167444 35.6883492571613, -82.65419362171986 35.6882642571639, -82.65458562182205 35.68802525715547, -82.65468762185058 35.68795025715062, -82.654818621887 35.68785625714495, -82.65503862194704 35.68770425713666)))",6327,37,021,002604,370210026043,1427,1427,20,1407,1372,12,7,4,0,12,20,1103,11,1092,1097,1072,11,5,3,0,6,6,621,562,59
census_2010_blockgroups_view.fid--2dc29038_13ec899ba8f_-2638,"MULTIPOLYGON (((-82.6037946225295 35.628661239838266, -82.60389862255633 35.628599239836404, -82.60396662257902 35.62852523982826, -82.60398462258567 35.6285012398252, -82.60402062259924 35.62845223981891, -82.60407462263595 35.628272239787826, -82.60414262267363 35.62810123975995, -82.60422862270813 35.62797023974215, -82.60436462275268 35.62782823972712, -82.60447162278344 35.62774423972104, -82.60453462279972 35.62770623971982, -82.60471962284733 35.62759723971661, -82.60480262286907 35.62754523971454, -82.60496762291238 35.62744223971051, -82.60506962293864 35.62738223970873, -82.60516662296537 35.62731323970466, -82.605245622989 35.62724523969894, -82.60529962300691 35.627187239692674, -82.60533662302356 35.62711923968268, -82.60536562303996 35.62704423967033, -82.60538262305536 35.62696223965535, -82.60538062306597 35.626891239640656, -82.60538062306875 35.62687323963707, -82.60536362307765 35.62679723961984, -82.60532262308458 35.62670823959744, -82.60525662309053 35.62659823956827, -82.60520662309658 35.62650523954421, -82.6051226231012 35.62638423951096, -82.60500262311159 35.6261872394585, -82.60479562312418 35.62588223937506, -82.60471962313021 35.625761239342644, -82.60466562313626 35.62566423931732, -82.60463462314722 35.6255592392928, -82.60462162315987 35.62546323927186, -82.60462262317469 35.62536823925255, -82.60465162319413 35.625273239236165, -82.60468562321209 35.6251932392234, -82.6047946232494 35.625069239209346, -82.60487762327205 35.62501123920611, -82.60495962329281 35.624965239205146, -82.60508862332199 35.62491523920821, -82.60519462334283 35.62489423921478, -82.60534562336917 35.624886239228665, -82.6054536233864 35.62489123924085, -82.60551362339577 35.6248952392478, -82.60637862352891 35.624964239350724, -82.60660762356423 35.62498223937787, -82.60691162361073 35.62500823941441, -82.60721562365678 35.62503723945151, -82.60729662366951 35.6250422394609, -82.6074466236927 35.62505323947857, -82.60752762370608 35.625054239487056, -82.6075646237039 35.62510823950185, -82.6076486236948 35.62525823954105, -82.60773162369179 35.625367239571766, -82.60786162369725 35.62547223960649, -82.60791762370067 35.62551023961998, -82.60802362370707 35.625583239645756, -82.60815762371288 35.625690239681276, -82.60838162371304 35.625930239753174, -82.60848462371123 35.626053239788845, -82.60857762371377 35.626137239815534, -82.60866062371989 35.62618723983425, -82.60878062373274 35.62623323985595, -82.60918362378354 35.62633823991872, -82.60943162380742 35.626451239967196, -82.60945862381011 35.626463239972466, -82.60975462384279 35.626570240024655, -82.6100116238747 35.626640240065306, -82.61004662387897 35.62665024007092, -82.61028662391257 35.62669124010393, -82.6104076239293 35.62671324012088, -82.61103662401256 35.62685224021378, -82.61110662402074 35.62687424022543, -82.61122762403468 35.62691424024606, -82.61136262404592 35.62698724027473, -82.6114126240501 35.62701424028543, -82.61144662405124 35.62704324029476, -82.61159662405662 35.6271702403361, -82.61167362405774 35.62724624035951, -82.61174662405875 35.627318240381655, -82.61188662406094 35.62745524042396, -82.61191862406129 35.62748724043376, -82.61217062406635 35.62772624050828, -82.61230362406619 35.627871240551535, -82.61236362406603 35.62793724057115, -82.61244362406818 35.628009240594004, -82.61247762406323 35.62807824061157, -82.61254762404603 35.628265240656894, -82.61262362402766 35.62846624070563, -82.61267662400871 35.62864624074771, -82.61268862399011 35.6287802407763, -82.61270462394741 35.629074240837824, -82.61270762394058 35.62912224084789, -82.61271762392471 35.62923624087209, -82.61273862391077 35.62934924089727, -82.61267162387189 35.62952924092709, -82.61266962387057 35.62953524092806, -82.6125536238175 35.62975424096086, -82.61241962376391 35.62995724098833, -82.61237062374606 35.630020240996224, -82.61225562370328 35.630174241015794, -82.61203862362493 35.63044824104928, -82.61183262355016 35.63071124108166, -82.61160162346827 35.630993241115426, -82.61143862340921 35.63120024114087, -82.61139362339041 35.63127424115124, -82.61128462334361 35.631459241177744, -82.61122562331508 35.63158124119652, -82.61128462332424 35.63158524120344, -82.61181562337286 35.6318432413105, -82.61205962339642 35.631953241358026, -82.61251462344269 35.63214424144369, -82.61261962345439 35.63218124146201, -82.61273062346815 35.632212241479664, -82.61289462349026 35.63224524150331, -82.61296362350014 35.6322562415126, -82.61307362351543 35.63227524152779, -82.61341162355315 35.63239524158698, -82.61360262357276 35.63247424162265, -82.61374162358412 35.6325502416524, -82.61385762358583 35.63266424168755, -82.61392962358516 35.63274624171175, -82.61400562358966 35.63279924173025, -82.61412362359881 35.63286724175622, -82.61426962361513 35.632919241781856, -82.61441462362754 35.632995241812246, -82.61447962362801 35.633062241832576, -82.61456962362702 35.63316524186277, -82.6146286236203 35.633272241890616, -82.61467962360629 35.633418241925625, -82.61472262359716 35.633524241951655, -82.61476862359343 35.63359824197148, -82.61480962359434 35.63363624198343, -82.61485362359647 35.63367024199483, -82.61490862360057 35.63370324200723, -82.61497162360756 35.63372524201817, -82.61506862362033 35.63374724203259, -82.61514762363304 35.63375024204136, -82.61518262363847 35.633752242045375, -82.6153476236669 35.63374624206103, -82.61569162372761 35.63372324209171, -82.61608262379667 35.633697242126594, -82.61630562383783 35.63367124214423, -82.61652562388039 35.63363224215885, -82.61674662392538 35.633579242170775, -82.61706762398919 35.633511242189904, -82.61736662404687 35.633460242210234, -82.61760662409027 35.633437242230215, -82.61784962413277 35.633423242252356, -82.61796462415137 35.633427242265, -82.6181136241751 35.633434242281716, -82.6183806242147 35.63346524231543, -82.61846562422713 35.633476242326395, -82.61862662425055 35.633498242347386, -82.61900662430467 35.63355724239843, -82.61924462433588 35.63361124243394, -82.61940062435785 35.633637242455215, -82.61951562437542 35.63364724246912, -82.6196006243901 35.63364424247719, -82.61966962440387 35.633629242481234, -82.61978462442912 35.63358924248493, -82.6198116244357 35.633576242485056, -82.61989562445586 35.63353524248533, -82.61990462445783 35.633532242485636, -82.62000962448491 35.633470242483774, -82.62010462451116 35.63340224247971, -82.62012362451851 35.63337524247612, -82.62015562453045 35.63333224247069, -82.62016462453796 35.63329324246365, -82.62017662454873 35.63323624245324, -82.6201776245526 35.63321224244848, -82.62018662457137 35.63310024242655, -82.62018262458534 35.63300524240687, -82.6201896245922 35.632968242399976, -82.62020662460723 35.63288924238569, -82.62030362461377 35.63295124240831, -82.62030762461406 35.632954242409305, -82.62055262463568 35.63307824245971, -82.62061562464218 35.633104242471504, -82.62072262465303 35.63314924249161, -82.62075062465591 35.63316024249675, -82.62083462466431 35.63319624251273, -82.62086262466714 35.63320824251807, -82.62126662470683 35.633387242596044, -82.62186662476545 35.63365424271201, -82.62211062478461 35.63379324276545, -82.62233562479905 35.633942242818925, -82.62243162480347 35.63401724284408, -82.62257662481 35.63413124288219, -82.62276962481546 35.63430424293721, -82.62282162481628 35.63435524295297, -82.62298062481867 35.63451124300113, -82.62303362481931 35.63456424301739, -82.62315962482103 35.63468924305572, -82.62328162482268 35.634810243092986, -82.62352062482906 35.63502624316146, -82.62355362483106 35.63504924316957, -82.62361662483474 35.63509324318503, -82.62370562484205 35.63514224320415, -82.62373762484476 35.63515924321087, -82.62385162485657 35.635205243231994, -82.62399262487406 35.635244243254434, -82.62412562489338 35.635262243271725, -82.62421762490854 35.63526324328139, -82.62429662492151 35.63526424328968, -82.62478362500394 35.63525524333793, -82.62581462517694 35.63524524344183, -82.62595562520066 35.6352442434561, -82.62634762526676 35.63523824349508, -82.62636462526973 35.63523724349668, -82.62641962527898 35.63523624350208, -82.62643762528202 35.63523624350392, -82.62656962530448 35.63523324351687, -82.62685862535328 35.635228243545576, -82.62696662537404 35.635210243553026, -82.62709762539895 35.63519024356238, -82.62725062542978 35.63515524357095, -82.62737762545665 35.635118243576464, -82.62821162563223 35.63487924361345, -82.62848962569065 35.63480024362589, -82.62873362574119 35.634735243637685, -82.62893162577943 35.634701243651165, -82.62911862581363 35.63468124366626, -82.62912462581481 35.63468024366667, -82.62927062583985 35.63467524368068, -82.62933462585015 35.6346772436876, -82.62943762586687 35.634680243698874, -82.62958262588836 35.634697243717234, -82.62976162591325 35.63472924374209, -82.62995162593622 35.63478524377299, -82.63018162596128 35.63487024381399, -82.6304056259815 35.63498124385956, -82.63094662602795 35.63526424397283, -82.6313476260623 35.63547424405684, -82.63146662607424 35.63552524407947, -82.63153062608177 35.63554524409005, -82.6316116260912 35.635571244103645, -82.63177162611203 35.63560924412789, -82.63181662611778 35.63562024413469, -82.63250962621309 35.635750244232405, -82.6327556262467 35.63579724426723, -82.63281462624164 35.63589424429308, -82.63285262623472 35.6359802443145, -82.63298062621172 35.63626724438613, -82.63307862619709 35.63646824443718, -82.63312562619383 35.636540244456675, -82.63324062618592 35.63671524450412, -82.63328462618404 35.63677524452091, -82.63338362618427 35.636880244552515, -82.63353362618635 35.63702924459825, -82.63387662619535 35.63734124469704, -82.63417162619754 35.63764524478931, -82.63449462619768 35.63799324489336, -82.63493362617868 35.63859024506014, -82.63543362615279 35.639298245255695, -82.63559162614494 35.639519245317004, -82.63588662613037 35.63993224543148, -82.63594262612764 35.64001024545318, -82.63622562611167 35.64041924556556, -82.63638162610651 35.64062124562277, -82.63646562610604 35.640715245650526, -82.63665862610593 35.64092424571293, -82.63672562610412 35.64100824573694, -82.63676862610065 35.641077245755426, -82.63680262609384 35.64115824577538, -82.63681762608564 35.64122724579105, -82.6368286260753 35.641306245808224, -82.63683562603454 35.641578245864395, -82.6368386260124 35.64172524589468, -82.63683462598817 35.641878245925405, -82.63683062595098 35.64211524597333, -82.63682362589469 35.642472246045386, -82.63685262587546 35.64262824608011, -82.63689662586972 35.642713246101984, -82.63690762586916 35.642729246106306, -82.63692862586844 35.64275624611397, -82.63695462586769 35.642789246123414, -82.63702662586654 35.642874246148075, -82.637134625869 35.64297524617976, -82.63717762585418 35.64311724621312, -82.63718462585304 35.64313224621693, -82.63731662583434 35.64339624628428, -82.63735562583095 35.64346024630135, -82.63737362582914 35.643491246309566, -82.6374246258261 35.64356624633003, -82.63750962582061 35.64369324636465, -82.6375176258203 35.643704246367655, -82.6375826258188 35.643784246390716, -82.63771762581425 35.64395924644023, -82.63787962580915 35.64416724649923, -82.63805562579526 35.64444724657439, -82.63809962578951 35.644532246596185, -82.6381516257736 35.64469124663395, -82.6381756257599 35.64480624665988, -82.63819062575202 35.644873246675026, -82.63820562573527 35.644998246702144, -82.63819562571358 35.64512824672747, -82.63817862569775 35.645212246742915, -82.63809862564409 35.64547424678813, -82.63795962556708 35.64582324684494, -82.63777762547831 35.646202246903506, -82.63770962544027 35.646376246931936, -82.63749162533321 35.64683524700311, -82.63743162530317 35.64696524702338, -82.63730962524153 35.64723324706549, -82.63718062518736 35.64744524709543, -82.63700962513009 35.647632247115965, -82.63681162505165 35.647927247155756, -82.63669862498271 35.6482522472104, -82.63660162487585 35.64884024732024, -82.63658162480469 35.649280247407866, -82.6365826247607 35.64956624746628, -82.63662262465637 35.650286247617046, -82.63661262462254 35.65049424765839, -82.63658062458853 35.65068024769304, -82.63648962454492 35.650865247721356, -82.63630362448299 35.65106624774329, -82.63605562440604 35.65129724776485, -82.63561262427912 35.65164224778962, -82.63549262424759 35.651717247792604, -82.63530662420116 35.65181724779388, -82.63515862416277 35.65190624779677, -82.63504062413115 35.65198424780055, -82.63503162412859 35.65199124780109, -82.63492762409781 35.65207824780806, -82.63485562407287 35.65216224781782, -82.63481262405205 35.652251247831536, -82.63469062398515 35.6525532478806, -82.63464262395077 35.652724247910434, -82.63461362393387 35.65280224792336, -82.63458962391907 35.65287224793516, -82.6344586238552 35.65314524797737, -82.63437962382304 35.65326824799427, -82.63425662377657 35.65343724801609, -82.63413562373283 35.65359024803486, -82.6340746237087 35.65368024804696, -82.63406562370523 35.653693248048654, -82.63393762365601 35.65387424807241, -82.6338886236367 35.65394624808196, -82.63376662358387 35.65415724811252, -82.63368662354515 35.65432224813788, -82.63366062352213 35.654443248159865, -82.6336616235183 35.65446924816524, -82.633665623506 35.6545532481828, -82.63371562349435 35.65468224821414, -82.63381962348642 35.654846248258316, -82.63388162348181 35.65494324828439, -82.63405662346337 35.6552512483652, -82.63410862345627 35.6553532483913, -82.63415262345052 35.655438248413176, -82.63418962344252 35.655530248435724, -82.63420862342745 35.65564824846171, -82.63421062340308 35.655808248494544, -82.63419262338422 35.65591124851367, -82.6341796233558 35.656081248546975, -82.63419162332713 35.65628024858877, -82.63421662329701 35.65650224863657, -82.63432762319377 35.65729124880879, -82.63436462317351 35.65746224884746, -82.63440662315705 35.657614248882716, -82.63448362314476 35.6577772489239, -82.63457962313637 35.65793524896591, -82.63477562314026 35.658121249023935, -82.63502462315023 35.65832524909117, -82.63527662316166 35.658523249157376, -82.63543062316423 35.6586722492036, -82.6355356231603 35.65881124924272, -82.63559562315251 35.6589262492723, -82.63562662314627 35.65900024929059, -82.6356766231149 35.65925724934809, -82.63568362309589 35.65938824937547, -82.63567162303774 35.65975224944844, -82.63565062299891 35.65998124949297, -82.63561262297533 35.6600932495118, -82.63553462293173 35.66029124954419, -82.635334622835 35.66070224960737, -82.63491662261947 35.66164824975719, -82.63487262258624 35.66181624978692, -82.63486762257448 35.66188724980088, -82.63487062255895 35.661991249822385, -82.63488662254505 35.66209824984589, -82.63490962253175 35.66220924987077, -82.6349856225086 35.66244124992591, -82.63506662247704 35.662733249993714, -82.63508162246465 35.66282925001489, -82.63512162244551 35.66299625005299, -82.6351496224231 35.66317225009172, -82.63519562238206 35.66348725016068, -82.63518062234601 35.66370525020358, -82.63515462231089 35.66390425024142, -82.63514362230167 35.663952250250105, -82.63511462227508 35.66409325027585, -82.63506162224067 35.66425925030423, -82.63500462221046 35.664393250325716, -82.63496162219083 35.66447425033778, -82.63478062211792 35.66475125037563, -82.63471562209092 35.66485625039033, -82.63455362201961 35.66514325043213, -82.63450662199625 35.66524425044792, -82.63439862193592 35.66551825049264, -82.63436162190293 35.66569225052428, -82.63435162188229 35.665815250548334, -82.63435562184969 35.666030250592534, -82.63435862184643 35.666055250597985, -82.63430662183434 35.66607725059709, -82.63417262180282 35.66613725059562, -82.6339976217651 35.66619225058876, -82.63383562174324 35.666159250565435, -82.63366762173668 35.66602125052002, -82.63363462175327 35.665878250487495, -82.6336816217897 35.66569225045437, -82.63377562184542 35.6654332504113, -82.6337486218671 35.66526325037387, -82.63379662190397 35.665076250340746, -82.63389762194629 35.66491125031744, -82.63408562201475 35.66467025028765, -82.63418062207637 35.66437325023688, -82.6342006221052 35.66420825020529, -82.63417662213442 35.66399325015904, -82.63416762214634 35.66390625014044, -82.63412662217173 35.663697250093605, -82.63399962218364 35.66348325003693, -82.63393862218531 35.663406250014994, -82.63386462216545 35.66345525001729, -82.63377062212844 35.663593250035795, -82.63362862208297 35.66373525005014, -82.6333596220135 35.66389525005509, -82.63306962194919 35.6639992500465, -82.63267262187466 35.66405425001684, -82.63240262183325 35.6640312499845, -82.63223462181455 35.66397124995498, -82.63208662180934 35.663845249914026, -82.63198562182396 35.66364124986213, -82.63189862189601 35.66308124973905, -82.63162262193246 35.66254724960179, -82.63140762192361 35.662372249544106, -82.631219621911 35.662251249500144, -82.6310436218868 35.6622182494753, -82.63085562185309 35.66223424945931, -82.63070062181541 35.66231124945899, -82.63055262176789 35.66245924947397, -82.6304106217052 35.662712249510896, -82.63004662156159 35.6632502495831, -82.62975662144031 35.663723249649735, -82.6296086213887 35.66389824967016, -82.62948062134699 35.6640302496839, -82.62917062127241 35.664179249682356, -82.62853062114236 35.66433224964781, -82.62829562108283 35.664464249650514, -82.62811862103062 35.664611249662315, -82.62805962101295 35.664662249666605, -82.62789062095437 35.66485924968939, -82.62776962091638 35.664975249700554, -82.62758162086392 35.6651122497092, -82.62741962083453 35.66512824969578, -82.6273116208173 35.66512324968363, -82.62716362081471 35.664980249639285, -82.62708362083195 35.6647822495907, -82.62699562084185 35.66462324954926, -82.62682762083182 35.664507249508375, -82.62655162079778 35.66443024946435, -82.62624862074824 35.66442424943197, -82.62587062068202 35.66444624939759, -82.62571162065287 35.66446324938471, -82.62564862064146 35.66446924937949, -82.62546162060748 35.66448824936417, -82.62539962059604 35.66449524935911, -82.62524262056468 35.664529249349975, -82.6247736204702 35.664635249323354, -82.62461762043876 35.66467124931461, -82.62501762062956 35.6638662491917, -82.62505062071686 35.66333624908711, -82.62500962079854 35.662763248966115, -82.6247606208217 35.66234424885514, -82.62470562082689 35.662251248830565, -82.62440062084528 35.66180324870789, -82.62377662083522 35.661195248519874, -82.62300862079886 35.66060324832031, -82.62287662078404 35.66055724829736, -82.62204862069096 35.66026724815311, -82.62094662057952 35.65980124794492, -82.62071762055633 35.659704247901615, -82.61995362046918 35.65944524777032, -82.61884362034239 35.65907024757985, -82.61832562028069 35.658911247494125, -82.61763162019811 35.65869824737941, -82.61620762002542 35.658282247148236, -82.61593061998674 35.65823424711006, -82.61457561979341 35.65802624692837, -82.61316761958633 35.65785024674774, -82.61223161944575 35.65775224663156, -82.61212261942926 35.65774124661811, -82.61163161935549 35.65769024655726, -82.60995161908993 35.6576002463662, -82.60979561906568 35.65758924634797, -82.60828261882924 35.65749024617223, -82.60790961877107 35.65746524612881, -82.60675061858981 35.65739024599432, -82.60584961844704 35.65734424589236, -82.60470261827942 35.657194245743874, -82.60420661822658 35.65700224565374, -82.60409461821783 35.65693824562923, -82.60391861820088 35.65685824559476, -82.60342261817271 35.65650624547211, -82.60305461819296 35.65597824532668, -82.60271861822353 35.65541824517814, -82.60223961824117 35.654788245000546, -82.6021876182431 35.65471924498114, -82.60211061824585 35.65461824495267, -82.6016946182903 35.65388224475996, -82.60147461833552 35.65335224462939, -82.60134261836265 35.65303424455097, -82.60131361836936 35.65295924453277, -82.60129361837377 35.65290924452053, -82.60123161838794 35.65275024448178, -82.6011256184126 35.652476244415, -82.60103861843305 35.65225024436006, -82.60084061846925 35.65180224424846, -82.60073761848813 35.65156924419036, -82.6006356185069 35.65133724413267, -82.600542618524 35.651126244080125, -82.60027061857446 35.65050624392587, -82.60026761857596 35.65049324392292, -82.6002246186037 35.65026724387243, -82.60006261870774 35.64941824368285, -82.59990261879965 35.64865024350991, -82.59989861882154 35.64850424347981, -82.59987061897684 35.6474672432657, -82.5997906191166 35.64647524305538, -82.59971061921685 35.645739242897235, -82.59967861935966 35.64477924269843, -82.5995646194534 35.6440482425378, -82.59951861949101 35.64375524247335, -82.5993906195625 35.64315324233761, -82.5993426195901 35.64292324228581, -82.59916661965956 35.642283242137395, -82.59921461972183 35.641931242070655, -82.5990286197691 35.64142424194824, -82.59904961978854 35.641320241929186, -82.59911661984756 35.64101024187291, -82.59913861986709 35.64090724185423, -82.5991466198796 35.64083524184035, -82.59915461989219 35.64076224182631, -82.59933662017689 35.63911224150897, -82.59946962031138 35.6383832413741, -82.59988562073029 35.63611524095491, -82.60003062087655 35.63532324080847, -82.60041162118281 35.63374824052683, -82.600583621321 35.633037240399695, -82.60075462145905 35.63232624027246, -82.60082562151614 35.63203224021988, -82.60119462174417 35.63095124003761, -82.60201962225271 35.62854223963168, -82.60212362226802 35.62855523964496, -82.60214462227118 35.6285572396476, -82.60238362230614 35.62858823967846, -82.60251962232613 35.62860523969588, -82.60264462234436 35.628621239712025, -82.60273762235822 35.628632239723835, -82.60301662239904 35.62866823975979, -82.60311062241277 35.62868023977184, -82.60317962242303 35.628688239780594, -82.60327762243732 35.62870123979328, -82.60338962245427 35.62871223980706, -82.60345962246481 35.6287192398157, -82.60352762247616 35.62871923982268, -82.60358662248595 35.62871923982872, -82.60369162250606 35.62870223983602, -82.60373062251503 35.62868623983682, -82.6037946225295 35.628661239838266)))",6359,37,021,002607,370210026071,1560,1560,58,1523,1479,16,3,5,0,20,37,1248,34,1214,1231,1207,10,3,3,0,8,17,707,639,68
census_2010_blockgroups_view.fid--2dc29038_13ec899ba8f_-2637,"MULTIPOLYGON (((-82.63253363483125 35.57978423283184, -82.63282063491677 35.57953823281125, -82.63352263512547 35.57894023276139, -82.63368163517352 35.578799232748985, -82.63385563522594 35.578646232735636, -82.63394263525686 35.57853923272274, -82.63394663525877 35.578531232721545, -82.63399463527952 35.57844823270952, -82.63399663528112 35.57844023270816, -82.63402863529976 35.57835323269362, -82.63406463533332 35.5781742326609, -82.63406663533904 35.578139232653996, -82.63407363535605 35.57803623263368, -82.63408263537899 35.57789623260614, -82.63411063544757 35.57748023252428, -82.63412763547174 35.57734123249764, -82.63413463548243 35.57727923248578, -82.63415563550517 35.57715423246248, -82.63415663550614 35.57714923246151, -82.634209635538 35.57699923243643, -82.63431563558417 35.576813232409364, -82.63443363563027 35.57664123238642, -82.63445363563775 35.57661423238301, -82.63454863567337 35.57648523236647, -82.63466663571135 35.57636523235405, -82.63477163573918 35.57629823235119, -82.63486763576124 35.57625823235288, -82.63501163578935 35.576231232362176, -82.63513363580871 35.576237232375924, -82.63526563582641 35.57626523239518, -82.63538463583865 35.576314232417324, -82.6354116358408 35.57632923242321, -82.63549463584711 35.576378232441684, -82.6356926358604 35.57650523248781, -82.63598763588661 35.5766542325485, -82.63628663591537 35.576791232607064, -82.63643363593178 35.57684323263268, -82.63682763597816 35.576967232698415, -82.63717563601749 35.5770882327587, -82.63726563602835 35.57711523277349, -82.63735663604089 35.57713223278628, -82.63780763610616 35.57719523284535, -82.63798063613217 35.577213232866804, -82.63811963615436 35.57721923288227, -82.63820263616756 35.57722323289161, -82.63833863619003 35.577224232905714, -82.63847163621394 35.57721223291691, -82.63857163623346 35.57719323292333, -82.63867063625462 35.57716323292733, -82.6388006362847 35.57710823292948, -82.63903063634227 35.57698223292745, -82.63905663634887 35.57696723292704, -82.63917263637619 35.57691523292836, -82.63926763639641 35.576886232932196, -82.63935963641408 35.57687123293858, -82.6394916364359 35.57687223295232, -82.63959563644974 35.576894232967405, -82.6396866364592 35.57693123298429, -82.63992763648078 35.57705123303352, -82.63997963648642 35.57707123304288, -82.64005863649459 35.5771032330575, -82.6402006365122 35.57714223308004, -82.6403206365288 35.57716423309682, -82.64042563654496 35.57717323310938, -82.64053063656294 35.57716923311934, -82.64066363658847 35.57714723312853, -82.64081863662035 35.577107233136246, -82.64110863668307 35.577013233146815, -82.6412846367244 35.57693523314899, -82.64140363675708 35.576851233144076, -82.64148263678403 35.57676123313391, -82.64152463680358 35.57667923312147, -82.64155763682245 35.576592233107085, -82.64157763684041 35.57649723308976, -82.6415776368544 35.57640623307125, -82.64154463687284 35.57625023303614, -82.64145963689666 35.5760032329771, -82.641382636925 35.57573523291462, -82.64136863694958 35.575560232877436, -82.64138063696761 35.57545523285728, -82.64140063697965 35.575399232847985, -82.6414166369885 35.575359232841485, -82.64145963700665 35.57528723283118, -82.64159863705005 35.57515523281849, -82.64183763711843 35.57496923280513, -82.64195063715341 35.57486323279512, -82.6419976371713 35.574798232786684, -82.64201863718462 35.57473423277591, -82.64203263720032 35.57464723275956, -82.6420366372052 35.57461923275425, -82.64203663723174 35.57444723271924, -82.64203263723886 35.57439623270839, -82.6420226372575 35.5742642326805, -82.64201463728841 35.57405423263689, -82.64198063734544 35.57364623255024, -82.6419606373804 35.573397232497484, -82.64207463739122 35.573450232519995, -82.6422146374027 35.573526232549796, -82.64225163740574 35.57354723255793, -82.64248463742892 35.573648232602345, -82.64274463745888 35.573735232646726, -82.64293863748419 35.57378023267579, -82.64302463749503 35.573802232689076, -82.64330163753024 35.573873232731955, -82.64326963748479 35.57413423278189, -82.6432666374789 35.57416923278867, -82.64325163743878 35.574414232837135, -82.64322263740571 35.57459823287158, -82.64318663737575 35.57475423289971, -82.6431296373488 35.57486823291712, -82.64303063731187 35.57500123293398, -82.64302363730965 35.575008232934685, -82.6429286372759 35.57512523294882, -82.64285763724419 35.57525423296778, -82.64278063720812 35.57540623299093, -82.64272863717727 35.57555023301491, -82.64260863710538 35.57588823307151, -82.64250863705003 35.57614023311263, -82.64240163700127 35.57634223314276, -82.6423446369765 35.57644123315711, -82.64218463690655 35.57672323319815, -82.64201063683586 35.576995233235664, -82.6418566367798 35.57719323326025, -82.64152063665706 35.5776282333144, -82.64137563660196 35.577830233340656, -82.64129763656554 35.57798223336364, -82.6412736365289 35.5781952334046, -82.64130463650541 35.57838123344573, -82.64131963647475 35.57859723349119, -82.64130163645132 35.578730233516474, -82.64128763643222 35.57883923353723, -82.64127063639515 35.57906223358095, -82.64130763636466 35.579300233633205, -82.64131563635802 35.579352233644705, -82.64131563634821 35.579416233657675, -82.64131663634376 35.57944623366394, -82.6412826363026 35.57967723370747, -82.64128463628931 35.57976623372584, -82.64128563628647 35.579785233729794, -82.6413066362751 35.579882233751725, -82.64131163627269 35.57990323375653, -82.64135663626757 35.57998523377785, -82.64136863626717 35.58000123378234, -82.64149063626282 35.5801612338274, -82.6416246362612 35.58031723387293, -82.64163563626117 35.58032923387652, -82.64167163625513 35.580407233896096, -82.64168163625172 35.58044023390387, -82.64169063624841 35.58047123391111, -82.64169863623749 35.58055123392823, -82.64168163621095 35.58070523395787, -82.64166363618861 35.580831233981684, -82.64165263617438 35.58091223399706, -82.64165263615588 35.58103223402151, -82.64166163613444 35.581181234052785, -82.64168563611159 35.58135623409094, -82.64168563609668 35.581453234110676, -82.64165963607873 35.58154223412616, -82.64160163605725 35.581619234135914, -82.64152263603589 35.58167223413855, -82.64137463599852 35.58175523414029, -82.6412766359753 35.58180023413944, -82.64110563593442 35.581881234138386, -82.6409566359023 35.58192923413293, -82.64090863589279 35.58193923413008, -82.64088063588717 35.581945234128355, -82.64070363585436 35.58196723411462, -82.64059563583429 35.58198123410651, -82.64033263578621 35.58200923408522, -82.64019663576063 35.58202823407515, -82.64010363574121 35.582054234070874, -82.64009163573824 35.58206023407086, -82.64002963572244 35.582096234071834, -82.63994463569664 35.5821722340786, -82.63993163569197 35.58218823408055, -82.63987463567096 35.582263234089986, -82.63979663563879 35.58238823410742, -82.63976263562348 35.58245123411681, -82.63969863559508 35.58256623413367, -82.6396696355839 35.58260823413926, -82.63960663555862 35.582704234152274, -82.63953963553722 35.582771234159104, -82.6394666355188 35.58281223415999, -82.6393936355041 35.58282823415574, -82.63932963549415 35.58282423414837, -82.63924863548289 35.58280923413695, -82.63914463547299 35.582761234116575, -82.63889563545266 35.58262423406307, -82.63874563543686 35.58256523403568, -82.63865563542639 35.58253523402029, -82.63852663540976 35.5825042340008, -82.6383686353878 35.58247623397883, -82.63834463538421 35.582473233975804, -82.63820963536428 35.58245723395872, -82.63808063534394 35.58245023394403, -82.63796263532461 35.58244823393155, -82.63785763530596 35.58245523392222, -82.63785163530487 35.58245623392182, -82.63768963527443 35.5824792339098, -82.63763263526374 35.58248723390565, -82.63757763525177 35.5825052339036, -82.63740763521442 35.58256423389827, -82.63703163512976 35.582708233888944, -82.63679063507753 35.58278723388034, -82.63666863505092 35.58282823387625, -82.63653363501855 35.58289323387557, -82.6366156350311 35.58290023388544, -82.63686263506848 35.582924233915676, -82.63694563508109 35.582932233925845, -82.63746963516054 35.58298223398976, -82.63766663519036 35.58300123401379, -82.63794363523317 35.58302223404649, -82.63812763526039 35.583044234069895, -82.6382916352835 35.583071234092195, -82.6384336353013 35.583109234114566, -82.63856963531641 35.583158234138445, -82.63870063532829 35.58322223416489, -82.63882063533721 35.5832942341919, -82.638897635342 35.583346234210374, -82.63895963534374 35.583402234228146, -82.63897463534403 35.583416234232566, -82.63903463534473 35.58347723425115, -82.63908363534178 35.58354923427083, -82.63911563533497 35.583628234290224, -82.63912863532248 35.583723234310895, -82.63912763529886 35.58387623434201, -82.63912663529341 35.58391023434884, -82.63912663528676 35.58395323435763, -82.63911963527656 35.58401223436895, -82.63911663527082 35.584046234375464, -82.63911363526667 35.584070234380064, -82.63910663526254 35.584089234383185, -82.63909863525777 35.58411223438714, -82.63908463524912 35.58415323439405, -82.6390496352336 35.58421623440327, -82.63899663521333 35.584290234412904, -82.63897763520595 35.58431823441671, -82.63895363519795 35.58434423441951, -82.63893163519086 35.584366234421765, -82.63886863516991 35.5844342344291, -82.6388486351629 35.584458234431956, -82.63883263515798 35.58447323443333, -82.63878663514342 35.584518234437816, -82.63877163513841 35.584534234439516, -82.63865263510316 35.58463523444791, -82.63849663505404 35.58478623446268, -82.63834763500671 35.58493223447715, -82.6376826347999 35.58555823453641, -82.63749663474191 35.58573423455325, -82.63740763471546 35.585810234559574, -82.63735463469999 35.585853234562954, -82.63722063466061 35.585964234571804, -82.63719663465434 35.5859792345724, -82.63714063463924 35.58601723457437, -82.63711463463234 35.58603323457496, -82.63703763461213 35.58608223457703, -82.63702363460825 35.58609223457764, -82.63701263460547 35.58609823457775, -82.63687863457321 35.586163234577235, -82.6368636345698 35.58616923457693, -82.63678163455091 35.58620323457545, -82.63646363447862 35.586329234568495, -82.63640563446502 35.58635523456781, -82.6362936344381 35.586409234567306, -82.63625963442914 35.586430234568155, -82.63619163441145 35.58647223456974, -82.6359976343633 35.5865752345708, -82.6358196343237 35.58664023456582, -82.63546263424882 35.58674123454971, -82.63524863420297 35.58680823454146, -82.635062634162 35.586873234535595, -82.63473063408881 35.58699023452538, -82.63456163405068 35.58705523452131, -82.6343696340106 35.58710823451232, -82.63417863397284 35.58714723450076, -82.63390963392295 35.58718123448007, -82.63377563389894 35.58719223446854, -82.63358063386393 35.58720923445198, -82.63316163378612 35.587262234419796, -82.63302363375942 35.58728623441054, -82.63278163371474 35.58731523439158, -82.63265963369425 35.587316234379294, -82.63246763366477 35.587300234356356, -82.6323496336483 35.58728023434015, -82.63220263363056 35.58723623431609, -82.63204763361409 35.587175234287834, -82.63197663360806 35.58713823427301, -82.63192763360613 35.587098234259784, -82.63184663360414 35.58702323423622, -82.63180763360607 35.586968234221004, -82.63175363361094 35.58687823419708, -82.63160163361994 35.58665523413612, -82.63155963361929 35.58661423412344, -82.63147963361779 35.586537234099524, -82.63132063360668 35.586438234063074, -82.6311776335905 35.586388234038154, -82.63111763358214 35.586378234029944, -82.63101363356762 35.58636023401569, -82.63080663353723 35.58633323398893, -82.63061063350656 35.58632123396641, -82.63044663348155 35.58630623394649, -82.63035263346723 35.58629823393522, -82.63015863343657 35.586287233913055, -82.62992863340034 35.58627423388685, -82.62977663337483 35.58627623387167, -82.62964363335048 35.586290233860865, -82.62957763333812 35.5862992338559, -82.62950663332462 35.58631023385088, -82.629386633301 35.58633423384343, -82.62920763326647 35.58636523383144, -82.62912863325106 35.586380233826326, -82.62867063316321 35.58645623379484, -82.62849263312901 35.58648623378265, -82.6283046330934 35.58651423376906, -82.62774363298723 35.58659823372868, -82.6275566329517 35.586627233715376, -82.62756463296489 35.58655023370049, -82.6275876329853 35.58644223368086, -82.62759263299317 35.586396233671955, -82.627605633012 35.58628823365135, -82.62760763310297 35.58569823353137, -82.627608633139 35.585465233483944, -82.6276086331522 35.58537923346649, -82.6276086331689 35.58527023344421, -82.62760963316944 35.5852682334439, -82.62760963317653 35.585222233434564, -82.62760763317968 35.58519923342969, -82.6276076331829 35.58517823342542, -82.6276056331899 35.58513123341562, -82.62760563319327 35.585109233411096, -82.62760563323599 35.584831233354514, -82.62760563327967 35.58454723329664, -82.62763263336846 35.58399923318779, -82.62763563337778 35.583941233176255, -82.62764463339418 35.58384423315748, -82.6276666334162 35.58372523313542, -82.62766963341946 35.58370723313211, -82.62768863343044 35.583656233123676, -82.62771963344359 35.58360423311623, -82.62773963345217 35.58357023311136, -82.62778163346651 35.58352223310594, -82.62780863347517 35.58349523310315, -82.62809663356474 35.583224233077566, -82.62821963360295 35.58310823306651, -82.62841763366133 35.58294223305296, -82.62849663368459 35.58287723304789, -82.62856163370478 35.58281623304209, -82.62863163372343 35.58277023303987, -82.62865163372628 35.58277323304252, -82.62874163373793 35.58279523305627, -82.62910963384002 35.58252923303987, -82.62930763389473 35.58238723303121, -82.62971063400633 35.58209723301355, -82.63009163411301 35.581815232995126, -82.63025463415887 35.581693232986986, -82.63048363422494 35.581511232973455, -82.63102763438626 35.58105023293526, -82.63132763447439 35.580801232915356, -82.63152463453265 35.5806352329017, -82.63164263456751 35.58053623289371, -82.63170163458487 35.580487232889766, -82.63184163462532 35.580375232881366, -82.63223263474168 35.58004123285333, -82.63240863479405 35.5798912328408, -82.6324336348016 35.57986923283897, -82.63250763482372 35.57980523283349, -82.63253363483125 35.57978423283184)))",6033,37,021,002506,370210025063,865,865,183,821,613,71,3,5,56,73,44,636,103,533,617,478,58,2,5,36,38,19,392,329,63
census_2010_blockgroups_view.fid--2dc29038_13ec899ba8f_-2636,"MULTIPOLYGON (((-82.6854206353172 35.63383624927515, -82.68587463537948 35.633923249339496, -82.68612063541315 35.63397024937435, -82.68638363545067 35.63401124940968, -82.68658963548152 35.63403324943528, -82.68678563551408 35.634034249455695, -82.68695563554583 35.63401224946862, -82.68710763557837 35.63396524947461, -82.68723763560769 35.63391524947777, -82.68724863560999 35.633912249478314, -82.68753263568328 35.633744249473196, -82.68762263571095 35.633661249465504, -82.68765963572244 35.63362724946236, -82.68772763575485 35.63349024944144, -82.6877436357621 35.63346024943689, -82.68774663576511 35.63344424943402, -82.68782663578243 35.63341824943692, -82.68784263578576 35.633414249437685, -82.68801863583145 35.63330724943393, -82.68804263583861 35.633287249432335, -82.6881086358577 35.633234249428305, -82.68811263585881 35.63323124942816, -82.68824763590014 35.633109249417124, -82.68831763592108 35.63304924941205, -82.68838163593988 35.63299624940776, -82.68852763597761 35.632909249405074, -82.68864963600434 35.632867249408974, -82.68885563604405 35.63283224942299, -82.68910263608744 35.632818249445506, -82.68938263613632 35.63280324947123, -82.68965063618336 35.63278824949557, -82.68968863618997 35.63278624949911, -82.6898626362196 35.632782249516126, -82.69016463627402 35.63275524954162, -82.69048563633845 35.632684249560114, -82.69059263636301 35.63264024956216, -82.69072563639354 35.632586249564746, -82.69087963642794 35.63252924956899, -82.69101263645764 35.63248024957255, -82.69108563647238 35.63246324957667, -82.69126363650841 35.63242224958659, -82.69145363654332 35.63240124960174, -82.69156663655997 35.63241524961624, -82.69167063656978 35.63246424963685, -82.69170863657163 35.63249324964672, -82.69178163657496 35.632550249665776, -82.69189463658553 35.6326042496884, -82.69199363659456 35.63265224970838, -82.69220663661213 35.632769249754055, -82.69223963661463 35.632788249761305, -82.69253663664163 35.632934249821616, -82.69283263667097 35.633064249878466, -82.69316863670336 35.63321724994418, -82.69323963671023 35.63324924995792, -82.69347863672859 35.633389250011085, -82.69355963673475 35.6334362500289, -82.69381963675367 35.63359525008806, -82.69396263676082 35.633703250124704, -82.69416263677321 35.63383925017307, -82.69427563678039 35.633915250200104, -82.69430163678187 35.63393325020639, -82.69449363678366 35.634129250266106, -82.69450663678236 35.6341522502721, -82.6946146367717 35.63433825032117, -82.69471963675286 35.63457425038016, -82.69478663672517 35.634826250438245, -82.69484263669789 35.63506425049261, -82.69490363665801 35.635389250565176, -82.6949256365923 35.635839250659146, -82.69488263655167 35.63605725069921, -82.6948626365207 35.63623625073361, -82.69487863649863 35.63639725076808, -82.69493563647913 35.63658525081231, -82.69494163647752 35.63660225081641, -82.69499863646159 35.63676725085592, -82.69512763639511 35.63733825098554, -82.69519363637754 35.63752425103027, -82.69497963632598 35.63762725102931, -82.69496663632272 35.637634251029354, -82.69440263619012 35.63788525102275, -82.69436363618021 35.63790725102321, -82.69433163617208 35.63792525102357, -82.69421763614275 35.63799225102554, -82.69413063611921 35.63805125102863, -82.69411163611406 35.63806425102932, -82.6940236360865 35.638148251037485, -82.69401463608341 35.638158251038504, -82.6939486360515 35.638294251059484, -82.69389663602372 35.63841825107941, -82.69385863599736 35.638548251102065, -82.6938346359803 35.63863325111693, -82.69381163596842 35.63868525112517, -82.69376163594299 35.638796251142686, -82.69368463589763 35.639007251177794, -82.69365863588085 35.639088251191694, -82.69363563586566 35.639162251204354, -82.69358863583764 35.63929325122632, -82.69354963579289 35.63954125127287, -82.69354763577782 35.63963725129225, -82.69352963575484 35.63976625131666, -82.69351963572889 35.6399242513479, -82.69349863570692 35.64004425137014, -82.69347263568632 35.64015025138913, -82.69344763565974 35.640295251416184, -82.69344263564912 35.640359251428634, -82.69342863561569 35.640561251468434, -82.69345163558417 35.64079025151745, -82.6934646355666 35.64091825154497, -82.69346563556573 35.64092525154646, -82.69350563554968 35.64107225158054, -82.69355063554065 35.64118025160719, -82.69361163553643 35.641273251632406, -82.69362163553578 35.64128825163649, -82.69369563553514 35.64137225166119, -82.69373863553761 35.64140325167193, -82.69386963554476 35.64149825170479, -82.69391363554718 35.64153025171582, -82.6940246356158 35.64120525166095, -82.69408163565235 35.64102925163088, -82.69417963571446 35.64073225158036, -82.69430763578394 35.64041925152965, -82.69450963584396 35.64024825151559, -82.694657635905 35.640012251482624, -82.6948326359477 35.63992425148263, -82.69498063597743 35.63989125149113, -82.69502163598484 35.63988725149455, -82.69510163599926 35.63988025150125, -82.695303636027 35.63991925153006, -82.69541163604323 35.63993025154332, -82.69554263606938 35.63990225155099, -82.6956466360901 35.63988025155721, -82.6961186361569 35.639957251621404, -82.69629363618358 35.63997325164258, -82.69653563623146 35.63992425165749, -82.69675763628037 35.63984725166452, -82.69696663632102 35.63980925167824, -82.69710163634278 35.639814251693096, -82.69726963636393 35.63985825171934, -82.69745063637644 35.63997325176134, -82.69761963639515 35.640034251791164, -82.69786863643421 35.640050251819964, -82.69812463648367 35.64000625183722, -82.69871663660606 35.639852251866586, -82.6989656366543 35.639808251883224, -82.69916063669699 35.63974225188972, -82.69926863673099 35.63963825187962, -82.69942963677477 35.63952825187377, -82.69946263678274 35.63951225187386, -82.69963163682277 35.63943525187549, -82.69990763687817 35.639374251891375, -82.70027163694641 35.6393252519187, -82.70043963697529 35.63931925193471, -82.70056063699205 35.6393412519517, -82.70064863699906 35.63939125197087, -82.70069563700099 35.63942925198348, -82.70076263700972 35.63944525199365, -82.70083663702619 35.639418251995714, -82.70088363704755 35.63933025198254, -82.70091063707316 35.63919325195742, -82.70095163709355 35.639105251943626, -82.70105863712156 35.639039251941185, -82.70117963714513 35.63901725194909, -82.70131463716586 35.639028251965215, -82.70162463720068 35.63913825201944, -82.70192063724484 35.63917125205663, -82.70235163732175 35.6391382520941, -82.7025596373523 35.639165252120954, -82.70285663739334 35.63922025216264, -82.70307863741598 35.639313252204445, -82.70351563744237 35.63961525231078, -82.70383863746474 35.63981925238559, -82.70407463746778 35.640055252457906, -82.70423663746179 35.64026925251818, -82.70435063744786 35.640483252573546, -82.70451263745862 35.640588252611614, -82.70480863748857 35.640714252667706, -82.70525263753811 35.64087325274566, -82.705562637583 35.64091725278646, -82.70636363771989 35.64089525286421, -82.70664663775939 35.64094525290339, -82.70690263778008 35.641087252958634, -82.70707063780219 35.64112625298381, -82.7072186378268 35.64112625299902, -82.70758863791224 35.64097225300559, -82.70771663793442 35.64096625301751, -82.70785163794929 35.641016253041535, -82.70815463798625 35.64110425309061, -82.70830863801959 35.64105425309622, -82.70853763807882 35.640917253091764, -82.7086166381019 35.640853253086846, -82.70883363816475 35.640680253073775, -82.70892863820164 35.64054325305558, -82.70892163822934 35.64035625301671, -82.70888063824957 35.640180252976656, -82.70890763827009 35.64007625295822, -82.70899563829323 35.64002125295606, -82.70927163834695 35.639971252974185, -82.70947963839251 35.63990025298101, -82.70963463842945 35.63982825298225, -82.7097496384654 35.63971925297178, -82.70982963850247 35.63956525294863, -82.70988963852112 35.6395092529433, -82.70995763854164 35.639449252938086, -82.70999763856267 35.6393562529232, -82.70990363857845 35.63915225287196, -82.70997163860316 35.63906525286121, -82.71005863862877 35.63899325285548, -82.71028763867712 35.638927252865436, -82.71042263870294 35.6389052528748, -82.71046863872155 35.63883425286511, -82.71044863873516 35.63872425284055, -82.71034163874012 35.638576252799396, -82.71013263872823 35.63842725274763, -82.70995063872496 35.63825125269296, -82.70975563871697 35.63809225264059, -82.70957363869921 35.63801025260515, -82.70928463865192 35.63800425257431, -82.70921063864725 35.63795525255671, -82.70918263865954 35.63784525253143, -82.7092306386954 35.63766425249936, -82.70952663886665 35.63687225236824, -82.7095966389136 35.636643252328675, -82.7096266389161 35.63665925233507, -82.70977263893293 35.636708252360066, -82.71001263896375 35.63676825239688, -82.71024263900074 35.63677625242209, -82.7104376390391 35.63673825243437, -82.71053863906167 35.63670125243724, -82.71059763907475 35.63668025243896, -82.71076863912053 35.636568252433705, -82.71136963929337 35.63609625239907, -82.71149763932672 35.63601825239632, -82.71158963934604 35.63599225240048, -82.71174863937594 35.6359702524123, -82.71200663942044 35.63596025243677, -82.71224063945625 35.63598125246498, -82.71241263947846 35.63602325249119, -82.712572639495 35.63608925252106, -82.71280763951599 35.63620725256925, -82.71313963954456 35.63638125263877, -82.71369063959179 35.63667125275451, -82.71399863961726 35.63683825282019, -82.71431263964358 35.637008252887085, -82.7152576397225 35.637518253088075, -82.71535063973036 35.63756825310785, -82.71556963974741 35.63769425315605, -82.71593363977631 35.63790125323556, -82.71620863980081 35.63803925329192, -82.71642563982407 35.6381232533313, -82.71661063985081 35.638150253355754, -82.71675763987513 35.63815125337108, -82.7169606399104 35.6381422533901, -82.71711263993583 35.63814125340547, -82.71724163995351 35.63816625342379, -82.71726563995675 35.63817125342728, -82.71758963999197 35.63829325348544, -82.71780464001714 35.638362253521564, -82.71804464004892 35.63841625355719, -82.71830364008586 35.63845625359193, -82.71855264012795 35.63845325361687, -82.71876864016977 35.63841525363127, -82.71893464020685 35.63835425363588, -82.7191476402575 35.63825625363774, -82.71933264030064 35.6381762536404, -82.71934364030324 35.638171253640486, -82.71955564035505 35.63806425364043, -82.71973264039944 35.637967253638806, -82.72055964061975 35.637432253614556, -82.72081764068818 35.637267253607334, -82.72101864074088 35.63714225360248, -82.72134464082652 35.6369392535945, -82.7215366408789 35.63680725358729, -82.72197864100518 35.63646525356293, -82.72205564102717 35.63640625355874, -82.72238364112226 35.636143253538755, -82.72261464118753 35.635970253527184, -82.72276364122523 35.63588625352532, -82.72291564125683 35.63584525353255, -82.72304464127853 35.63584425354556, -82.72322264130332 35.63587625357035, -82.72354264134081 35.63597925362416, -82.72398364104824 35.63835725415451, -82.72412664095388 35.639124254325615, -82.72395164072618 35.64041425457089, -82.72434464058567 35.64175225488417, -82.72480864052812 35.64262825511051, -82.72485564048567 35.64295525518204, -82.72484164045017 35.643170255224426, -82.7248076404179 35.64334325525623, -82.72475064038757 35.64347825527792, -82.724742640385 35.64348625527876, -82.72470664037334 35.64352325528259, -82.72461664035063 35.64357325528354, -82.72440364031311 35.64358625526434, -82.72418864027938 35.64357225523937, -82.72399464024814 35.64356525521809, -82.72386464022365 35.64358325520848, -82.7237376401952 35.643630255205004, -82.72357864015551 35.643716255206236, -82.72313164003879 35.64399025521626, -82.72299864000253 35.64408125522117, -82.72295963999196 35.644108255222676, -82.72285163995802 35.644211255232584, -82.7227836399316 35.64430925524559, -82.72273263990438 35.64443125526524, -82.72271163988111 35.64455925528922, -82.72267563985035 35.64472025531838, -82.72258863974972 35.64527925542349, -82.7225246396523 35.64584225553179, -82.72249563962595 35.64598225555734, -82.72236663956481 35.646239255596534, -82.72229363953923 35.6463262556068, -82.72226963953091 35.646354255610056, -82.72210963947845 35.64652225562794, -82.72202163945028 35.6466092556366, -82.72158163930904 35.64705025568144, -82.7213736392466 35.64723025569676, -82.72118563919369 35.64737025570604, -82.72115063918335 35.6473992557084, -82.7209846391332 35.64754525572113, -82.72086363909426 35.64766725573355, -82.72075963906057 35.647773255744596, -82.72055063899393 35.6479792557651, -82.72048563897377 35.64804025577088, -82.72002663883002 35.64847625581271, -82.71983163876659 35.64867725583368, -82.71961563869299 35.64892125586136, -82.71948963864344 35.649106255886124, -82.71942263861504 35.64921825590207, -82.71937563859453 35.64930025591397, -82.71927763855706 35.649437255931865, -82.7191746385153 35.64959725595391, -82.7191266384977 35.649659255961645, -82.71907663847958 35.64972325596957, -82.71898863844254 35.64986825599016, -82.71890663839974 35.6500572560203, -82.71885563836939 35.65019925604403, -82.71882163833406 35.65039125607969, -82.71878263830423 35.650543256106715, -82.71870663824032 35.65087525616664, -82.71867263822357 35.65094725617782, -82.71863663820527 35.651027256190446, -82.718552638166 35.65119125621529, -82.71845763812594 35.6513482562376, -82.718339638082 35.65150625625769, -82.71822763804195 35.65164425627435, -82.71809463799315 35.65181725629592, -82.71799063795112 35.651977256317934, -82.71767463781231 35.65253625639951, -82.71750463773164 35.652876256451414, -82.71730263764742 35.65320425649766, -82.71709063756087 35.6535362565436, -82.71689163748192 35.653833256583745, -82.7167276374192 35.65406325661386, -82.71645163731611 35.65443325666099, -82.71643763731088 35.654452256663454, -82.71630563726308 35.654619256683894, -82.71606563717144 35.6549542567276, -82.71589663710364 35.65521125676268, -82.7156956370134 35.655579256817155, -82.71569663701278 35.65558425681824, -82.71542463696177 35.655621256797865, -82.715378636953 35.65562825679459, -82.71498863687877 35.6556882567668, -82.7144246367731 35.65576325672424, -82.71440763676982 35.65576625672305, -82.71410863671254 35.65581425670217, -82.71398163668819 35.655835256693415, -82.71397263668646 35.65583625669267, -82.71356363660921 35.65589525666277, -82.71342763658329 35.65591625665303, -82.71307063651606 35.65596625662665, -82.71269263644429 35.65602325659939, -82.71244663639733 35.65606125658197, -82.71064663605651 35.65632525645095, -82.71048963602671 35.656349256439825, -82.70999363593201 35.656427256404726, -82.7097556358871 35.65646125638726, -82.70964563586635 35.65647625637904, -82.70934863581031 35.6565192563573, -82.70931663580419 35.65652425635501, -82.70920763578329 35.65654225634749, -82.70874063569346 35.65661925631532, -82.70829463560769 35.65669325628454, -82.70744463544028 35.65686025623136, -82.70734763542072 35.65688225622592, -82.70688863532722 35.656992256201214, -82.70652163525189 35.65708425618229, -82.70651063524976 35.65708625618157, -82.70566063507275 35.657315256141025, -82.70538163501556 35.65738425612641, -82.70527363499325 35.65741225612105, -82.70500163493925 35.65746825610459, -82.70493463492608 35.65748125610034, -82.70465063487259 35.65752125607933, -82.70462463486766 35.65752525607751, -82.704384634825 35.65754225605633, -82.70424463480138 35.65754425604234, -82.70394863475384 35.65753225600953, -82.70369763471605 35.65750625597846, -82.70346463468323 35.657467255946514, -82.7032316346519 35.65741825591268, -82.70308763463412 35.65737825588971, -82.70292563461399 35.65733325586388, -82.70277763459768 35.657279255837736, -82.7026786345867 35.65724325582014, -82.70241563456054 35.657128255769685, -82.70212563453333 35.65699125571197, -82.7018896345119 35.65687525566412, -82.70159763448515 35.65673325560517, -82.70132263445929 35.65660325555038, -82.70116963444485 35.65653125552006, -82.70086863441432 35.65640425546324, -82.70059763438243 35.656318255417816, -82.70047263436612 35.65628825539888, -82.70034563434963 35.6562582553797, -82.70017663432604 35.656228255356204, -82.70015163432252 35.656224255352875, -82.70007663431154 35.65621425534313, -82.70005263430805 35.656211255340054, -82.699948634293 35.656196255326336, -82.69983463427523 35.65618825531298, -82.69966563424873 35.656177255293414, -82.69923363417739 35.656173255248206, -82.69917963416839 35.656173255242635, -82.69896163413124 35.65617825522132, -82.69892963412586 35.656178255218, -82.6988756341166 35.65618025521289, -82.69883663411042 35.65617825520845, -82.69880563410527 35.656178255205305, -82.69860763407299 35.656173255183916, -82.69838163403713 35.65616125515828, -82.69807363399278 35.656116255117475, -82.69799263398217 35.656097255105394, -82.69780463395725 35.65605625507767, -82.69777963395521 35.65604225507221, -82.69753663392746 35.65595925503029, -82.69712063388586 35.655779254950886, -82.6960096337818 35.65525325472961, -82.6957426337565 35.655128254676626, -82.69500063368594 35.654784254530306, -82.69484463367117 35.654711254499425, -82.69437663362689 35.654492254406705, -82.69422163361222 35.65442025437609, -82.69323263353601 35.653845254157275, -82.69299163352179 35.65367725409832, -82.69282863351374 35.65355225405606, -82.69190463347347 35.652815253810864, -82.69135263344941 35.65237425366426, -82.69133563344872 35.65236025365963, -82.69128763344676 35.652321253646754, -82.69127163344608 35.652308253642474, -82.69125563344542 35.652295253638215, -82.6912076334433 35.65225725362549, -82.69119263344267 35.65224525362155, -82.6909586334328 35.65205625355895, -82.69083763342681 35.651964253527794, -82.69059663341471 35.65178225346596, -82.69027763339126 35.65158925339377, -82.68994163335873 35.65143725332833, -82.68963863332024 35.6513592532813, -82.68956963331141 35.651342253270776, -82.68919163325405 35.651305253224386, -82.6891086332415 35.65129725321421, -82.68898663321974 35.6513062532036, -82.68861563315352 35.651335253171304, -82.68837563310684 35.65137825315549, -82.6881736330674 35.651416253142585, -82.68805063304265 35.65144325313534, -82.68768663296935 35.651525253114706, -82.68768163296855 35.65152525311421, -82.68755963294396 35.65155325310737, -82.68730863289417 35.65160425309198, -82.6870456328419 35.6516592530762, -82.6865536327464 35.65174725304361, -82.68651163273809 35.651755253040925, -82.68629963269946 35.65177725302371, -82.68608963266132 35.651797253006215, -82.685878632623 35.65181825298881, -82.68562163257872 35.65182725296424, -82.68546363255163 35.65183225294908, -82.68546063255128 35.651831252948526, -82.68525063251677 35.651828252926336, -82.68500763247688 35.65182425290058, -82.68490163246075 35.651814252887654, -82.6846246324181 35.651791252854565, -82.68415063234863 35.65173025279344, -82.68386563230894 35.651679252753745, -82.68377863229672 35.651664252741774, -82.68352463226242 35.65161225270506, -82.68327863222945 35.6515602526692, -82.68254063213041 35.65140525256179, -82.68229563209744 35.65135425252622, -82.68214163207683 35.651321252503756, -82.68192863204833 35.65127625247267, -82.68168363201804 35.65120825243362, -82.68159263200671 35.651183252419166, -82.68153363200014 35.651162252408874, -82.68145863199179 35.65113525239565, -82.68130763197499 35.651081252369174, -82.6812356319676 35.65105125235566, -82.68116263195986 35.65102225234226, -82.68102563194564 35.65096625231675, -82.68097663194058 35.650946252307676, -82.6806576319127 35.6507822522414, -82.68063263191087 35.65076725223586, -82.68050763190173 35.650691252207494, -82.68049663190105 35.65068425220489, -82.68046363189875 35.65066325219721, -82.68045263189784 35.650657252194854, -82.68044463189722 35.65065225219302, -82.68028463188763 35.650542252154246, -82.68019363188216 35.65047925213201, -82.67995863187258 35.650287252068686, -82.6798176318698 35.65015325202695, -82.67972463186783 35.65006525199938, -82.67967663186865 35.650008251982904, -82.67951563187103 35.64981825192763, -82.6794016318766 35.64965925188341, -82.67926163188548 35.649450251826494, -82.67908263189706 35.64918125175327, -82.67811663196336 35.64770725135351, -82.67773563198942 35.647126251195914, -82.6774636320139 35.64667325107562, -82.677420632017 35.64660725105776, -82.6770006320466 35.645961250882955, -82.67648263210077 35.64504925064379, -82.67635563211402 35.64482625058534, -82.67619463213501 35.64451625050558, -82.67606863215148 35.64427325044305, -82.67588363217548 35.64391725035147, -82.6757416322095 35.643543250260684, -82.67573463221112 35.643525250256324, -82.6756376322342 35.64327025019433, -82.6755166322634 35.64295025011667, -82.67521263232834 35.64220024993258, -82.67501963235961 35.64178824982874, -82.67473763240115 35.64121424968281, -82.6744896324325 35.64074224956108, -82.67450363243704 35.640728249559636, -82.67455763245434 35.640674249554195, -82.67458863246408 35.64064424955128, -82.6748766325537 35.640374249525784, -82.675021632599 35.64023724951269, -82.67509763262579 35.640145249501785, -82.6751666326509 35.64005724949091, -82.67521163267175 35.63997024947777, -82.67524263269526 35.6398512494567, -82.67527263274184 35.63958124940477, -82.67529563276861 35.63943224937676, -82.67533363279912 35.639275249348586, -82.67557863294623 35.638585249233095, -82.67573863302643 35.63823824917878, -82.67591363310497 35.63791724913136, -82.67605163315969 35.637711249103475, -82.67607363316866 35.63767724909882, -82.67611263318159 35.63763524909427, -82.6761616331981 35.637581249088285, -82.67624363322591 35.63748924907801, -82.6764346332872 35.63729724905836, -82.6765816333327 35.637161249045775, -82.67674963337758 35.637051249040546, -82.67701163344425 35.63690224903714, -82.67717863348291 35.63683124903976, -82.67737663352553 35.636769249047425, -82.67750463355067 35.63674424905551, -82.67753263355623 35.63673824905712, -82.67774363359237 35.63673224907756, -82.67805063364412 35.63672824910831, -82.6782126336749 35.6367032491198, -82.67829463369227 35.636679249123326, -82.67840663371574 35.63664824912849, -82.67885063382404 35.63642524912866, -82.67912663389508 35.63626224912371, -82.67926563393368 35.63616224911764, -82.67944663399246 35.63597624909832, -82.6799526341656 35.635399249032616, -82.68012363422336 35.63520924901137, -82.68036463430445 35.63494324898191, -82.68066363440339 35.634624248947624, -82.68074463442998 35.63453924893853, -82.68098363450801 35.63429124891253, -82.68098763450948 35.63428624891186, -82.6810676345359 35.63420124890277, -82.68110063454702 35.63416424889862, -82.68119963458034 35.634055248886575, -82.68123363459158 35.6340192488827, -82.68136063463444 35.633878248866985, -82.6816016347154 35.633613248837726, -82.68173763476237 35.633455248819416, -82.68186163480502 35.63331224880303, -82.68190363481963 35.63326324879732, -82.68191863482454 35.633247248795605, -82.68203563486394 35.63311824878136, -82.68207963487849 35.63307124877623, -82.68215163490262 35.632992248767565, -82.68217463491021 35.63296824876497, -82.68224663493108 35.63291024876053, -82.68234063495491 35.632857248759485, -82.68242563497199 35.632838248764244, -82.68244463497577 35.63283424876534, -82.68253263499149 35.63282724877297, -82.68258663500116 35.6328232487777, -82.6826396350089 35.63283024878461, -82.68267563501405 35.632835248789284, -82.68286763503671 35.63289624882143, -82.68294463504334 35.632936248837545, -82.68304063505148 35.63298724885779, -82.68307763505469 35.63300624886541, -82.68314163506042 35.63303824887852, -82.68344563508752 35.63319124894093, -82.68354763509663 35.63324224896179, -82.68362963510401 35.63328324897861, -82.68365663510684 35.63329424898355, -82.68392763513442 35.63340824903463, -82.68399163514076 35.63343624904693, -82.68410263515172 35.63348524906827, -82.68416963515826 35.6335152490813, -82.68435563517828 35.63358624911487, -82.68437763518054 35.63359524911898, -82.68455963520263 35.63364924914869, -82.68477463522994 35.63370424918192, -82.68515263528153 35.63377824923582, -82.68516863528353 35.633782249238244, -82.6854206353172 35.63383624927515)))",6350,37,021,002605,370210026051,1247,1247,33,1239,1192,26,3,3,0,15,8,950,23,927,947,913,19,2,3,0,10,3,523,475,48
census_2010_blockgroups_view.fid--2dc29038_13ec899ba8f_-2635,"MULTIPOLYGON (((-82.54470361355767 35.623171232647415, -82.54504161363074 35.62306123265976, -82.54527061368006 35.6229882326684, -82.54542761367986 35.62315823271911, -82.54553761366778 35.6233552327706, -82.54536761358914 35.623682232819675, -82.5452406135301 35.62392823285665, -82.54517461351271 35.62397023285843, -82.54519761350758 35.62402823287256, -82.54521761350497 35.624066232882406, -82.54526961349919 35.62416023290689, -82.54533261349636 35.62424623293083, -82.5454006134976 35.62431123295104, -82.54540761349799 35.62431623295285, -82.54546761350134 35.62435923296768, -82.54549761350432 35.62437223297348, -82.5455476135094 35.624393232982904, -82.54560261351601 35.624409232991766, -82.54566361352342 35.62442723300176, -82.54577961353912 35.624450233018365, -82.54588561355564 35.624457233030654, -82.54593261356392 35.62445423303491, -82.54604461358322 35.6244492330454, -82.54608461359032 35.62444623304884, -82.54624761362356 35.62440623305745, -82.54624961362397 35.624406233057655, -82.54651061367994 35.624324233067846, -82.5467616137364 35.62422823307412, -82.54683861375355 35.62420023307632, -82.54697661378394 35.6241512330805, -82.54703361379728 35.624126233081284, -82.54700761374897 35.62441123313663, -82.54700561374406 35.62444123314251, -82.54699061369868 35.62471923319762, -82.54695161364259 35.625041233259104, -82.5469236135845 35.62538723332663, -82.5469206135763 35.62543723333648, -82.54691761355343 35.62558223336571, -82.54690861353312 35.6257042333897, -82.54686561347994 35.6260032334461, -82.54683561344143 35.6262202334872, -82.54680461337921 35.62659023355927, -82.54677061332518 35.62690423361971, -82.54676261331116 35.6269862336356, -82.5467616133098 35.626994233637085, -82.54674661327478 35.627205233678545, -82.54673061325454 35.627319233700106, -82.54668561319447 35.62766023376484, -82.54667061317421 35.62777523378673, -82.54664061312822 35.628041233837806, -82.54662561310391 35.62818223386495, -82.5465816130431 35.62852923393104, -82.54654861298984 35.628839233990725, -82.54654761298733 35.628854233993735, -82.54651561294328 35.62910523404153, -82.54650061292226 35.629225234064414, -82.54645661285906 35.62958823413373, -82.54644261283805 35.62970923415695, -82.54643161282227 35.62979923417418, -82.54643561281074 35.62987823419066, -82.54645061280559 35.62992823420231, -82.5464626128037 35.62995323420865, -82.54650561280394 35.629998234222285, -82.54654161280274 35.63004423423533, -82.54657561280347 35.630076234245365, -82.54665061280517 35.630146234267265, -82.54674661280461 35.63025323429896, -82.54708961279718 35.63067023441906, -82.54724661279164 35.63087523447696, -82.54735961278341 35.63105023452423, -82.54737661278226 35.631076234531314, -82.54748961276549 35.63130623458974, -82.5475336127537 35.631430234619486, -82.5476346127229 35.631738234692534, -82.54777361268101 35.63215923479255, -82.54794961263538 35.63264523490951, -82.54795361263399 35.632658234912576, -82.54804861260182 35.63296923498566, -82.54808261258982 35.63308323501237, -82.54811561258741 35.63313423502615, -82.54815961258905 35.63317123503821, -82.5482116125957 35.633184235046144, -82.5482356125995 35.63318523504889, -82.5482616126035 35.6331872350519, -82.54831761261387 35.63318023505627, -82.5484316126401 35.633133235058466, -82.54854461266892 35.63306823505683, -82.54876161272853 35.63291523504795, -82.54905061280562 35.632726235039286, -82.54911961282393 35.63268223503735, -82.54919561284059 35.63265623503988, -82.5493176128726 35.63258023503695, -82.54932661287421 35.63257923503768, -82.54936261281956 35.632972235121414, -82.5493666128109 35.633032235133975, -82.54947961261985 35.63439223542252, -82.54950461257822 35.634689235485496, -82.54952461255742 35.63484523551931, -82.54947861254377 35.63488423552251, -82.54934261250334 35.6350002355322, -82.54929761248965 35.63504023553568, -82.5491866124566 35.63513523554359, -82.54913861244259 35.63517423554665, -82.54902161240784 35.63527323555478, -82.54866161230177 35.635573235578796, -82.54850261225481 35.63570623558954, -82.54833061220428 35.63584923560092, -82.5478146120519 35.6362812356358, -82.54764361200132 35.63642523564753, -82.54762261199521 35.63644223564881, -82.54756161197714 35.63649323565294, -82.5475416119711 35.636511235654524, -82.54741161193351 35.63661423566211, -82.54737161192261 35.63664223566373, -82.54724961188829 35.6367332356697, -82.54706861184005 35.636851235675074, -82.54689361179581 35.636949235677044, -82.54682561177947 35.63698223567677, -82.5467296117561 35.6370302356767, -82.54663161173302 35.63707423567553, -82.54654061171162 35.63711523567454, -82.54640861168288 35.63715923566992, -82.54640361168171 35.63716123566984, -82.54624061164816 35.6372032356616, -82.54577661156486 35.63724423562219, -82.54570261155112 35.63725323561647, -82.545466611507 35.63728523559873, -82.54506661143368 35.637330235566665, -82.54474861137525 35.63736623554132, -82.54455661133842 35.63739823552813, -82.54431561128851 35.63746223551634, -82.54396961121245 35.63758323550538, -82.54389861119687 35.63760723550301, -82.54351861111373 35.637737235490384, -82.54323461105083 35.637839235481955, -82.54321661104679 35.63784623548145, -82.54311061102231 35.637890235479546, -82.5430126109969 35.63795023548166, -82.54290761096786 35.6380252354861, -82.54282261094 35.63811423549553, -82.54275061091234 35.63821623550887, -82.54264761086259 35.638427235541215, -82.54258661083679 35.6385292355557, -82.5425846108361 35.63853123555591, -82.54252061081175 35.63862023556746, -82.54241761077846 35.63872523557824, -82.54236761076388 35.63876623558141, -82.54231561074887 35.63880723558444, -82.54225361073364 35.63883923558452, -82.54221361072354 35.638861235584905, -82.54188661064569 35.63901423558248, -82.54183861063419 35.63903723558217, -82.54176361061677 35.639069235581005, -82.54171561061881 35.63900423556278, -82.54167161061986 35.63895023554729, -82.54138961062701 35.63860023544703, -82.54129661062949 35.638484235413834, -82.54125461063043 35.63843223539895, -82.54115761062373 35.63837223537678, -82.54110461061983 35.63834023536482, -82.54068961058726 35.638104235274106, -82.54053361057517 35.63801523523996, -82.54028661057013 35.63778223516716, -82.53993661055885 35.63747823506926, -82.53951161054155 35.63713323495531, -82.53944261053618 35.63709423494025, -82.53940761053332 35.637075234932794, -82.53930961052369 35.637032234913946, -82.53929561052226 35.637026234911275, -82.53915561050668 35.63697623488673, -82.53901961048764 35.636953234867995, -82.53888161046281 35.63696623485653, -82.53886261045932 35.636968234854955, -82.53879761044529 35.63698923485256, -82.53874161043314 35.637007234850515, -82.53873461043169 35.63700923485015, -82.53869861042337 35.63702423484951, -82.53857261039434 35.63707723484731, -82.5385306103844 35.63709623484685, -82.53831861033639 35.637179234841966, -82.5381596103031 35.63722423483478, -82.53812661029603 35.63723423483344, -82.53802061027716 35.637242234824164, -82.53795961026856 35.63723223481585, -82.537896610264 35.63719423480161, -82.53779661026192 35.637100234772284, -82.53764661026167 35.63694023472419, -82.5374596102642 35.6367232346608, -82.53727761026201 35.63654123460503, -82.53719561026121 35.63645823457968, -82.53695061023984 35.63633323452912, -82.53681461022784 35.63626423450103, -82.5366096102147 35.63612923445248, -82.53649361020715 35.63605323442508, -82.53587161019061 35.63549123424676, -82.53577061018431 35.63542323422255, -82.53569261017942 35.635371234203916, -82.53536361015892 35.6351502341251, -82.53532661015554 35.635132234117606, -82.53521661014562 35.6350782340953, -82.53517961014205 35.635061234088006, -82.53517661014175 35.635060234087504, -82.53510561013508 35.63502723407351, -82.53501461012645 35.63498523405562, -82.534878610111 35.63493923403229, -82.53480261010239 35.63491323401911, -82.53459561007895 35.6348422339834, -82.53439961005793 35.63476723394798, -82.53434561005209 35.634747233938334, -82.53414261002901 35.63467823390346, -82.53352260994926 35.63452823380915, -82.53316360990588 35.634423233750844, -82.53293460987813 35.634356233713646, -82.53275060985423 35.63431323368599, -82.53222860978629 35.63419223360765, -82.5320026097568 35.634140233573795, -82.5318976097446 35.63410623355609, -82.53185760974091 35.634087233548115, -82.53182160973796 35.63406723354034, -82.53177160973343 35.6340432335303, -82.53168760972638 35.63399823351254, -82.53144260972245 35.63376023343885, -82.53125360972416 35.63354623337591, -82.53112260971925 35.63343723334029, -82.53097860970682 35.633362233310145, -82.53091360969917 35.63334223329943, -82.53078760968432 35.633303233278525, -82.53061360966214 35.63325923325166, -82.53039460963274 35.63321423321998, -82.53005660963116 35.632861233113395, -82.53003360962904 35.63285023310882, -82.52984860960659 35.63279623307881, -82.52977060959728 35.632773233066104, -82.52958260959223 35.63260323301209, -82.52951460959366 35.63252123298844, -82.52948160960187 35.63243223296695, -82.52942160961717 35.632268232927395, -82.52940660961892 35.63224123292037, -82.5290786097981 35.630727232578494, -82.5283486096758 35.63073423250488, -82.52844560977435 35.63020023240612, -82.52850660980633 35.63005823238346, -82.52856760984953 35.62984423234625, -82.52863460988951 35.629657232315054, -82.52871560992747 35.62949823229107, -82.52890361000021 35.629229232255696, -82.52897161003523 35.62907523223128, -82.52912661010512 35.62878923218906, -82.52919361014337 35.628613232160085, -82.52932861019029 35.628454232141635, -82.52952361025152 35.62826723212365, -82.52964461028012 35.62821223212487, -82.52972561029692 35.62819023212878, -82.52988661033635 35.62810823212864, -82.53010261039256 35.62797623212391, -82.53018361041619 35.62791023211887, -82.53048461049762 35.627706232108245, -82.53139061074208 35.627096232077385, -82.53169261082354 35.62689323206709, -82.53173761083382 35.62687523206801, -82.53177761084044 35.62687523207213, -82.53180661084258 35.626892232078575, -82.5318266108402 35.626929232088195, -82.5318256108327 35.62697723209781, -82.53174361080146 35.62709123211263, -82.5315506107352 35.62731323213799, -82.53152761072084 35.627381232149375, -82.53154361070597 35.62749523217432, -82.53161461069163 35.62766423221597, -82.53156961065731 35.62783823224669, -82.53159761061843 35.628120232307054, -82.53165261061477 35.62820323232964, -82.53168361061705 35.628222232336626, -82.53174161062499 35.6282332323448, -82.53178361063294 35.62822623234772, -82.53182461064354 35.62820223234706, -82.53201261070357 35.628015232328316, -82.5322896107762 35.62784223232167, -82.53261961088263 35.62750723228734, -82.53269361090203 35.62746123228565, -82.53271561090757 35.62744923228542, -82.53281361092908 35.62741523228861, -82.5329146109485 35.62739823229552, -82.5331756109937 35.62738623231994, -82.53328361100723 35.627414232336704, -82.53377061105235 35.627646232433996, -82.53402561107907 35.6277472324808, -82.53439261110354 35.627983232566535, -82.53450961111575 35.628030232588195, -82.53462961113085 35.62806123260679, -82.53468161113983 35.62805923261178, -82.53480261116951 35.627997232611584, -82.53502961123279 35.62783123260111, -82.53507661124985 35.6277712325938, -82.53518661131409 35.627473232544446, -82.53523561137717 35.627117232477005, -82.53523661140017 35.626969232446996, -82.53522861141457 35.626867232425404, -82.53516961143792 35.62665223237555, -82.5350616114572 35.626411232315455, -82.53498561145983 35.62631223228747, -82.53483561144975 35.626216232252496, -82.53473561143747 35.62618823223647, -82.5345846114116 35.62619323222207, -82.53453061139741 35.62622723222341, -82.53452061139126 35.626256232228265, -82.53452961138733 35.62629123223634, -82.5345646113898 35.6263132322444, -82.53462661139666 35.626335232255215, -82.53477861141803 35.62636023227591, -82.5348226114202 35.626393232287164, -82.53488361141778 35.626475232310185, -82.53491061138854 35.62669323235729, -82.53490661137185 35.626797232378074, -82.53486161133547 35.626985232411684, -82.5348076113161 35.62705223241979, -82.53463861127366 35.627145232421306, -82.53444861123693 35.627179232408736, -82.53433961121881 35.62717923239751, -82.53424961120575 35.62716723238578, -82.53413561119726 35.627099232360294, -82.53404361120467 35.62695223232086, -82.53401561121608 35.6268482322968, -82.53399861124566 35.62663823225232, -82.53401261126989 35.62649623222489, -82.53404261129064 35.626394232207204, -82.53404061130198 35.62631823219151, -82.53388861136794 35.62572723205563, -82.53379961139376 35.625464231992915, -82.53380161145691 35.625057231910304, -82.53378261146432 35.624988231894314, -82.53374961146831 35.62492723187847, -82.53365561147955 35.62475323183339, -82.53362361149351 35.62462823180472, -82.53364961151813 35.624496231780526, -82.53383761160272 35.62415023172935, -82.53389361164263 35.62395223169484, -82.5338976116772 35.62373223165052, -82.53385761170811 35.62348823159679, -82.53383061172141 35.62337323157059, -82.53379161172501 35.62330823155335, -82.53371661171934 35.62326423153664, -82.53361261170728 35.62323023151903, -82.53352561169572 35.62321123150624, -82.53341561167845 35.62320523149364, -82.53334761166685 35.62320723148712, -82.53309061161954 35.6232372314668, -82.53300861160795 35.62322423145576, -82.53295061160264 35.62319623144402, -82.5329086116006 35.6231642314332, -82.53281261159577 35.62309223140874, -82.53272361158552 35.62306323139369, -82.5326686115777 35.62305423138614, -82.53248261155164 35.62302323136076, -82.53237861153819 35.622998231344944, -82.53236961153718 35.62299523134339, -82.53222661152054 35.62294923131936, -82.53214661151296 35.622912231303545, -82.5320826115112 35.622855231285435, -82.53202361151236 35.6227842312649, -82.53195761151592 35.622690231239005, -82.53188261152145 35.622573231207454, -82.53179061152622 35.622443231171545, -82.53174861153055 35.62237023115238, -82.53170161153521 35.622289231131, -82.53165461154325 35.622186231105275, -82.53163461155067 35.62211723108916, -82.53163061155388 35.6220922310837, -82.53161161156858 35.621976231058085, -82.53158561157211 35.621925231045054, -82.5315066115843 35.62176123100352, -82.53144061156205 35.621834231011604, -82.53135561153594 35.621912231018754, -82.5313216115243 35.6219512310232, -82.5312976115132 35.62199723103002, -82.53127961150093 35.62205723104045, -82.53127561149364 35.62210023104872, -82.53127861147892 35.62219923106931, -82.53129061146716 35.62228823108854, -82.53130361145539 35.62237823110823, -82.5312926114314 35.62252223113639, -82.53126061139965 35.62269323116796, -82.53121761136974 35.622841231193604, -82.53117561134705 35.62294323121003, -82.53106361128863 35.62320123125104, -82.5310366112771 35.62324723125766, -82.53100961126857 35.62327323126012, -82.53097261125826 35.623300231261844, -82.53094261125078 35.62331623126199, -82.53078561121443 35.62338323125946, -82.53068561118948 35.62343723126018, -82.53039061110593 35.623661231275435, -82.5303416110929 35.623693231276896, -82.53029161107925 35.62372823127894, -82.53021061105932 35.62377023127912, -82.53012661103965 35.62380723127799, -82.52995961100481 35.623853231270196, -82.52982661097577 35.6238982312657, -82.52977861096367 35.623925231266256, -82.52974461095515 35.62394423126661, -82.52972261094934 35.62395823126717, -82.52967861093741 35.623988231268825, -82.5295636109052 35.624073231274274, -82.5295116108904 35.62411323127703, -82.52942261086571 35.62417723128087, -82.52935261084842 35.624214231281215, -82.52928361083386 35.62423423127821, -82.52925561082786 35.6242432312772, -82.52906361078928 35.62428623126615, -82.52870961072058 35.62435123124302, -82.52851861068254 35.6243922312317, -82.52842761066437 35.6244122312264, -82.52827461062876 35.62447823122416, -82.52822561061741 35.624499231223346, -82.52819961061137 35.62451023122295, -82.52806961058086 35.624568231221375, -82.52797261056094 35.6245932312165, -82.52789461054458 35.62461523121286, -82.52805661059293 35.62447623120135, -82.5282186106397 35.624347231191706, -82.52850461072164 35.624123231175524, -82.52903261087117 35.62372223114819, -82.52922161092435 35.62358123113897, -82.52936661096466 35.62347523113228, -82.52948161099724 35.623388231126434, -82.52955861101911 35.623329231122305, -82.52981461109152 35.62313523110918, -82.5300596111615 35.62294523109575, -82.53013361118397 35.62287923108989, -82.53019761120558 35.62280823108205, -82.53024761122427 35.62274023107331, -82.53028761124403 35.622655231060186, -82.53032861126988 35.62253223103931, -82.53041661134495 35.6221402309686, -82.53051261142537 35.6217222308934, -82.5307996116589 35.62051623067746, -82.53083361168972 35.62035323064779, -82.53086961173209 35.62011723060349, -82.53087461174609 35.620032230586695, -82.53086961177543 35.619836230546234, -82.5307996118439 35.619317230433474, -82.53072061200848 35.61816523019093, -82.53071761202492 35.61805523016824, -82.53072861204677 35.617925230142966, -82.53080561210967 35.61760023008464, -82.53088761217505 35.617264230024716, -82.53100561226377 35.616816229945705, -82.53104061228741 35.61670022992575, -82.53107861230455 35.61663022991533, -82.53114861233006 35.61654022990424, -82.53121061235039 35.6164752298974, -82.53127861237093 35.616415229892155, -82.53146561242272 35.61628022988394, -82.53156461245028 35.61620822987939, -82.53177961251191 35.616040229867366, -82.53184061252927 35.61599322986405, -82.53201661258136 35.61584422985188, -82.53267561277985 35.61526622980194, -82.53279161281489 35.61516422979316, -82.53291661285229 35.61505622978402, -82.53297361286945 35.615006229779674, -82.53330061296796 35.614719229754904, -82.5337126130908 35.61436622972542, -82.53383961312484 35.61428222972133, -82.53393861314818 35.61423722972233, -82.53402861316835 35.61420322972472, -82.5341986132038 35.61415622973261, -82.53437061323756 35.614122229743394, -82.53449361326437 35.61408122974768, -82.53457961328529 35.61403822974779, -82.53462261329746 35.61400522974548, -82.53466761331225 35.613958229740604, -82.53471861333334 35.61387622972913, -82.53473761334459 35.61382322972025, -82.53475161335655 35.613761229709134, -82.53477461340377 35.613479229654104, -82.53478961341621 35.613415229642634, -82.53482661344 35.61330022962297, -82.53491861348542 35.61310522959274, -82.5351906136117 35.6125782295134, -82.53535861369278 35.61223322946052, -82.53549461376069 35.61193922941473, -82.53560161382026 35.611668229370544, -82.53565461385016 35.61153122934807, -82.53567761387337 35.61140522932479, -82.53570061391065 35.611188229282995, -82.53570061393823 35.611009229246534, -82.53569361395255 35.61090922922548, -82.53564761397598 35.61070722917968, -82.535563614002 35.610448229118354, -82.53550961401889 35.61028022907858, -82.53550961403063 35.61020422906308, -82.53552561404274 35.61014322905234, -82.53554861405719 35.61007422904067, -82.53558661407516 35.609998229029166, -82.53563961409401 35.60993322902135, -82.53570061411185 35.60988322901742, -82.53579261413589 35.609826229015255, -82.53593761416812 35.60977322901939, -82.53602161418446 35.60975722902482, -82.53610561419909 35.609753229032634, -82.53621961421553 35.60976922904762, -82.53637261423626 35.6097992290694, -82.53643361424345 35.60981822907956, -82.53656961426202 35.60984422909883, -82.53649061424233 35.60988722909952, -82.53635461421757 35.609901229088294, -82.53619661418934 35.609914229074704, -82.53611261417308 35.6099292290691, -82.5360446141576 35.60995622906761, -82.53594461413063 35.6100242290712, -82.5359146141162 35.61008522908052, -82.53591461410907 35.6101312290899, -82.53592161409968 35.61020022910464, -82.5359376140942 35.610253229117035, -82.53596061409147 35.610295229127985, -82.5359986140926 35.6103292291388, -82.53605661409875 35.61035122914929, -82.53610461410398 35.61036922915787, -82.5361976141182 35.61037722916902, -82.53649461416998 35.6103612291963, -82.53658861418492 35.61036522920681, -82.53667861419534 35.610394229221946, -82.53673861420134 35.61042022923344, -82.53697361421933 35.61055622928526, -82.5370076142224 35.610573229292214, -82.53711861423194 35.61063122931541, -82.53727461424897 35.61068822934306, -82.53735661426147 35.61069522935293, -82.53743761428026 35.610661229354356, -82.53749661427196 35.610778229384174, -82.5375146142699 35.61081122939271, -82.53762061426715 35.610943229430454, -82.53768761427065 35.61099222944736, -82.53774561427521 35.61102522946005, -82.53779861428112 35.611044229469364, -82.53787261429135 35.611057229479584, -82.53796861430823 35.611051229488275, -82.53805261432508 35.61103222949305, -82.53810561433802 35.61100522949294, -82.53817261435685 35.610955229489676, -82.53824061437713 35.610897229484884, -82.53828661439513 35.61083022947597, -82.53836061442905 35.610689229454856, -82.53836261443053 35.610682229453595, -82.53842361446328 35.61053522942999, -82.53848861449565 35.610395229408205, -82.53854761452224 35.610286229392095, -82.53858561454554 35.61017622937363, -82.53860161458024 35.60996822933295, -82.5386346146 35.609875229317424, -82.53867861461843 35.60980322930731, -82.53875961464236 35.609735229301705, -82.53883861466149 35.60969622930194, -82.53898261468863 35.60967522931246, -82.53920661472799 35.60966122933264, -82.53927861474209 35.609647229337206, -82.5393296147532 35.60963022933895, -82.53937661476454 35.609607229339076, -82.53947761479253 35.60953422933465, -82.53952861480929 35.609480229328895, -82.53955661482475 35.60941022931745, -82.53960261486064 35.609227229285025, -82.53962961488554 35.60909422926072, -82.53963961490498 35.608979229238344, -82.5396376149193 35.60888422921881, -82.53958561496398 35.60853822914306, -82.539492614998 35.60821722906814, -82.5394796150083 35.608136229050295, -82.53945661501604 35.60806122903269, -82.53942561502156 35.607992229015444, -82.539415615025 35.60795922900771, -82.53940461502914 35.607920228998616, -82.5393936150369 35.6078582289849, -82.53940261504479 35.607816228977285, -82.53942761505323 35.60778922897431, -82.53946061506099 35.60777422897461, -82.53952261507202 35.60776922898002, -82.53958461508137 35.607775228987606, -82.53965961508736 35.60781722900387, -82.53977661508826 35.60793722904031, -82.54002761508272 35.60824322912842, -82.54009561508593 35.608296229146205, -82.5401456150866 35.6083452291613, -82.54013761507728 35.60839722917109, -82.54017961506182 35.60854322920509, -82.5402386150406 35.608744229252025, -82.54027761503224 35.6088402292756, -82.54033761502777 35.6089342293009, -82.54038361502168 35.60902322932376, -82.54040561501148 35.60911322934436, -82.54040961501013 35.609126229347396, -82.54042261499843 35.609216229367014, -82.54042161498249 35.609318229387696, -82.54044061496319 35.60946422941935, -82.5404376149527 35.60952922943225, -82.5403936149298 35.60963022944832, -82.54027761488292 35.60980922947286, -82.540220614863 35.60987722948078, -82.5401346148384 35.60994422948561, -82.5399566147929 35.610047229488266, -82.53988361477175 35.61010622949281, -82.5398546147582 35.610163229501374, -82.53985161475164 35.61020222950902, -82.53985061474849 35.61022122951276, -82.53987761473729 35.61032322953629, -82.53997361472655 35.61049622958142, -82.5400126147212 35.610573229601044, -82.54003461471552 35.61063322961552, -82.5400276147063 35.6106862296256, -82.53995761465359 35.61095222967252, -82.53991661461544 35.61115622970981, -82.53986861457709 35.61135322974503, -82.53982361454929 35.611485229767304, -82.53975361451046 35.61166122979586, -82.53967261447629 35.611796229815035, -82.53958661444628 35.61189822982693, -82.53943261438052 35.61215822986404, -82.53942961437383 35.61219922987206, -82.53944761437212 35.61222922988004, -82.53948861437713 35.61224122988668, -82.53951761438364 35.61223022988742, -82.53954361439158 35.61220622988522, -82.5395786144064 35.61214822987697, -82.53970161445243 35.611982229855876, -82.53986961450434 35.61182622984141, -82.53997061453327 35.61174722983569, -82.54004661455345 35.61169822983352, -82.54011761457318 35.611646229830285, -82.54023161460835 35.611541229820574, -82.54031361463629 35.61144822981012, -82.54034961464824 35.611409229805844, -82.54038561466501 35.61133922979529, -82.5404166146867 35.61123222977673, -82.54047561471619 35.61110422975671, -82.54063061476795 35.61093522973827, -82.54066761478401 35.61087122972902, -82.5406836147951 35.610816229719504, -82.54069261480522 35.610760229708994, -82.54068361481283 35.610701229696126, -82.5406016148181 35.61057822966265, -82.54059961482643 35.610522229651025, -82.54062761484134 35.61045622964046, -82.54063461483736 35.61048922964784, -82.54064261483468 35.610515229653984, -82.54067061483477 35.61054522966302, -82.5407476148373 35.61061122968437, -82.54075761483759 35.610620229687235, -82.5408356148391 35.61069422971032, -82.54090561483693 35.610784229735806, -82.54093161482923 35.610862229754325, -82.54092761481618 35.61094222977023, -82.54086761476589 35.6112042298174, -82.54083061473457 35.6113672298468, -82.54082761472625 35.611418229856824, -82.54082261470968 35.61152022987705, -82.54081761469978 35.611579229888555, -82.54079961466226 35.611803229932285, -82.54077861465136 35.611851229939944, -82.54073561463508 35.61191022994747, -82.5406776146172 35.611964229952534, -82.54062761460432 35.61199322995327, -82.54058761459386 35.61201822995425, -82.54056061458445 35.61205022995803, -82.54054461457443 35.61209822996615, -82.54055461457303 35.61211822997125, -82.54056061457227 35.612129229974016, -82.5406066145772 35.61214722998247, -82.54068761459199 35.61213822998898, -82.54075761460719 35.61211522999151, -82.54129461473484 35.61186522999584, -82.54196761489034 35.61158123000714, -82.54228361496595 35.61143123000912, -82.5425676150376 35.61127223000597, -82.54267361503528 35.61140123004314, -82.54269861503371 35.6114382300532, -82.54278261502812 35.611565230087656, -82.54306761501505 35.611957230196765, -82.54312961501206 35.61204323022064, -82.54319761501056 35.612126230244534, -82.54317561500274 35.612153230247685, -82.54313461498647 35.61221423025595, -82.54309861497204 35.61226923026346, -82.54296561491543 35.612493230295385, -82.54293861490378 35.61254023030214, -82.54291161489198 35.61258723030892, -82.54260061485921 35.61246523025217, -82.54235961483177 35.61238323021067, -82.54223561480863 35.612400230201445, -82.54212861478793 35.61241923019427, -82.54166861469568 35.612522230167976, -82.54062561448595 35.61275923010903, -82.54041161444479 35.61279623009455, -82.54029061442311 35.612806230084125, -82.54017461440513 35.61279823007055, -82.54013561440053 35.61278623006414, -82.53999661438718 35.61272323003697, -82.53993961437814 35.61272023003055, -82.53989261436575 35.61275023003177, -82.53987461435729 35.61278523003707, -82.53987661435058 35.61283123004661, -82.53989061434692 35.61287023005601, -82.53993261435048 35.61289223006481, -82.54003861436466 35.61291423008023, -82.54034261440744 35.612964230121634, -82.54055461443525 35.613012230153174, -82.54074061445735 35.61306923018388, -82.5408036144636 35.61309623019582, -82.54083861446514 35.61312423020521, -82.54087361446479 35.613164230216896, -82.54086661445324 35.61323123022981, -82.54082161443115 35.61332623024456, -82.54074261440277 35.61342523025653, -82.5406826143831 35.613488230263194, -82.5405916143564 35.61356323026916, -82.5405286143393 35.61360623027139, -82.54046361432295 35.613642230272085, -82.54039661430727 35.61367223027126, -82.54028561428575 35.61369223026391, -82.54024561427758 35.613702230261865, -82.5401626142602 35.61372523025801, -82.54003861423368 35.61376423025317, -82.53994561421129 35.61380923025274, -82.53984561418498 35.61387223025529, -82.53971861415052 35.61395923026, -82.53961661412151 35.61403723026534, -82.53953561410158 35.61407923026556, -82.53945961408543 35.61410223026248, -82.53938461407223 35.61410723025573, -82.53928361405545 35.61410723024536, -82.53919461404222 35.61409723023415, -82.53913961403555 35.61408123022531, -82.53911061403328 35.614064230218844, -82.5390966140378 35.61402023020843, -82.53899661401735 35.614045230203274, -82.53886861398561 35.61411323020395, -82.53881661397423 35.614131230202354, -82.53872661395697 35.61414623019607, -82.53864661394091 35.614164230191506, -82.53858561392802 35.61418223018886, -82.5385436139169 35.61420923019005, -82.53851161390402 35.61425823019675, -82.53849861389602 35.61429623020313, -82.53849261388453 35.61436423021634, -82.53850861387804 35.61442323023002, -82.53854561387652 35.61447323024397, -82.53858361387984 35.61449223025178, -82.53861461388533 35.614490230254574, -82.53862861388978 35.614476230253146, -82.53862561389656 35.61442923024327, -82.53859961390677 35.61433523022144, -82.53860161391488 35.61428423021125, -82.53863661392421 35.61426123021024, -82.53868761393305 35.61425923021501, -82.53873961393997 35.614270230222665, -82.53876861393819 35.614313230234345, -82.53877761391566 35.61446923026704, -82.53880361390425 35.614571230290515, -82.53888561387494 35.61484923035545, -82.53893461386657 35.614956230382276, -82.53897361386697 35.61499623039444, -82.53906861387252 35.61506223041759, -82.53918561387647 35.61516223045003, -82.53926961388208 35.615216230469635, -82.53945261389678 35.61531823050926, -82.53959561390694 35.61540623054187, -82.5396496139074 35.61546123055856, -82.53975961390002 35.61562823060392, -82.53981161389723 35.61570223062427, -82.53985461389904 35.615736230635605, -82.53990761390551 35.61575123064417, -82.53999061391993 35.615747230651856, -82.54004761393561 35.61570723064953, -82.54012961396383 35.61561223063858, -82.54019561398994 35.61551423062551, -82.5402576140127 35.61543323061542, -82.54052861411097 35.61508723057285, -82.54063961414363 35.61499523056553, -82.54069561415757 35.61496523056516, -82.54079661417707 35.61494723057184, -82.54089861419565 35.614936230580085, -82.54099861421477 35.61492023058713, -82.54103761421209 35.6149802306034, -82.5410386142119 35.61498223060384, -82.54106161420633 35.61504323061865, -82.54107761419874 35.6151092306337, -82.54108561418819 35.61518623065022, -82.54108461418589 35.61520023065293, -82.54108261417404 35.615275230668026, -82.54107461416359 35.615334230679224, -82.54107161415878 35.61536223068461, -82.54102761412899 35.61550823070977, -82.54101061411724 35.61556623071985, -82.54077561396797 35.61628123084118, -82.54067361391711 35.61650123087548, -82.54066161391201 35.61652123087838, -82.54061961389412 35.61659223088845, -82.54054561386624 35.61669323090141, -82.54045661382713 35.61685123092445, -82.54042661381317 35.616909230933125, -82.54040261378898 35.617040230957365, -82.54040561377823 35.617113230972556, -82.54045861375639 35.617312231018424, -82.54062661370897 35.61780023113506, -82.54066261370114 35.617890231157055, -82.54074561369147 35.61804223119657, -82.54111661365486 35.618679231364325, -82.54118161364579 35.6188082313973, -82.54122261363574 35.618917231423666, -82.54125161362562 35.61901423144635, -82.54129661359654 35.61925123149928, -82.5413066135888 35.61931223151265, -82.54134161356451 35.619507231555986, -82.5413816135078 35.61991823164374, -82.54138461348468 35.62007123167519, -82.54137561347366 35.62013323168692, -82.54134261345601 35.62021223169957, -82.54127761343223 35.62029623170993, -82.54121461340915 35.62037823172023, -82.54110861336714 35.62053623174144, -82.54106161335123 35.62058923174739, -82.54102861333949 35.6206292317522, -82.54095361331767 35.620690231756896, -82.5408986133005 35.62074223176177, -82.54081461327722 35.620803231765656, -82.540604613221 35.62094123177212, -82.54055561320672 35.6209812317752, -82.54051261319279 35.62102523177969, -82.54047961318024 35.62107123178564, -82.5404326131584 35.62116223179936, -82.54041261314508 35.62122723181052, -82.54039161312726 35.621320231827276, -82.54038461311592 35.62138623184004, -82.54037461309632 35.621502231862586, -82.54035361306835 35.621661231892816, -82.54033261305176 35.62174623190801, -82.54033061305043 35.62175223190894, -82.5403026130353 35.62182023192, -82.54026461301935 35.62188323192886, -82.54021961300222 35.62194523193686, -82.54016961298828 35.62198223193919, -82.54015061298286 35.62199723194033, -82.54003561295602 35.62204723193867, -82.53993861293544 35.6220762319346, -82.53973661289668 35.622110231920814, -82.53960461287271 35.622123231909875, -82.53946361284795 35.622132231897176, -82.53937161283115 35.62214223188975, -82.53931661282043 35.62215223188617, -82.53927261281166 35.62216223188361, -82.53920761279585 35.62219423188344, -82.53913061277414 35.62225223188732, -82.53908161275878 35.622299231891894, -82.53907761275671 35.6223082318933, -82.53905961274836 35.62234323189858, -82.53903361273471 35.6224032319081, -82.53902261272259 35.622470231920616, -82.53903161271296 35.62254223193623, -82.53907261270915 35.62261123195449, -82.53913861270654 35.622699231979155, -82.53922861270803 35.62278623200609, -82.53951661271331 35.62306223209192, -82.53964061271358 35.62319423213155, -82.53967461271066 35.62324923214623, -82.53969961270612 35.62330623216036, -82.53971661269887 35.62337123217538, -82.53972761268868 35.62344923219229, -82.53973061268009 35.62350823220464, -82.53972361266023 35.623629232228595, -82.53971061264755 35.62369723224109, -82.53968361263048 35.62377923225503, -82.53947761252675 35.62423023232555, -82.53944061250756 35.62431423233894, -82.53936761247786 35.62442823235463, -82.53930461245571 35.624504232363606, -82.5392526124413 35.62454123236578, -82.5391036124035 35.62462623236773, -82.53889861235794 35.624701232361964, -82.53873561232142 35.624762232357654, -82.53836261223194 35.62494123235565, -82.5383066122211 35.6249512323519, -82.53829661221974 35.624949232350566, -82.53821161220736 35.62493823233959, -82.53814361219999 35.62491223232729, -82.53810361220006 35.624869232314424, -82.53803561218643 35.62488423231045, -82.53796361217185 35.62490123230647, -82.53784461214603 35.62494023230223, -82.53783761214416 35.62494523230247, -82.53781461213707 35.624966232304374, -82.53779561212883 35.6249992323092, -82.53799861215865 35.6250242323352, -82.53860761224786 35.62510123241343, -82.53881161227777 35.62512723243969, -82.53942761236797 35.62520523251891, -82.53961061239667 35.62521623253997, -82.53980161243055 35.62520223255671, -82.53982361243439 35.6252012325588, -82.53991161245345 35.62517223256193, -82.54001361247884 35.625117232561266, -82.54012261250911 35.62503823255638, -82.54073061269183 35.624508232511026, -82.54082061272318 35.62440123249847, -82.5410146128171 35.62400223243727, -82.54108561284566 35.623893232422375, -82.54114961286616 35.6238292324159, -82.54122461288812 35.623767232410984, -82.54163061299259 35.62352723240391, -82.54198661309256 35.62326223238654, -82.5421026131251 35.62317623238099, -82.5424596132217 35.622934232368436, -82.54255561325877 35.622797232350464, -82.54265161331077 35.62256323231265, -82.54265861330079 35.62263523232806, -82.54270861329384 35.62273423235334, -82.54281961328756 35.62289423239728, -82.54288561328836 35.62296023241752, -82.54294361328891 35.623019232435496, -82.5430056132923 35.62306423245101, -82.54310161330109 35.623110232470204, -82.54323161331511 35.62315923249362, -82.54339561333849 35.62318423251558, -82.54346061334932 35.62318423252225, -82.5442396134887 35.623119232589055, -82.5443616135105 35.623109232599646, -82.54449761353213 35.62311523261479, -82.54467661355555 35.62315623264152, -82.54470361355767 35.623171232647415)))",6038,37,021,000500,370210005001,1235,1235,20,1222,1193,10,1,14,0,4,13,1037,15,1022,1027,1004,8,1,11,0,3,10,711,585,126
census_2010_blockgroups_view.fid--2dc29038_13ec899ba8f_-2634,"MULTIPOLYGON (((-82.639770652065 35.475212212271664, -82.63989765208672 35.47520821228391, -82.63993165209257 35.47520721228719, -82.6402616521635 35.475101212299336, -82.64038365218961 35.475063212304065, -82.64055965224317 35.474904212289744, -82.64068665230815 35.4746172122443, -82.64106765241019 35.47436321223153, -82.6421416526978 35.47364921219597, -82.64353665308784 35.47261321212759, -82.64434765331447 35.472012212088146, -82.64479465344967 35.47161321205267, -82.64537065363096 35.47105321199749, -82.64588165381598 35.470398211916404, -82.64596865383794 35.4703492119153, -82.64620065389589 35.47022221191316, -82.64682465405306 35.46987121190544, -82.64714365416712 35.4694722118568, -82.64746365426416 35.469185211831096, -82.64797465435636 35.469137211873594, -82.64824665445275 35.468802211833214, -82.64895065458681 35.46869021188239, -82.6493496546824 35.46849821188409, -82.6500216548624 35.46805121186175, -82.65112365509665 35.46771621190617, -82.65125165516436 35.467412211857415, -82.6516346552937 35.466982211808954, -82.6517116553196 35.466896211799295, -82.65206665543872 35.466502211755355, -82.65235365552788 35.46623121172955, -82.65289765565232 35.46600821173976, -82.65332965573397 35.46594321177065, -82.65358465582025 35.4656562117383, -82.65359565582388 35.46564421173693, -82.6538946558952 35.465502211738716, -82.65412865595084 35.465393211740334, -82.65441665600383 35.46535921176294, -82.65464165604621 35.465326211779136, -82.65480065607296 35.46532421179506, -82.65490765608756 35.465345211810266, -82.65524865613345 35.46541521185938, -82.65566665618321 35.465544211928425, -82.6556896561849 35.465558211933626, -82.65582765619526 35.465640211964406, -82.65621465620552 35.4659942120761, -82.65684065628491 35.46615521217294, -82.65689565628904 35.466188212185266, -82.65729465631847 35.46642921227518, -82.65737365632421 35.466477212293, -82.65763865636488 35.46649921232457, -82.65779865638946 35.466512212343694, -82.65818965645903 35.466482212377514, -82.65856365655343 35.46627121237269, -82.65874865660004 35.46616721237045, -82.6590146566974 35.465819212326785, -82.65915165676878 35.46550121227599, -82.65916265683352 35.46508921219319, -82.65955665693751 35.464837212182175, -82.66050565714053 35.4645402122187, -82.66106165726411 35.46433621223401, -82.66145765737818 35.464020212210116, -82.66149865738971 35.463989212207984, -82.66201665753366 35.46361021218371, -82.66252865769128 35.46313521213936, -82.66249365771971 35.46291121209011, -82.66229765772655 35.462653212017564, -82.66205565771335 35.46247621195671, -82.66145665761417 35.462474211895085, -82.66090765750616 35.4625842118613, -82.66053565744943 35.462551211816525, -82.66042965746085 35.46236121176709, -82.66033865747072 35.462197211724316, -82.66042965755457 35.461747211641956, -82.65991665766317 35.460478211330965, -82.65971565774036 35.45975421116293, -82.65963165777808 35.45941621108548, -82.65970265790254 35.4586782109424, -82.6595046579262 35.45830821084683, -82.65895465789396 35.45792121071177, -82.65874065779764 35.45831921077093, -82.65815765764964 35.458654210779564, -82.65786565763821 35.45841121070016, -82.65782465774667 35.45765621054219, -82.65761865779665 35.45710521040893, -82.65752565781963 35.45685321034811, -82.65772565795342 35.45619521023451, -82.65873665820268 35.45566221022925, -82.65897265829337 35.45532521018475, -82.65901665831235 35.45524921017374, -82.6593096584358 35.45475921010388, -82.65935565845493 35.45468421009327, -82.6595796586436 35.453692209914166, -82.65957965873672 35.45308220978989, -82.6595796587729 35.45284520974168, -82.65969265879349 35.452833209750686, -82.66028865889997 35.4527842098017, -82.66073165894738 35.452956209881975, -82.66170765902153 35.453532210099056, -82.66213565901903 35.45401421024106, -82.66245965901702 35.45438021034874, -82.66340365900278 35.45550021067335, -82.66431565901745 35.45639621094914, -82.66497165903849 35.45697221113355, -82.6654516590913 35.45714821121853, -82.66674765928231 35.45730821138354, -82.66725965931121 35.45767621151089, -82.66823565938779 35.45823621172479, -82.66879565946397 35.45834721180464, -82.66954765957173 35.45845921190429, -82.6695766595757 35.45846521190848, -82.67033165967517 35.458635212020354, -82.67151565978395 35.4592112122587, -82.67183565981517 35.45935521232077, -82.67237965987866 35.45953121241218, -82.67157965965036 35.460155212457636, -82.67106765944317 35.460955212568244, -82.67041165921685 35.46172321265761, -82.67033165906419 35.46263521283524, -82.66985165875478 35.46413921309261, -82.66892365845882 35.46506721318677, -82.66875965838845 35.46534921322746, -82.66868365835543 35.46548321324703, -82.668379658212 35.46609121333985, -82.66829965804958 35.467067213530456, -82.66802765792364 35.46759521361024, -82.6676756577674 35.46823521370466, -82.66773965764851 35.469083213884055, -82.66781965751261 35.47005921409098, -82.66737165728414 35.47106721425059, -82.66716365709797 35.472059214431354, -82.66636365683306 35.472923214525565, -82.66597965671055 35.473307214564535, -82.6659796565956 35.4740592147178, -82.66642765655514 35.47481121491684, -82.66637965643957 35.475515215055346, -82.66626765632068 35.47617121517755, -82.6663956562391 35.47684321532758, -82.66671565619458 35.47748321549069, -82.6668436561278 35.478059215621094, -82.66693965605079 35.478667215754804, -82.66690765597698 35.4791152158428, -82.66631565581984 35.47949921586051, -82.66564365562014 35.48007521590914, -82.665019655443 35.48055521594309, -82.66458765528809 35.481099216009696, -82.66405965506821 35.48196321613175, -82.66389965500743 35.48218721616107, -82.66313165482593 35.48253921615418, -82.66237965462507 35.48303521617832, -82.66213965454854 35.483275216202635, -82.66213565454477 35.483295216206336, -82.66205965446184 35.483755216292266, -82.66175565426943 35.48468321645022, -82.66133965408038 35.48546721656734, -82.66121165397591 35.48601121666513, -82.6611316538525 35.486731216803626, -82.6610516536948 35.48767521698775, -82.66093965359298 35.48821921708718, -82.66079565348835 35.48874721717997, -82.66069965341609 35.48911521724515, -82.66031565327638 35.48961121730688, -82.66013965318588 35.49001121737038, -82.66079565313585 35.49105121764943, -82.661595653215 35.49140321780298, -82.66295665332359 35.49217121809878, -82.66318465332765 35.49239321816727, -82.66354865333405 35.49274721827668, -82.66438065339389 35.4932592184661, -82.66506865342262 35.49381921865058, -82.66542065333915 35.494747218875666, -82.66562865328314 35.4953392190176, -82.66596465325578 35.495883219162806, -82.66633265324354 35.49636321929831, -82.66679665326676 35.49671521941747, -82.66745265330978 35.49714721957264, -82.66809265335004 35.49757921972609, -82.66834865334862 35.497867219811035, -82.66905265336524 35.49852322001669, -82.66998065340442 35.49927522026494, -82.670844653411 35.50017122053595, -82.67103665338406 35.50055522063381, -82.67126065338462 35.50079522070562, -82.67127565338195 35.50082922071405, -82.67142065335742 35.501147220793754, -82.67183665333108 35.50177122096348, -82.67186865330703 35.501963221005845, -82.67164465316448 35.502651221123074, -82.6716446531106 35.503003221194874, -82.67182065298805 35.50399522141497, -82.67151665285662 35.504523221491525, -82.67149065285629 35.50449722148355, -82.67141365285529 35.50442022145994, -82.67138865285496 35.50439522145233, -82.671348652775 35.50487422154578, -82.67132465272678 35.50516322160228, -82.67132465268756 35.50541922165444, -82.67126065261824 35.50580322172611, -82.6716626526371 35.50611622183101, -82.67204365265516 35.506412221930375, -82.67181365256673 35.50674022197368, -82.67110365239873 35.50706622196741, -82.67055265225335 35.50741722198255, -82.67057765224517 35.50749822200163, -82.6706526522215 35.50773422205741, -82.67120665228423 35.507926222153245, -82.67120865224092 35.50821122221146, -82.67047165207526 35.508493222193565, -82.66976865193226 35.508663222156166, -82.66954565184324 35.50900322220265, -82.66961465182023 35.50922822225557, -82.66995465189004 35.509141222272625, -82.67028265197617 35.50893522226423, -82.67063365202145 35.50902022231752, -82.67111365210404 35.50900222236291, -82.67182565223195 35.508940222423135, -82.67194865222926 35.50909122246658, -82.67200465222803 35.509160222486344, -82.67124065188811 35.5105502226914, -82.67107165183246 35.51073022271079, -82.67085765175044 35.51103422275087, -82.67060365165277 35.51139622279858, -82.67040665157741 35.51167422283509, -82.67023465150498 35.5119602228758, -82.67004465142443 35.51228022292151, -82.67016265144342 35.512284222934376, -82.67027065146057 35.51228922294648, -82.67045365149106 35.5122892229652, -82.67051765149951 35.512303222974566, -82.67054965150383 35.51231022297929, -82.67059165150522 35.51234622299095, -82.6706136515056 35.51236822299772, -82.67063265150585 35.51238722300345, -82.67067865150625 35.512434223017806, -82.67068765150582 35.51244722302138, -82.67070465150519 35.51246922302756, -82.67072065150454 35.51249122303372, -82.6707696515024 35.51255822305241, -82.67078365150108 35.512582223058686, -82.67081565149805 35.51263622307296, -82.67084365148912 35.51272522309397, -82.67084265148296 35.5127642231018, -82.67084165147523 35.5128142231119, -82.67083065146083 35.51289622312747, -82.67080465143796 35.5130172231495, -82.67074465137883 35.5133382232087, -82.67074365137802 35.51334222320947, -82.67072465134501 35.51353722324728, -82.67072065133645 35.51358922325747, -82.67071065132542 35.51365022326882, -82.67066065126507 35.51399022333302, -82.67064465124483 35.514104223354586, -82.67061765121238 35.514287223389104, -82.67061665121071 35.514297223391075, -82.67061665120039 35.514364223404726, -82.67062865116768 35.51459122345219, -82.67064965115864 35.51467222347091, -82.67067965115017 35.51476022349185, -82.67071365114538 35.514829223509395, -82.67071665114509 35.51483422351074, -82.67075865114373 35.51488822352603, -82.67079765114357 35.51493222353902, -82.67083165114286 35.514973223550825, -82.67081465114015 35.514973223549084, -82.67070265111842 35.51499322354174, -82.6706826511145 35.514997223540455, -82.67054265108659 35.51502722353221, -82.67032365104203 35.515080223520634, -82.67027965103308 35.515091223518354, -82.67019865101607 35.51511422351482, -82.67012965100169 35.515133223511576, -82.6700156509763 35.51517522350842, -82.66999365097122 35.51518422350806, -82.66989265094661 35.51523522350808, -82.6697756509154 35.51531222351178, -82.66967565088575 35.51539722351888, -82.66955565084743 35.515517223531106, -82.6694226508046 35.51565222354495, -82.66942065080404 35.515654223545205, -82.66940565079939 35.515668223546456, -82.66936465078564 35.51571322355143, -82.66935065078103 35.515728223553054, -82.66911565070417 35.51597522357937, -82.66910965070186 35.51598322358036, -82.66895365064795 35.51616622360168, -82.66886365061166 35.51630522362082, -82.66876265056628 35.516492223648605, -82.66859065048338 35.51684622370312, -82.66849865043852 35.517039223733015, -82.66844665041356 35.517146223749464, -82.66844365041182 35.51715422375085, -82.66837665037355 35.51733122378, -82.66835065035357 35.5174332237982, -82.66833165033862 35.51751022381189, -82.66830465030677 35.51768922384564, -82.6682886502709 35.51790622388822, -82.66828265025457 35.51800622390796, -82.66826665020503 35.51831222396865, -82.66825165015737 35.51860722402725, -82.6682496501438 35.51869322404455, -82.6682456501044 35.5189462240957, -82.66824565010332 35.518953224097146, -82.66825365009132 35.519040224115706, -82.66827365006675 35.519222224154824, -82.66828565005741 35.519296224171114, -82.66837664999237 35.519820224287216, -82.66840764996046 35.52006222433967, -82.66840764996007 35.52006422434014, -82.66843064992521 35.52031722439404, -82.66843064992437 35.52032222439507, -82.66843664991042 35.52042022441566, -82.66844164989973 35.52049522443147, -82.66845264986789 35.52071522447736, -82.66845864985373 35.52081422449821, -82.66722264966145 35.520727224353955, -82.66649164950425 35.52096022432652, -82.66076064827016 35.52279522411364, -82.6588506478589 35.523407224042764, -82.65864364781544 35.523466224033605, -82.6580236476852 35.52364322400615, -82.65781764764174 35.523703223997295, -82.65708264748173 35.52395022397239, -82.65685164743157 35.524027223964396, -82.65524464708164 35.52456722390983, -82.65487864700181 35.52469122389761, -82.65414464684169 35.52493922387293, -82.65400964681135 35.52499122386973, -82.6538586467772 35.52505022386632, -82.65363364671688 35.52519922387362, -82.65351364668469 35.52527922387763, -82.6527796464724 35.52586822392241, -82.65058164583598 35.527636224057574, -82.64984864562378 35.52822622410266, -82.64878864532726 35.529011224154075, -82.64700864482882 35.53033222424085, -82.64699064482365 35.53034622424181, -82.64614064459406 35.530922224272075, -82.64556764443935 35.531310224292454, -82.64447564414434 35.53205022433135, -82.64435364411166 35.532131224335345, -82.64292364372605 35.533096224385396, -82.64278864368946 35.53318822439033, -82.64199564347547 35.533724224418265, -82.6394966428011 35.53541322450629, -82.63775264233091 35.536589224567194, -82.6356396417608 35.538016224641375, -82.63498164158317 35.538461224664594, -82.63455764146892 35.538747224679454, -82.63410964134782 35.53905122469545, -82.63370064122975 35.539377224719935, -82.63318864109638 35.53969222473159, -82.63289864101286 35.53992222474875, -82.63256364092483 35.54013322475741, -82.63236064087305 35.54025122476063, -82.63206064080397 35.540376224755384, -82.631288640734 35.53999622459887, -82.63045164065839 35.539582224428706, -82.63027464064244 35.539494224392676, -82.62988864060897 35.539294224312385, -82.62943864057289 35.5390422242149, -82.62911664054924 35.53884722414221, -82.62882564053002 35.53865722407365, -82.6283396405012 35.538319223955035, -82.62798664048366 35.53805122386432, -82.62769264047269 35.53780422378384, -82.62738964046306 35.537538223698604, -82.6273226404612 35.5374782236795, -82.62724664045913 35.537409223657654, -82.62712664045657 35.53729622362233, -82.62706264045522 35.53723522360335, -82.62697264045346 35.537149223576655, -82.62670264044789 35.536893223496776, -82.62661364044615 35.53680822347039, -82.62646264044331 35.53666322342533, -82.626397640442 35.536601223406144, -82.62617464043743 35.53638922334005, -82.62600764043395 35.53623122329072, -82.625856640431 35.53608722324598, -82.62574764042861 35.53598422321377, -82.62542064042174 35.535675223117316, -82.62531264041941 35.5355732230855, -82.62516764041645 35.53543522304253, -82.62491964041165 35.53519822296884, -82.62473464040801 35.535021222913855, -82.62459064040529 35.534883222871024, -82.62456964040476 35.5348632228648, -82.62450864040352 35.53480522284667, -82.62448864040313 35.53478622284078, -82.6243436404002 35.53464822279778, -82.62390864039098 35.53423722266953, -82.62376464038815 35.53410022262689, -82.62373564038762 35.534072222618214, -82.62369864038682 35.53403722260725, -82.62364864038575 35.5339902225925, -82.6236206403852 35.5339632225842, -82.62345464038182 35.53380522253504, -82.62295964037199 35.533333222388165, -82.62279764036899 35.53317722233973, -82.62277264036841 35.5331542223325, -82.62275264036862 35.53313122232574, -82.62256164036307 35.532960222271335, -82.62221064035401 35.53263922216998, -82.62200464034602 35.53246822211409, -82.62167664033196 35.53220422202671, -82.62147564032206 35.5320512219749, -82.62135364031555 35.53196122194415, -82.62120864030679 35.531861221908926, -82.62097364029218 35.53170222185242, -82.62087464028596 35.531635221828665, -82.6205606402642 35.53143722175607, -82.62025264024076 35.53125622168771, -82.62000964022221 35.531114221633864, -82.61998064022018 35.531096221627266, -82.61997564021966 35.5310942216263, -82.61989164021269 35.53104822160838, -82.61986264021023 35.53103322160231, -82.61946364017764 35.53081322151665, -82.61941964017406 35.53078922150725, -82.6182726400815 35.530150221259554, -82.61787664004959 35.52992922117395, -82.61750364001958 35.52972122109341, -82.61748364001788 35.5297102210891, -82.61709563998545 35.52950122100675, -82.61687963996603 35.529394220962814, -82.61644063992539 35.52918322087485, -82.61636163991784 35.52914722085942, -82.6161656398988 35.52905922082147, -82.61597163987894 35.52897822078509, -82.61591563987334 35.52895422077448, -82.61541563981899 35.528767220685104, -82.61496563976836 35.52861022060704, -82.61488863975947 35.52858422059391, -82.61447763970992 35.52846222052686, -82.6140806396613 35.52834922046319, -82.61342363957955 35.528171220359624, -82.6118726393866 35.52774922011472, -82.61084063925826 35.52746821995169, -82.61068963923965 35.52742621992766, -82.6102366391833 35.52730321985625, -82.61008663916466 35.527262219832515, -82.6098506391353 35.5271982197954, -82.60950263909187 35.52710421974051, -82.60914263904712 35.52700621968367, -82.60890663901758 35.52694321964667, -82.60868463899004 35.52688221961145, -82.60801963890772 35.52669921950607, -82.6077986388802 35.526639219471114, -82.60757563885235 35.52657921943613, -82.60695763877533 35.52641221933879, -82.60690863876859 35.526403219331925, -82.60685363876088 35.52639421932451, -82.60667963873117 35.52639921930761, -82.60668663874993 35.52628421928492, -82.6066876387566 35.5262422192765, -82.60669663878525 35.52606521924132, -82.6067216388341 35.52577321918449, -82.60673163885134 35.52567221916495, -82.60673463886027 35.52561721915402, -82.60675063890459 35.52534521910028, -82.6067756389678 35.52496021902443, -82.60678363901876 35.52463621895932, -82.6067816390346 35.5245312189377, -82.60677963907582 35.524260218882304, -82.60677863909237 35.524151218859984, -82.60677563914196 35.52382421879312, -82.60677563914231 35.52382221879271, -82.60679163916106 35.523717218773015, -82.60680063917007 35.52366821876396, -82.60680263917725 35.52362321875489, -82.60680563918038 35.523606218751816, -82.60681663918956 35.52355821874315, -82.60680163923104 35.523271218683234, -82.60679663924726 35.52316021866011, -82.60679463924943 35.523144218656654, -82.60679063925562 35.52309921864709, -82.60678963925777 35.52308421864392, -82.6067816392667 35.5230172186294, -82.60675863929367 35.52281621858615, -82.6067516393028 35.52274921857179, -82.60673863931906 35.52262921854604, -82.60673263932742 35.52256821853297, -82.60668263936465 35.522271218467424, -82.60666363937962 35.52215321844137, -82.60665063938954 35.52207421842403, -82.60663963939628 35.522018218411404, -82.60657763943385 35.52170621834155, -82.60655563944357 35.5216192183216, -82.60652263945826 35.52148721829133, -82.606494639471 35.52137421826547, -82.60647063948166 35.52127821824346, -82.6064056395076 35.521038218187904, -82.6063756395197 35.520927218162264, -82.6063586395261 35.52086721814828, -82.60635563952715 35.52085721814596, -82.60629463954703 35.520661218099754, -82.60623363956466 35.52048021805668, -82.60615063958839 35.52023521799825, -82.60598163963029 35.51977921788808, -82.60576663967382 35.51926221776083, -82.60572563968118 35.51917021773795, -82.6055816397066 35.51884821765762, -82.60553063971388 35.518745217631356, -82.60542863972874 35.518538217578744, -82.60529663974735 35.518273217511265, -82.60515863976543 35.51800621744271, -82.60502963977792 35.51778521738459, -82.60479263979644 35.51740721728334, -82.60463263980733 35.517163217217224, -82.60421263983109 35.51655321705004, -82.60406963983738 35.516357216995495, -82.60401963983959 35.516288216976236, -82.60386663984457 35.516090216920254, -82.60313363985837 35.51520621666514, -82.60279963986362 35.51481021655031, -82.6027566398643 35.514759216535516, -82.60262963986673 35.51460621649134, -82.60258763986751 35.51455521647667, -82.6023066398727 35.51421721637904, -82.60183663988124 35.513652216215846, -82.60147263989009 35.51320021608658, -82.60134763989313 35.51304521604219, -82.6012046398987 35.51285321598839, -82.60118363989972 35.5128242159804, -82.60112363990295 35.512738215956716, -82.60110363990388 35.51271021594897, -82.60099563991032 35.51255121590552, -82.60075463992482 35.5121962158086, -82.60067463992986 35.512076215775906, -82.60063163993271 35.5120112157583, -82.6005716399373 35.511916215732754, -82.60056063993824 35.51189821572802, -82.60052763994103 35.511844215713644, -82.60051663994182 35.51182721570903, -82.60034463995719 35.511540215633, -82.60012363998136 35.51114321552949, -82.60007463998747 35.511050215505534, -82.60002763999343 35.51096021548236, -82.59961464005181 35.51013221527154, -82.5994686400705 35.50985221519956, -82.59938364008185 35.5096862151571, -82.59916164010922 35.509267215049, -82.59893864013056 35.50888621494854, -82.59874364014335 35.50859121486851, -82.59856764014596 35.508383214808134, -82.59833164014388 35.50814121473472, -82.59810464013873 35.50792921466828, -82.5978726401318 35.507723214602606, -82.59758864012153 35.507482214524444, -82.59740564011507 35.50732621447396, -82.59722664011099 35.50715921442167, -82.59710764010974 35.50703821438474, -82.59705764010927 35.506987214369275, -82.5968986401115 35.50680021431487, -82.59674164011729 35.50659221425648, -82.59659864012498 35.50638721420004, -82.59607164016518 35.50555421397652, -82.5959936401716 35.50542821394282, -82.59565164019996 35.504872213794606, -82.59583564032212 35.50427421369172, -82.59619664046369 35.50374121362021, -82.59622064046923 35.50373121362061, -82.59696764063607 35.503451213640155, -82.59724664076896 35.502886213553715, -82.59807764097727 35.502427213545324, -82.59851064105447 35.50239221358257, -82.59880364109695 35.50243221362078, -82.59911264114245 35.50247021366013, -82.59929564117505 35.502455213675795, -82.5995766412253 35.502432213699905, -82.59968364124427 35.502424213709226, -82.5996596412723 35.502215213664286, -82.59939364125646 35.50203021359933, -82.5992556412689 35.501799213538185, -82.59901764127582 35.50149621345211, -82.59909864128939 35.50149521346021, -82.59921664131048 35.501486213470514, -82.59932364133557 35.50143821347168, -82.59941064135825 35.501384213469564, -82.59949964138711 35.501292213459934, -82.599560641408 35.50122221345193, -82.59971364144543 35.50114321345155, -82.5999646414981 35.50107121346257, -82.600007641507 35.50106021346475, -82.60042264157957 35.50103621350235, -82.60065964161909 35.50103521352647, -82.60106464167698 35.50109521358017, -82.60146264172886 35.50118821363984, -82.60174364176713 35.50124321367984, -82.60195964180052 35.50125921370519, -82.60221764185148 35.501206213720856, -82.60249364191229 35.50110821372917, -82.60274864197146 35.50099821373286, -82.60291664201372 35.50090421373094, -82.60302564205328 35.500764213713616, -82.60303764205754 35.500749213711785, -82.60310364209319 35.50058821368576, -82.60311664212338 35.500405213649834, -82.60309664213938 35.500279213622136, -82.60308664216039 35.50013121359101, -82.60307364217181 35.50004221357149, -82.60307664218352 35.49996921355695, -82.60309064219547 35.499906213545636, -82.60314064221393 35.49984021353724, -82.60322164223902 35.49976421353008, -82.60289464225659 35.49929521340118, -82.60242364222566 35.49898621328992, -82.60269064227738 35.49893821330748, -82.60305764234978 35.49886321332983, -82.60346964245689 35.498610213320596, -82.60368764251592 35.4984612133125, -82.60386164256275 35.49834421330651, -82.603930642675 35.49768621317962, -82.60408564275336 35.497342213125485, -82.60485364303383 35.49634321300069, -82.60481864305696 35.49615421295862, -82.6047216431652 35.49534221278341, -82.60522964328028 35.49514121279447, -82.60589064352614 35.49425221268115, -82.6063006436391 35.49395921266347, -82.60674164373543 35.493808212677955, -82.60702264376172 35.49394121273377, -82.6073266438101 35.49395421276756, -82.60781164390632 35.49385221279644, -82.60814064396592 35.49381921282343, -82.60833264400063 35.49380121283938, -82.60870964407098 35.49375021286764, -82.60896664410663 35.49379621290336, -82.60946164415724 35.49400221299591, -82.60982164417165 35.49429821309312, -82.61019364418262 35.494630213198725, -82.61037664420317 35.49469421323054, -82.61060564424102 35.49469521325419, -82.61066464425284 35.494682213257576, -82.61075264427011 35.49466521326309, -82.61086764429885 35.49460221326209, -82.61091964433157 35.494444213235234, -82.61089564436648 35.49419021318105, -82.61083364438964 35.493972213130334, -82.6107786444102 35.49377821308516, -82.61081264442807 35.49369821307233, -82.61074264445979 35.49341521300757, -82.61105264460039 35.49283321292087, -82.6110696446075 35.49280521291687, -82.61139464473901 35.49229821284692, -82.61210064494256 35.49173421280433, -82.61263464507395 35.491455212802194, -82.61340864521311 35.4913852128672, -82.61347464522551 35.49137621287214, -82.61386564529805 35.49132621290202, -82.61444964538157 35.49141421297971, -82.61445564533153 35.49174721304818, -82.61454364532305 35.49189821308785, -82.6147176453218 35.49209521314578, -82.61474464529698 35.492286213187505, -82.61476864527644 35.49244721322274, -82.61448564512423 35.49313421333365, -82.61427964496329 35.493962213481126, -82.61386964473301 35.49502121365476, -82.61375664466897 35.495317213703544, -82.61411964464699 35.495854213850016, -82.61459664477995 35.495503213827405, -82.61473164481754 35.495404213821, -82.6151716449417 35.49507021379807, -82.61600064517275 35.49446021375877, -82.61602264517924 35.49444221375732, -82.61635364527226 35.494193213740566, -82.61649364531232 35.49408321373248, -82.616498645314 35.49407821373196, -82.6165136453183 35.49406621373105, -82.61651964531985 35.49406221373079, -82.61807864567064 35.4934622137683, -82.61832864574336 35.4932582137523, -82.61928264602008 35.492485213692625, -82.62297364709121 35.48949121346073, -82.62404564740204 35.48862321339381, -82.62452264754047 35.48823621336378, -82.62489264759813 35.48826121340678, -82.62511564763284 35.48827621343262, -82.62586264775247 35.48830521351502, -82.62600564777543 35.48831021353064, -82.62637764783481 35.48832621357201, -82.62702164796957 35.48814421360087, -82.62760864809219 35.48798021362751, -82.6283306482453 35.487763213657196, -82.62889364838723 35.48744621365028, -82.62890264838938 35.48744221365037, -82.6294346485374 35.4870522136254, -82.62969064864356 35.486636213566854, -82.62968564865562 35.486552213549274, -82.6296586487386 35.485980213430054, -82.62937064882055 35.48513221322782, -82.62927764884013 35.48490321317165, -82.62909864887814 35.48446021306314, -82.62901864887219 35.484412213045175, -82.63017964914326 35.48390121305994, -82.63072264926971 35.48366421306728, -82.63204664957844 35.48308321308445, -82.63239464970478 35.48263521302883, -82.63287164979789 35.48254421305911, -82.63318964988521 35.482318213045666, -82.63350164995144 35.48222421305839, -82.63471865020874 35.48186321310938, -82.63482265023283 35.48181921311111, -82.63513765030537 35.481687213116466, -82.63524265032932 35.481644213118415, -82.63522665035605 35.48145221307769, -82.63484265036571 35.48097221294066, -82.63465065039745 35.480556212836305, -82.63484265048805 35.4801722127777, -82.63490765050632 35.48012321277442, -82.63516265057785 35.479932212761604, -82.63548265072156 35.47934021267376, -82.63596265087962 35.478828212618616, -82.63661865107662 35.47825221256838, -82.636826651214 35.477580212452814, -82.63724265132957 35.47727621243343, -82.6378506515602 35.47642821232294, -82.63824465167282 35.4761192123003, -82.6383626517064 35.47602821229386, -82.639770652065 35.475212212271664)))",6432,37,021,002302,370210023023,2686,2686,101,2654,2558,12,14,18,2,50,32,2133,69,2064,2119,2052,5,13,14,2,33,14,1232,1126,106
census_2010_blockgroups_view.fid--2dc29038_13ec899ba8f_-2633,"MULTIPOLYGON (((-82.51858562034482 35.55094621526749, -82.51898162046932 35.55056321523025, -82.51950762063446 35.550056215181144, -82.51993362075702 35.54971821515606, -82.52026362084037 35.54953221515211, -82.5202836208452 35.549522215152116, -82.52077762095598 35.54933421516455, -82.52069462090562 35.54957221520451, -82.5206576208843 35.54967121522083, -82.52028862066788 35.550681215388416, -82.52016662059587 35.5510182154444, -82.52023462060869 35.55100821544939, -82.5202986206217 35.550992215452695, -82.52035362063505 35.550965215452884, -82.52040062065143 35.550909215446275, -82.52050162069669 35.55072321541878, -82.52058562073817 35.55054421539105, -82.52058962074072 35.55053221538896, -82.52068062078789 35.55032321535585, -82.52075162082792 35.55013921532564, -82.5208826209062 35.54977121526429, -82.52091662092882 35.54966121524537, -82.52099262096 35.54954021522856, -82.52107762098854 35.5494462152182, -82.5211746210164 35.549369215212444, -82.52128862104655 35.549296215209274, -82.52145462108899 35.549199215206606, -82.52175062116277 35.549038215204256, -82.52182362118072 35.54900021520405, -82.52194562121056 35.548938215203975, -82.5224296213321 35.548669215198856, -82.52261462137679 35.548578215199385, -82.52280362141963 35.5485032152035, -82.52285062142846 35.54849621520693, -82.52300062145616 35.54847821521863, -82.5231646214795 35.54850321524057, -82.52332062149992 35.54853821526371, -82.52350362152096 35.54859921529494, -82.52374162154612 35.548692215338214, -82.52398962157388 35.54877921538136, -82.52416762159598 35.54882721540947, -82.52460962165053 35.5489492154796, -82.5247646216689 35.54899721550528, -82.52485262167913 35.54902521552002, -82.52512362171203 35.549103215563704, -82.52523362172597 35.5491312155807, -82.52526162172961 35.54913821558498, -82.52532562173923 35.54914421559279, -82.52539362174797 35.54916121560324, -82.5253866217372 35.54922321561512, -82.52536962170532 35.549412215651884, -82.52536362169451 35.54947621566424, -82.52534762166735 35.54963621569513, -82.52530362158608 35.55011721578852, -82.52529662157156 35.55020421580548, -82.52528362155816 35.55027721581902, -82.52524962152191 35.55047621585596, -82.52515762145919 35.550785215909364, -82.52508062140582 35.551049215955175, -82.52494862132875 35.55140821601468, -82.52474062118085 35.552146216143484, -82.5247036211521 35.5522932161696, -82.52457962105319 35.5528032162606, -82.52450162099429 35.553102216313434, -82.52431362085196 35.55382521644125, -82.52428362083344 35.553913216456024, -82.52426062081652 35.55399821647096, -82.52418062075726 35.554297216523594, -82.52414462073055 35.5544322165474, -82.5240836206642 35.55479821661552, -82.52404562062209 35.55503121665905, -82.52403462059554 35.55519221669071, -82.52404362057767 35.555318216717296, -82.52406462055438 35.55549221675483, -82.52409562053082 35.555679216796065, -82.52412962051028 35.55584921683414, -82.52419262049436 35.556020216875375, -82.5242346204806 35.556155216907115, -82.52430062047159 35.55628521694036, -82.52430762047076 35.55629821694373, -82.52442862045724 35.5565162170005, -82.52448462044953 35.55662721702884, -82.52453762044674 35.55670221704957, -82.52455662044608 35.5567272170566, -82.52487262049415 35.55675521709476, -82.5253126205612 35.556794217147846, -82.52758362090685 35.55699521742183, -82.52834162102218 35.55706221751336, -82.52868062107387 35.55709221755424, -82.52898362112055 35.55711521759005, -82.52902462112688 35.55711821759484, -82.53068362137947 35.557265217795084, -82.53107262143885 35.55729821784172, -82.53175662154324 35.557357217923936, -82.53201462158263 35.55737921795491, -82.53229762162577 35.55740421798908, -82.53278862170052 35.55744721804824, -82.53304762173987 35.55747121807967, -82.53319862176285 35.5574842180978, -82.53331562178056 35.557495218112095, -82.53365462183224 35.557525218152946, -82.53380762185543 35.55753921817156, -82.53840162248508 35.55840021881835, -82.53849362249724 35.55842021883189, -82.53854662250434 35.558431218839495, -82.53853762248765 35.55853021885876, -82.5385536224839 35.558572218868974, -82.53860562247212 35.55870421890111, -82.53867062245897 35.558860218939536, -82.53870762245434 35.55893021895763, -82.53874662244962 35.55900321897642, -82.53935062241216 35.55989821922057, -82.53960962240919 35.56019721930804, -82.53994562240545 35.56058421942129, -82.54039462240158 35.5610932195709, -82.5406036223999 35.5613302196406, -82.54065562239892 35.561392219658536, -82.54072862239528 35.561495219687004, -82.54146062236543 35.562479219962405, -82.54150962236409 35.56254021997982, -82.54169762235382 35.56281022005407, -82.54175262235096 35.56288822007563, -82.54189762234002 35.563115220136744, -82.54219562232925 35.56350722024704, -82.54226762232429 35.56361722027679, -82.54236762231781 35.563767220317615, -82.5424386223093 35.56389922035173, -82.54248562230386 35.56398522037409, -82.54249162230268 35.56399922037752, -82.5425446222937 35.564115220406556, -82.54262462228046 35.56428722044987, -82.5427756222393 35.56471822055305, -82.54280662223327 35.56479022057085, -82.54290362221522 35.565012220626016, -82.5429806222001 35.565194220670904, -82.54301262219404 35.565268220689305, -82.54319162214958 35.56575022080572, -82.54326062213244 35.56593622085068, -82.54331462211894 35.56608222088595, -82.54347762207863 35.56652022099181, -82.54353262206517 35.56666722102736, -82.54357562205446 35.5667832210554, -82.54370462202182 35.56713422114007, -82.54374762201097 35.5672512211683, -82.54391862204548 35.56721122117771, -82.54440962214447 35.567097221204875, -82.54443062214918 35.56708922120539, -82.544596622186 35.56702922121034, -82.54477562219577 35.567159221255096, -82.54482562219948 35.56718822126611, -82.54494462220882 35.567256221292176, -82.5452246222348 35.56738922134809, -82.54558262226936 35.56755122141773, -82.54572362228271 35.56761622144545, -82.54583762229369 35.56766822146774, -82.54576762226714 35.56776522148027, -82.54555762218753 35.56805622151787, -82.54548762216093 35.568153221530444, -82.54535962214162 35.5681412215149, -82.54519562211681 35.56812522149478, -82.54432162198506 35.56803922138754, -82.54403062194109 35.56801122135202, -82.54381362190986 35.56798022132346, -82.5434456218567 35.56792822127506, -82.54316362181483 35.56789622123958, -82.54294662178246 35.567873221212594, -82.54230762169597 35.56774622112114, -82.54213462167061 35.56772422109892, -82.54196262164533 35.56770322107699, -82.5417616216174 35.56766822104926, -82.5414966215836 35.56760122100842, -82.54116862154375 35.5675072209556, -82.54079262150582 35.56734822088465, -82.54040462147155 35.56715222080493, -82.54017162145439 35.56701222075246, -82.54006862144693 35.56695022072926, -82.53997162143936 35.56689422070793, -82.53985362143031 35.566826220681975, -82.53979062142542 35.5667902206682, -82.53952362140507 35.56663422060903, -82.53912462136846 35.56644222052904, -82.53902862135698 35.56641322051327, -82.53874062132257 35.56632622046594, -82.53864562131123 35.566297220450295, -82.53849062129432 35.566240220422785, -82.5380256212434 35.56606922034022, -82.53787162122653 35.56601322031308, -82.5372536211592 35.56578422020303, -82.53629262105213 35.565444220035126, -82.53579062099709 35.56526021994613, -82.53502662091344 35.56498021981078, -82.53454262086146 35.56479621972361, -82.53406462080629 35.564639219642515, -82.53364662075714 35.56450821957301, -82.53321862070024 35.56441621951031, -82.53276962063362 35.56436521945391, -82.5322246205491 35.56432721939018, -82.53151962043758 35.564292219310616, -82.53131162040461 35.564282219287286, -82.53056562029096 35.56421621919724, -82.5297756201787 35.564094219091324, -82.52931762011585 35.564009219026964, -82.52906062008049 35.563962218991044, -82.52838661998712 35.56384221889736, -82.5278436199157 35.56372121881704, -82.52716361983394 35.56351921870608, -82.52654061976524 35.56329421859635, -82.5260806197194 35.563096218508775, -82.5259356197049 35.563034218481306, -82.52504261961643 35.56264621831068, -82.52464361957702 35.56247221823436, -82.52417861952613 35.56230221815198, -82.52365661946462 35.56213921806519, -82.52316561940286 35.5620112179888, -82.52280161935407 35.56193621793616, -82.52259261932593 35.56189321790592, -82.52212061926313 35.561793217837106, -82.52166261920053 35.561706217772304, -82.52111361912529 35.56160321769503, -82.5202986190136 35.561451217580384, -82.51997261897023 35.56138121753269, -82.5197736189456 35.56132721750124, -82.51963161892846 35.561285217478144, -82.51948461891237 35.56123121745204, -82.51942961890643 35.5612112174424, -82.51919961888444 35.56110621739741, -82.5189846188672 35.56098621735089, -82.51883561885911 35.56087821731362, -82.51868961885087 35.56077421727749, -82.5185486188475 35.560644217236536, -82.51837461884477 35.560474217184094, -82.51833961884547 35.560432217171964, -82.51827361884688 35.560351217148735, -82.51818761885148 35.56022921711501, -82.51803861886494 35.5599812170493, -82.5179176188804 35.55975021698985, -82.51784461889974 35.55954521694063, -82.51775561892882 35.559260216873575, -82.51770861896455 35.55897721681112, -82.51770161899238 35.558789216772226, -82.51767361910458 35.55802921661473, -82.5176716191141 35.557965216601474, -82.51763261922844 35.55717921643757, -82.51762561924794 35.55704521640961, -82.51761261928708 35.556776216353576, -82.51760861929847 35.55669821633723, -82.51760561930597 35.55664621632641, -82.51759961932544 35.55651321629871, -82.51759761933494 35.55644921628546, -82.51757961943959 35.55574921614119, -82.51756261954435 35.55504921599715, -82.51752161961826 35.55452421588607, -82.51751561962918 35.55444721586981, -82.51752161967276 35.55417021581408, -82.51754661977341 35.553542215688935, -82.51755061978658 35.55346121567279, -82.51757061984416 35.55310821560304, -82.51759961991185 35.55269921552289, -82.51761761996428 35.552377215459224, -82.51763961998229 35.55228421544254, -82.51768662001929 35.55209421540867, -82.51776662006665 35.55187221537177, -82.5179156201266 35.55164321534045, -82.51808862018589 35.55144421531774, -82.51824062023412 35.5512942153028, -82.51828262024732 35.551253215298836, -82.5182916202504 35.5512432152977, -82.51858562034482 35.55094621526749)))",6168,37,021,002000,370210020003,778,778,72,741,407,293,2,9,0,30,37,635,52,583,621,358,231,2,8,0,22,14,289,255,34
census_2010_blockgroups_view.fid--2dc29038_13ec899ba8f_-2632,"MULTIPOLYGON (((-82.37903558965495 35.60017321092502, -82.3792295896827 35.60020121095067, -82.37934058969864 35.60021721096537, -82.37981058976398 35.60029721102998, -82.38000458979076 35.60033121105685, -82.38000458978452 35.60037221106523, -82.38004258976186 35.600559211107075, -82.38005858975264 35.60063621112436, -82.38009858975408 35.6006692111352, -82.38039458978778 35.6007682111858, -82.38061458980476 35.60089421123406, -82.38071058981214 35.60094921125515, -82.38076458981257 35.60100421127185, -82.38077658980771 35.60104821128205, -82.38103458984784 35.60106521131205, -82.38134658987404 35.601229211377465, -82.38141958988209 35.60125521139034, -82.38157458989926 35.601310211417434, -82.38178058992598 35.60135821144834, -82.38210558996764 35.60143621149767, -82.38265659003945 35.601561211579835, -82.38347059013284 35.601828211717915, -82.38426259022145 35.60210321185529, -82.38453459024275 35.60225621191435, -82.38476459025422 35.602428211973056, -82.38481759025687 35.602468211986604, -82.38511359025766 35.60278021208047, -82.38534559026401 35.60298721214642, -82.38544559027223 35.603041212167646, -82.38558759029162 35.603068212187736, -82.3855685902784 35.60313321219896, -82.38550059023319 35.6033532122367, -82.3853855901916 35.6034992122545, -82.38537259018668 35.60351721225683, -82.38513059012193 35.6036772122644, -82.38507659011128 35.60368821226108, -82.38477959004024 35.60383021225939, -82.38472659002475 35.603874212262845, -82.38440358994585 35.60403921226311, -82.38430958992099 35.60409921226559, -82.38412158987417 35.60420121226694, -82.3840265898504 35.604253212267764, -82.38389858981567 35.60434121227246, -82.38380358978466 35.60444021228274, -82.38376858976717 35.60451621229458, -82.38373158975806 35.60453521229461, -82.38362358973112 35.60459421229544, -82.38358758972203 35.604614212295814, -82.38317158961871 35.60483821229855, -82.38283458953487 35.60502021230072, -82.38239658942497 35.605262212304844, -82.38202558933337 35.60545821230639, -82.38192458930824 35.60551321230721, -82.38176258926748 35.60560321230875, -82.38163958923772 35.60566421230848, -82.38150158920597 35.60572221230604, -82.38142658918882 35.60575321230459, -82.38136158917366 35.60578121230365, -82.3812005891378 35.605841212299254, -82.38112558912093 35.60587021229738, -82.38105558910551 35.605895212295245, -82.38084558905906 35.605971212289134, -82.3807765890436 35.605997212287235, -82.38069558902578 35.60602621228476, -82.38045258897178 35.60611521227788, -82.38037258895392 35.606145212275706, -82.38027558893239 35.606180212272825, -82.38007558888809 35.60625321226703, -82.37998458886801 35.60628621226437, -82.37988858884657 35.606322212261844, -82.37986058884039 35.606332212260945, -82.37977858882218 35.60636221225858, -82.379751588816 35.60637321225807, -82.37973858881327 35.60637721225753, -82.37971858880871 35.60638521225711, -82.37970258880526 35.60639021225648, -82.37969158880267 35.606395212256345, -82.37963458879017 35.60641521225458, -82.37946658875285 35.60647721224983, -82.37941058874021 35.60649921224851, -82.37923158870072 35.60656321224309, -82.37869658858241 35.60675621222722, -82.37869458858194 35.606757212227166, -82.37851958854276 35.60682321222263, -82.37843458852383 35.60685521222033, -82.37817858846664 35.60695121221343, -82.37809458844762 35.60698421221151, -82.3780625884406 35.60699521221043, -82.37796858841972 35.60703021220785, -82.37793758841273 35.607042212207126, -82.37789858840412 35.607056212206, -82.37778258837842 35.607098212202516, -82.37774458836981 35.60711321220168, -82.37763758834615 35.60715221219859, -82.3773185882751 35.60727021218964, -82.3772125882514 35.60731021218686, -82.37715458823864 35.607331212185194, -82.37698258820048 35.60739421218028, -82.37692558818759 35.60741621217887, -82.37680158816 35.60746221217543, -82.37658258811175 35.6075402121687, -82.3763635880633 35.60761921216221, -82.37574158792467 35.60785121214524, -82.37555658788366 35.60791821213975, -82.3752145878078 35.60804321212998, -82.37513358778983 35.608073212127735, -82.3750005877602 35.60812221212393, -82.37439458762479 35.60835021210782, -82.37436058761773 35.60835921210626, -82.37414258757188 35.60842321209675, -82.37401258754558 35.608454212089605, -82.37396458753564 35.60846721208732, -82.3738075875045 35.60850021207781, -82.3736195874695 35.608526212063786, -82.37348858744464 35.608546212054335, -82.37345358743845 35.60854921205136, -82.37335058741974 35.608560212042995, -82.37331658741327 35.60856521204047, -82.37318058738832 35.608581212029705, -82.37277558731387 35.60863021199796, -82.37264058728886 35.60864721198746, -82.37253458726948 35.60865921197904, -82.37242558724935 35.608673211970604, -82.37221658721087 35.60869821195415, -82.37211158719151 35.60871121194602, -82.37175458712582 35.60875421191798, -82.37119458702261 35.60882321187427, -82.37068658692934 35.608883211834126, -82.37033058686384 35.60892621180619, -82.37008958681965 35.60895421178708, -82.36936758668693 35.60904021173014, -82.36912758664265 35.60907021171153, -82.36877558657795 35.60911221168379, -82.36809158645222 35.60919421163, -82.36771958638394 35.609238211600584, -82.36756958635635 35.60925621158876, -82.36736758631925 35.609280211572816, -82.36732858631196 35.60928521156984, -82.36726758630064 35.60929321156524, -82.36721158629032 35.60930021156089, -82.36720558628923 35.60930121156042, -82.3671735862833 35.60930521155793, -82.36673058620087 35.60936421152428, -82.36666858618945 35.609372211519556, -82.36653958616598 35.60938621150909, -82.36628658611943 35.60941621148909, -82.36522158592328 35.60954621140577, -82.36463258581607 35.60961021135809, -82.36449858579269 35.609618211345946, -82.36439658577474 35.60962521133684, -82.36419158574034 35.60962821131634, -82.36384758568599 35.60961221127765, -82.36361758565197 35.609586211248676, -82.363611585651 35.60958621124804, -82.3632345855987 35.60952121119604, -82.36273958553184 35.609424211125294, -82.36246358549451 35.609370211085896, -82.36243158549019 35.60936421108142, -82.3622695854688 35.60932921105763, -82.36194158542433 35.60926621101103, -82.3618515854121 35.60924921099831, -82.36182958540874 35.609247210995626, -82.36163958538319 35.60920921096833, -82.36158958537634 35.60920021096139, -82.36136258534358 35.60916921093172, -82.36133958534035 35.6091652109285, -82.36121158532204 35.6091472109116, -82.36092958528047 35.60911421087593, -82.36076858525678 35.60909521085545, -82.36046958521105 35.60907121081985, -82.36025258517462 35.609075210798274, -82.36007258514296 35.609087210782135, -82.3598055850945 35.609115210760294, -82.35969858507465 35.609129210752144, -82.35929058499823 35.6091872107219, -82.35907558495806 35.60921721070581, -82.3584295848374 35.60930721065754, -82.35821558479724 35.60933821064176, -82.35818558479168 35.609342210639475, -82.35809858477538 35.60935421063297, -82.35806958476986 35.609359210630984, -82.3555245842953 35.60970821043964, -82.35528858425096 35.60974221042219, -82.35458558411975 35.60983921036949, -82.35420758405125 35.60987821033847, -82.35394258400595 35.60988821031316, -82.35382658398748 35.609883210300225, -82.35377758397989 35.60988021029454, -82.35363058395667 35.60987321027798, -82.3535825839491 35.60987121027261, -82.35340858392419 35.60984621024961, -82.35329358390744 35.60983121023478, -82.35289158385342 35.609751210177045, -82.35272058383038 35.609717210152546, -82.35259358381346 35.60969121013419, -82.35221458376238 35.60961621007994, -82.35208858374537 35.609591210061794, -82.35198258373111 35.60957021004668, -82.35166658368827 35.609509210001725, -82.35156158367406 35.60948920998686, -82.35143958365757 35.60946520996943, -82.35133358364253 35.60944920995525, -82.35105058360196 35.609409209918006, -82.35064458354 35.609376209869424, -82.35050458351851 35.60936520985271, -82.35041458350423 35.609361209842646, -82.35035458349476 35.609358209835854, -82.35017558346644 35.60935020981582, -82.35011658345702 35.60934820980934, -82.35001158344036 35.60934320979746, -82.34994458342969 35.60934120979014, -82.34969658338986 35.60933320976297, -82.349591583373 35.609330209751626, -82.34954858336626 35.60932820974673, -82.34942158334583 35.60932420973282, -82.34937958333904 35.609323209728316, -82.34928658332433 35.60931920971793, -82.34901058328043 35.6093082096872, -82.34891858326571 35.609305209677125, -82.34872258323448 35.60929720965532, -82.34813458314062 35.60927620959044, -82.34793858310925 35.609269209568865, -82.34764758306291 35.60925820953661, -82.34677658292402 35.60922520944014, -82.34648658287759 35.60921520940827, -82.34619858283071 35.609211209377776, -82.34606158280722 35.60921620936461, -82.34585658277186 35.609226209345564, -82.34559258272326 35.609258209324864, -82.34541158268868 35.609288209312325, -82.34480758256802 35.60942320927749, -82.34439358248528 35.60951620925369, -82.34410958242844 35.6095802092374, -82.34326058225842 35.60977220918891, -82.3429775822017 35.60983720917299, -82.3429475821957 35.60984320917108, -82.3428605821783 35.60986320916618, -82.3428325821726 35.60987020916466, -82.34247658210137 35.609950209144266, -82.34168158194187 35.61013220909925, -82.3414105818875 35.61019420908392, -82.34105658181622 35.610277209064265, -82.34100258182738 35.61014720903234, -82.34094558183898 35.610011208998834, -82.34089658187227 35.60974320893939, -82.34087158188932 35.609606208909035, -82.34128758197157 35.609519208934266, -82.3425385822184 35.60925920901036, -82.3428145822728 35.60920220902726, -82.34295658230079 35.609173209035994, -82.34384558247608 35.608989209090225, -82.34412258253066 35.608932209107195, -82.34651258300343 35.60842920925138, -82.34687358307458 35.6083542092733, -82.3474025831792 35.60824320930532, -82.34750458319951 35.608221209311274, -82.34781358326046 35.60815720933015, -82.3479165832807 35.608136209336536, -82.34823858334452 35.60806720935569, -82.34920758353609 35.607864209414345, -82.34953058359979 35.60779720943402, -82.3499375836804 35.60771120945846, -82.35116058392194 35.60745620953276, -82.3515685840025 35.607371209557556, -82.35193258407448 35.60729420957936, -82.35225358413811 35.60722620959862, -82.3530265842907 35.607065209645555, -82.35339158436281 35.606989209667695, -82.35441558456519 35.60677420972959, -82.35611258490061 35.60641920983237, -82.35748658517335 35.60612320991383, -82.35751858517959 35.60611720991589, -82.35811658530137 35.60596920994744, -82.35850058538136 35.60586220996523, -82.35854558539087 35.605848209967085, -82.35868458542024 35.60580720997308, -82.35873058542988 35.60579420997513, -82.3588935854642 35.605746209982215, -82.35891358546856 35.605739209982794, -82.35918658552741 35.60565020999284, -82.35945558558693 35.605553210000906, -82.35963558562658 35.60548921000641, -82.35986858567787 35.60540621001366, -82.36017458574815 35.60527921001928, -82.36061558584876 35.60509921002815, -82.36177058611763 35.60459421004468, -82.3623015862412 35.60436321005243, -82.36244858627556 35.60429821005436, -82.36321358645311 35.603967210065946, -82.36355658653271 35.6038192100712, -82.36419758668227 35.60353721008004, -82.3649345868532 35.60321921009132, -82.36546258697612 35.6029882100988, -82.3660505871128 35.60273221010737, -82.36704958734519 35.60229721012193, -82.36757858746813 35.6020672101297, -82.36771058749899 35.60200921013152, -82.36810958759179 35.60183521013725, -82.36824258762252 35.601778210139386, -82.3683105876386 35.60174721014015, -82.36851858768688 35.60165721014329, -82.36858758770293 35.60162721014433, -82.36888958777318 35.60149521014862, -82.36923058785156 35.601353210154855, -82.36946058790357 35.60126221016009, -82.36977858797519 35.60113921016784, -82.3701675880607 35.60100221018006, -82.37047658812745 35.600900210191185, -82.37094658822774 35.60075421020994, -82.37155458835333 35.600592210239654, -82.37196158843584 35.60049321026151, -82.37217758847909 35.60044421027376, -82.37238758852114 35.60039721028589, -82.37280358860227 35.60031721031245, -82.37310858866041 35.60026721033373, -82.3731345886654 35.6002622103354, -82.37321658868098 35.600249210341225, -82.37324358868614 35.60024521034316, -82.37336658870971 35.60022421035155, -82.37357958875013 35.60019021036659, -82.37373858877966 35.60016921037869, -82.37386358880278 35.60015321038828, -82.37401858883133 35.60013421040048, -82.37407358884155 35.60012721040467, -82.3745635889311 35.60007221044399, -82.37477058896772 35.60005621046204, -82.37512158902994 35.60002921049272, -82.37576458914064 35.60000121055322, -82.37606058919077 35.59999321058207, -82.37644758925512 35.59999121062153, -82.37687258932434 35.599998210666755, -82.37705358935362 35.6000022106862, -82.37757358943553 35.600028210744995, -82.37766258944951 35.600033210755136, -82.37786658948096 35.60004821077925, -82.37822458953583 35.600076210821776, -82.37874358961263 35.600134210887056, -82.37881858962368 35.60014321089664, -82.37903558965495 35.60017321092502)))",6127,37,021,003104,370210031043,606,606,156,580,516,21,2,5,0,36,26,441,93,348,426,383,16,2,5,0,20,15,269,243,26
census_2010_blockgroups_view.fid--2dc29038_13ec899ba8f_-2631,"MULTIPOLYGON (((-82.38150158920597 35.60572221230604, -82.38163958923772 35.60566421230848, -82.38176258926748 35.60560321230875, -82.38192458930824 35.60551321230721, -82.38202558933337 35.60545821230639, -82.38239658942497 35.605262212304844, -82.38283458953487 35.60502021230072, -82.38317158961871 35.60483821229855, -82.38358758972203 35.604614212295814, -82.38362358973112 35.60459421229544, -82.38373158975806 35.60453521229461, -82.38376858976717 35.60451621229458, -82.38376358976444 35.60452821229647, -82.38373658972938 35.6047262123339, -82.38366958969976 35.604846212351376, -82.38358958967378 35.604929212360055, -82.38357558966904 35.6049452123619, -82.38313758954806 35.60525921238049, -82.38281458946584 35.60544521238508, -82.38267958942491 35.60556621239573, -82.38262058937265 35.60584121244545, -82.38259858935203 35.605951212465534, -82.38260358929826 35.60630521253799, -82.38260558927864 35.606434212564416, -82.38251658923157 35.60664321259765, -82.38243558918856 35.60683521262832, -82.38243858917669 35.606915212644914, -82.38245458911942 35.60730321272537, -82.38253058912201 35.607368212746394, -82.38261158911988 35.60746821277501, -82.3826575890784 35.607786212844346, -82.38261758900217 35.608237212931854, -82.38257658896653 35.608424212965645, -82.3824485889098 35.608654212999205, -82.38238758888923 35.60872221300672, -82.38207258878234 35.609077213046376, -82.38194358874364 35.60918921305584, -82.38174158868323 35.60936421307056, -82.3815535886268 35.60952821308452, -82.38110258850313 35.60984621310263, -82.38088458844307 35.61000121311171, -82.38069458839041 35.610139213120114, -82.38035858829419 35.61040221313896, -82.3802885882755 35.61044821314108, -82.37992358817968 35.61067721315003, -82.37987758816863 35.61070021314993, -82.37983958815936 35.6107192131499, -82.379794588149 35.6107382131491, -82.37956658808655 35.610898213158144, -82.37949958806817 35.61094521316081, -82.37928258799685 35.6111752131852, -82.37921058797303 35.6112522131934, -82.37906258792984 35.611373213202704, -82.37829058773173 35.6118292132158, -82.3782545877224 35.611851213216625, -82.37811258768359 35.61195021322202, -82.37803858765021 35.612087213242276, -82.37805958765101 35.61210421324785, -82.37816658765685 35.61218121327454, -82.37839558765393 35.612445213351734, -82.37841658765247 35.61247721336041, -82.37850258764607 35.61261021339625, -82.37872458761333 35.61306021351051, -82.378738587602 35.61314821352987, -82.37884558757557 35.61343421359894, -82.37904058753553 35.61390221371411, -82.37905458753285 35.61393421372209, -82.37914358747382 35.61441221382831, -82.379183587447 35.61462821387631, -82.37926158739565 35.61504421396887, -82.37935058737607 35.61526621402312, -82.379401587365 35.615392214054, -82.37943358735808 35.61547121407331, -82.37948158734703 35.61559421410327, -82.37968858733345 35.61590421418754, -82.37980958732462 35.61609021423781, -82.38003058727871 35.61662421436903, -82.38010658727305 35.61674221440077, -82.38019558727466 35.61682721442725, -82.38051958727998 35.61713921452402, -82.3805725872735 35.61723821454956, -82.38069358722225 35.617699214655666, -82.38091558720119 35.61807321475446, -82.38102358719777 35.61821121479371, -82.38114458718398 35.61843021485062, -82.38115958717782 35.61848621486356, -82.38117158717304 35.61852921487351, -82.38117058714913 35.61868321490468, -82.3811555871357 35.618754214917566, -82.38111058709507 35.61896921495662, -82.3811365870585 35.61923321501291, -82.38118158704219 35.61938721504883, -82.38121758702941 35.61950821507718, -82.3813315870025 35.619804215148974, -82.38137558699758 35.61988321516962, -82.38157358697624 35.620233215261116, -82.38160458696963 35.62030921527972, -82.38155658693925 35.620454215304235, -82.3815795868748 35.62089621539641, -82.38160258685323 35.62106021543206, -82.38165558683193 35.621255215477134, -82.38173158682201 35.6214002155144, -82.3818845868139 35.621617215574275, -82.38189958679814 35.62173521559975, -82.38211958685022 35.621633215601726, -82.38229458689145 35.6215542156037, -82.3824635869424 35.621405215590826, -82.38411258706456 35.622380215958785, -82.39011958717886 35.62807021773361, -82.39015058717264 35.628144217751846, -82.39003858712684 35.62832021777611, -82.38981458705769 35.62852821779525, -82.38962258700359 35.62867221780473, -82.38938258694415 35.62880021780597, -82.38887058680257 35.62916821782804, -82.38840658666146 35.62958421786473, -82.38771858647833 35.63003221788489, -82.38472658571368 35.63177621793086, -82.38392658551443 35.63220821793616, -82.38323858529188 35.63291221800828, -82.38283858515638 35.633360218058016, -82.38258258505958 35.63371221810317, -82.38237458496579 35.634096218159726, -82.38222858490064 35.634361218198535, -82.38218258487966 35.63444821821144, -82.38216658469389 35.63563221845032, -82.38200658442734 35.63718421874912, -82.38197458437014 35.63752021881405, -82.38197458433542 35.63774421885962, -82.38181458426199 35.63804821890482, -82.38179558425558 35.63806921890721, -82.38165458420585 35.63824021892735, -82.38136658410117 35.63860821897245, -82.38107858398926 35.639024219027284, -82.37963858349856 35.64065621921039, -82.37885458324006 35.6414882192986, -82.37872658319418 35.641648219317865, -82.37874258316712 35.641840219358514, -82.37895058313963 35.64224021946125, -82.37920758290251 35.644048219854966, -82.37960758279536 35.6451682201238, -82.37987958269674 35.646096220340326, -82.38031158259001 35.64724822061886, -82.38039158256363 35.64750422067914, -82.38050358252521 35.647872220765414, -82.38055158251954 35.64796022078822, -82.3807755824935 35.64836822089433, -82.3811115824699 35.6488802210329, -82.38130358242734 35.649360221150246, -82.38205558223486 35.65140822164379, -82.38226358219002 35.651920221769274, -82.38247158213525 35.65249622190776, -82.38272758211082 35.65292822202193, -82.38272758206365 35.65323222208358, -82.38306358204754 35.65369622221257, -82.3832075820094 35.65409622230866, -82.38349558201743 35.654352222390365, -82.38363958198926 35.65468822247349, -82.38376758197334 35.654928222535474, -82.38397558195574 35.65526422262517, -82.38415158192791 35.65563222271809, -82.38434358191012 35.6559522228029, -82.3843595818533 35.65633622288254, -82.38432758181585 35.6565442229215, -82.38429558176844 35.65681622297346, -82.38422458171111 35.65711022302582, -82.38419958169057 35.65721622304479, -82.3840235815897 35.657680223120906, -82.38383158150836 35.65800022316618, -82.38351158139837 35.65836822320795, -82.38320758128118 35.65880022326436, -82.38295158118929 35.65912022330298, -82.38264758109938 35.659376223323626, -82.38243958103762 35.65955222333791, -82.38226358095649 35.659888223388066, -82.38224758086471 35.66046422350346, -82.38232758074412 35.66132822368717, -82.3823755806877 35.66174422377668, -82.38247158061434 35.66232022390357, -82.38247158053255 35.66284822401082, -82.38239158045991 35.66323222408065, -82.38232758038245 35.663664224161785, -82.38226358031241 35.6640482242332, -82.38218358023465 35.66446422430947, -82.3822955802012 35.66480022438928, -82.38240758016273 35.66516822447563, -82.38256758014212 35.66547222455386, -82.38282358013997 35.66576022463883, -82.38288758009355 35.66612822472018, -82.3828715800462 35.66641622477704, -82.38283957998888 35.66675222484198, -82.38282357994662 35.667008224892335, -82.38271157988098 35.66731222494254, -82.38263157983555 35.66752022497652, -82.38235957970379 35.66808022506224, -82.38210357960195 35.668464225113894, -82.38202357953162 35.66883222518037, -82.38199157943967 35.669392225290885, -82.38181657934868 35.669792225354094, -82.38168857927799 35.6701122254059, -82.3815125791918 35.670480225462505, -82.38133657909579 35.67091222553211, -82.38116057900461 35.67131222559524, -82.38104857894147 35.67160022564217, -82.38106457888956 35.671952225715366, -82.38100057881954 35.67233622578679, -82.38088857873406 35.67276822586308, -82.38066457859784 35.67340822596989, -82.38047257848915 35.67390422605085, -82.38023257837266 35.67440022612689, -82.3800575783043 35.67465422616041, -82.38005657830378 35.67465622616079, -82.37972057818378 35.67507222621063, -82.37924057803984 35.675488226245555, -82.37882457792877 35.675760226257964, -82.37850457782129 35.67611222629643, -82.37831257774236 35.67641622633845, -82.3780565776504 35.676736226377, -82.3775605774642 35.67740822646235, -82.37717657731878 35.677936226529994, -82.37677657718324 35.67838422657977, -82.37660057711432 35.67864022661359, -82.37650457706629 35.678848226645925, -82.3763605770102 35.679056226673325, -82.37624857697676 35.67915222668132, -82.37616857694617 35.6792642266958, -82.37612057692328 35.6793602267103, -82.37607257689301 35.67950422673469, -82.37610757687636 35.67964922676769, -82.37619457685064 35.679908226829276, -82.37640857685088 35.68013522689753, -82.37672057686243 35.68039422698232, -82.37701857685902 35.680734227082176, -82.37721557686646 35.68089622713536, -82.37732957685975 35.68106122718066, -82.37741557685452 35.68118722721515, -82.37754957683649 35.68144622728156, -82.37763757680351 35.68175322735299, -82.37787657674288 35.68239922750898, -82.37822857670339 35.68303022767347, -82.37867557669459 35.68356422782809, -82.37917157669891 35.68406622798124, -82.37951757670338 35.684406228086054, -82.37991057673318 35.68463422817291, -82.38002957670771 35.68492522824433, -82.3802145766833 35.68528022833551, -82.3804285766837 35.68550622840357, -82.38079057669347 35.68583022850673, -82.38089057670068 35.68589022852925, -82.38116757672053 35.68605822859195, -82.3814795767419 35.68625322866379, -82.38180657676332 35.68646422874037, -82.38218257680283 35.68661122880906, -82.38239557681544 35.68675722886064, -82.38250257682819 35.686789228878276, -82.38255957683494 35.68680622888756, -82.3826895768506 35.68684422890871, -82.382836576868 35.68688922893301, -82.38289057687179 35.68692222894532, -82.38301657688028 35.68700222897459, -82.38322957690275 35.68708422901322, -82.38349057693821 35.687134229050265, -82.3834995769393 35.68713722905184, -82.38370257696063 35.687216229088826, -82.38367757694395 35.68729722910269, -82.3836055768939 35.68754322914522, -82.38360157689111 35.687557229147664, -82.38358157687719 35.687625229159416, -82.38351857683419 35.687835229195635, -82.38353657680084 35.68806922924502, -82.38359157677601 35.688288229295146, -82.38366157676577 35.68842922933107, -82.38369857674891 35.68857722936495, -82.38371857671859 35.68879422941116, -82.38372557669376 35.68896222944591, -82.38372357667636 35.68907222946807, -82.38358957647709 35.69021422968631, -82.38357957646136 35.690305229703796, -82.38350857622947 35.69172422998479, -82.38327957608354 35.692421230102774, -82.38276457584593 35.693403230249096, -82.38235057560665 35.69450423043011, -82.38217757552978 35.69481523047546, -82.38188257543659 35.695101230503155, -82.38148357534196 35.695285230499266, -82.38014457507062 35.69560523042614, -82.3799035750045 35.695774230435575, -82.37978457494786 35.69601223047166, -82.3797905749126 35.69624623051983, -82.3798585745149 35.698882231062505, -82.37986557447111 35.69917223112215, -82.37972357435656 35.699759231226686, -82.37948357424858 35.700199231291364, -82.37906057411071 35.700636231336496, -82.37897557408283 35.70072523134575, -82.37830957392266 35.701046231342225, -82.37776357381554 35.701154231307775, -82.37614657352951 35.701272231164815, -82.37545757338238 35.70148523113698, -82.37484657322806 35.70182823114361, -82.37435257307375 35.702295231187506, -82.37386757288196 35.70301423128354, -82.37331457266275 35.70383623139339, -82.372567572433 35.704520231455255, -82.37168957216268 35.70532523152815, -82.37005457158358 35.70731223176306, -82.36924057134101 35.70800723182023, -82.36852057116528 35.70837123181979, -82.36728057088638 35.708845231788054, -82.36642857069481 35.70917123176627, -82.36592757057905 35.709382231757424, -82.36559957049825 35.709553231758306, -82.36529657041812 35.70974623176619, -82.36499757032921 35.71000023178691, -82.36475857024722 35.710273231817744, -82.36457557017424 35.710548231854624, -82.36445857011982 35.71077423188854, -82.36438557008142 35.71094323191525, -82.36431357003184 35.71118623195719, -82.36427356999005 35.711412231999084, -82.36423956994811 35.71164623204303, -82.36419556988315 35.71201723211383, -82.36412056980822 35.712420232187995, -82.36400456974698 35.712691232231094, -82.36387256969591 35.712879232255574, -82.36374256965067 35.71303223227324, -82.36358456960554 35.71315423228178, -82.36337656954765 35.71330523229097, -82.36311056947558 35.71348623230019, -82.36288756941236 35.71365523231155, -82.36274356936742 35.7137912323243, -82.36258956931255 35.71398023234677, -82.36242456923738 35.71428823239233, -82.36227456916156 35.71461723244368, -82.36204856905624 35.71505423250908, -82.36194256901572 35.71520223252824, -82.36183756897888 35.715327232542776, -82.36168156892704 35.715495232560755, -82.3612575687918 35.71591423260209, -82.36104056871763 35.71616023262963, -82.36094156867556 35.716325232652956, -82.36082356862039 35.716555232687476, -82.36065356853165 35.71694523274916, -82.36034756836726 35.71767723286627, -82.3602445683187 35.71788023289682, -82.36013656827926 35.71801923291392, -82.36001256824125 35.71813123292389, -82.35985156820288 35.718207232922644, -82.35967456816678 35.71825123291333, -82.35948856813327 35.71826823289754, -82.35926156809676 35.71826123287265, -82.35891056804152 35.71824323283277, -82.35857156798676 35.718234232795915, -82.35829456793813 35.718252232770965, -82.35795856786918 35.71833823275376, -82.35765656779895 35.718468232748904, -82.35730256771103 35.718657232750765, -82.35692556761292 35.718887232758554, -82.35658556751642 35.719146232776026, -82.35619056739739 35.71949123280529, -82.35592156730799 35.719780232836236, -82.35569156722585 35.72006423287013, -82.35547256714062 35.720379232911526, -82.35530756707259 35.720641232947735, -82.35514756699925 35.720943232992546, -82.35500356692195 35.72128723304752, -82.35478756680193 35.72182923313534, -82.35462056671622 35.72220323319402, -82.35450756666614 35.722405233223405, -82.35440256662172 35.72257923324788, -82.35425956656447 35.72279523327702, -82.35404756648232 35.72309823331666, -82.35400256646292 35.72317523332762, -82.35393256643202 35.72329923334562, -82.35386956639408 35.72347623337501, -82.35381856636 35.723641233403264, -82.35369256620213 35.7245232335694, -82.35364056616213 35.72472523360511, -82.35357356612177 35.72491323363641, -82.35348856608103 35.725085233662526, -82.35337956603757 35.72524923368456, -82.35322456598003 35.72545423371022, -82.35292156587204 35.72582623375439, -82.35272356579807 35.72609123378782, -82.35251956571842 35.72638623382666, -82.35241756567274 35.7265722338539, -82.35232656562617 35.72677423388549, -82.35227156559219 35.72693423391233, -82.35220756553834 35.72721323396246, -82.3521805655037 35.727407233999024, -82.35218656547937 35.727570234032775, -82.35220356544716 35.72779523408026, -82.35226056540941 35.7280992341479, -82.35231156539265 35.72826123418604, -82.3523625653709 35.72845523423072, -82.35243056535322 35.728641234275514, -82.35247856533391 35.728817234316196, -82.35251256531123 35.72899923435671, -82.35250156528801 35.72913723438363, -82.35248256527079 35.72922723439999, -82.35244956525123 35.72931823441502, -82.35239156522854 35.729402234426104, -82.35232556520735 35.72946823443268, -82.35224056518221 35.729539234438306, -82.352119565152 35.7296052344392, -82.3519765651219 35.72964623443276, -82.35180656508862 35.7296792344219, -82.3512575649916 35.72971923437327, -82.35068856488931 35.72977123432508, -82.35040356483266 35.729832234307985, -82.35019756478984 35.72988823429805, -82.34995256473317 35.72999223429389, -82.3499495647323 35.729994234294004, -82.34958956464352 35.73018223429499, -82.34925056455737 35.73037523429911, -82.3490145644948 35.7305262343054, -82.34829956430931 35.730958234319274, -82.34791156421151 35.731174234323085, -82.347720564168 35.73125123431893, -82.34755356413339 35.73129623431084, -82.34729156408252 35.73134423429354, -82.34702056403134 35.73138523427383, -82.34678056398722 35.73141323425472, -82.34652856393852 35.731458234237785, -82.34634056390097 35.731499234226746, -82.34618356386768 35.73154623422005, -82.34604756383808 35.73159223421531, -82.34589856380363 35.731655234212774, -82.34576256377034 35.73172423421268, -82.34562956373698 35.73179723421371, -82.34542256367789 35.73195723422484, -82.34520056360722 35.73217523424619, -82.34503056354228 35.73241223427676, -82.3449245634911 35.73262823430966, -82.34483856343876 35.732873234350535, -82.34455356325049 35.733781234505564, -82.34442856316778 35.734180234573714, -82.34418356303004 35.73480523467525, -82.34405156296252 35.73509923472142, -82.34392956290259 35.73535423476061, -82.34372556280745 35.73574923481973, -82.34362156276111 35.735936234846996, -82.34328956260475 35.73658823494507, -82.34271456233313 35.73772323511617, -82.3420435621246 35.738350235174174, -82.34203756212328 35.73835223517392, -82.34138556196373 35.73868423517394, -82.34124856192078 35.738814235186254, -82.34102456184743 35.7390482352106, -82.34084456178414 35.739263235235654, -82.34073256173528 35.73945823526366, -82.34066556169493 35.73964623529494, -82.34065456168618 35.73969123530297, -82.34064456167674 35.73974123531205, -82.34063256165462 35.739870235337, -82.34062556162347 35.74006323537548, -82.34064456154019 35.74061923549041, -82.3406395615219 35.7407312355126, -82.34062256150216 35.74084023553303, -82.3405975614824 35.74094023555074, -82.34056356146293 35.74102923556527, -82.3405105614411 35.7411132355769, -82.34044256141864 35.74118523558446, -82.34034756138941 35.741272235592305, -82.34024556136065 35.741348235597236, -82.34002756130616 35.741467235598876, -82.3391425610994 35.741854235585926, -82.33882356102004 35.742025235587725, -82.33862756096441 35.7421742355977, -82.33852756093498 35.74225723560424, -82.33850556092712 35.74228423560749, -82.33845356090843 35.7423492356153, -82.33832856085678 35.74254823564276, -82.3382675608265 35.74267823566287, -82.33822656079974 35.74280623568463, -82.33820656077776 35.742926235706896, -82.33820056074057 35.74315923575364, -82.33821756072192 35.74329723578344, -82.33826656070403 35.743464235822366, -82.33821556069654 35.74345823581586, -82.3381255606832 35.74344823580459, -82.33806556067461 35.743439235796565, -82.33801656066747 35.7434332357903, -82.33790556065046 35.743424235776985, -82.3376525606012 35.74347223576054, -82.33737056054093 35.74355923574907, -82.33734856053604 35.74356723574839, -82.33715356052491 35.7434312357007, -82.3372355605776 35.743180235658144, -82.3370415605621 35.743073235616365, -82.33680956050769 35.74317623561326, -82.33654456046351 35.743178235586285, -82.33627356045508 35.742944235510734, -82.33590656039702 35.742927235469274, -82.33573256036928 35.742920235449915, -82.33525556027367 35.743027235422346, -82.33525956028016 35.74298923541502, -82.33521156031513 35.74271423535424, -82.33525856038185 35.74233523528209, -82.33519156040394 35.74212123523171, -82.33514456045789 35.741725235146355, -82.33510356048355 35.74151623509972, -82.33531856063365 35.740780234972455, -82.33539256074936 35.740115234845106, -82.33538556082769 35.739604234740575, -82.3353995608566 35.73943323470726, -82.33552756093061 35.7390932346514, -82.33583056103137 35.73876823461677, -82.33591756106355 35.73865323460238, -82.33599956110363 35.738483234576314, -82.33619456123267 35.73786123447015, -82.33623456131271 35.737389234378526, -82.33623056133747 35.737225234344756, -82.33622756137049 35.73701023430076, -82.33626756146157 35.736466234194374, -82.33644956160204 35.735757234069204, -82.33653056164886 35.735542234033886, -82.33657756174982 35.73494323391712, -82.33668556181637 35.734630233864664, -82.33677256186586 35.73440423382783, -82.33687356191416 35.734201233797, -82.33696056197554 35.73389923374471, -82.33700156204043 35.73352523367299, -82.33697456206329 35.733349233634414, -82.33689356213532 35.73280023351463, -82.33677856218982 35.73232723340661, -82.33669756220628 35.73213523335923, -82.33664356223322 35.731904233306686, -82.3365555622563 35.73166223324844, -82.33654256227636 35.73151923321807, -82.33658956232432 35.731261233170535, -82.33661656238257 35.730915233103026, -82.33669656246518 35.73046923302077, -82.33674356250525 35.73026123298336, -82.33693256258955 35.729920232933665, -82.33698656264295 35.72963423288114, -82.33685156265724 35.72939823281925, -82.33659556266105 35.72910123273248, -82.33609656264946 35.72864523258826, -82.33590056265876 35.72837623251341, -82.33585356267666 35.72821123247505, -82.33585356268769 35.72814023246057, -82.3356985627065 35.72785423238655, -82.33567156272505 35.727706232353626, -82.33594056293967 35.72661223215926, -82.33596056296611 35.72646323213109, -82.33595356299914 35.726243232085686, -82.33586556301607 35.72604023203534, -82.33565756301759 35.725809231966956, -82.33508456301327 35.7252272317895, -82.33478756300173 35.72498523170964, -82.33467256300496 35.72484223166876, -82.33458556301527 35.724683231627445, -82.33455156308051 35.72422723153133, -82.3344705630935 35.724057231488494, -82.33424156309934 35.72377623140774, -82.33408556311265 35.72352423134041, -82.33391056314959 35.7231002312362, -82.33387056319246 35.72278223116752, -82.33369556326097 35.72215523102205, -82.33355956329808 35.72177123093006, -82.33320956334613 35.72108923075535, -82.33302056336264 35.72078223067347, -82.33295056337323 35.72063923063719, -82.33280456339527 35.72034223056182, -82.3324205634163 35.71979823041164, -82.33221156346866 35.719238230276325, -82.33190756352347 35.718562230107615, -82.33166456354047 35.71819423000783, -82.33142856358435 35.71766022987493, -82.33137456361216 35.71742422982145, -82.33142856368163 35.717034229747874, -82.33143556374259 35.71664922967039, -82.33146256379227 35.71635822961406, -82.33143556383914 35.71602822954429, -82.33134056388823 35.71561122944976, -82.33117156393715 35.715116229331755, -82.3311585639545 35.71499022930483, -82.33118556400689 35.71468222924502, -82.3312255640408 35.71450622921349, -82.33129956408294 35.714314229182136, -82.33133356415514 35.713885229098494, -82.3313295641578 35.713864229093865, -82.33125856420847 35.713462229004904, -82.3310435642506 35.71296222888112, -82.3309895642648 35.712813228845285, -82.33096256428429 35.71265922881126, -82.3310025643634 35.71219222872055, -82.3310905644403 35.71179122864813, -82.33109656450351 35.71139022856739, -82.33096856457036 35.71082422843921, -82.33093456459464 35.71063122839653, -82.33092756461133 35.71051622837245, -82.33090156467372 35.71008722828262, -82.33092756475992 35.70956022817829, -82.33088056478037 35.709378228136494, -82.33074556477666 35.70925822809821, -82.33050956476421 35.70908722803907, -82.33009856478749 35.70849922787722, -82.32983056478588 35.70822422779366, -82.32957956478445 35.70796622771534, -82.32945856480276 35.707719227652646, -82.32941856482427 35.70753822761183, -82.32947156488014 35.7072352275557, -82.32955956491426 35.70710922753926, -82.33021256509744 35.706625227508376, -82.33033356513279 35.70652622750078, -82.33051556520293 35.70626822746723, -82.33063056528178 35.705883227400975, -82.33065056534055 35.7055262273305, -82.33057656540005 35.70506422722903, -82.33048156542341 35.704812227168084, -82.33042156542717 35.70472422714406, -82.33021256541994 35.70454822708667, -82.33000556541379 35.704367227028484, -82.32994956541236 35.70431722701259, -82.32976056542626 35.70402622693402, -82.32962556545004 35.70372922685972, -82.3295775654848 35.703454226798925, -82.32959856557275 35.7029102266906, -82.32953056558787 35.70274022664908, -82.32922056562548 35.70216822650091, -82.32891156568003 35.7014872263307, -82.32889256570722 35.701292226289084, -82.32888256572237 35.701184226266136, -82.32878256572268 35.70107522623369, -82.32877656573706 35.700976226213, -82.32875456576744 35.70075722616624, -82.328728565806 35.700481226107534, -82.32863456582625 35.70025022605086, -82.3284795658295 35.70006422599712, -82.32827056584374 35.69975022591178, -82.32811556588801 35.69930022580436, -82.32808156591815 35.69906922575394, -82.3281015659547 35.6988552257126, -82.32825656603079 35.69853022566255, -82.3285395661185 35.69826722563838, -82.32863356615621 35.698124225619075, -82.32866756617892 35.69801422560027, -82.32868756621556 35.69779922555867, -82.32861356625703 35.697453225480736, -82.3286195663186 35.69706322540222, -82.32874056642817 35.69648622529753, -82.32889556652212 35.6960462252242, -82.32892256655553 35.695859225189025, -82.32893556659687 35.69560722513919, -82.3288615666214 35.69537022508343, -82.32874056663118 35.69517822503192, -82.32855156663312 35.69496422496898, -82.32814056663005 35.69454622484167, -82.32801956662388 35.69445722481112, -82.32780456661288 35.69429922475678, -82.32773656663058 35.69411222471183, -82.32791156676274 35.69344722459483, -82.32788456680518 35.6931452245307, -82.32773656688047 35.692502224384825, -82.32764156689812 35.69228722433147, -82.32777656698268 35.69188622426388, -82.32795856704864 35.69165522423583, -82.32800356706086 35.69162422423421, -82.3282005671143 35.691490224227266, -82.32909656731098 35.69117722425633, -82.32937256737713 35.69104522425801, -82.32957456743443 35.69089122424761, -82.329703567477 35.69075422423312, -82.32979056751617 35.690594224209654, -82.32983056754752 35.690435224181485, -82.32982956755264 35.69040122417439, -82.32982456759508 35.69012222411727, -82.3297495676263 35.689841224052486, -82.32974256765242 35.689665224015975, -82.32975656765805 35.68964422401317, -82.32987756773353 35.68928622395302, -82.33012656783087 35.688924223905225, -82.33028756790479 35.68862022386012, -82.33032856792333 35.688544223848886, -82.33077956807793 35.68802822379067, -82.330988568139 35.68785722377753, -82.33127156819947 35.68776922378886, -82.33152756824602 35.68774222380985, -82.33168956827886 35.68770322381865, -82.33187756833044 35.68757122381127, -82.3319445683576 35.687467223797036, -82.33206656843657 35.687088223732694, -82.33207356846334 35.68692322369994, -82.33219456853705 35.6865772236422, -82.33243356863352 35.686210223592276, -82.33256456868621 35.68601022356526, -82.33259156870429 35.68592222355015, -82.33257156872983 35.685736223510375, -82.3324695687685 35.68537822342715, -82.33246956880267 35.68515822338246, -82.33248356881256 35.68510922337386, -82.33247656882587 35.685016223354296, -82.33268456896855 35.684318223234044, -82.33274556900591 35.6841422232046, -82.33275856903623 35.683960223168995, -82.332674569099 35.68346622306003, -82.33265156911666 35.683328223029626, -82.33263756919776 35.6827902229189, -82.3323945693631 35.68146522262484, -82.33238156938386 35.68131722259341, -82.33247556946507 35.680894222517246, -82.33254956950547 35.68071222248792, -82.33262956954759 35.680526222458376, -82.33303456968785 35.68005322240417, -82.33318256972863 35.67994822239812, -82.3334245697841 35.67984922240297, -82.33399756988813 35.679789222450005, -82.33416556993221 35.679684222446, -82.3342465699591 35.67959722243674, -82.33429456998213 35.67949922242174, -82.33434057000376 35.6794092224082, -82.3342735700463 35.679063222331045, -82.33394957009244 35.67842022216701, -82.33388157011271 35.678217222118796, -82.33384857015407 35.67791522205412, -82.33382957015756 35.67787222204339, -82.33378757016621 35.67777222201871, -82.33376857016684 35.677747222011725, -82.33374057016788 35.67771122200151, -82.33345557020303 35.677180221864226, -82.33354057032415 35.67649022173292, -82.3335545703446 35.67637322171063, -82.33393657049643 35.67580122163386, -82.33457057069859 35.67517322157187, -82.33499657085142 35.67464222150795, -82.33520857096478 35.674137221427344, -82.33531257101991 35.673892221388314, -82.33538557105508 35.67374322136561, -82.33562157116933 35.67325822129144, -82.3358565712834 35.6727732212172, -82.33599457135004 35.67249022117404, -82.33633357158578 35.6713312209737, -82.33654557173318 35.67060622084826, -82.33742357221324 35.66844622050029, -82.3388155727803 35.66627222020259, -82.34023957328542 35.66453221999616, -82.34052357343847 35.66384721988635, -82.34060057346706 35.66374521987361, -82.3411135736578 35.663061219787686, -82.34114657366995 35.663018219782344, -82.34204857391927 35.66237121974398, -82.34340957422822 35.6618302197746, -82.34446357447132 35.66138621979317, -82.34468257451543 35.66133521980544, -82.34490757455738 35.66130421982233, -82.34494157456182 35.66131221982746, -82.34504557457475 35.66133921984373, -82.34508057457903 35.66134921984937, -82.3452925746056 35.66140421988237, -82.34592857468509 35.66157021998169, -82.34614157471154 35.661626220015044, -82.34618657471715 35.66163822002215, -82.34630857473647 35.66164422003596, -82.34658757479603 35.66155722004706, -82.34666457481234 35.66153422005037, -82.34687357483831 35.66158922008308, -82.34700157484926 35.66165522010966, -82.34725057488633 35.66168222014088, -82.34740557491698 35.66164922015011, -82.3477085749995 35.661440220138964, -82.34782857503768 35.6613222201274, -82.34791757506547 35.66123722011927, -82.34820657514064 35.66106122011334, -82.34826157515498 35.66102722011213, -82.34842857519794 35.66092822010929, -82.34848457521215 35.660896220108555, -82.34864557525357 35.660800220105656, -82.34872557527419 35.660753220104446, -82.3489065753245 35.66062122009625, -82.34908157538005 35.660449220079386, -82.34921657542259 35.66031922006694, -82.34922357541748 35.66035922007574, -82.34924657540228 35.66048222010306, -82.34925457539721 35.66052322011226, -82.34935457542728 35.6604362201049, -82.34943157545189 35.660359220097156, -82.34948557547031 35.66029822009039, -82.34955057549426 35.660213220079854, -82.34967857554301 35.660035220056876, -82.34986857561499 35.659773220023254, -82.34996057565111 35.65963822000532, -82.35001057567425 35.65954221999098, -82.35004757570171 35.65940421996678, -82.3500925757734 35.65898921988715, -82.35013157588337 35.658321219755514, -82.35013157590252 35.658197219730376, -82.35013157590531 35.65817921972668, -82.35012357592807 35.658024219694376, -82.35009257596596 35.65774621963472, -82.35006757597853 35.65763821961024, -82.35004357598731 35.657556219591136, -82.3500325759914 35.65751821958224, -82.34999957600363 35.65740421955571, -82.34998857600765 35.65736621954692, -82.34989657606103 35.6569232194474, -82.35005057615265 35.65649621937661, -82.35024657626818 35.655959219287695, -82.35030557631234 35.655737219248685, -82.3505765765391 35.65456221903804, -82.35059857656206 35.65443721901497, -82.35067657660734 35.65422821898052, -82.35077257665667 35.65401221894656, -82.35083957668401 35.65390721893219, -82.35092557671867 35.653775218914255, -82.35102557675434 35.65365221889958, -82.3512285768206 35.65344021887743, -82.35135157685849 35.6533272188672, -82.35141957688214 35.65324721885793, -82.35143257688759 35.65322621885504, -82.3514385768903 35.65321521885341, -82.35145857689868 35.65318221884882, -82.35146557690133 35.65317221884752, -82.35147857690708 35.65314921884411, -82.35151457692214 35.65309021883586, -82.35151957692378 35.65308521883536, -82.3515395769295 35.65306921883421, -82.35155657693473 35.65305421883288, -82.35171257697363 35.65296921883176, -82.35181757699962 35.65291321883124, -82.35198457704183 35.65281921882937, -82.35210357707302 35.65274521882654, -82.35221357710714 35.65264221881699, -82.35222057710911 35.65263721881672, -82.3523055771422 35.65251421880045, -82.35232757715137 35.65247821879543, -82.35269957722718 35.65238621881513, -82.3530435773234 35.65213221879904, -82.35354457748716 35.65160921874448, -82.35361857751117 35.65153321873669, -82.35373557756968 35.65128021869741, -82.35399457764105 35.65109621868675, -82.35408957774544 35.65052321858016, -82.35414857777667 35.650384218558024, -82.35424157784911 35.650016218492915, -82.35462657807301 35.64898121832238, -82.35521157835487 35.64778521813986, -82.35536057842971 35.64746121808939, -82.3554765784875 35.64721121805057, -82.3558585786755 35.64640521792626, -82.35586557873344 35.646038217852485, -82.35597657876602 35.64594621784522, -82.3562965790773 35.64427721753933, -82.35633357911233 35.64409021750512, -82.35638157941459 35.642188217123795, -82.3564605796193 35.64095021688055, -82.35657857990813 35.6392092165391, -82.35658557997893 35.63875921644849, -82.35661458023698 35.637122216119025, -82.35661158026825 35.63691721607709, -82.3564805802551 35.63686221605236, -82.35646158025708 35.63682921604372, -82.35636158026682 35.63665921599891, -82.35636858032052 35.63631921593057, -82.35637358034906 35.63614021589477, -82.35635758034523 35.63614821589472, -82.35615158031244 35.63614021587182, -82.35615158037615 35.63572821578816, -82.35603958042891 35.635267215682994, -82.35598258045619 35.635030215628994, -82.35584758050604 35.634563215520274, -82.35581358056754 35.63412921542858, -82.3558275805937 35.6339752153988, -82.35598158068461 35.63355221532876, -82.35622458077415 35.633233215289, -82.35645258083396 35.63309021528347, -82.35666958087354 35.63306621530106, -82.356809580899 35.63305121531239, -82.35687058091258 35.63302921531418, -82.3569175809322 35.632952215303405, -82.3569375809499 35.63285921528653, -82.3569775809871 35.63266121525049, -82.3571095810495 35.63239921521087, -82.35673058100735 35.63226621514479, -82.35610258093745 35.632047215035556, -82.35590558091758 35.63196521499862, -82.355799580909 35.63190721497588, -82.35570058090373 35.631835214951096, -82.35563858090194 35.631780214933535, -82.35562358090162 35.63176621492918, -82.35548858090284 35.6316142148844, -82.35541458089854 35.63156321486632, -82.35533658089153 35.63152521485059, -82.35533558090339 35.63144721483464, -82.35533558092179 35.63132821481047, -82.35534258094061 35.63121421478807, -82.35534358094327 35.631198214784916, -82.35535158095401 35.63113721477339, -82.35536258096676 35.63106621476004, -82.35538558098558 35.630969214742755, -82.35543758102654 35.630760214705695, -82.35551658108413 35.63047221465533, -82.35555658111294 35.63032921463042, -82.35556158111706 35.63030721462647, -82.35559258114338 35.63017021460184, -82.3556005811494 35.63014021459654, -82.35560458117762 35.62996221456089, -82.35559458119029 35.62986921454094, -82.35556258120232 35.62975721451483, -82.3555255812169 35.62962321448383, -82.35547558123575 35.629448214443144, -82.35543558125124 35.629305214409975, -82.35532658129232 35.6289232143212, -82.35529858130324 35.628822214297834, -82.35529358131421 35.62874621428186, -82.3552515814048 35.62811521414935, -82.35523458144466 35.62783921409155, -82.35521958156035 35.6270752139349, -82.35522058158838 35.626895213898464, -82.3552195815938 35.62685921389104, -82.35520758166525 35.62638421379332, -82.35520458168995 35.62622121375988, -82.35520158171326 35.626067213728355, -82.3551855817844 35.625590213629806, -82.35518058180641 35.62544221359921, -82.35517758182915 35.62529221356844, -82.3551765818438 35.62519621354891, -82.35517458186983 35.62502621351412, -82.35517958189182 35.624889213486824, -82.35519258190612 35.62481021347215, -82.35521358192139 35.62473421345883, -82.35524558193858 35.62465721344655, -82.35533858197482 35.62452221342872, -82.35539758199342 35.624465213423214, -82.3554145819987 35.62444921342174, -82.35562358206063 35.6242722134073, -82.35570358208429 35.62420421340176, -82.35572158208949 35.624190213400745, -82.35586158213547 35.62404221338516, -82.35591358215537 35.62396921337565, -82.35593958216512 35.62393421337128, -82.35596958217845 35.62388021336338, -82.35597758218206 35.623865213361114, -82.356031582212 35.6237292133391, -82.35603358221451 35.62371521333641, -82.35604358222558 35.623654213325146, -82.35605258224206 35.62355721330629, -82.35605458229358 35.62322621323931, -82.3560545822999 35.623185213231025, -82.3560595823281 35.62300821319558, -82.35606358236012 35.622805213154734, -82.35607758244869 35.62224721304288, -82.35607758245632 35.62219821303294, -82.35607758247053 35.622106213014234, -82.3560645824852 35.62199721299075, -82.35595958246805 35.62199621297969, -82.35565858242029 35.62198321294615, -82.35559658241039 35.621981212939275, -82.35489858230156 35.6219382128586, -82.3544425822293 35.62191821280762, -82.35427958220332 35.62191221278954, -82.35403758216418 35.62190621276335, -82.35372458211415 35.62189521272889, -82.35297558199436 35.621869212646374, -82.352788581965 35.62185921262505, -82.35247758191602 35.62184321258982, -82.35215358186518 35.62182521255278, -82.35191458182763 35.621813212525666, -82.35129358172497 35.62181321246167, -82.35118158170759 35.621806212448746, -82.35112358169845 35.62180321244211, -82.35100758168198 35.6217852124265, -82.35086358166353 35.62175121240476, -82.35074958165049 35.62171321238528, -82.35052458162802 35.621618212342874, -82.35034758161193 35.62153321230729, -82.35007258158699 35.62140021225199, -82.349833581564 35.62129321220558, -82.34951158152998 35.621169212147244, -82.34934458151348 35.621097212115394, -82.3492055815026 35.621019212085244, -82.34908858149547 35.620940212057135, -82.34890358149204 35.62076421200233, -82.34887958149088 35.62074621199616, -82.34882458148843 35.62070321198184, -82.34873458148098 35.62065521196275, -82.34866158147344 35.620626211949315, -82.34835958143358 35.62056121190502, -82.34825458141945 35.62054021188995, -82.34805158139206 35.62050021186088, -82.34794358137911 35.6204682118433, -82.34789858137377 35.62045521183597, -82.34784358136774 35.62043521182627, -82.34777258135988 35.620410211813834, -82.34767558135201 35.62035721179313, -82.34747458133506 35.62025221175104, -82.34744858133274 35.62023921174573, -82.34732558132012 35.620189211722874, -82.34724958131088 35.620168211710805, -82.34716758129989 35.62015121169888, -82.34644758119842 35.620038211601795, -82.3462665811714 35.6200192115793, -82.3459485811239 35.61998621153976, -82.34585758111105 35.619972211527525, -82.3457515810988 35.61993821150967, -82.34567958109206 35.619905211495535, -82.34566758109078 35.61990021149335, -82.34553058108085 35.61981821146258, -82.34544658107639 35.619757211441495, -82.34533658107347 35.619658211410076, -82.34528258107413 35.61959621139192, -82.34524958107687 35.61954321137777, -82.34524458107727 35.61953521137565, -82.34515658108707 35.6193782113347, -82.34513358108988 35.61933521132359, -82.3450875810931 35.61926521130468, -82.345035581093 35.61921021128808, -82.34503058109293 35.619205211286534, -82.34495558108998 35.61914421126643, -82.34486058108509 35.61907421124245, -82.34469058107327 35.61896921120362, -82.34452358106309 35.61885621116347, -82.34435158105266 35.618740211122166, -82.34427358104837 35.61868421110279, -82.34420058104686 35.61861621108144, -82.34418658104667 35.61860221107715, -82.34406758104636 35.61847721103947, -82.34384358105713 35.61816821095364, -82.34378758105868 35.61809821093369, -82.34375058105954 35.618053210920735, -82.3436595810584 35.61796321089314, -82.34363758105737 35.617946210887325, -82.34349458104874 35.617849210852924, -82.34345458104632 35.61782221084328, -82.34333358103547 35.61776321081894, -82.3432925810311 35.617747210811395, -82.34322058102373 35.61771821079811, -82.34307058100586 35.61767321077354, -82.34301558099895 35.617659210765, -82.34299458099625 35.617654210761835, -82.34284858097739 35.617620210739815, -82.3421495808869 35.6174582106349, -82.34189558085396 35.6174002105969, -82.34145558079634 35.61730221053169, -82.34128458077507 35.61725721050491, -82.34117658076347 35.61721621048547, -82.34107858075623 35.6171582104636, -82.34096458075109 35.61707021043401, -82.34059558074321 35.616726210326064, -82.34032058073971 35.61645521024275, -82.34016558073779 35.61630221019573, -82.33998258073056 35.61615321014658, -82.33987158072257 35.61608621012153, -82.3398145807169 35.61606221011085, -82.33974458070779 35.61604621010038, -82.3397475807121 35.61602121009555, -82.3397665807191 35.615996210092476, -82.33979858073602 35.615921210080494, -82.3398595807639 35.61580621006342, -82.33986658076684 35.615794210061715, -82.33993358079528 35.61568221004592, -82.33999758081792 35.61560421003668, -82.34009558084803 35.6155142100285, -82.34026258089521 35.615387210019925, -82.34048658095604 35.61523321001178, -82.34072058101924 35.61507421000363, -82.34103158110265 35.614867209993584, -82.34196758135299 35.61424820996449, -82.34203458137078 35.614205209962584, -82.34213758139957 35.61412920995779, -82.34219158141683 35.61407520995233, -82.3422135814269 35.61403320994615, -82.34222458143505 35.61399220993891, -82.34223258144317 35.61394820993083, -82.34222558145025 35.61389520991938, -82.34222158145124 35.61388420991668, -82.3421185814822 35.6135742098431, -82.34208458149246 35.61347120981876, -82.34205858150005 35.61339420980039, -82.34202558151081 35.61328920977573, -82.34185758156782 35.61274120964708, -82.34180258158686 35.612559209604456, -82.341938581615 35.612522209611, -82.3421955816682 35.6124532096235, -82.34235158169922 35.61241920963266, -82.34242658171391 35.612404209637305, -82.34248858172735 35.61238320963943, -82.34253258173699 35.61236820964091, -82.3425965817608 35.61228220963012, -82.34258658178317 35.61212720959766, -82.34249458181016 35.61185420953266, -82.34247358181638 35.61179120951773, -82.34242158184351 35.61156020946548, -82.3424225818525 35.61150320945406, -82.34246958186532 35.61147020945208, -82.34251258187552 35.611450209452514, -82.34278358192897 35.611394209469054, -82.34337558204857 35.611253209501434, -82.34380258213426 35.61115520952553, -82.34408558219097 35.611091209541726, -82.34435458224728 35.61101420955377, -82.34438158225238 35.61101020955582, -82.34437858229809 35.61071120949477, -82.34437558234973 35.61037420942604, -82.34439458243938 35.60981420931426, -82.34440258247514 35.60959120926986, -82.34439358248528 35.60951620925369, -82.34480758256802 35.60942320927749, -82.34541158268868 35.609288209312325, -82.34559258272326 35.609258209324864, -82.34585658277186 35.609226209345564, -82.34606158280722 35.60921620936461, -82.34619858283071 35.609211209377776, -82.34648658287759 35.60921520940827, -82.34677658292402 35.60922520944014, -82.34764758306291 35.60925820953661, -82.34793858310925 35.609269209568865, -82.34813458314062 35.60927620959044, -82.34872258323448 35.60929720965532, -82.34891858326571 35.609305209677125, -82.34901058328043 35.6093082096872, -82.34928658332433 35.60931920971793, -82.34937958333904 35.609323209728316, -82.34942158334583 35.60932420973282, -82.34954858336626 35.60932820974673, -82.349591583373 35.609330209751626, -82.34969658338986 35.60933320976297, -82.34994458342969 35.60934120979014, -82.35001158344036 35.60934320979746, -82.35011658345702 35.60934820980934, -82.35017558346644 35.60935020981582, -82.35035458349476 35.609358209835854, -82.35041458350423 35.609361209842646, -82.35050458351851 35.60936520985271, -82.35064458354 35.609376209869424, -82.35105058360196 35.609409209918006, -82.35133358364253 35.60944920995525, -82.35143958365757 35.60946520996943, -82.35156158367406 35.60948920998686, -82.35166658368827 35.609509210001725, -82.35198258373111 35.60957021004668, -82.35208858374537 35.609591210061794, -82.35221458376238 35.60961621007994, -82.35259358381346 35.60969121013419, -82.35272058383038 35.609717210152546, -82.35289158385342 35.609751210177045, -82.35329358390744 35.60983121023478, -82.35340858392419 35.60984621024961, -82.3535825839491 35.60987121027261, -82.35363058395667 35.60987321027798, -82.35377758397989 35.60988021029454, -82.35382658398748 35.609883210300225, -82.35394258400595 35.60988821031316, -82.35420758405125 35.60987821033847, -82.35458558411975 35.60983921036949, -82.35528858425096 35.60974221042219, -82.3555245842953 35.60970821043964, -82.35806958476986 35.609359210630984, -82.35809858477538 35.60935421063297, -82.35818558479168 35.609342210639475, -82.35821558479724 35.60933821064176, -82.3584295848374 35.60930721065754, -82.35907558495806 35.60921721070581, -82.35929058499823 35.6091872107219, -82.35969858507465 35.609129210752144, -82.3598055850945 35.609115210760294, -82.36007258514296 35.609087210782135, -82.36025258517462 35.609075210798274, -82.36046958521105 35.60907121081985, -82.36076858525678 35.60909521085545, -82.36092958528047 35.60911421087593, -82.36121158532204 35.6091472109116, -82.36133958534035 35.6091652109285, -82.36136258534358 35.60916921093172, -82.36158958537634 35.60920021096139, -82.36163958538319 35.60920921096833, -82.36182958540874 35.609247210995626, -82.3618515854121 35.60924921099831, -82.36194158542433 35.60926621101103, -82.3622695854688 35.60932921105763, -82.36243158549019 35.60936421108142, -82.36246358549451 35.609370211085896, -82.36273958553184 35.609424211125294, -82.3632345855987 35.60952121119604, -82.363611585651 35.60958621124804, -82.36361758565197 35.609586211248676, -82.36384758568599 35.60961221127765, -82.36419158574034 35.60962821131634, -82.36439658577474 35.60962521133684, -82.36449858579269 35.609618211345946, -82.36463258581607 35.60961021135809, -82.36522158592328 35.60954621140577, -82.36628658611943 35.60941621148909, -82.36653958616598 35.60938621150909, -82.36666858618945 35.609372211519556, -82.36673058620087 35.60936421152428, -82.3671735862833 35.60930521155793, -82.36720558628923 35.60930121156042, -82.36721158629032 35.60930021156089, -82.36726758630064 35.60929321156524, -82.36732858631196 35.60928521156984, -82.36736758631925 35.609280211572816, -82.36756958635635 35.60925621158876, -82.36771958638394 35.609238211600584, -82.36809158645222 35.60919421163, -82.36877558657795 35.60911221168379, -82.36912758664265 35.60907021171153, -82.36936758668693 35.60904021173014, -82.37008958681965 35.60895421178708, -82.37033058686384 35.60892621180619, -82.37068658692934 35.608883211834126, -82.37119458702261 35.60882321187427, -82.37175458712582 35.60875421191798, -82.37211158719151 35.60871121194602, -82.37221658721087 35.60869821195415, -82.37242558724935 35.608673211970604, -82.37253458726948 35.60865921197904, -82.37264058728886 35.60864721198746, -82.37277558731387 35.60863021199796, -82.37318058738832 35.608581212029705, -82.37331658741327 35.60856521204047, -82.37335058741974 35.608560212042995, -82.37345358743845 35.60854921205136, -82.37348858744464 35.608546212054335, -82.3736195874695 35.608526212063786, -82.3738075875045 35.60850021207781, -82.37396458753564 35.60846721208732, -82.37401258754558 35.608454212089605, -82.37414258757188 35.60842321209675, -82.37436058761773 35.60835921210626, -82.37439458762479 35.60835021210782, -82.3750005877602 35.60812221212393, -82.37513358778983 35.608073212127735, -82.3752145878078 35.60804321212998, -82.37555658788366 35.60791821213975, -82.37574158792467 35.60785121214524, -82.3763635880633 35.60761921216221, -82.37658258811175 35.6075402121687, -82.37680158816 35.60746221217543, -82.37692558818759 35.60741621217887, -82.37698258820048 35.60739421218028, -82.37715458823864 35.607331212185194, -82.3772125882514 35.60731021218686, -82.3773185882751 35.60727021218964, -82.37763758834615 35.60715221219859, -82.37774458836981 35.60711321220168, -82.37778258837842 35.607098212202516, -82.37789858840412 35.607056212206, -82.37793758841273 35.607042212207126, -82.37796858841972 35.60703021220785, -82.3780625884406 35.60699521221043, -82.37809458844762 35.60698421221151, -82.37817858846664 35.60695121221343, -82.37843458852383 35.60685521222033, -82.37851958854276 35.60682321222263, -82.37869458858194 35.606757212227166, -82.37869658858241 35.60675621222722, -82.37923158870072 35.60656321224309, -82.37941058874021 35.60649921224851, -82.37946658875285 35.60647721224983, -82.37963458879017 35.60641521225458, -82.37969158880267 35.606395212256345, -82.37970258880526 35.60639021225648, -82.37971858880871 35.60638521225711, -82.37973858881327 35.60637721225753, -82.379751588816 35.60637321225807, -82.37977858882218 35.60636221225858, -82.37986058884039 35.606332212260945, -82.37988858884657 35.606322212261844, -82.37998458886801 35.60628621226437, -82.38007558888809 35.60625321226703, -82.38027558893239 35.606180212272825, -82.38037258895392 35.606145212275706, -82.38045258897178 35.60611521227788, -82.38069558902578 35.60602621228476, -82.3807765890436 35.605997212287235, -82.38084558905906 35.605971212289134, -82.38105558910551 35.605895212295245, -82.38112558912093 35.60587021229738, -82.3812005891378 35.605841212299254, -82.38136158917366 35.60578121230365, -82.38142658918882 35.60575321230459, -82.38150158920597 35.60572221230604)))",6481,37,021,003104,370210031041,2135,2135,87,2091,1897,130,16,22,1,25,44,1793,51,1742,1774,1632,96,11,16,1,18,19,896,790,106
census_2010_blockgroups_view.fid--2dc29038_13ec899ba8f_-2630,"MULTIPOLYGON (((-82.5478966118409 35.63773623594044, -82.5478606118523 35.63762423591392, -82.54785861185307 35.63761723591225, -82.54796461187269 35.63760423592054, -82.54799561187859 35.63759923592271, -82.5480726118935 35.63758523592778, -82.54808561189603 35.63758323592871, -82.548329611947 35.63751523593994, -82.54869361202724 35.63738723595136, -82.54889961207238 35.63731623595802, -82.54914061212442 35.637238235966926, -82.5493346121644 35.63718823597674, -82.5495996122203 35.637111235988264, -82.54975461225094 35.637079235997724, -82.54988561227532 35.63706223600774, -82.55000761229553 35.637062236020284, -82.55012661231152 35.63708723603763, -82.55025661232472 35.63714123606197, -82.55037261233328 35.637211236088156, -82.55040161233391 35.63723823609664, -82.55048261233586 35.637312236120025, -82.55055061233473 35.637393236143495, -82.5505816123307 35.63745223615868, -82.55060861232494 35.637519236175166, -82.55061961231623 35.63758723619009, -82.55061261230468 35.63765423620302, -82.55056561225615 35.6379182362519, -82.55056661224258 35.638007236270184, -82.55058061223332 35.638082236286905, -82.55060761222259 35.63818123630976, -82.55081461217962 35.638682236433006, -82.55097761213936 35.639118236538536, -82.55104261212531 35.63927923657801, -82.55109461211767 35.639385236604994, -82.5512136121071 35.63958123665706, -82.55129361210298 35.63969423668835, -82.551790612064 35.64048223689986, -82.55193961205042 35.640730236965645, -82.5520686120425 35.640920237017575, -82.55222361203697 35.641123237074844, -82.55243761203882 35.641341237141226, -82.55246561204028 35.64136223714841, -82.5525516120442 35.64142923717087, -82.55265161205304 35.641479237191376, -82.55275461206726 35.64149823720586, -82.55288661208984 35.641494237218566, -82.55308661212885 35.64145623723141, -82.55326161216618 35.64140323723864, -82.55344961220828 35.64133223724347, -82.55359161224256 35.641263237244104, -82.55367061226725 35.64118823723695, -82.55379161232439 35.64094823720051, -82.55380261232301 35.64096923720588, -82.5538826123213 35.64106623723387, -82.55404961232662 35.641211237280594, -82.55434761233626 35.641469237363786, -82.55440961233619 35.64153723738393, -82.5544666123327 35.6416212374069, -82.55450461232797 35.64169223742532, -82.55454161232038 35.64178123744721, -82.55459161230355 35.64194423748553, -82.55463261228363 35.642117237525, -82.55471861224211 35.64247923760752, -82.55472861223235 35.642553237623574, -82.554756612215 35.64269523765539, -82.55478461220336 35.6428012376799, -82.5547936121998 35.64283423768749, -82.55499061209974 35.643694237882876, -82.55499161208895 35.643765237897384, -82.55499361207971 35.643827237910216, -82.55495261203207 35.64409123795973, -82.5548136119902 35.64421323797035, -82.55471761196104 35.64429923797797, -82.55459461192062 35.644428237991534, -82.5544016118647 35.644583238003285, -82.55435861185202 35.644619238006136, -82.55428061182617 35.644702238015036, -82.55427361182306 35.64471523801699, -82.55423961180736 35.644780238026684, -82.55421061178643 35.64488423804487, -82.55418061175347 35.645066238078805, -82.55417261174401 35.64511823808859, -82.55415661172148 35.64524723811321, -82.55411761169633 35.64536823813381, -82.55408361168156 35.64542723814237, -82.55401861166055 35.64549323814912, -82.55392161163276 35.64556923815468, -82.55385661161162 35.64563623816154, -82.5538316115968 35.645705238173, -82.55384461158968 35.64576523818657, -82.55389461157962 35.64588423821596, -82.55393861156739 35.646011238246345, -82.5539406115659 35.646022238248804, -82.55395961155632 35.646105238267594, -82.55396561154372 35.64619323828616, -82.55396661152538 35.64631323831071, -82.55395361151206 35.64638523832404, -82.55392561149105 35.646491238342705, -82.55391861147464 35.646590238362236, -82.55392561145814 35.64670423838607, -82.55395461144265 35.646836238415915, -82.55396961142625 35.64695823844231, -82.55399261140212 35.64713923848154, -82.55399761138709 35.64724223850303, -82.55398961137911 35.647285238510975, -82.55397561137016 35.64732823851827, -82.55395961136082 35.64737123852534, -82.55392761134567 35.64743523853512, -82.55382961130503 35.64759323855717, -82.55377561127831 35.64770823857506, -82.5537616112645 35.64778223858864, -82.55375761125333 35.64785023860211, -82.5537676112422 35.64793323862001, -82.5538746112084 35.64826723869905, -82.55396961118186 35.64854123876456, -82.5539846111736 35.64861123878037, -82.55402961115108 35.64880523882451, -82.5540896111027 35.64918323890762, -82.55415161111628 35.64916223890968, -82.55426261114646 35.64908623890564, -82.55440161118152 35.64900823890409, -82.55455261121882 35.6489292389035, -82.5547636112652 35.648856238910405, -82.55478261126898 35.64885223891151, -82.55482961127817 35.64884323891451, -82.55492361129548 35.64883223892191, -82.55517061133723 35.64882723894631, -82.55528161135766 35.64881423895509, -82.55536861137598 35.64878923895895, -82.5554106113895 35.648747238954726, -82.55543061140087 35.64869523894622, -82.55543061140311 35.64868023894318, -82.55543061141228 35.648621238931185, -82.55539561141974 35.64853523891003, -82.55524761143216 35.648295238845925, -82.55522061143756 35.64823123883016, -82.55521961144588 35.64817623881889, -82.5552466114598 35.64811523880924, -82.55528261147349 35.64806523880275, -82.5553276114887 35.64801523879717, -82.55539661150709 35.64797023879516, -82.55546761152866 35.647907238789536, -82.5555166115448 35.64785523878401, -82.55558761157 35.647768238773665, -82.5556116115833 35.647708238763904, -82.5556126115918 35.64765423875303, -82.55556061159069 35.64760523873768, -82.55549361158772 35.64755223872002, -82.55537661158117 35.6474692386911, -82.55531861157539 35.647444238680016, -82.55504461154793 35.647327238627994, -82.55493761154075 35.647258238602994, -82.55484961153606 35.64719423858091, -82.55474661153154 35.64711223855358, -82.55466961153002 35.647039238530844, -82.55479061157273 35.646893238513485, -82.55480461157755 35.64687723851167, -82.5548826116025 35.6467992385038, -82.55496461162771 35.64672423849701, -82.5552526117206 35.64643223846718, -82.5554016117683 35.64628323845221, -82.55540161177504 35.64624023844343, -82.55541561179149 35.64614823842613, -82.55545361181409 35.6460432384087, -82.55554461186671 35.64580023836861, -82.55558961188568 35.6457252383579, -82.55565161190717 35.64565323834961, -82.55589061197173 35.64549223834144, -82.55589761197425 35.64548323834034, -82.55595861199508 35.64541423833258, -82.55599261201196 35.64534123832117, -82.55601661202674 35.645271238309405, -82.5560316120418 35.645190238294425, -82.55603061204685 35.64515623828747, -82.55603061205174 35.64512423828092, -82.55605161207166 35.64501823826152, -82.55610361209537 35.644920238246925, -82.55616861211703 35.64485023823935, -82.55618961212386 35.64482823823699, -82.55626261214283 35.644784238235594, -82.55620361216076 35.64460423819285, -82.55621761216716 35.64457823818897, -82.55634961222455 35.64434823815584, -82.55652261227813 35.6441872381408, -82.55655761230716 35.64403723811382, -82.55657161231858 35.643978238103244, -82.55663061235092 35.643832238079625, -82.55671961236166 35.64385823809405, -82.55681061237075 35.64389723811132, -82.55684061237368 35.64391023811706, -82.55721061239218 35.644189238211936, -82.55728361239818 35.64422823822732, -82.55730261239982 35.644238238231345, -82.55739261240991 35.64427023824718, -82.55746861242113 35.64427923825682, -82.55750761242687 35.6442842382618, -82.55763261244928 35.64427323827244, -82.55773461247118 35.64424123827645, -82.55802761255258 35.644029238263336, -82.55817561259195 35.643933238259045, -82.558234612605 35.64391223826084, -82.5583116126196 35.64390023826639, -82.55835261262659 35.64389923827033, -82.55839761263398 35.64389923827497, -82.55847761264567 35.64391023828542, -82.55877261268387 35.64398023833, -82.55887061269797 35.643994238342984, -82.5589546127135 35.64398423834953, -82.55902761272822 35.64396723835362, -82.55927661278275 35.64388223836192, -82.55937161280174 35.643861238367364, -82.55946361281768 35.643857238376064, -82.55956361283152 35.643875238390024, -82.559632612839 35.64390123840244, -82.55970961284423 35.64395023842029, -82.55975561284455 35.64399723843457, -82.55980761284228 35.6440682384544, -82.55990261283337 35.64422823849674, -82.55996561282959 35.64432023852196, -82.5600326128327 35.644372238539376, -82.56011861284126 35.644409238555745, -82.56020061285183 35.64442923856829, -82.56028261286558 35.6444282385765, -82.56037961288513 35.64440623858199, -82.56052361291616 35.644360238587424, -82.5606116129345 35.64433623859162, -82.5609836130045 35.6442832386191, -82.56103861301466 35.64427623862335, -82.56151361310279 35.64421623865993, -82.56161761311948 35.644220238671465, -82.5616916131299 35.64423223868154, -82.56176961313967 35.64425323869379, -82.56188761315279 35.644295238714534, -82.56200561316463 35.644345238736776, -82.56211361317648 35.64438523875609, -82.56221661318891 35.64441523877275, -82.56226561319612 35.64442123877899, -82.56230961320281 35.6444252387844, -82.56242361322117 35.64442923879688, -82.56250961323683 35.644420238803875, -82.56259561325363 35.64440423880948, -82.56268961327328 35.64437823881386, -82.56277061329163 35.64434623881571, -82.562850613312 35.644300238814594, -82.56287661331835 35.64428723881457, -82.56297361334434 35.64422323881151, -82.56313361338466 35.644134238809805, -82.56357061349756 35.64387323880165, -82.56367061352114 35.64382823880277, -82.56375161353732 35.64381023880743, -82.56385361355628 35.64379723881531, -82.56396961357561 35.64379723882721, -82.56406361359008 35.64380423883826, -82.56416061360316 35.643824238852375, -82.56423761361096 35.643856238866775, -82.56432261361805 35.643902238884905, -82.56448861362364 35.644044238930874, -82.56455761362852 35.64408723894671, -82.5646236136358 35.6441112389584, -82.56470661364737 35.64412523896976, -82.56480661366373 35.64412723898049, -82.56492561368394 35.64412423899213, -82.5650156136977 35.64413223900297, -82.5650866137071 35.64414723901335, -82.56516961371706 35.644172239026936, -82.56525061372409 35.644214239043805, -82.56525561372423 35.644218239045195, -82.56531061372661 35.64426223905976, -82.5653606137243 35.64433123907896, -82.56540161372062 35.64439923909703, -82.56542361371395 35.644466239112916, -82.56544561369641 35.64460323914308, -82.56546861369081 35.644664239157905, -82.56554961367944 35.644825239198994, -82.56557761367688 35.6448722392114, -82.56566661368109 35.6449402392344, -82.5656916136842 35.6449472392384, -82.56570561368596 35.64495123924069, -82.56574961369128 35.644964239247884, -82.56576461369296 35.64496923925038, -82.56581261370233 35.64496023925348, -82.56584661370889 35.64495423925586, -82.56591161372636 35.644911239253766, -82.56594061373991 35.64485423924513, -82.56597661376364 35.644739239225444, -82.56610461384584 35.644344239158116, -82.56615161388349 35.64415123912365, -82.56621261393765 35.64386623907188, -82.56623261395947 35.643746239049506, -82.56623361396113 35.64373623904761, -82.5662416139742 35.6436602390329, -82.56623861398744 35.64357123901449, -82.56622161399525 35.643502238998714, -82.56618361400473 35.643400238973996, -82.56622361401293 35.643390238976146, -82.56636261404817 35.643311238974334, -82.56648161407794 35.64324623897333, -82.5666376141181 35.64315423897067, -82.56672961414345 35.64308923896687, -82.5667786141607 35.643030238959845, -82.56683161418228 35.642947238948416, -82.56694061422648 35.642778238925295, -82.56706961427953 35.64257323889679, -82.56746061443913 35.641960238812175, -82.56759061449215 35.64175623878395, -82.56782661451761 35.64184523882635, -82.56789461452587 35.64186523883744, -82.56796361453598 35.64187423884635, -82.56803561454774 35.64187523885395, -82.5682716145921 35.64184223887154, -82.56882461469584 35.64176523891266, -82.56894361471684 35.641757238923326, -82.5690026147253 35.641766238931176, -82.56908161473439 35.64179223894465, -82.56916061474163 35.64183023896047, -82.56930361475197 35.64191723899292, -82.56942661475733 35.64201523902553, -82.56953061476288 35.64209123905172, -82.56961961476867 35.642149239072644, -82.56970261477716 35.64218423908829, -82.56977961478707 35.642202239099895, -82.56985461479849 35.64220923910902, -82.5699496148154 35.64220223911732, -82.57003661483226 35.64218623912305, -82.57010161484754 35.64215723912382, -82.57016361486423 35.642116239121904, -82.57021261488006 35.6420662391167, -82.57024061488902 35.64203823911386, -82.57031661491494 35.6419522391042, -82.57041661494374 35.64187323909835, -82.57061561499945 35.641726239088904, -82.57076261503845 35.64163223908491, -82.57074861502093 35.64173023910335, -82.57076761500437 35.64185823913144, -82.57080561499292 35.641973239158794, -82.57081261499096 35.641993239163526, -82.57086461498794 35.64206923918438, -82.57094061499397 35.64211223920088, -82.57105261500526 35.64215923922199, -82.57121361502378 35.64221323924957, -82.57125661502825 35.642230239257394, -82.5715156150546 35.6423382393061, -82.57159661506238 35.642375239321915, -82.57164561506573 35.642406239333326, -82.57168061506572 35.64244423934465, -82.57169361506323 35.642474239352055, -82.57170761506096 35.6425042393596, -82.57175261505769 35.642573239378294, -82.57179061505978 35.64260123938795, -82.57188861506486 35.64267323941262, -82.57194561506898 35.64270823942562, -82.57198861507207 35.64273423943532, -82.5721196150815 35.64281423946515, -82.57216661508656 35.642832239473606, -82.57221861509571 35.642829239478296, -82.5722566151043 35.6428142394792, -82.57231661512276 35.642759239474145, -82.57231961512454 35.64275123947279, -82.57235161514089 35.64267923946149, -82.57237261515742 35.64259523944652, -82.57237961517191 35.64250823942949, -82.57237061518282 35.6424282394123, -82.57232761518783 35.64234923939177, -82.57225461518641 35.64228023937023, -82.5722446151879 35.64225923936494, -82.57222961519041 35.642227239356906, -82.57216861520072 35.64209423932353, -82.57212161520853 35.6419932392981, -82.57209961520947 35.64196323928977, -82.57206161521114 35.64191223927546, -82.57203161521056 35.64188323926646, -82.57193561520863 35.641792239238065, -82.57184861520439 35.64172623921566, -82.57176661520202 35.641653239192415, -82.5716106151912 35.64155523915642, -82.57141661517593 35.64144523911404, -82.5713056151672 35.64138223908985, -82.57121161516432 35.64130023906349, -82.57130461518435 35.641270239066884, -82.57143361521115 35.64123523907304, -82.57194961531809 35.641098239098234, -82.5721056153511 35.64105223910491, -82.57232861539802 35.6409882391148, -82.57257561545104 35.64091023912431, -82.57268961547743 35.6408622391262, -82.57279261550383 35.64080223912461, -82.57288761553255 35.64071823911726, -82.5730076155709 35.64059923910536, -82.57304361558211 35.64056523910218, -82.57322761564245 35.64037223908174, -82.5736266157651 35.64000723904844, -82.57441661600201 35.63932223899019, -82.5745986160519 35.63919523898306, -82.57478161610508 35.639047238971685, -82.57480761611313 35.63902323896954, -82.57493861615286 35.6389072389594, -82.57515761622328 35.638686238936906, -82.57524561625517 35.63857423892309, -82.575331616292 35.63842823890222, -82.57537461631657 35.638315238883656, -82.57538861632423 35.63828123887815, -82.57544261638073 35.63797223882073, -82.57544261638238 35.63796223881878, -82.57545161640219 35.63784323879542, -82.5754636164025 35.637854238798894, -82.5755026164039 35.63788723880958, -82.57551561640433 35.63789823881323, -82.57553361640495 35.63791423881833, -82.57565761640609 35.63804023885671, -82.57571261640207 35.63812523887969, -82.57574261640015 35.63817023889198, -82.57576761639938 35.63820223890099, -82.5758706164232 35.63815823890266, -82.57621661651115 35.63796123889812, -82.57629061651389 35.63802323891832, -82.5764536165147 35.63819323896972, -82.57653961651526 35.63828223899668, -82.57656661650955 35.63834823901286, -82.57662061651352 35.638381239025186, -82.57671461651057 35.638501239059266, -82.57674161650658 35.63855623907323, -82.5768226165056 35.63865023910068, -82.57686261650635 35.638688239112525, -82.57703161651744 35.6387982391523, -82.57717961653277 35.638858239179775, -82.57723361653652 35.638892239192245, -82.57731361654658 35.63891323920471, -82.57736761655028 35.63894723921726, -82.5774626165636 35.63896323923022, -82.57785261661074 35.639078239293724, -82.57813561664152 35.63918323934422, -82.57841861667002 35.63930323939773, -82.57846561667607 35.63931523940507, -82.57848561667855 35.63932023940814, -82.57873461670397 35.63942423945483, -82.57889561671712 35.639512239489406, -82.57901061672956 35.6395552395099, -82.57906361673547 35.6395742395192, -82.57920561675067 35.63962823954486, -82.57922161675233 35.639635239547964, -82.57927361675713 35.63966023955836, -82.57944861678267 35.63968323958104, -82.57952561679612 35.639679239588105, -82.57957661680483 35.63967723959297, -82.57974461683884 35.63963823960232, -82.57982461685717 35.63960523960375, -82.57987861687126 35.63957223960264, -82.57995961688718 35.63955623960768, -82.58021661695534 35.63939123960049, -82.58039061700119 35.63928123959597, -82.58043261701174 35.63925823959568, -82.58042961700139 35.639322239608326, -82.58042361697031 35.63951723964744, -82.58042161695988 35.639582239660456, -82.58040761689576 35.639983239740666, -82.58038661679537 35.640611239866466, -82.58037861672044 35.641088239962784, -82.58038061670534 35.64118823998331, -82.58038861665948 35.641494240046505, -82.58039661664598 35.64159024006684, -82.58039761664199 35.641617240072456, -82.58041361661382 35.6418172401148, -82.58042261659668 35.641938240140306, -82.58044961656854 35.642149240186136, -82.58045561656243 35.642195240196116, -82.58051561651119 35.64259224028309, -82.58055561648433 35.642809240331424, -82.58066961642928 35.64328924044091, -82.58073061640603 35.643505240491116, -82.58085561636729 35.643891240582626, -82.5808936163554 35.644009240610494, -82.58105261631545 35.64443924071444, -82.58108461630714 35.64452724073568, -82.58118261628276 35.644791240799485, -82.58121561627452 35.64488024082101, -82.58138461623224 35.645336240931236, -82.58165361616595 35.64605524110531, -82.58166461616297 35.64608624111276, -82.5817386161425 35.646299241163774, -82.58196161608895 35.646886241306206, -82.58219061602898 35.64752124145914, -82.58232161598633 35.64793824155746, -82.58244761594081 35.64836924165818, -82.5825006159126 35.648609241712535, -82.58255161588123 35.64886724177028, -82.58258161585849 35.64904724181005, -82.58262161582891 35.64928224186203, -82.58265461578854 35.64957924192595, -82.58267361575066 35.649845241982035, -82.58268261572297 35.650034242021476, -82.5826886157041 35.65016324204833, -82.58268861569937 35.65019324205447, -82.5826946156669 35.6504102420993, -82.5826876156253 35.6506722421519, -82.5826846156001 35.65083224218421, -82.58268261558827 35.65090724219926, -82.58263961550637 35.6513912422934, -82.58260661546134 35.65164724234214, -82.58242661523647 35.65291024258083, -82.58218361493206 35.65462024290412, -82.58217861483033 35.655274243036786, -82.58224161473947 35.65593024317688, -82.58249361460977 35.657042243429316, -82.58312161440399 35.659050243902804, -82.58365361422999 35.66075024430372, -82.58374761419935 35.66105024437452, -82.5837636141937 35.66110424438709, -82.58381461417707 35.66126624442536, -82.58383161417142 35.66132124443835, -82.58378961416368 35.66132624443499, -82.58366661414061 35.66134324442582, -82.58365461413827 35.66134524442498, -82.58362761413228 35.661355244424264, -82.58333561407275 35.661426244408666, -82.58310261402515 35.66148324439631, -82.58255861391497 35.661611244366505, -82.5824606138945 35.66163824436185, -82.58227061385475 35.661691244353186, -82.58220661385648 35.66161124433025, -82.58214661384325 35.661632244328324, -82.58196961380429 35.66169424432278, -82.58191161379125 35.661716244321305, -82.58189461379318 35.6616852443133, -82.58184561379925 35.6615932442895, -82.58182961380122 35.66156324428176, -82.58176961380835 35.66145224425296, -82.58158961382983 35.66111924416662, -82.58153061383705 35.661009244138135, -82.58134161385982 35.660658244047234, -82.58077561392803 35.659607243774936, -82.58058761395083 35.659257243684344, -82.58056661395355 35.65921724367398, -82.58050361396116 35.65910024364369, -82.58048261396365 35.65906124363357, -82.57997261402473 35.65811624338869, -82.57991661403322 35.6580012433595, -82.57987161404336 35.65788724333174, -82.57984061405362 35.657787243308114, -82.57981061406669 35.6576702432812, -82.57979261408043 35.65756224325742, -82.57978661408947 35.65749724324353, -82.57969261407167 35.657511243236684, -82.57923861398272 35.65759824320773, -82.57901261393917 35.65763724319242, -82.57880261389464 35.657699243183416, -82.5785296138334 35.65780224317635, -82.57827061377441 35.657905243170674, -82.57819961375846 35.65793224316892, -82.57798761371042 35.65801524316396, -82.57791761369442 35.658043243162496, -82.57777561366325 35.65809224315785, -82.57753761361062 35.65817724315066, -82.5773466135714 35.65822524314086, -82.57729561356089 35.65823824313824, -82.57720061354186 35.65825924313274, -82.57707561351675 35.658287243125606, -82.57670361344205 35.6583702431042, -82.57657961341705 35.658399243097364, -82.57634361337198 35.658437243080854, -82.57616061333995 35.658447243064046, -82.57602061331764 35.65844124304839, -82.57596561330875 35.6584392430424, -82.57576161327783 35.658420243017524, -82.57552461324322 35.65838924298684, -82.57527961320976 35.65834224295206, -82.57512461319004 35.65830324292816, -82.5746646131345 35.658167242853196, -82.574603613127 35.65815024284343, -82.57440861310293 35.65809624281237, -82.57437861309901 35.658089242807854, -82.57411961306498 35.65803124276939, -82.57400461304874 35.6580122427537, -82.57382661302253 35.65799024273097, -82.5737116130053 35.65797824271662, -82.57323961293241 35.657942242660745, -82.57323461293159 35.657942242660326, -82.57286361287363 35.65791824261725, -82.57222761277409 35.65787824254362, -82.57183361271366 35.657845242496435, -82.5716486126859 35.65782624247349, -82.57147961266041 35.65780924245268, -82.57142261265173 35.6578042424458, -82.57089361257025 35.65776224238278, -82.57075361254849 35.6577522423664, -82.5703346124849 35.65771324231536, -82.57019561246368 35.65770124229861, -82.5700426124406 35.65768624227978, -82.56992561242265 35.657676242265715, -82.5695866123705 35.65764924222537, -82.56943461234695 35.65763824220749, -82.56878661224677 35.657589242130925, -82.56854261221439 35.65753624209498, -82.56824661218018 35.65743924204474, -82.56823261217852 35.657435242042524, -82.56796461214853 35.65734124199586, -82.56766161211604 35.65722524194101, -82.5672836120735 35.65709424187549, -82.56717661206355 35.65704324185408, -82.56707861205359 35.6570022418356, -82.56695761204138 35.65695124181276, -82.56638761198647 35.656693241701625, -82.56610861195675 35.656585241651, -82.5659386119348 35.65654424162512, -82.565881611926 35.65654024161846, -82.56586961192423 35.65653924161701, -82.56579661190973 35.65655424161254, -82.5656876118831 35.65660924161261, -82.56559761186048 35.6566592416135, -82.56545461182598 35.65672824161279, -82.56498861172754 35.656864241592565, -82.56485761169795 35.656915241589495, -82.56457161163259 35.65703024158349, -82.56431061157771 35.65710524157186, -82.56403961152338 35.65716524155624, -82.56387461148682 35.65722424155128, -82.56371461144815 35.657302241550674, -82.56365761143428 35.657331241550715, -82.5636096114232 35.65735124154983, -82.56344361138463 35.65742224154727, -82.56329861135453 35.657461241540275, -82.56326261134687 35.65747224153883, -82.56301061129632 35.657528241524275, -82.5629326112835 35.6575272415161, -82.56287561127407 35.65752724151027, -82.56276061126115 35.65748724149019, -82.5625446112388 35.65739924145008, -82.56239161121631 35.65738024143046, -82.56229561120229 35.65736824141813, -82.5621726111759 35.65740624141323, -82.56204761114135 35.657495241418594, -82.56202961113685 35.65750524141867, -82.56190861110518 35.65758024142151, -82.561792611078 35.657631241419956, -82.5617406110689 35.65763424141521, -82.56169561106528 35.657609241405524, -82.56163961106358 35.65756024138979, -82.56149761104234 35.657545241372155, -82.56104361097412 35.65749824131579, -82.56069861095118 35.65727524123492, -82.56046261089362 35.65739424123488, -82.56012661081134 35.65756524123511, -82.5590916105646 35.65804924122726, -82.55740361012012 35.65911124126975, -82.5571516100506 35.659290241280296, -82.55687460997406 35.659488241292166, -82.55637360986199 35.65967424127841, -82.5559756097914 35.65970324124341, -82.55533460967732 35.65975224118745, -82.55471560961107 35.65951524107549, -82.55412360954979 35.6592752409657, -82.55326960946134 35.65892924080747, -82.55254560933169 35.658990240745325, -82.55169160915804 35.65919524069918, -82.5503706088407 35.65982924069238, -82.55024760880482 35.65992924070002, -82.54980860864632 35.66048324076768, -82.5491886085726 35.660293240665226, -82.54891760855543 35.66011324060071, -82.5484716085272 35.659816240494365, -82.54825360854029 35.659497240406935, -82.54807160859515 35.658946240276045, -82.54799960861648 35.6587312402249, -82.54787460862234 35.658558240176845, -82.54764560862422 35.658300240100694, -82.5473086086226 35.657948239994425, -82.54676760854527 35.65786723992224, -82.54642760849664 35.65781623987692, -82.54638860849107 35.65781023987163, -82.54627460847469 35.65779323985646, -82.54623660846921 35.65778823985147, -82.54619760845686 35.65782623985526, -82.54608160842002 35.657940239866534, -82.54604360840762 35.65797923987051, -82.54604360840749 35.6579802398707, -82.54588560836493 35.65808623987608, -82.54549760825978 35.65834923988967, -82.5454126082554 35.65828623986811, -82.54525860824711 35.65817423982951, -82.54525660824696 35.65817323982908, -82.54518460823226 35.65819123982531, -82.54496560818706 35.6582482398144, -82.54489260817188 35.65826823981097, -82.54488760817068 35.65827023981085, -82.54478160815938 35.658229239791616, -82.54446960812601 35.65811023973528, -82.54445760812675 35.65809223973037, -82.54439460813154 35.65799323970374, -82.54431160813783 35.65786323966871, -82.54424460814299 35.65775823964041, -82.54391860810131 35.65767723959046, -82.54377060808245 35.65764023956764, -82.54374960807971 35.6576352395645, -82.54368660807162 35.65762023955491, -82.54366660806902 35.657615239551795, -82.54364660807602 35.65754823953613, -82.54358860809704 35.65735023948992, -82.54358360809901 35.65733223948571, -82.54356860810373 35.65728523947464, -82.54353660811323 35.657189239451746, -82.54353660811353 35.65718723945134, -82.54350360812926 35.657050239420016, -82.54349660815059 35.65690423938958, -82.54349460815232 35.6568912393868, -82.54348560816288 35.65681323936996, -82.54347460816388 35.6567952393652, -82.54344960816603 35.656754239354285, -82.5433656081576 35.65671823933831, -82.54321160813157 35.656721239323055, -82.54309460810502 35.6567672393204, -82.54293260806703 35.65683923931834, -82.54290260805982 35.656853239318146, -82.54281660804399 35.65686323931133, -82.54273460803076 35.65686123930249, -82.54260760801627 35.656818239280675, -82.54244660799621 35.65677523925533, -82.54220960795908 35.65676023922789, -82.54195560791803 35.65675323920034, -82.54179460789422 35.65673423917989, -82.54163260786665 35.656738239164014, -82.54138460782039 35.65677123914527, -82.54121360779305 35.65676423912631, -82.54116560778463 35.65676723912185, -82.5409726077503 35.65678223910514, -82.54059760766572 35.65692623909582, -82.54059060767628 35.65685023907965, -82.54030560768771 35.65647023897296, -82.5402766076988 35.65636723894902, -82.5403646077642 35.65603823889106, -82.54057060782225 35.65588423888092, -82.54089860789199 35.65578523889449, -82.5413886080568 35.65524523883502, -82.54163860812267 35.65508723882857, -82.54179060815474 35.655043238835255, -82.54227660823776 35.65502823888222, -82.54230260824217 35.655028238884924, -82.54253060829417 35.654936238889604, -82.54268260834493 35.65477123887171, -82.54288760843409 35.65441423882011, -82.54296260848612 35.65415823877567, -82.54295060850805 35.65400323874295, -82.54285360853041 35.65375423868228, -82.54276360852597 35.653686238659134, -82.54266660851125 35.65367723864739, -82.54256660848878 35.653715238644835, -82.54232560839961 35.654033238684754, -82.54222560837091 35.654111238690284, -82.54188360829674 35.65422423867811, -82.54176860828808 35.654156238652455, -82.541772608303 35.65406423863413, -82.54182160832099 35.65400023862614, -82.54213360839891 35.65383123862384, -82.5423256085015 35.653373238550394, -82.54328260876015 35.65272823851755, -82.54371660884318 35.652657238547725, -82.5439436088963 35.65255723855073, -82.54424760899059 35.65227423852442, -82.54463860908592 35.652077238524576, -82.54480760913339 35.65195123851626, -82.54493460918094 35.651780238494524, -82.544984609211 35.65163923847096, -82.54503260928679 35.651200238386544, -82.54510360932187 35.65104923836314, -82.54590960962024 35.6499842382292, -82.54610060965139 35.64998723824948, -82.54617260965264 35.650057238271174, -82.54617860963297 35.650191238299094, -82.54601560958504 35.65032623830979, -82.54575960950915 35.65054223832739, -82.54565960945035 35.65081523837268, -82.5456726094341 35.65093423839827, -82.54599760936551 35.651728238593286, -82.54605160935733 35.65183923862147, -82.5461226093625 35.651882238637505, -82.54621860937873 35.65188023864701, -82.5462826093983 35.6518222386418, -82.54609460942065 35.651475238551775, -82.54602560949078 35.650947238437226, -82.54606460951752 35.65081623841458, -82.54613260953914 35.65074923840786, -82.54624460956319 35.65071423841228, -82.54631060957733 35.65069323841479, -82.5463876095939 35.65066923841781, -82.54641060959774 35.650668238420046, -82.5469306096859 35.65065723847126, -82.5469666096919 35.650657238475, -82.54709960971951 35.650621238481335, -82.54720360974105 35.65059323848634, -82.547302609764 35.65055123848796, -82.54740060979015 35.65048723848497, -82.54740960979305 35.650478238484084, -82.54746960981232 35.650418238478046, -82.54755060985083 35.65025623845339, -82.54758060987322 35.6501432384335, -82.54758060991833 35.6498512383741, -82.54758760992375 35.64982323836909, -82.54760360993572 35.64976323835855, -82.54764460995213 35.649701238350104, -82.54771960997341 35.649644238346234, -82.54791961002574 35.64952023834154, -82.54797361004135 35.64947723833836, -82.54804061006793 35.649377238324874, -82.54806861008689 35.64928423830884, -82.54807161012018 35.64907223826596, -82.54808661013655 35.648982238249225, -82.54812261015533 35.64889923823601, -82.54817861017627 35.64882423822654, -82.54836361022976 35.64867623821542, -82.54843161025087 35.648613238209606, -82.54847561027066 35.648532238197646, -82.5485086103007 35.648373238168666, -82.548537610318 35.648292238155214, -82.5485886103433 35.648183238138216, -82.54868061038356 35.648021238114666, -82.54872061040433 35.647930238100315, -82.5487686104374 35.64776723807211, -82.54878361045648 35.64766023805183, -82.54880461050267 35.64738323799758, -82.54880661051865 35.647282237977265, -82.54878361052592 35.6472102379602, -82.54874961052998 35.64714723794387, -82.54873361052996 35.647130237938754, -82.54869161052993 35.647085237925296, -82.54860561052493 35.64702523790425, -82.54834561050241 35.6468912378502, -82.54817661048529 35.64682023781839, -82.54807861047459 35.646784237800965, -82.54790661045423 35.64673123777253, -82.54784961045063 35.646693237758825, -82.54782761045425 35.64664623774705, -82.54782361045459 35.64663923774524, -82.54784361046661 35.646583237735854, -82.54789361048182 35.64653823773188, -82.54795861049509 35.64652223773521, -82.54806561051059 35.646537237749335, -82.54815561051743 35.64658923776918, -82.54834961053238 35.64670123781198, -82.54847361054516 35.64675223783508, -82.54857661055884 35.646774237850096, -82.54869661057799 35.64677923786347, -82.54910661064795 35.646767237903255, -82.54922361066568 35.646778237917516, -82.54935461068435 35.64679823793505, -82.5493556106845 35.646798237935165, -82.54963561071747 35.64688623798191, -82.54970361072796 35.6468912379899, -82.54975661073844 35.64688023799308, -82.549768610741 35.64687723799368, -82.54982861075648 35.64684123799263, -82.54986161077107 35.646782237983935, -82.54986261078355 35.646702237967766, -82.54982761078992 35.646623237948084, -82.54974761078422 35.646574237929876, -82.54971461078 35.64656623792481, -82.54965761077263 35.646552237916126, -82.54921361070122 35.64653723786748, -82.54911261068783 35.646515237852526, -82.5489846106733 35.64647223783064, -82.54890461066663 35.64642923781365, -82.54885161066493 35.64638323779887, -82.54881861066686 35.64633523778566, -82.54880461067557 35.64626323776958, -82.54882261069422 35.646162237750836, -82.54889361073381 35.64598223772155, -82.54889561073479 35.64597823772094, -82.5489276107578 35.64586323770081, -82.54894461078241 35.6457222376739, -82.54892661079614 35.645613237649805, -82.54890661080279 35.64554923763471, -82.54884361081868 35.645378237593405, -82.5488046108254 35.64529323757211, -82.54877861083939 35.64517423754517, -82.54876861086427 35.64500223750923, -82.54878661089384 35.64483023747602, -82.54882461091977 35.64470323745411, -82.5488706109456 35.644585237434754, -82.54893661097265 35.64448123742039, -82.54899061099272 35.64440923741134, -82.549051611015 35.644330237401505, -82.54911961104146 35.64423223738856, -82.54918261107152 35.64410523736919, -82.54921661109088 35.64401623735454, -82.54923361110765 35.64392623733798, -82.54923161112147 35.643834237319034, -82.54920761113574 35.64371623729257, -82.54913961115673 35.643507237243014, -82.54899061119299 35.6431122371473, -82.54889861122486 35.64280623707554, -82.54882361126538 35.64246323699796, -82.54865561139877 35.64141823676795, -82.54858161146467 35.64091123665712, -82.54840761162123 35.639710236394805, -82.54839161163517 35.63960223637118, -82.54833261167079 35.63930823630526, -82.54829261169532 35.639106236259984, -82.54819861173881 35.63872323617234, -82.5481256117657 35.63847023611341, -82.54801761180106 35.638125236032025, -82.5478966118409 35.63773623594044)))",6455,37,021,001600,370210016003,1486,1486,122,1463,1382,33,5,10,0,33,23,1245,83,1162,1234,1176,24,4,7,0,23,11,717,611,106
census_2010_blockgroups_view.fid--2dc29038_13ec899ba8f_-262f,"MULTIPOLYGON (((-82.44016761787972 35.48243919329141, -82.43999661783353 35.48255619329763, -82.43948661769522 35.48290819331684, -82.439316617649 35.48302619332335, -82.43893661754598 35.48328819333759, -82.43811761732346 35.483856193369, -82.43779961723659 35.48407919338167, -82.43775761722515 35.484109193383404, -82.43741961713376 35.48434019339566, -82.43724261708583 35.48446219340228, -82.43671061694154 35.48482919342229, -82.4365346168936 35.48495219342918, -82.43606861676759 35.48527119344623, -82.43594261673327 35.48535919345119, -82.43534661657198 35.48576819347306, -82.43467661638944 35.48623619349949, -82.43467561638911 35.4862371934995, -82.4343686163034 35.486465193514384, -82.43423161626264 35.48658319352429, -82.43404461620416 35.48676219354141, -82.43392861616647 35.486883193554085, -82.4337486161034 35.48710019357968, -82.43358461604346 35.48731419360638, -82.43342661597856 35.487567193641574, -82.43333161593765 35.487731193665105, -82.43312661583434 35.48818419373612, -82.43308861581528 35.48826719374913, -82.43255361554115 35.489477193940004, -82.43247761550283 35.489645193966346, -82.43241361546971 35.48979219398962, -82.43234761543503 35.48994719401445, -82.43233761542977 35.48997019401802, -82.43178561514824 35.49121019421328, -82.43169361509996 35.491426194247744, -82.43155961503663 35.491694194288385, -82.43144061498398 35.49190919431988, -82.43132261493636 35.49209219434498, -82.43120761489347 35.49224819436487, -82.43108261484866 35.492405194383885, -82.43096561480894 35.492538194398946, -82.43079361475392 35.49271119441643, -82.43058061469031 35.49289619443214, -82.43009061455035 35.49328019445985, -82.42991161449952 35.49341919446978, -82.42979861446713 35.49350819447628, -82.42828361403795 35.49467219455717, -82.42795561394519 35.49492319457457, -82.42697461366711 35.49567819462722, -82.42664761357425 35.495931194645074, -82.42629161347351 35.496204194663974, -82.42543161322949 35.49686719471036, -82.42522761317142 35.49702619472171, -82.4250356131165 35.49717719473266, -82.42487461307084 35.49730119474131, -82.42482861305788 35.49733619474372, -82.42469161301922 35.4974401947508, -82.42464661300622 35.4974761947535, -82.42446061295375 35.497618194763284, -82.42438561293199 35.49767919476792, -82.42407661284162 35.49793519478827, -82.4237666127461 35.49822319481491, -82.42365161270878 35.498342194827295, -82.42342361263464 35.498580194852195, -82.42333061260344 35.49868319486362, -82.42295961247389 35.49912719491571, -82.42269861237534 35.49948819496227, -82.42209261213118 35.50042619509056, -82.4219806120859 35.50060019511443, -82.42153761190684 35.50128919520894, -82.42120661177258 35.50180719528022, -82.42103761170495 35.502066195315436, -82.42084961162557 35.50238019535987, -82.4207386115749 35.50259119539135, -82.42068261154596 35.50271919541164, -82.4205246114527 35.503156195484216, -82.42043561140058 35.50340019552462, -82.42036361135843 35.50359719555722, -82.42017161124448 35.504132195646186, -82.42014561122885 35.504206195658575, -82.42007961119194 35.50437519568618, -82.42004661117376 35.504458195699605, -82.42002761116295 35.50450819570784, -82.41993461111757 35.50470319573784, -82.41992861111449 35.504717195740135, -82.41989661109886 35.50478419575039, -82.41976661104263 35.50501019578297, -82.41961461098236 35.50523919581389, -82.41961361098218 35.505239195813786, -82.4194216109112 35.5054951958461, -82.41919061083354 35.505752195874564, -82.41896561076213 35.50597519589673, -82.41871161068609 35.50619619591559, -82.41849561063005 35.5063291959204, -82.4184596106224 35.506340195919, -82.41819861056555 35.50642919591019, -82.41794061051706 35.50646719589146, -82.41781961049439 35.50648419588249, -82.4176066104545 35.506515195866946, -82.41745861042743 35.50653219585517, -82.4173386104052 35.506547195845876, -82.41728661039588 35.50655219584158, -82.4171306103673 35.506570195829184, -82.41707961035782 35.50657719582537, -82.41685661031683 35.506604195807995, -82.41652961025676 35.5066431957823, -82.4150286099805 35.50682619566533, -82.41488360995085 35.506863195658, -82.41478860993132 35.50688819565328, -82.4145846098845 35.506973195649586, -82.41438860983264 35.50710019565528, -82.41435860982479 35.50711919565611, -82.41426860980116 35.50717619565842, -82.41423960979327 35.50719619565945, -82.41402660973483 35.507347195668274, -82.41377460966584 35.507525195678554, -82.41311960948748 35.50798119570389, -82.4127916093946 35.50823319572142, -82.41250160930795 35.50848519574283, -82.41227960923611 35.50871419576655, -82.41213560918602 35.5088851957865, -82.41170760903077 35.50943519585421, -82.4115556089746 35.50963719587972, -82.41051460859224 35.51100619605084, -82.41035660853369 35.51121719607746, -82.41029060850835 35.51131119608975, -82.41015460845624 35.511504196115006, -82.41008860842281 35.51165019613783, -82.410037608392 35.51179619616226, -82.41001260836153 35.51196719619446, -82.40996360821944 35.51283919636652, -82.40995460816531 35.51318219643531, -82.40994660811668 35.513490196497116, -82.40996060806685 35.51382919656736, -82.41002160803527 35.51410019662872, -82.41008160799377 35.51443519670285, -82.4100956079833 35.51451819672116, -82.4101056079736 35.514592196737254, -82.41012660795617 35.51472819676698, -82.41012560793283 35.51487919679764, -82.41010060790761 35.51501619682284, -82.41009160789808 35.515068196832466, -82.41003160786391 35.5152261968584, -82.4099326078201 35.51540519688466, -82.40982960778351 35.51553219689987, -82.4097006077428 35.515658196912185, -82.40961660771939 35.51572019691617, -82.40954560769929 35.51577419691979, -82.4094066076644 35.5158521969214, -82.40936760765535 35.51586919692084, -82.40923460762441 35.51592719691897, -82.409062607588 35.51597919691187, -82.40901460757777 35.51599419690998, -82.40893660756274 35.516008196904764, -82.40882260754084 35.516028196897125, -82.40858960750012 35.51604219687606, -82.40839860747043 35.51603019685395, -82.4081996074421 35.51600019682746, -82.40810260742977 35.51597619681266, -82.40778760738925 35.51590119676498, -82.4074526073466 35.5158181967137, -82.40744860734611 35.515817196713094, -82.40717860731074 35.51575719667321, -82.40693060727665 35.515712196638525, -82.40677860725458 35.51569219661889, -82.40664760723557 35.51567519660198, -82.40643160720231 35.515659196576514, -82.40638060719434 35.51565619657073, -82.40608760714794 35.51564319653794, -82.40524460700922 35.51563919645059, -82.40502760697328 35.515639196428225, -82.4047666069309 35.51563419640045, -82.40461660690578 35.51563619638538, -82.40452660689067 35.51563819637657, -82.40432960685659 35.515648196358356, -82.40416760682555 35.51567519634719, -82.40400660679146 35.51572419634063, -82.40388660676209 35.51578619634091, -82.40377760673286 35.515859196344536, -82.4036776067021 35.5159521963532, -82.40357360666506 35.51608119636864, -82.403313606558 35.51649819642662, -82.40319860651019 35.51668519645282, -82.40306560645492 35.51690219648322, -82.40284260636197 35.51726719653443, -82.40276160632722 35.5174061965544, -82.4027126063065 35.51748819656599, -82.40263160627177 35.51762719658591, -82.40256060624372 35.51773319660013, -82.40250760622249 35.51781419661114, -82.40241060621534 35.51775619658942, -82.40212260619452 35.517582196524515, -82.40207260619086 35.51755219651321, -82.40202660618745 35.51752519650304, -82.40189760617781 35.51744919647434, -82.40151360614905 35.517223196389004, -82.40138560613941 35.51714819636059, -82.40128760613214 35.51709019633877, -82.40099460611029 35.516917196273496, -82.40089760610306 35.51686019625201, -82.40060460608122 35.516687196186744, -82.3999126060295 35.51627919603271, -82.39972760601576 35.51617019599163, -82.39943560599372 35.51599919592686, -82.39901160596229 35.51574819583234, -82.39816260589915 35.51524619564317, -82.39773760586672 35.51500019554955, -82.39731260583437 35.51475319545564, -82.39725660583025 35.51472019544321, -82.39708960581777 35.51462119540593, -82.39703460581381 35.51458819539364, -82.39683960579927 35.514473195350206, -82.39645860577093 35.514248195265345, -82.3962566057559 35.5141281952202, -82.39606260574145 35.51401419517716, -82.3960296057389 35.5139951951699, -82.39593060573121 35.513938195148164, -82.39589760572875 35.51391919514095, -82.39521560567809 35.51351519498876, -82.39465260563357 35.51320019486696, -82.39427960559709 35.51303619479539, -82.39417960558656 35.512997194777114, -82.39387860555526 35.512877194721895, -82.39383260555104 35.51285519471272, -82.39346260552398 35.51263319462957, -82.39304060553347 35.51211819448164, -82.3929396055369 35.51198719444464, -82.39283460554171 35.51184319440465, -82.39265560554972 35.51159819433647, -82.39225760556754 35.51105419418509, -82.39211860557319 35.51086819413306, -82.39193760558052 35.51062619406533, -82.39187760558286 35.5105461940429, -82.39159460559482 35.51016419393621, -82.39129260560756 35.50975619382231, -82.3907496056259 35.5090531936238, -82.39054760562053 35.508871193566094, -82.39049760561669 35.508842193555054, -82.39031360560254 35.50873619351465, -82.39015260558692 35.50866519348371, -82.3899736055655 35.50861219345456, -82.38982960554645 35.50858119343344, -82.38972760553278 35.5085601934187, -82.38945860549482 35.508518193382514, -82.38939360548514 35.50851119337446, -82.38924760546301 35.50849819335682, -82.38900660542454 35.50848919333015, -82.38872260537661 35.508496193302456, -82.38838460531541 35.508531193274784, -82.38821460528376 35.50855419326205, -82.38799860524345 35.50858419324594, -82.38678660501408 35.50877419315995, -82.38522160471973 35.50900719304653, -82.38513960470425 35.50901919304056, -82.384115604511 35.50917619296718, -82.38400460448996 35.50919319295925, -82.383672604427 35.509246192935926, -82.38356260440605 35.509264192928235, -82.38331160435901 35.509301192909966, -82.38307660431587 35.50932919289159, -82.38297860429891 35.509334192882484, -82.38291560428787 35.50933819287681, -82.38268560425095 35.50933119285169, -82.38245960421932 35.509294192820974, -82.38236860420822 35.50926819280635, -82.38217760418505 35.50921419277574, -82.38195060416426 35.509105192730345, -82.38135560412177 35.50874219259547, -82.38085460408585 35.50843719248213, -82.38077760408035 35.50839019246466, -82.38054860406429 35.50824919241248, -82.38047260405894 35.508202192395174, -82.37998560402454 35.50790219228419, -82.37924560397214 35.50744819211599, -82.37852460392088 35.50700619195209, -82.37803860388644 35.50670819184169, -82.37764460385893 35.50646419175161, -82.37699360381309 35.5060621916032, -82.37646160377471 35.50574019148309, -82.37606660374622 35.50550119139398, -82.37589360373414 35.50539419135447, -82.37537460369735 35.50507519123642, -82.37520160368514 35.50496919119714, -82.37493260366622 35.504803191135714, -82.37412660360947 35.504306190952015, -82.37385860359062 35.50414119089103, -82.37355860356934 35.50395719082287, -82.3726616035058 35.503406190618804, -82.37236260348456 35.503223190550884, -82.37226460347756 35.50316319052869, -82.37197260345705 35.502983190462096, -82.37187560345014 35.50292419044019, -82.37180060344475 35.50287819042314, -82.37157860342916 35.50274119037255, -82.37150460342387 35.50269619035573, -82.37093460338356 35.502346190226135, -82.37073660336941 35.502225190181214, -82.37010660332663 35.501826190035494, -82.36923160326442 35.50129118983701, -82.36881860323491 35.50103918974341, -82.3686586032223 35.50094918970868, -82.36808160317617 35.50062918958445, -82.36775160314801 35.50045818951581, -82.3674676031257 35.500298189454156, -82.3673746031223 35.500220189428724, -82.36732860312331 35.50016418941258, -82.36729860312637 35.500112189399, -82.36724360314444 35.49993518935739, -82.36722360315176 35.499866189341354, -82.36719260315837 35.49979018932279, -82.36715560316067 35.49973518930783, -82.36710060316071 35.49967618929019, -82.36705560315744 35.49964918928006, -82.36703560315593 35.49963718927553, -82.36696760315014 35.49960218926145, -82.3668126031311 35.49955918923679, -82.36658560310097 35.49951118920372, -82.3665246030939 35.49949218919359, -82.36642760308457 35.499448189174736, -82.36637960308141 35.49941718916355, -82.36634560308148 35.49938018915245, -82.36631760308424 35.49933218913985, -82.36630060309464 35.49924618912068, -82.36630460310279 35.49919718911115, -82.3663236031127 35.49915318910415, -82.36635060312268 35.49911718909959, -82.36640960313933 35.49907218909656, -82.36644460314803 35.499053189096294, -82.36653560316618 35.49903318910157, -82.366583603175 35.49902718910533, -82.36663760318332 35.499031189111626, -82.36669060319042 35.49904218911931, -82.36677460320057 35.49906618913278, -82.36705760323053 35.49917518918402, -82.36715360323981 35.49921818920258, -82.36734760326144 35.49928618923642, -82.36742360327023 35.499310189248995, -82.36757560329124 35.49933718927011, -82.36774960331715 35.49935518929164, -82.36791760334462 35.499357189309336, -82.36801260336091 35.49935318931831, -82.36808760337559 35.49933818932296, -82.36816060339272 35.49930518932377, -82.3682056034055 35.49927018932125, -82.36826360342765 35.49918818931052, -82.36828360343848 35.49913918930265, -82.36827460345089 35.499049189283504, -82.36824860345335 35.499005189271855, -82.36819560345444 35.498941189253436, -82.36815960345265 35.498914189244275, -82.36805160343984 35.49888118922644, -82.36789060341269 35.498885189210704, -82.36779160339353 35.49890318920424, -82.36759760335417 35.498951189194, -82.36752460334112 35.498957189187706, -82.36745760333002 35.498957189180835, -82.3673896033196 35.49895218917282, -82.3673046033082 35.498935189160655, -82.36719860329715 35.49889318914126, -82.36713160329144 35.49885818912723, -82.36707060328727 35.49882018911325, -82.36706060328807 35.49880418910901, -82.36688160328389 35.49863918905711, -82.36671660328328 35.498465189004826, -82.3666276032822 35.49837718897783, -82.36657960328054 35.49833618896463, -82.36653460328014 35.498290188950605, -82.3664876032776 35.498256188938846, -82.36636460326696 35.49819318891347, -82.36629660325913 35.498171188902, -82.36624960325253 35.498164188895764, -82.36614860323813 35.49814918888237, -82.36604460322198 35.49814218887023, -82.36597060320977 35.49814218886264, -82.36580560318471 35.4981281888428, -82.36574660317712 35.498114188833945, -82.36569360317131 35.49809518882463, -82.3656366031666 35.498064188812485, -82.3655776031634 35.49802218879788, -82.36553760316454 35.49797118878341, -82.36551260316747 35.49792518877149, -82.36551160316763 35.49792318877101, -82.36542760318348 35.497730188723224, -82.36530960321507 35.49739718864349, -82.36524060323961 35.497163188588836, -82.36523260324677 35.49710818857697, -82.36523160325352 35.49706318856766, -82.36523660326249 35.49701018855739, -82.36528260329467 35.496850188529606, -82.36543160337278 35.49650218847428, -82.36547160339144 35.49642318846236, -82.36554160342968 35.496250188434445, -82.36561360346542 35.496094188410204, -82.36563760347968 35.496027188399076, -82.36565260349126 35.495968188388645, -82.36565860350159 35.49590718837682, -82.36566560351305 35.495840188363964, -82.36565760351928 35.4957911883532, -82.36563060353005 35.495692188330324, -82.3655076035552 35.49539618825757, -82.36550560355585 35.49539018825624, -82.36509860362683 35.494490188031634, -82.36500360363779 35.49431718798679, -82.36496160363922 35.49426218797129, -82.36490860363743 35.49421718795671, -82.36484960363224 35.49418718794453, -82.36482660362921 35.494182187941206, -82.36472160361545 35.494159187925725, -82.36465860360563 35.49415518791844, -82.36463360360095 35.49415918791665, -82.36458360359116 35.49416918791363, -82.3645026035728 35.49420118791171, -82.36441660355202 35.49424418791166, -82.36427560351314 35.49434618791787, -82.36416060348456 35.49440818791859, -82.36408960346837 35.49443718791727, -82.36400160345156 35.494452187911264, -82.36392160343853 35.494451187902776, -82.3638416034286 35.494430187890295, -82.36382160342664 35.49442118788645, -82.36375360341827 35.4944021878756, -82.36366860341032 35.494363187858994, -82.36358060340449 35.49430618783833, -82.36347960340076 35.49422218781095, -82.36342060340023 35.494162187792696, -82.36327060339892 35.49400918774617, -82.36319660339959 35.49392518772155, -82.36314960340191 35.49386018770356, -82.36308260340888 35.493742187672716, -82.36306860341348 35.493697187662114, -82.3630726034202 35.493658187654596, -82.36308860342992 35.49361218764695, -82.36311660344178 35.49356518764025, -82.36315860345545 35.4935211876357, -82.36319960346708 35.493489187633394, -82.36324660347735 35.49347318763499, -82.36331060349033 35.49345718763826, -82.36338360350287 35.49345418764513, -82.36354560352264 35.493499187670906, -82.36366760353408 35.49355618769503, -82.36379460354674 35.493610187719035, -82.3638626035563 35.49362118772826, -82.36394760356956 35.49362618773803, -82.3640276035849 35.49361218774339, -82.36409460360136 35.49357718774319, -82.36413860361338 35.49354618774144, -82.36417660362606 35.49350418773678, -82.36433160369047 35.49325118770132, -82.36440860372541 35.49310718768, -82.36443560373898 35.49304718767061, -82.36447760375661 35.49297818766094, -82.36447960375723 35.4929761876607, -82.3645776037898 35.49286918764903, -82.36463660380683 35.492822187645544, -82.36471560382752 35.49277218764355, -82.36479660384676 35.49273418764419, -82.36497460388114 35.49270118765568, -82.36515960391522 35.49267818767011, -82.36521860392726 35.49266318767314, -82.36529660394321 35.4926431876771, -82.36534660395519 35.492619187677334, -82.36538660396648 35.492588187675146, -82.36542860398127 35.4925371876691, -82.36545360399312 35.492487187661524, -82.36544660400446 35.492406187644384, -82.36543860400936 35.49236518763523, -82.3654126040126 35.49231618762256, -82.36538060401398 35.49227318761056, -82.3653296040108 35.492239187598415, -82.36526860400554 35.49220718758568, -82.36514060398736 35.49218818756867, -82.36496860395954 35.49218418755023, -82.3647916039287 35.49219518753425, -82.36473960391639 35.49221918753377, -82.36467260389948 35.49225718753459, -82.36461860388302 35.49230618753897, -82.3645676038662 35.49236118754491, -82.3644566038218 35.492531187568055, -82.3643836037951 35.49262618757984, -82.3643236037771 35.49267918758442, -82.36426060376084 35.492717187585605, -82.36419160374594 35.49274018758323, -82.36410060372933 35.49275018757587, -82.36400260371427 35.49274318756438, -82.36393260370616 35.492720187552514, -82.36387560370262 35.49268218753899, -82.36380760369987 35.49262718752083, -82.3636856036974 35.49251218748496, -82.36351360369108 35.49236818743806, -82.36338760369087 35.49223418739786, -82.3631066036831 35.49198318731811, -82.3630356036792 35.491932187300414, -82.3629656036742 35.491889187284535, -82.36288060366294 35.49187118727213, -82.36277060364476 35.49187118726083, -82.36271560363281 35.49189018725905, -82.36257860360269 35.49193918725495, -82.3624766035786 35.49198618725396, -82.36237260355728 35.49201318724876, -82.36228160354199 35.49201518723979, -82.36220760353355 35.49199018722715, -82.36214760352814 35.49196118721507, -82.36210260352627 35.4919251872032, -82.3620626035291 35.49186318718654, -82.36204760353552 35.49180518717317, -82.36205660354672 35.491742187161314, -82.36208960355941 35.49169518715512, -82.3621516035792 35.49163318714896, -82.36220860359484 35.49159218714647, -82.36227260361035 35.49156018714656, -82.36233860362483 35.491536187148455, -82.36242460364502 35.49149818714959, -82.36268060370024 35.49141318715866, -82.36276560371743 35.49139318716329, -82.36286360373622 35.49137618716993, -82.36293460374807 35.49137518717699, -82.3629986037568 35.49138718718597, -82.36306260376352 35.491412187197646, -82.36312960376812 35.49145418721302, -82.36318860377112 35.4914971872278, -82.36325960377376 35.49155718724729, -82.36338060377456 35.491682187285136, -82.36342560377398 35.49173418730037, -82.36348260377632 35.491780187315484, -82.36354760378092 35.49182018733027, -82.36361960378757 35.4918541873446, -82.36371060380094 35.491865187356225, -82.3638166038206 35.49185018736408, -82.36391560384733 35.49178318736058, -82.36397460386769 35.49171418735266, -82.36399660388096 35.491651187342086, -82.36399060389024 35.49158418732789, -82.36395360389461 35.49151618731031, -82.36388860389296 35.491457187291644, -82.36378660388624 35.49139118726778, -82.36368860387759 35.49134218724773, -82.36358760386659 35.49130518722985, -82.36329460384032 35.4911611871705, -82.36304360381412 35.491062187124626, -82.36294160380281 35.491026187106804, -82.36272960378116 35.49093918706748, -82.36263460377069 35.49090518705077, -82.36253660375836 35.4908801870356, -82.36243660374292 35.490873187023965, -82.36230660372165 35.49087218701041, -82.36218160369805 35.49089118700141, -82.36187960363534 35.4909751869874, -82.36169860359686 35.491031186980145, -82.3614536035483 35.49108418696578, -82.3613356035289 35.491083186953475, -82.36122560351428 35.49106018693748, -82.36116160350774 35.49103418692558, -82.36110460350466 35.49099318691142, -82.3610616035063 35.49093618689552, -82.36105060351267 35.49088318688354, -82.36104660352012 35.490830186872415, -82.36104960352974 35.490770186860544, -82.36108660354577 35.49070618685135, -82.36114060356424 35.49064418684431, -82.36120460358055 35.49060618684316, -82.36138760361898 35.49055318685119, -82.3615336036467 35.49052918686134, -82.36189060371603 35.490461186884204, -82.36199760373604 35.49044618689214, -82.36219360377079 35.49043118690928, -82.36228560378574 35.49043218691888, -82.36245660381078 35.49045318694072, -82.36265260383414 35.49051118697266, -82.36284460385303 35.49059518700938, -82.36307760387291 35.49071618705796, -82.3633046038954 35.49081318710091, -82.36337760390478 35.49083118711205, -82.36346960391842 35.49084118712354, -82.36354960393348 35.4908291871293, -82.36360660394683 35.49080318712995, -82.36365060395896 35.490771187127976, -82.36368560396988 35.490738187124805, -82.36371460398138 35.49069418711885, -82.36373360399371 35.49063418710864, -82.36372960400112 35.49058218709762, -82.36371860400722 35.490530187085994, -82.3636586040081 35.49046018706568, -82.36360960400606 35.49042118705269, -82.36352760399797 35.490385187036956, -82.36343860398756 35.49035718702213, -82.36334460397515 35.49033718700842, -82.36325160396196 35.490323186995965, -82.36315860394964 35.49030318698242, -82.36307860394 35.490280186969535, -82.36301260393289 35.49025518695769, -82.3629336039268 35.49021018694037, -82.36285560392297 35.49015118692043, -82.36279960392228 35.49009518690326, -82.36267260391843 35.48998418686771, -82.36259960391249 35.48994418685207, -82.36250660390205 35.4899121868361, -82.36236360387942 35.489906186820185, -82.36221460385445 35.48990818680525, -82.36204760382648 35.48991118678865, -82.36191160380493 35.48990518677351, -82.36179260378958 35.48987718675559, -82.36158560376722 35.48980018671873, -82.3614146037518 35.4897171866843, -82.36130560374284 35.48965818666109, -82.36108760372285 35.489554186617575, -82.360896603704 35.48947118658112, -82.36086860370207 35.48945418657486, -82.36058060366638 35.489377186529545, -82.36032160362916 35.48934018649551, -82.36004360358803 35.489310186460855, -82.35989160356564 35.489292186441574, -82.35976460354593 35.489284186426936, -82.35950460350743 35.48925518639428, -82.3593946034911 35.489243186380605, -82.35916260345621 35.48922118635223, -82.3590386034388 35.48920118633551, -82.35909660347116 35.48905318631131, -82.35909560351678 35.488755186250806, -82.35914360367944 35.48774718605114, -82.35956460391715 35.48665218587213, -82.35956560392817 35.48658118585778, -82.35960960398457 35.486261185797304, -82.35963160403016 35.4859881857442, -82.35985760409999 35.485776185724376, -82.35996160414183 35.48561518570241, -82.3599636041583 35.48551018568127, -82.36046460428253 35.48524018567795, -82.361117604424 35.48502018570032, -82.36270460458408 35.48568418599812, -82.36288560461361 35.48568618601713, -82.36401360470907 35.486277186252984, -82.36463260484076 35.486085186277585, -82.36681460529672 35.48546118637503, -82.36715360534792 35.48549218641617, -82.36868560559732 35.48551518657817, -82.36950160572825 35.48554018666701, -82.36951760573899 35.48548718665797, -82.36956960578537 35.48524118661328, -82.3697506058539 35.484989186580755, -82.36997260594455 35.484637186532105, -82.37014960602988 35.48427218647619, -82.37026060608123 35.48405718644392, -82.37029760612347 35.48382118639979, -82.37023860615967 35.48352218633304, -82.37008260617662 35.48324418626058, -82.36998760617568 35.48314818623134, -82.36990060617788 35.48304018620049, -82.36954360616996 35.482708186096446, -82.36948660617321 35.482625186073705, -82.36950060618263 35.48257918606588, -82.36951960619245 35.48253518605884, -82.36960760621443 35.48248718605816, -82.36970160623272 35.48246918606414, -82.36968260623075 35.48246118606055, -82.37029960634342 35.48239118610969, -82.37030260634523 35.48238218610816, -82.37039360636379 35.48235918611288, -82.3705686064154 35.48221118610076, -82.37074560647537 35.48201118607841, -82.37085660652896 35.481781186043136, -82.37117160668949 35.48107418593187, -82.37143860679438 35.48067818587889, -82.3717266068978 35.4803141858346, -82.37189460697348 35.48000118578837, -82.3719386070482 35.47956218570373, -82.3718836070607 35.479421185669466, -82.37179260710622 35.47902718558009, -82.3715826071096 35.478779185508216, -82.37147160712578 35.478554185451145, -82.37139060711428 35.47854218544041, -82.37124160711666 35.47836618538931, -82.37102360709862 35.478249185343174, -82.37098160709617 35.47822018533296, -82.37082360708345 35.47813318529909, -82.37069160707854 35.478023185263254, -82.37055760706848 35.47794418523342, -82.37051060706646 35.47790718522112, -82.3704216070689 35.47779518518922, -82.37036260707166 35.477714185166775, -82.37030460707787 35.477611185139835, -82.37025960709713 35.477437185099916, -82.37021560711398 35.477280185063556, -82.37021060714906 35.47704618501556, -82.37028360718801 35.4768711849875, -82.37032660720791 35.476787184974825, -82.3703326072438 35.476560184929376, -82.37031660726262 35.47642018489929, -82.37027760727568 35.47629318486952, -82.37022360728614 35.47616718483838, -82.3701576072876 35.47608618481521, -82.37001060729408 35.475886184759474, -82.36995160729799 35.47579718473538, -82.36992060730438 35.4757221847169, -82.36991160731681 35.47563118469762, -82.36990360731724 35.47562018469447, -82.36985760732148 35.47554318467416, -82.3698326073418 35.475383184639114, -82.36983860735789 35.475285184619835, -82.3698346073652 35.47523318460881, -82.36988860738361 35.4751711846018, -82.369967607418 35.47503218458174, -82.37002860743542 35.47498418457823, -82.3700916074554 35.47492218457208, -82.37016160747407 35.47487518456973, -82.37033160751587 35.474786184569155, -82.37041160753445 35.47475118457023, -82.3706046075869 35.47461718456289, -82.37060460758765 35.47461218456184, -82.37090460776115 35.47380418442864, -82.37109260796859 35.47265418421448, -82.37106860797688 35.47257418419575, -82.37111560803284 35.47226018413684, -82.37099960807815 35.47184018403967, -82.37067560808462 35.47144918392707, -82.37067060809106 35.47140218391701, -82.37036260807812 35.47115518383526, -82.37033260808835 35.47105618381207, -82.36959960808083 35.47031618358652, -82.36811060805218 35.468901183146436, -82.36807860813184 35.46834718303077, -82.36805260818969 35.467942182945826, -82.36810560830611 35.467240182808766, -82.3680036083135 35.46708218276626, -82.36777160832781 35.466739182672775, -82.36774260832966 35.466696182661096, -82.3675306083426 35.46638418257598, -82.36749760850373 35.46529818235215, -82.36749560851335 35.465233182338714, -82.3674896085406 35.4650491823008, -82.36748360856812 35.4648631822624, -82.36746060868083 35.464103182105795, -82.36704860865348 35.46383818200964, -82.3669466086466 35.463773181986014, -82.3665346086191 35.46350918189015, -82.36648860861614 35.46347918187931, -82.36644260861334 35.46344818186833, -82.3662746086018 35.46334218182958, -82.36612260859903 35.4631971817845, -82.36578160859452 35.462859181680955, -82.36489360858114 35.46199118141355, -82.36356760848606 35.461184181113616, -82.36354960848476 35.461173181109544, -82.36349860848108 35.461142181098054, -82.36348160847987 35.46113218109429, -82.3634576084782 35.461117181088724, -82.36338560847292 35.46107418107263, -82.36336260847118 35.461060181067424, -82.36325060845688 35.46103318105046, -82.36300060842484 35.460973181012605, -82.3630886084403 35.46096718102042, -82.36320360846017 35.46096118103105, -82.36348760850963 35.46094418105674, -82.36434160865795 35.46089618113464, -82.36462660870748 35.46088018116063, -82.36485660874138 35.460906181189515, -82.36498160876316 35.46089918120095, -82.36605060894783 35.46084518129973, -82.36640760900933 35.46082818133291, -82.36657860904094 35.46080618134602, -82.36709160913537 35.4607421813857, -82.36726360916694 35.46072118139908, -82.36734160918004 35.46072018140688, -82.36757660921947 35.46071618143015, -82.36765560923243 35.46071618143826, -82.367716609243 35.46071318144391, -82.36785260926543 35.46071318145785, -82.36821260932544 35.460709181494025, -82.36837060935187 35.46070718150988, -82.36893360944022 35.46073718157369, -82.37019560958977 35.461120181781084, -82.3718116098828 35.46094818191195, -82.37335861007577 35.46135518215335, -82.37415861013959 35.46180018232586, -82.37482661022115 35.46198718243238, -82.37482661016485 35.46235418250688, -82.3750406101856 35.46244918254813, -82.37568261024757 35.46273618267225, -82.37579461025832 35.462786182693876, -82.37590161027101 35.462819182711556, -82.37696261039478 35.46315418288846, -82.37841861065475 35.4630261830119, -82.37926661076531 35.46321818313795, -82.38035061091486 35.46341018328819, -82.38053061093964 35.46344218331326, -82.38238661113077 35.46419418365633, -82.38278661096857 35.46568218399948, -82.38315461091156 35.466450184193235, -82.38371561096022 35.46673718430902, -82.38448661098393 35.46741218452524, -82.38593561103193 35.46865918492718, -82.38825561120903 35.47000218543798, -82.39010161146716 35.47030718568938, -82.39329861202194 35.47013218598198, -82.39528161237936 35.469937186145906, -82.39859261291616 35.47000218649889, -82.39921861293651 35.470544186673195, -82.40014961298444 35.47123418690885, -82.40073661311365 35.471024186926456, -82.40102661328896 35.47019318678747, -82.40219361350404 35.470048186877825, -82.40318561355735 35.470769187126045, -82.40368161361698 35.47091418720633, -82.40439061367859 35.47127618735264, -82.40529961372751 35.47193618757994, -82.40532961372483 35.47198618759322, -82.4059456136713 35.4729991878621, -82.40606961366045 35.47320318791625, -82.40614361364312 35.47339618796308, -82.40638961367733 35.47343818799682, -82.40686461372322 35.47365018808869, -82.40707461374336 35.47374518812955, -82.40769861384153 35.47377718820007, -82.40837261398562 35.47356418822602, -82.40840261399187 35.47355518822723, -82.40886961409173 35.473407188245055, -82.40891561410153 35.47339318824698, -82.40905161413515 35.47332018824607, -82.40958961426792 35.473034188243204, -82.40966761428712 35.47299318824285, -82.40975961431288 35.472924188238345, -82.41067561456896 35.472241188193586, -82.4124976148258 35.47252918843904, -82.41388861492818 35.47336018875054, -82.4151836150244 35.474128189039426, -82.4175666153569 35.47452818936521, -82.41884561568342 35.4737771893439, -82.42058861612603 35.472769189318, -82.4214046163957 35.47189018922322, -82.42314761687985 35.470611189142225, -82.42425061704985 35.47069118927168, -82.42507761724401 35.47031618928027, -82.42511761724357 35.47036218929378, -82.42515061724109 35.470414189307675, -82.42520061723647 35.470498189329895, -82.42529761723168 35.47063418936747, -82.42541961721805 35.47085418942467, -82.4255016172144 35.47096618945586, -82.42558161721327 35.47106018948315, -82.42567361721437 35.47115218951128, -82.42577761721934 35.4712321895382, -82.42590961722728 35.47132218957004, -82.4260846172435 35.47140518960477, -82.42630461726723 35.471487189644, -82.42669961730715 35.47165318971833, -82.42696461732211 35.47184118978368, -82.42711061732629 35.47197118982507, -82.42717161732435 35.47204918984715, -82.42719661731705 35.47212418986494, -82.42720561730323 35.47222418988614, -82.42719561728576 35.4723271899061, -82.42714861725821 35.47245618992747, -82.42710661723684 35.472550189942275, -82.42708361722154 35.472625189955146, -82.42708861721292 35.47268718996827, -82.42710261720754 35.472737189979824, -82.42715561720634 35.47280218999844, -82.42723461720678 35.47288419002325, -82.42745561720021 35.47316519010307, -82.42751361719557 35.47325819012788, -82.42756761718621 35.47337719015757, -82.42761261718049 35.473463190179615, -82.42765961718105 35.473510190194034, -82.42772461718462 35.47355719021022, -82.42783961719569 35.47360919023259, -82.42809861722608 35.47369019027562, -82.4281846172355 35.47372119029072, -82.42822661723862 35.473746190300105, -82.42824261723636 35.47377819030829, -82.42823861722974 35.47381719031578, -82.42822061722171 35.473850190320654, -82.4281706172082 35.47388419032243, -82.42809261719319 35.473898190317236, -82.42785861715268 35.47391019029565, -82.42761461711122 35.473917190272076, -82.42752561709317 35.47393919026744, -82.42746961707958 35.47396719026738, -82.42741261706325 35.47401219027068, -82.42736561704552 35.47407719027907, -82.4273366170282 35.4741591902927, -82.42733461700807 35.47428819031878, -82.42741261695137 35.47474219041896, -82.42748561688097 35.47528019053575, -82.42749661685806 35.475441190569576, -82.42750361681172 35.47575119063334, -82.42752261677867 35.47598719068321, -82.42760361672207 35.47644319078411, -82.42776561664597 35.47711419093705, -82.4278606166111 35.47744419101385, -82.42789761660353 35.47753319103575, -82.42794061659747 35.47761919105755, -82.42800361659306 35.47771619108378, -82.42810061658929 35.47784519111995, -82.42825661658756 35.47802419117223, -82.42831061658538 35.47809719119262, -82.4283466165805 35.47816719121058, -82.4283646165723 35.478240191227215, -82.42837161655676 35.478349191250146, -82.42836761652958 35.47852219128485, -82.42834861650081 35.478689191316775, -82.42831061646464 35.47888419135256, -82.42828061642173 35.47913119139966, -82.42827661639322 35.47931319143622, -82.42828661632849 35.479746191525166, -82.42828361631553 35.47982719154138, -82.42827261630268 35.479899191554836, -82.42823561627573 35.480035191578715, -82.4282036162474 35.48018519160583, -82.42818561621704 35.48036419164038, -82.42819261620735 35.48043419165529, -82.42820761620024 35.48049719166962, -82.42824661619461 35.480575191689525, -82.42830861619085 35.4806671917145, -82.42838561619145 35.48074619173854, -82.42848761619467 35.480835191767056, -82.42867861619847 35.481016191823464, -82.42887161623344 35.48099619183918, -82.42907661627044 35.48097619185612, -82.42945061633873 35.48093419188596, -82.42964461637398 35.480913191901664, -82.42969861638393 35.48090619190578, -82.42994261643011 35.480868191923065, -82.43032661650346 35.48080419194946, -82.43072461657937 35.48073819197689, -82.4312396166769 35.4806571920133, -82.43172161677045 35.48056719204449, -82.43209061684519 35.480477192063965, -82.43235961690078 35.480404192076776, -82.43279761699134 35.48028619209778, -82.43302561703936 35.48021919210758, -82.43310261705561 35.48019619211074, -82.43327861709247 35.48014519211847, -82.4333356171038 35.480133192121876, -82.43333961710444 35.480133192122324, -82.43338961711285 35.48013219212725, -82.43341561711642 35.48013719213088, -82.43343461711926 35.48013919213327, -82.43348161712451 35.48015519214132, -82.43353561712912 35.48018319215253, -82.43368861713557 35.48030619219326, -82.43386161714272 35.48044619223944, -82.43397661714825 35.48053419226915, -82.43411861715701 35.4806301923032, -82.4343016171695 35.48074619234556, -82.43449661718455 35.4808581923883, -82.43472461720215 35.480989192438294, -82.43478061720651 35.4810211924506, -82.43479361720952 35.48101519245069, -82.43500361727678 35.48080319242914, -82.43517661732429 35.480680192421936, -82.43538961737403 35.480585192424456, -82.43578261746589 35.48041019242923, -82.43593461750646 35.480309192424286, -82.43600661753298 35.48021419241237, -82.43601161753674 35.480195192409056, -82.43605661756526 35.48005719238561, -82.43608661764605 35.47956319228834, -82.43614761768906 35.47934819225094, -82.4363016177475 35.47913319222307, -82.43638961781988 35.47875619215552, -82.43649561790332 35.47832619207895, -82.4365786179417 35.47816519205476, -82.43668361797519 35.478060192044204, -82.4368296180137 35.47796619204008, -82.43729261812604 35.47773319204027, -82.43746161817144 35.477619192034396, -82.43759861821648 35.477473192018834, -82.43767361824928 35.477340191999524, -82.43778561831255 35.477048191951646, -82.43785061834114 35.47693219193475, -82.43793561837248 35.4768191919205, -82.43808761842197 35.47666019190385, -82.43822261846398 35.476532191891664, -82.43848861854644 35.47628119186799, -82.43898761870476 35.47578619181861, -82.43911961875271 35.47561619179756, -82.43921761880013 35.475412191766225, -82.43926361880187 35.47545019177862, -82.43935861880242 35.47554919180848, -82.43947961879371 35.475736191858914, -82.43949261878748 35.47579119187143, -82.43962061878003 35.47597819192253, -82.43976161877835 35.47614119197012, -82.44009061877428 35.47652219208125, -82.44029961875992 35.47684119216759, -82.44046061875808 35.4770271922218, -82.44050061875119 35.477115192243865, -82.44050061873426 35.47722519226617, -82.4404336186962 35.47740119229504, -82.44034561865807 35.477555192317325, -82.44021161860894 35.47773119233935, -82.44007761853284 35.47808319239717, -82.43987461843642 35.47849319245959, -82.43986961843356 35.47850619246174, -82.43984261839364 35.478737192505896, -82.43985561838403 35.47881419252282, -82.44016061835607 35.47932519265791, -82.44026561834646 35.47950119270452, -82.44039661831862 35.47982419278356, -82.44039961831818 35.47983019278506, -82.44055461824766 35.48045719292841, -82.44066261824206 35.48061019297053, -82.44097761824185 35.4809511930721, -82.44097361818635 35.48130919314444, -82.44097161814307 35.48158919320119, -82.44099861810702 35.48185319325759, -82.44100161810614 35.48186219325972, -82.4408346180609 35.481977193265955, -82.44033361792489 35.48232319328485, -82.44016761787972 35.48243919329141)))",6311,37,021,003204,370210032043,1896,1896,42,1864,1818,5,6,11,0,24,32,1461,27,1434,1445,1416,3,4,5,0,17,16,820,729,91
census_2010_blockgroups_view.fid--2dc29038_13ec899ba8f_-262e,"MULTIPOLYGON (((-82.6281156287562 35.61449723945076, -82.62802762873237 35.61455723945399, -82.62787462869335 35.614645239456145, -82.62777662866992 35.614691239455446, -82.62766762864493 35.61473623945345, -82.62753762861739 35.61477423944781, -82.62744262859714 35.614803239444015, -82.6265186284106 35.61501623939255, -82.6263176283693 35.615067239382256, -82.62614962833418 35.61511423937464, -82.625825628262 35.61523323936559, -82.62568162822797 35.61529823936404, -82.62564262821876 35.61531623936367, -82.62545662817364 35.615408239363326, -82.62523762811853 35.61552923936552, -82.62511562808663 35.61560523936848, -82.62507962807702 35.615628239369435, -82.62498962805286 35.61568823937244, -82.62491362803216 35.61574023937522, -82.62479062799761 35.615832239381376, -82.62464562795549 35.61594923939031, -82.62462862795046 35.61596323939138, -82.62451662791614 35.61606523940067, -82.62450162791158 35.61607823940176, -82.62436462786694 35.6162202394167, -82.62417162780038 35.616444239442544, -82.62410462777521 35.616535239454144, -82.6240556277568 35.61660223946279, -82.62396462772047 35.61673923948132, -82.62387162768087 35.61689623950377, -82.62378862764182 35.61706023952864, -82.6233826274412 35.61792423966299, -82.62325662737685 35.61820623970753, -82.62319562734527 35.6183452397296, -82.62306762727545 35.61866023978058, -82.6230456272636 35.61871323978909, -82.62301162724731 35.61878223979971, -82.62299462723945 35.61881523980468, -82.62296262720963 35.61897423983384, -82.62296262718564 35.619130239865555, -82.62298362715951 35.619322239906886, -82.62298462715889 35.619327239907975, -82.62302162713722 35.619508239948615, -82.62310362712108 35.61970123999639, -82.62318862711001 35.61986524003855, -82.62326262710657 35.61996724006683, -82.62334462710497 35.62006624009546, -82.62344262710685 35.620160240124676, -82.62368962711473 35.62037524019388, -82.62395462712489 35.62059524026589, -82.62398162712601 35.620617240273134, -82.6241006271298 35.62072124030658, -82.6242216271296 35.620853240345916, -82.62433162712634 35.62099324038573, -82.62433762712617 35.62100124038799, -82.62438462712267 35.62107424040763, -82.62445062711812 35.621175240435036, -82.62453462710896 35.621325240474185, -82.62454262710816 35.62133924047784, -82.62457962710306 35.62141224049653, -82.62458762710204 35.621427240500424, -82.62461162709874 35.62147524051264, -82.62461962709757 35.621491240516775, -82.62463762709496 35.62152724052591, -82.62476762707405 35.62180324059555, -82.62478162707197 35.62183224060285, -82.62487562706448 35.62198224064308, -82.62499562705909 35.622147240689024, -82.62506862705426 35.62225724071893, -82.6251156270511 35.6223282407382, -82.62521062704253 35.62248624078017, -82.6252716270298 35.62263524081677, -82.62528162702223 35.62269524083004, -82.62529962700918 35.622799240853055, -82.62530862697353 35.6230402409031, -82.62529662689208 35.62355624100698, -82.62529662689178 35.62355824100742, -82.62528562684938 35.62382124105988, -82.62527862679755 35.624150241126145, -82.62525262668585 35.62484724126552, -82.62524662664515 35.62510524131744, -82.62523562656358 35.62562224142164, -82.62523062653769 35.62578524145439, -82.62522162648226 35.626135241524736, -82.62520062645898 35.62626324154868, -82.625197626457 35.62627324155042, -82.62517662644241 35.626345241562916, -82.62513862642383 35.626425241575284, -82.62512962641907 35.626446241578606, -82.62505862639354 35.62653524158953, -82.62497762636711 35.62661924159831, -82.62485362633308 35.6267062416033, -82.62469162629257 35.626794241604564, -82.62461162627406 35.62682824160328, -82.62460662627261 35.626831241603405, -82.6244756262451 35.626869241597696, -82.62435662622238 35.626888241589356, -82.62425062620382 35.626894241579656, -82.62416262618973 35.62689024156977, -82.62406462617675 35.62686924155544, -82.62397662616657 35.626840241540485, -82.62389262615977 35.62679324152229, -82.6236586261429 35.62665024146906, -82.62355862613211 35.626612241451134, -82.62344262611693 35.62658524143367, -82.62328062609005 35.62658524141701, -82.62311562605738 35.62661924140708, -82.62297562602544 35.62667524140402, -82.62282162598513 35.62677024140762, -82.62273262595855 35.62684724141416, -82.62266062593672 35.626911241419855, -82.62250062588231 35.62709124144002, -82.62229162580647 35.62735824147299, -82.62183962564737 35.62790224153737, -82.62176562562122 35.627992241548135, -82.62129762545892 35.62854024161169, -82.62109962539103 35.62876724163764, -82.6209176253266 35.62898924166415, -82.62077062527085 35.62919224169042, -82.62065062521785 35.62940624172166, -82.62057962517692 35.629595241752874, -82.62056662516888 35.62963324175928, -82.62052062511538 35.629931241815314, -82.62048062505262 35.630295241885335, -82.62043762498381 35.630695241962385, -82.6204366249828 35.63070024196331, -82.62038462491878 35.631060242031346, -82.62035562487063 35.631341242085604, -82.62036062483509 35.631577242134135, -82.62038562480426 35.63180424218303, -82.6204086247912 35.63191324220757, -82.620434624778 35.632027242233434, -82.62052662475072 35.63230324229918, -82.62058862473287 35.632486242342814, -82.6206206247242 35.63257724236461, -82.62077362468517 35.63299524246552, -82.62078562468135 35.633033242474454, -82.62082662466827 35.63316224250503, -82.62086262466714 35.63320824251807, -82.62083462466431 35.63319624251273, -82.62075062465591 35.63316024249675, -82.62072262465303 35.63314924249161, -82.62061562464218 35.633104242471504, -82.62055262463568 35.63307824245971, -82.62030762461406 35.632954242409305, -82.62030362461377 35.63295124240831, -82.62020662460723 35.63288924238569, -82.6201896245922 35.632968242399976, -82.62018262458534 35.63300524240687, -82.62018662457137 35.63310024242655, -82.6201776245526 35.63321224244848, -82.62017662454873 35.63323624245324, -82.62016462453796 35.63329324246365, -82.62015562453045 35.63333224247069, -82.62012362451851 35.63337524247612, -82.62010462451116 35.63340224247971, -82.62000962448491 35.633470242483774, -82.61990462445783 35.633532242485636, -82.61989562445586 35.63353524248533, -82.6198116244357 35.633576242485056, -82.61978462442912 35.63358924248493, -82.61966962440387 35.633629242481234, -82.6196006243901 35.63364424247719, -82.61951562437542 35.63364724246912, -82.61940062435785 35.633637242455215, -82.61924462433588 35.63361124243394, -82.61900662430467 35.63355724239843, -82.61862662425055 35.633498242347386, -82.61846562422713 35.633476242326395, -82.6183806242147 35.63346524231543, -82.6181136241751 35.633434242281716, -82.61796462415137 35.633427242265, -82.61784962413277 35.633423242252356, -82.61760662409027 35.633437242230215, -82.61736662404687 35.633460242210234, -82.61706762398919 35.633511242189904, -82.61674662392538 35.633579242170775, -82.61652562388039 35.63363224215885, -82.61630562383783 35.63367124214423, -82.61608262379667 35.633697242126594, -82.61569162372761 35.63372324209171, -82.6153476236669 35.63374624206103, -82.61518262363847 35.633752242045375, -82.61514762363304 35.63375024204136, -82.61506862362033 35.63374724203259, -82.61497162360756 35.63372524201817, -82.61490862360057 35.63370324200723, -82.61485362359647 35.63367024199483, -82.61480962359434 35.63363624198343, -82.61476862359343 35.63359824197148, -82.61472262359716 35.633524241951655, -82.61467962360629 35.633418241925625, -82.6146286236203 35.633272241890616, -82.61456962362702 35.63316524186277, -82.61447962362801 35.633062241832576, -82.61441462362754 35.632995241812246, -82.61426962361513 35.632919241781856, -82.61412362359881 35.63286724175622, -82.61400562358966 35.63279924173025, -82.61392962358516 35.63274624171175, -82.61385762358583 35.63266424168755, -82.61374162358412 35.6325502416524, -82.61360262357276 35.63247424162265, -82.61341162355315 35.63239524158698, -82.61307362351543 35.63227524152779, -82.61296362350014 35.6322562415126, -82.61289462349026 35.63224524150331, -82.61273062346815 35.632212241479664, -82.61261962345439 35.63218124146201, -82.61251462344269 35.63214424144369, -82.61205962339642 35.631953241358026, -82.61181562337286 35.6318432413105, -82.61128462332424 35.63158524120344, -82.61122562331508 35.63158124119652, -82.61128462334361 35.631459241177744, -82.61139362339041 35.63127424115124, -82.61143862340921 35.63120024114087, -82.61160162346827 35.630993241115426, -82.61183262355016 35.63071124108166, -82.61203862362493 35.63044824104928, -82.61225562370328 35.630174241015794, -82.61237062374606 35.630020240996224, -82.61241962376391 35.62995724098833, -82.6125536238175 35.62975424096086, -82.61266962387057 35.62953524092806, -82.61267162387189 35.62952924092709, -82.61273862391077 35.62934924089727, -82.61271762392471 35.62923624087209, -82.61270762394058 35.62912224084789, -82.61270462394741 35.629074240837824, -82.61268862399011 35.6287802407763, -82.61267662400871 35.62864624074771, -82.61262362402766 35.62846624070563, -82.61254762404603 35.628265240656894, -82.61247762406323 35.62807824061157, -82.61244362406818 35.628009240594004, -82.61236362406603 35.62793724057115, -82.61230362406619 35.627871240551535, -82.61217062406635 35.62772624050828, -82.61191862406129 35.62748724043376, -82.61188662406094 35.62745524042396, -82.61174662405875 35.627318240381655, -82.61167362405774 35.62724624035951, -82.61159662405662 35.6271702403361, -82.61144662405124 35.62704324029476, -82.6114126240501 35.62701424028543, -82.61136262404592 35.62698724027473, -82.61122762403468 35.62691424024606, -82.61110662402074 35.62687424022543, -82.61103662401256 35.62685224021378, -82.6104076239293 35.62671324012088, -82.61028662391257 35.62669124010393, -82.61004662387897 35.62665024007092, -82.6100116238747 35.626640240065306, -82.60975462384279 35.626570240024655, -82.60945862381011 35.626463239972466, -82.60943162380742 35.626451239967196, -82.60918362378354 35.62633823991872, -82.60878062373274 35.62623323985595, -82.60866062371989 35.62618723983425, -82.60857762371377 35.626137239815534, -82.60848462371123 35.626053239788845, -82.60838162371304 35.625930239753174, -82.60815762371288 35.625690239681276, -82.60802362370707 35.625583239645756, -82.60791762370067 35.62551023961998, -82.60786162369725 35.62547223960649, -82.60773162369179 35.625367239571766, -82.6076486236948 35.62525823954105, -82.6075646237039 35.62510823950185, -82.60752762370608 35.625054239487056, -82.6074466236927 35.62505323947857, -82.60729662366951 35.6250422394609, -82.60721562365678 35.62503723945151, -82.60691162361073 35.62500823941441, -82.60660762356423 35.62498223937787, -82.60637862352891 35.624964239350724, -82.60551362339577 35.6248952392478, -82.6054536233864 35.62489123924085, -82.60534562336917 35.624886239228665, -82.60519462334283 35.62489423921478, -82.60508862332199 35.62491523920821, -82.60495962329281 35.624965239205146, -82.60487762327205 35.62501123920611, -82.6047946232494 35.625069239209346, -82.60468562321209 35.6251932392234, -82.60465162319413 35.625273239236165, -82.60462262317469 35.62536823925255, -82.60462162315987 35.62546323927186, -82.60463462314722 35.6255592392928, -82.60466562313626 35.62566423931732, -82.60471962313021 35.625761239342644, -82.60479562312418 35.62588223937506, -82.60500262311159 35.6261872394585, -82.6051226231012 35.62638423951096, -82.60520662309658 35.62650523954421, -82.60525662309053 35.62659823956827, -82.60532262308458 35.62670823959744, -82.60536362307765 35.62679723961984, -82.60538062306875 35.62687323963707, -82.60538062306597 35.626891239640656, -82.60538262305536 35.62696223965535, -82.60536562303996 35.62704423967033, -82.60533662302356 35.62711923968268, -82.60529962300691 35.627187239692674, -82.605245622989 35.62724523969894, -82.60516662296537 35.62731323970466, -82.60506962293864 35.62738223970873, -82.60496762291238 35.62744223971051, -82.60480262286907 35.62754523971454, -82.60471962284733 35.62759723971661, -82.60453462279972 35.62770623971982, -82.60447162278344 35.62774423972104, -82.60436462275268 35.62782823972712, -82.60422862270813 35.62797023974215, -82.60414262267363 35.62810123975995, -82.60407462263595 35.628272239787826, -82.60402062259924 35.62845223981891, -82.60398462258567 35.6285012398252, -82.60396662257902 35.62852523982826, -82.60389862255633 35.628599239836404, -82.6037946225295 35.628661239838266, -82.60373062251503 35.62868623983682, -82.60369162250606 35.62870223983602, -82.60358662248595 35.62871923982872, -82.60352762247616 35.62871923982268, -82.60345962246481 35.6287192398157, -82.60338962245427 35.62871223980706, -82.60327762243732 35.62870123979328, -82.60317962242303 35.628688239780594, -82.60311062241277 35.62868023977184, -82.60301662239904 35.62866823975979, -82.60273762235822 35.628632239723835, -82.60264462234436 35.628621239712025, -82.60251962232613 35.62860523969588, -82.60238362230614 35.62858823967846, -82.60214462227118 35.6285572396476, -82.60212362226802 35.62855523964496, -82.60201962225271 35.62854223963168, -82.6019926223183 35.6280872395362, -82.60191462251575 35.62672223925021, -82.60188862258137 35.62626823915501, -82.60186562262876 35.62593623908503, -82.60185362265301 35.62576623904921, -82.60184362267623 35.62560423901515, -82.60183762269023 35.625507238994764, -82.6017886226892 35.62546123898036, -82.60117762267654 35.624884238800064, -82.60093062267131 35.6246512387273, -82.6005656226637 35.62430723861967, -82.60065562268571 35.62426123861962, -82.60070262269758 35.62423523861911, -82.60074462270777 35.62421423861916, -82.60099962277069 35.62408123861828, -82.60111562279936 35.62402023861771, -82.6012536228332 35.62394923861744, -82.6012736228387 35.62393523861669, -82.60133362285471 35.62389623861488, -82.60135462286016 35.62388323861436, -82.601480622865 35.62398823864868, -82.60185862287925 35.62430323875171, -82.60198562288407 35.62440923878633, -82.60203062289742 35.62437123878319, -82.60216862293734 35.624261238774984, -82.6022146229506 35.624224238772236, -82.6022676229731 35.624135238759465, -82.60246362302527 35.624008238753795, -82.60275862309719 35.62386023875395, -82.60281362311004 35.62383623875471, -82.60314662318707 35.62369523876015, -82.60338362324309 35.623587238762575, -82.60348062327118 35.62351023875683, -82.60356862330005 35.623417238746896, -82.60364662332893 35.62331423873395, -82.60371362335532 35.62321523872064, -82.60390862340563 35.62309923871708, -82.60415062347468 35.62291223870381, -82.60422362350606 35.6227872386859, -82.60426562353089 35.622671238666555, -82.60430162356039 35.6225192386393, -82.60430862357765 35.622414238618624, -82.6043246236135 35.6221992385765, -82.6043586236618 35.62192223852358, -82.60438462367557 35.62186123851376, -82.60443062368871 35.6218252385112, -82.60449362370241 35.62180423851338, -82.60453562370967 35.62180223851728, -82.60460862372243 35.621798238523965, -82.60471962373758 35.62182023853986, -82.60482262375044 35.62184723855593, -82.60489562375955 35.62186723856755, -82.6050866237909 35.62187023858775, -82.60523462381855 35.62185023859886, -82.60540462385518 35.621796238605334, -82.60558662389668 35.62172323860917, -82.60567662391466 35.62170323861433, -82.60584862394894 35.62166623862447, -82.60596562397075 35.62165123863345, -82.60589562396392 35.62162023861995, -82.6057906239493 35.62160123860529, -82.60542262388505 35.62162123857158, -82.60523462385527 35.62161223855038, -82.60507562383602 35.62156523852445, -82.60497562382673 35.62151723850441, -82.60493162382267 35.621496238495624, -82.60480362381776 35.621390238460954, -82.60472862382093 35.62128823843242, -82.60466562383068 35.62115723839926, -82.60464362383752 35.62108923838316, -82.60463262384543 35.62102623836919, -82.60462562386768 35.62087423833755, -82.60463662389476 35.620710238305264, -82.60465262391514 35.620595238283514, -82.604674623936 35.6204832382629, -82.60469562395214 35.6204012382484, -82.6047726239976 35.62018923821309, -82.60481662402053 35.62008823819708, -82.60499962410748 35.61972123814111, -82.6050446241274 35.61964023812922, -82.60506762414103 35.619577238118765, -82.60508962416186 35.619465238098215, -82.60507662416762 35.61941423808647, -82.60503762416865 35.61936523807245, -82.60498662416603 35.61932723805951, -82.60492362416068 35.619294238046294, -82.60484462415079 35.619273238033884, -82.60476462413747 35.619273238025755, -82.60468562412215 35.61928723802043, -82.60466562411773 35.619294238019776, -82.60461662410717 35.619310238017995, -82.60446062406693 35.61940323802088, -82.60443762406064 35.61941923802188, -82.60436262403938 35.619476238025705, -82.60424762400581 35.619569238032874, -82.60413862397623 35.619644238037, -82.604013623944 35.619718238039226, -82.60394562392753 35.619752238039105, -82.60387662391211 35.61977723803716, -82.60379862389615 35.6197972380332, -82.60370962387918 35.61981123802689, -82.60359962386062 35.61981323801598, -82.60353362385041 35.61980823800823, -82.60345262383778 35.619802237998734, -82.60340062383042 35.61979423799172, -82.60332862382013 35.619783237982055, -82.60324062380919 35.61975923796818, -82.60318762380412 35.61973523795778, -82.60308262379813 35.619660237931775, -82.60304762379741 35.6196272379214, -82.60302162379688 35.61960223791366, -82.6029616237986 35.61952723789219, -82.60283562380047 35.619379237849195, -82.60275462380078 35.619289237822485, -82.60254762380177 35.61905923775434, -82.60250762380473 35.61899723773762, -82.60247662380927 35.6189342377216, -82.60245662381614 35.61886823770609, -82.60243962382876 35.618768237684, -82.60243962384948 35.61863323765647, -82.60246662387482 35.618498237631734, -82.60248062388423 35.61845223762387, -82.60252562391219 35.61831923760135, -82.60256462393487 35.618214237584084, -82.60259162394802 35.61815823757535, -82.60265462397842 35.618028237555365, -82.60270262400125 35.617932237540785, -82.60271162400713 35.617903237535806, -82.60271762401096 35.61788523753275, -82.60272462401468 35.617868237529954, -82.60273962402864 35.61779423751642, -82.60273962403711 35.61773923750526, -82.60272362404429 35.61767523749056, -82.60269662404734 35.61762623747782, -82.60269262404734 35.61762223747658, -82.60264262404618 35.617575237461885, -82.60257762404134 35.61753723744747, -82.60254662404742 35.61746423742935, -82.60251862405575 35.61738023740943, -82.60249062406379 35.61729723738966, -82.60241862409038 35.617047237331334, -82.60238562410791 35.616897237297394, -82.60237862411253 35.6168602372891, -82.60236762412003 35.61679923727554, -82.60236262412958 35.616732237261424, -82.6023526241615 35.61651423721602, -82.6023656242083 35.616224237158185, -82.60236962422839 35.616098237132974, -82.60238262428882 35.615720237057374, -82.60237962431292 35.61556023702441, -82.6023636243637 35.615213236952115, -82.60235962441651 35.61486623688108, -82.60236562443266 35.61476823686166, -82.6023726244509 35.61465723683982, -82.60239862448628 35.61445523680134, -82.60243862452288 35.61426123676589, -82.60245462453413 35.614205236756156, -82.60251062457174 35.6140212367244, -82.60259062461017 35.61385823669944, -82.60267062463986 35.61375223668605, -82.60271762465565 35.61370023668033, -82.60276362466878 35.613664236677714, -82.60282462468784 35.61360623667222, -82.6029306247189 35.6135192366653, -82.60304162475033 35.61343523665965, -82.60305362475371 35.613426236659, -82.60309362476559 35.61339223665615, -82.60313562477748 35.61336023665397, -82.60321062480139 35.61328623664665, -82.60324962481343 35.613250236643296, -82.60332662483755 35.61317623663618, -82.60345662489085 35.612970236607545, -82.60354762493147 35.61280523658324, -82.60361062495936 35.61269223656672, -82.60390262509658 35.612116236479345, -82.60403662516602 35.61181023643082, -82.60411562520997 35.61161023639823, -82.60418662524529 35.611457236374356, -82.60422362526197 35.611389236364225, -82.60424662527178 35.611350236358696, -82.60446062535986 35.611009236311205, -82.60452262538874 35.61088823629298, -82.6045776254146 35.610780236276604, -82.60459162542205 35.610746236271126, -82.60473562549518 35.61042723622088, -82.60476262551012 35.61035923620982, -82.6047776255199 35.610312236201835, -82.60482762555114 35.61016323617656, -82.60489062559301 35.60995923614154, -82.60497362564128 35.60973523610442, -82.60499162565371 35.60967423609385, -82.60502062567258 35.60958323607829, -82.60507862572113 35.60933023603274, -82.6050916257368 35.60924223601611, -82.60510562576194 35.609094235987385, -82.60510462578608 35.608936235955134, -82.60509362580247 35.60881823592999, -82.60506762582354 35.60865323589365, -82.60495362588138 35.60815423578033, -82.60494262588747 35.60810323576882, -82.60484662594118 35.60765023566671, -82.604802625967 35.60743523561837, -82.60474862599915 35.607168235558476, -82.60472462602424 35.60697923551751, -82.60471862604633 35.606829235486344, -82.60471962605327 35.60678523547744, -82.60472262606338 35.60672323546514, -82.60474062609038 35.606567235435215, -82.60474362609438 35.606544235430825, -82.6047816261201 35.606418235409066, -82.60479662612912 35.60637623540211, -82.60492562620243 35.60603923534668, -82.6049646262231 35.605947235331946, -82.60502462625092 35.60583123531453, -82.6050286262526 35.60582423531349, -82.60507762627309 35.60574423530225, -82.60514662629693 35.60566423529295, -82.60520162631447 35.60560923528746, -82.60527462633571 35.60555023528298, -82.60528162633784 35.605544235282416, -82.60563462643594 35.60528723526632, -82.60571562645954 35.60522223526136, -82.60573362646457 35.605209235260595, -82.60585062650043 35.60510223525078, -82.60590562651775 35.60504923524568, -82.60597962654387 35.60495923523491, -82.60604162656887 35.604864235222, -82.60612962661061 35.60468823519516, -82.60615062662038 35.60464723518894, -82.60621162665193 35.604508235166854, -82.60624962667488 35.60440023514881, -82.60627562669413 35.60430323513173, -82.60628762671153 35.60420323511265, -82.60629162672511 35.60411923509584, -82.60628062675801 35.6038932350487, -82.60626062678982 35.603665235000214, -82.60623562685586 35.60320923490477, -82.60622962687405 35.603084234878665, -82.60621862690655 35.60286123483215, -82.60623562693299 35.60270823480272, -82.6062756269341 35.602744234814196, -82.60644262694548 35.60285023485292, -82.60652562695121 35.6029032348722, -82.60669062696323 35.60300323490956, -82.60710062699671 35.60322823499747, -82.60732262701487 35.60335023504505, -82.60782862705476 35.60363723515553, -82.60834162709247 35.6039462352711, -82.60870062711874 35.60416323535217, -82.61006762721885 35.60498923566081, -82.61106162729283 35.60558223588364, -82.61176262734362 35.606009236042595, -82.6119976273593 35.60616123609765, -82.6120976273636 35.60624123612425, -82.61216162736419 35.60630623614404, -82.61221862736373 35.60637123616312, -82.61227262736028 35.60645223618515, -82.61235062734946 35.606606236224536, -82.6124286273306 35.60681323627474, -82.61247162732329 35.60690723629839, -82.61249562732073 35.60694923630929, -82.61250862731951 35.606971236315125, -82.61256162731698 35.60704523633559, -82.61259062731659 35.607079236345534, -82.61263162731626 35.607125236359124, -82.61269262731719 35.6071852363776, -82.61273062731777 35.607222236389006, -82.61283862732212 35.607311236418276, -82.61302962733409 35.607439236463904, -82.61312762734016 35.60750623648767, -82.61323662734833 35.60757023651189, -82.61346162736731 35.60769023655946, -82.61379762739917 35.60784623662569, -82.61427362744428 35.60806723671959, -82.61436462745293 35.60810923673754, -82.61500362751411 35.6084022368628, -82.61513862752841 35.608455236887465, -82.61526262754234 35.60849823690892, -82.61545062756623 35.60854623693803, -82.6155506275801 35.60856423695197, -82.6156536275955 35.60857523696474, -82.615775627617 35.608567236975674, -82.61604462766361 35.60855523700083, -82.61615162768268 35.60854623701004, -82.61615862768394 35.60854623701074, -82.61638962772638 35.608520237029104, -82.6165726277556 35.608528237049526, -82.61668062776965 35.608553237065784, -82.61676362777712 35.60859423708264, -82.61680162778056 35.60861323709037, -82.616945627789 35.60871423712572, -82.61727662780304 35.6089802372139, -82.61742462781025 35.60909323725217, -82.6175786278177 35.609211237291966, -82.61770662782455 35.60930523732427, -82.6177986278286 35.609378237348594, -82.61790562783054 35.609481237380585, -82.61800762782991 35.60959523741424, -82.61826262780838 35.61001023752495, -82.61830062780523 35.610072237541544, -82.61839662780146 35.610200237577494, -82.61851162780118 35.6103262376149, -82.61880562780665 35.61060823770252, -82.61904062781197 35.61082723777126, -82.6191156278148 35.610890237791885, -82.61929662782167 35.611041237841164, -82.61939362782527 35.61112223786762, -82.61956362783535 35.6112402379091, -82.61975162784958 35.61135123795107, -82.61978962785273 35.611371237959034, -82.61993362786502 35.6114472379893, -82.62003962787408 35.611503238011586, -82.62020462788968 35.6115802380442, -82.620355627906 35.611637238071374, -82.62038062790896 35.61164423807531, -82.62053862792854 35.61168823810051, -82.62063462794124 35.611709238114685, -82.62072162795374 35.611722238126184, -82.6208266279704 35.61172723813801, -82.62094562799133 35.611720238148806, -82.62116662803483 35.61167623816257, -82.62129462806222 35.611636238167534, -82.62174062815718 35.61150123818581, -82.62195062820035 35.611448238196616, -82.62210762822997 35.611425238208014, -82.62275362834534 35.611373238263766, -82.62287662836631 35.61137023827576, -82.62296362837922 35.611380238286735, -82.62304762838998 35.611401238299635, -82.62312462839786 35.61143323831407, -82.62320362840238 35.611489238333654, -82.62330062840556 35.61157323836065, -82.62345462840793 35.61172423840725, -82.62363062841064 35.61189723846056, -82.6240196284212 35.61224823857197, -82.62423262842705 35.61244023863301, -82.62439362843071 35.61259023868011, -82.62442362843208 35.61261423868805, -82.6245376284364 35.61270923871912, -82.62463462844146 35.6127812387438, -82.6247506284501 35.61285023876969, -82.62488462846318 35.612910238795656, -82.62498762847501 35.612944238813206, -82.62511662849246 35.61297023883172, -82.62523762851109 35.61298023884618, -82.62534962852948 35.6129822388581, -82.62544362854564 35.61297823886691, -82.62556462856809 35.61296323887633, -82.62587962862914 35.61290723889726, -82.62595462864421 35.612890238901436, -82.62604162866165 35.6128712389066, -82.62640462873043 35.61281623893261, -82.62649462874697 35.61280623893981, -82.62651862873741 35.612894238960166, -82.62655562872781 35.6129962389848, -82.62662862871693 35.61314623902282, -82.62669562871002 35.613263239053595, -82.62671162870838 35.61329123906086, -82.62678062870361 35.61339623908934, -82.62691062870284 35.613542239132514, -82.6270026287069 35.613615239156736, -82.62709162871337 35.61366923917692, -82.62720662872344 35.613728239200775, -82.62733562873719 35.61377823922421, -82.62750162875646 35.613832239252254, -82.62779162879258 35.61391123929808, -82.62797462881667 35.61395223932527, -82.62819862884591 35.614004239358806, -82.62828262885695 35.61402323937132, -82.62846462888105 35.614063239398135, -82.6284196288588 35.61415923941308, -82.62841562885725 35.61416523941396, -82.6283716288379 35.61424323942527, -82.62830462881162 35.61434123943839, -82.62820762878172 35.614431239446766, -82.62819762877832 35.61444223944794, -82.6281156287562 35.61449723945076)))",6358,37,021,002607,370210026072,1487,1487,109,1459,1351,38,14,9,1,46,28,1147,74,1073,1133,1058,25,10,6,1,33,14,659,598,61
census_2010_blockgroups_view.fid--2dc29038_13ec899ba8f_-262d,"MULTIPOLYGON (((-82.52417263756466 35.44466619422342, -82.52662163797388 35.444642194469246, -82.52659063788631 35.44518119457572, -82.52658963788127 35.44521319458214, -82.52658363786436 35.44531719460264, -82.52656963783235 35.44551119464069, -82.52655263778858 35.44577919469345, -82.52652563774068 35.446063194748476, -82.52652163773544 35.4460931947541, -82.5265006377023 35.446287194791445, -82.52649363769135 35.44635119480372, -82.52648863768329 35.44639819481282, -82.52647063765819 35.446543194840494, -82.52646363764723 35.44660719485272, -82.52645663763614 35.44667219486523, -82.52635163750223 35.44743419500944, -82.52627363740226 35.448003195117224, -82.52621263734596 35.448305195172374, -82.52616563731331 35.448468195200654, -82.52610763728103 35.44861619522488, -82.52591263717943 35.44906919529703, -82.52584363713729 35.44927019533082, -82.52577163708986 35.449502195370655, -82.52572563704217 35.44976419541919, -82.5257146370284 35.449842195433924, -82.52569263699834 35.45001519546686, -82.52567463694946 35.45031519552608, -82.52567563689465 35.450675195599324, -82.52567563687856 35.45078019562071, -82.52567663687215 35.4508231956295, -82.52568663685483 35.45094719565583, -82.52571663683759 35.451092195688325, -82.52573863682532 35.45119619571171, -82.52555663678343 35.45127319570879, -82.52531663672588 35.451389195707854, -82.52514263668412 35.451474195707256, -82.52500563664914 35.45155419570953, -82.52481763660104 35.451665195712806, -82.5245436365282 35.451845195721354, -82.52430463646236 35.45201619573166, -82.52414963641792 35.4521391957408, -82.52407963639777 35.45219519574501, -82.52387863633776 35.45237019576007, -82.52380263631352 35.45244619576772, -82.52363663626043 35.45261319578471, -82.52348163620793 35.45278919580457, -82.52329563614323 35.45301019583053, -82.52311263607808 35.45323819585815, -82.52281263597105 35.453613195903635, -82.52263163590634 35.453840195931264, -82.52193563566185 35.45468519603188, -82.52110763537371 35.455672196147745, -82.52043263513865 35.4564781962425, -82.52023163506779 35.45672319627177, -82.52015663504207 35.456810196281836, -82.5200416350022 35.45694619629771, -82.51968563487699 35.45737919634928, -82.51958863484434 35.45748819636154, -82.51934963476315 35.457760196392314, -82.51931463475194 35.45779519639584, -82.51928663474274 35.45782519639907, -82.51920263471538 35.45791319640843, -82.51900363465467 35.45809419642478, -82.51884763460939 35.458221196434636, -82.51875463458377 35.45828819643883, -82.51867563456166 35.458347196442695, -82.51850163451623 35.45845619644704, -82.51834563447811 35.45853619644728, -82.51814263443106 35.45862419644443, -82.5179096343798 35.45870719643743, -82.5178786343728 35.458719196436704, -82.51761163431459 35.458810196427834, -82.5174596342822 35.45885719642181, -82.5172486342383 35.45891619641218, -82.51724063423681 35.45891719641157, -82.5170396341962 35.45896519640076, -82.51680663415134 35.45900619638519, -82.51651963409908 35.45903719636209, -82.5162756340554 35.459058196341346, -82.51609363402396 35.45906719632463, -82.5158066339742 35.459081196297994, -82.51570863395713 35.45908719628916, -82.51557963393464 35.459094196277384, -82.51550263392114 35.45909919627052, -82.51510463385101 35.4591271962355, -82.5149436338223 35.45914019622161, -82.51488563381194 35.45914519621666, -82.51479363379553 35.45915319620889, -82.51468063377489 35.45916519619972, -82.51452463374649 35.459182196187214, -82.51431863370769 35.45921319617241, -82.51417963368117 35.459236196162905, -82.51404563365527 35.45926019615407, -82.51371963359054 35.45933019613484, -82.51329163350161 35.459448196115034, -82.51281463340416 35.45956919609072, -82.51270763338198 35.45959819608568, -82.51249263333706 35.45965919607608, -82.51231363329889 35.45971519606913, -82.51222463327922 35.459747196066466, -82.51220563327512 35.45975319606577, -82.51215063326295 35.459773196064226, -82.51213263325879 35.459781196064, -82.5121076332496 35.459814196068145, -82.51203163322384 35.459900196077804, -82.51190663318104 35.46004419609435, -82.51176763313377 35.46020319611239, -82.5117466331201 35.46026919612367, -82.51170063308962 35.4604191961495, -82.5116896330827 35.46045219615506, -82.51165863306232 35.46055219617218, -82.51165263305813 35.46057319617586, -82.51165163305575 35.460587196178615, -82.5114406330486 35.460406196120154, -82.51092463303044 35.45996619597787, -82.51036963300265 35.459547195835825, -82.51013363298702 35.45939419578053, -82.50992063297286 35.459256195730596, -82.50925363292323 35.4588591955815, -82.508520632865 35.458446195422525, -82.50743963278128 35.457824195185296, -82.50703463274985 35.45759119509639, -82.50645663270484 35.45726019496986, -82.50576963265242 35.456859194817966, -82.50544863263252 35.45664219474096, -82.5052206326225 35.45646119468076, -82.50517163262234 35.456409194665184, -82.50501263262156 35.45624219461499, -82.50477863263423 35.455906194522676, -82.50460563265716 35.4555691944364, -82.50435763274609 35.45472019423844, -82.50434763274839 35.45469419423213, -82.50416663279019 35.45422519411827, -82.5039906328051 35.45393719404163, -82.50377963281164 35.45366619396487, -82.50354463281126 35.45341419388967, -82.5035296328113 35.45339819388483, -82.50309363279453 35.453036193766515, -82.50245763275895 35.4525801936087, -82.50140663270192 35.45181619334569, -82.50001363262541 35.45080919299818, -82.4998576326177 35.45069119295829, -82.49981163261519 35.45065719294661, -82.49955763260478 35.45045119287869, -82.49937063260352 35.45025719282013, -82.4991566326054 35.45001319274861, -82.49884663262338 35.449560192624766, -82.49853563265154 35.44903919248691, -82.49831863267795 35.44863219238198, -82.49825463268469 35.44851919235247, -82.49811863269932 35.44827619228912, -82.49799263270893 35.44807719223574, -82.49780963271223 35.447857192172236, -82.4970366327061 35.44706119193127, -82.49674263270364 35.44675919183978, -82.4958616326956 35.4458591915666, -82.49536863269108 35.4453551914136, -82.49501963268624 35.44500919130749, -82.49512163270327 35.44500819131773, -82.49542863275403 35.445008191349196, -82.49553163277106 35.44500819135977, -82.49560563278334 35.445008191367336, -82.49577363281126 35.445007191384356, -82.49650163293245 35.44500319145807, -82.49671863296832 35.445003191480346, -82.4967446329726 35.44500319148293, -82.49728763306292 35.445000191538, -82.49937663340972 35.44499319175052, -82.50118163371299 35.44496319192931, -82.5012776337294 35.44496019193854, -82.50289963400213 35.444932192098996, -82.50394063417701 35.444915192202124, -82.50719863472324 35.44487019252669, -82.51094063535 35.444822192900155, -82.51237263558998 35.444803193042915, -82.51265163563659 35.444800193070854, -82.51277863565777 35.44479919308369, -82.51403263586784 35.44478319320885, -82.51412863588371 35.444783193218754, -82.51579263616071 35.444773193387086, -82.51735963642156 35.44476419354574, -82.51747363644115 35.444759193556365, -82.52108863704954 35.444695193913546, -82.52121063706974 35.44469519392605, -82.52322163740581 35.444675194127804, -82.52354763746024 35.44467219416063, -82.52417263756466 35.44466619422342)))",6401,37,021,002203,370210022033,1332,1332,205,1295,1083,100,2,16,0,94,37,989,130,859,978,840,69,2,12,0,55,11,660,576,84
census_2010_blockgroups_view.fid--2dc29038_13ec899ba8f_-262c,"MULTIPOLYGON (((-82.72037366121955 35.50298722617666, -82.7204346612361 35.50294522617428, -82.72050866126682 35.502824226157195, -82.72052666129119 35.50268522613068, -82.72053266129834 35.50264522612314, -82.72055266139061 35.50206322600652, -82.72065966142753 35.50193822599198, -82.72088466149009 35.501774225981585, -82.72101766152677 35.501679225975835, -82.72114166156983 35.501532225958464, -82.72122966160028 35.50142922594659, -82.7213226616187 35.50141022595214, -82.72140566163031 35.50142422596355, -82.72165966164816 35.50158422602204, -82.72166766164875 35.50158922602388, -82.7217726616436 35.50173722606481, -82.7220196615975 35.50230722620636, -82.7222366616066 35.50248422626453, -82.72258166163827 35.50265222633415, -82.72271166164573 35.50274522636641, -82.72276766164369 35.5028192263872, -82.72277666162731 35.50293622641193, -82.72279666159658 35.50315922645953, -82.72281466157905 35.50329322648861, -82.7229656615725 35.50350022654632, -82.7230976615668 35.50368122659673, -82.72321966157318 35.503772226627696, -82.7233446615796 35.50386622665971, -82.72380166160518 35.50419622677368, -82.72407066162258 35.50437522683775, -82.72414466162836 35.504418226854035, -82.72441866164937 35.5045792269149, -82.72446566165151 35.5046162269272, -82.72459466165736 35.5047182269613, -82.72493466166807 35.50501822705719, -82.72510766167348 35.50517122710605, -82.7256006616562 35.50582122728906, -82.72581466163457 35.506195227387195, -82.72600766161797 35.506514227471946, -82.72600966161798 35.50651622747256, -82.72618666162353 35.50667222752247, -82.7263296616361 35.50674622755226, -82.72648466165693 35.50677822757469, -82.72654866166795 35.50677622758073, -82.72657066167177 35.5067752275828, -82.72663766168316 35.50677322758918, -82.72666066168699 35.50677322759155, -82.72665666167103 35.50687322761151, -82.72666366165876 35.50696122763018, -82.72671766165428 35.5070492276537, -82.72675266165585 35.50707722766296, -82.72696666166472 35.507252227720585, -82.72722166165421 35.50759822781718, -82.72730866162411 35.5078902278856, -82.72740566159077 35.50821322796142, -82.7273026615706 35.50823322795494, -82.72726866156384 35.50824022795287, -82.72714266153979 35.50826022794411, -82.7269926615124 35.50827622793195, -82.7268896614934 35.508288227923906, -82.72679266147661 35.508292227914815, -82.72648966142624 35.508292227883864, -82.72638166140956 35.50828322787099, -82.72632566140088 35.50827922786444, -82.72626966139293 35.50827022785682, -82.72600766135879 35.50820822781744, -82.72587766134377 35.50816522779536, -82.72563766131859 35.50806822775102, -82.72495866125229 35.507763227619364, -82.72449566120689 35.5075562275298, -82.72435866119348 35.507494227503145, -82.72394766115306 35.50731122742376, -82.72394366115259 35.50731022742319, -82.72384766114129 35.507279227407025, -82.72380466113572 35.50726922740065, -82.72373466112619 35.50725522739065, -82.7236606611149 35.50724822738159, -82.72353566109396 35.50724922736905, -82.72349466108639 35.50725422736586, -82.7234736610818 35.50726122736516, -82.7234346610743 35.50726822736257, -82.72342666107258 35.50727022736214, -82.72335166105641 35.5072942273594, -82.72328166104028 35.507324227358346, -82.72320766102155 35.50736522735915, -82.7231446610037 35.50741422736267, -82.72308766098566 35.507470227368245, -82.72302666096506 35.50753822737594, -82.72261366081855 35.50804622743725, -82.7225806608067 35.50808822744241, -82.72251166078388 35.50816222745043, -82.7223786607416 35.508293227463604, -82.7223476607325 35.50831922746571, -82.72218566068501 35.508453227476465, -82.72205466064973 35.50854122748104, -82.72198166062995 35.50859122748377, -82.72189466060732 35.50864422748565, -82.72181266058729 35.50868622748582, -82.72150966051612 35.50882222748252, -82.72138266048717 35.50887322747997, -82.72105266041409 35.50899122747026, -82.72070666033764 35.50911522746019, -82.72040866027126 35.50922422745193, -82.7195166600726 35.509552227427555, -82.71921966000643 35.50966222741962, -82.71917065999558 35.509679227418026, -82.71902665996348 35.509732227414155, -82.71897865995265 35.50975122741308, -82.71866865988373 35.50986422740441, -82.71773865967705 35.51020322737844, -82.71742965960823 35.51031722737005, -82.71713165954186 35.51042622736177, -82.71623865934343 35.510752227336894, -82.71594165927709 35.51086222732896, -82.71578965924341 35.51091722732465, -82.71533665914257 35.51108322731217, -82.71518565910895 35.511139227308114, -82.71487665904036 35.51125122729937, -82.71441265893728 35.5114202272863, -82.71395265883464 35.511590227273935, -82.71385365881234 35.51162822727154, -82.7136496587653 35.51171422726825, -82.71348065872522 35.51179222726685, -82.71336965869786 35.51185022726729, -82.71328765867726 35.51189522726811, -82.71305465861722 35.51203422727262, -82.71287365856803 35.51215922727957, -82.71262665849689 35.51235522729429, -82.71260065848921 35.51237722729604, -82.71250365845988 35.51246322730362, -82.71237265841899 35.51258822731579, -82.71225565838076 35.51271022732867, -82.71220565836363 35.51276822733535, -82.71213765834024 35.512847227344565, -82.71199865828936 35.51302822736724, -82.71186265823424 35.51324022739658, -82.711799658207 35.51335022741245, -82.7117876582015 35.51337322741598, -82.71167665814946 35.51359222744931, -82.71162265812464 35.51369622746494, -82.7114626580497 35.5140112275128, -82.71141065802502 35.51411622752888, -82.71126765795822 35.51439722757151, -82.71083765775727 35.51524222769984, -82.71069565769045 35.515524227742766, -82.71061165765126 35.51568922776786, -82.71035965753339 35.516185227843174, -82.7102766574942 35.516351227868476, -82.71018665745214 35.51652822789539, -82.70991865732591 35.51706122797668, -82.70983065728397 35.51723922800396, -82.70981365727613 35.51727222800897, -82.70976265725267 35.51737022802374, -82.7097466572448 35.51740422802893, -82.70954565715122 35.51779722808855, -82.7091176569508 35.51864122821684, -82.70902565690585 35.51883422824673, -82.70895065687073 35.51898222826923, -82.70885465682548 35.5191732282984, -82.70874665677681 35.51937422832828, -82.70840865670127 35.51950022831937, -82.70828065668324 35.51947822830183, -82.70812565666925 35.51940122827024, -82.70792365666044 35.51923922821656, -82.70702365662125 35.51851722797726, -82.70686265662046 35.51834722792618, -82.70678865663167 35.51819322788717, -82.70672065662808 35.51814322787003, -82.70619665658114 35.51788022776279, -82.70597465656697 35.51773122770964, -82.70572765654296 35.51761922766157, -82.70555165652591 35.517539227627296, -82.70507365647074 35.51738022754595, -82.70487565645415 35.51727322750386, -82.70467765643755 35.51716622746185, -82.70442265642303 35.51698422739859, -82.7042076564149 35.51680322733966, -82.70398365641641 35.51655022726521, -82.70394465641661 35.516506227252215, -82.70356865643562 35.51597322710518, -82.7035006564319 35.515924227088114, -82.70266765629401 35.5159192270019, -82.702176656219 35.51587522694272, -82.70188165616916 35.51588022691351, -82.701766656145 35.5159132269085, -82.7014576560666 35.51608922691278, -82.70114165599378 35.51622122690728, -82.70091865594463 35.51630022690064, -82.70029565580683 35.51652322688231, -82.6999486557477 35.5165322268486, -82.69980165572356 35.51653022683317, -82.6992666556556 35.51639222675031, -82.69884865559584 35.51632822669454, -82.6986886555729 35.51630422667323, -82.69830565550917 35.51630422663403, -82.6978086554055 35.516441226611114, -82.6976336553586 35.51655722661684, -82.69736465526842 35.516854226649905, -82.69722365523579 35.51691422664771, -82.6970826552115 35.51691922663425, -82.69692865520018 35.51682622659956, -82.69688765520252 35.51676622658313, -82.69682765522374 35.51656222653542, -82.696575655247 35.51613622642277, -82.69647065525683 35.515958226375766, -82.6960676552302 35.51569422628066, -82.6960136552489 35.5155132262383, -82.69595865525206 35.51543322621629, -82.69592665524561 35.51544022621447, -82.69583065522585 35.515465226209756, -82.69579965521926 35.5154742262084, -82.69573065520889 35.51546722619988, -82.69566265519863 35.515460226191514, -82.69446565501785 35.51534022604457, -82.69304165480257 35.51519922587009, -82.69048765431151 35.51563122569677, -82.68916665405746 35.515855225607254, -82.68913965404678 35.51589522561262, -82.68905965401498 35.516016225629116, -82.68903365400438 35.51605722563484, -82.68871365387793 35.51653522569953, -82.6885216538033 35.51681422573672, -82.68831765372353 35.51711322577676, -82.68810865364348 35.517409225815776, -82.68803065361223 35.51752822583203, -82.68781265351444 35.51793022589165, -82.68756365339848 35.51841722596542, -82.68751165336694 35.51856622599044, -82.68746765333084 35.51875422602421, -82.6874426532489 35.519262226125235, -82.6874416532472 35.51927222612719, -82.68741865319627 35.51958022618757, -82.68738965315248 35.51983422623645, -82.68737365313676 35.51991922625204, -82.6873486531217 35.51999122626419, -82.68732165310871 35.52004622627265, -82.68727265309069 35.5201112262809, -82.6872426530807 35.52014322628434, -82.6871746530582 35.520216226292234, -82.68716865305649 35.52022122629266, -82.68695865298919 35.520432226314206, -82.68693865298351 35.52044822631537, -82.68685565295907 35.520517226321, -82.6867436529262 35.52061022632846, -82.68669265291125 35.52065222633182, -82.68647665283969 35.52088522635714, -82.6864286528216 35.520951226365675, -82.68605865268054 35.52147022643359, -82.68586665261151 35.521712226463244, -82.68557765251049 35.52205822650425, -82.68528065240614 35.52241722654698, -82.68517665236945 35.52254322656204, -82.68500165230739 35.52275822658797, -82.68486065225991 35.522915226605576, -82.68485965225949 35.522917226605806, -82.68474665222321 35.52303122661751, -82.68462165218594 35.52313922662667, -82.68454765216651 35.52318522662852, -82.68451265215701 35.52320922662978, -82.6843756521226 35.523285226631266, -82.6841776520723 35.52339822663405, -82.68393865201371 35.5235212266347, -82.68388365200059 35.523547226634285, -82.68365665194612 35.523656226633264, -82.68358165192831 35.52369122663274, -82.68335965187515 35.523797226631565, -82.68328565185729 35.523833226631396, -82.68299065178738 35.523969226628935, -82.68270665172163 35.5240902266245, -82.68267465171415 35.52410422662405, -82.68256265168928 35.524145226620966, -82.68172465150563 35.52443422659405, -82.6815646514688 35.52450022659112, -82.68134165141488 35.52461022659072, -82.68121265138183 35.524686226592976, -82.68097665131701 35.52485322660291, -82.6806696512323 35.525072226616125, -82.68046665117467 35.525228226627114, -82.6802816511215 35.525374226637965, -82.6802296511072 35.52541122664011, -82.68012365107796 35.52548722664477, -82.6799396510254 35.52563022665513, -82.67966265093834 35.52589822668133, -82.67956365090483 35.52600922669388, -82.67949665088207 35.526085226702456, -82.6794296508611 35.526149226708675, -82.6793596508374 35.52622822671755, -82.67930965083471 35.52619122670489, -82.67893265082179 35.52586622660007, -82.67890765082177 35.52583922659197, -82.67884765082158 35.52577522657285, -82.67876365082385 35.52566922654263, -82.67870765082957 35.52557122651692, -82.6786636508375 35.52547122649208, -82.67862165085076 35.52533922646086, -82.67858565086779 35.525189226426605, -82.67857465089044 35.525029226392874, -82.67857565092007 35.52483722635381, -82.67861665097973 35.52449222628769, -82.67866465104062 35.524146226222165, -82.67874765114476 35.52355722611051, -82.67883365125694 35.52291822598915, -82.678864651297 35.52269022594588, -82.6789626514187 35.52200222581564, -82.67905565151857 35.521451225712845, -82.67907165154132 35.521320225687795, -82.67907965157895 35.52108322564036, -82.67907365159027 35.5210022256232, -82.67907165159671 35.52095822561406, -82.6790506516161 35.520809225581466, -82.67900065163867 35.52060722553524, -82.67892165166047 35.52037922548069, -82.6789046516649 35.52033122546913, -82.67885865167344 35.520226225443096, -82.67881165168184 35.520120225416676, -82.67872565169286 35.519954225374, -82.67862865170207 35.51978922533041, -82.67854565170983 35.519648225293196, -82.67847565171596 35.51953222526242, -82.67844965171828 35.51948922525092, -82.67840465172098 35.51942222523277, -82.67829865172358 35.51929022519498, -82.67823865172329 35.519227225176, -82.6782246517229 35.519214225171886, -82.67817765172175 35.5191712251583, -82.67812265171948 35.51912622514351, -82.67802165171555 35.51904222511606, -82.6775426516919 35.51867622499241, -82.67742665168619 35.5185872249624, -82.67711265167263 35.518335224878925, -82.67688465166121 35.51816222482031, -82.67629665163413 35.51770022466604, -82.67580665161036 35.517323224538956, -82.67551865159652 35.51710122446428, -82.67521565157857 35.51688922439005, -82.67513965157208 35.516849224374084, -82.67509965156862 35.516828224365725, -82.67489865154602 35.516757224330696, -82.67488965154507 35.51675422432917, -82.67481665153582 35.516735224317834, -82.67480665153442 35.51673322431642, -82.67452565149584 35.51668022427683, -82.67440765148115 35.51664822425823, -82.6743066514675 35.516627224243635, -82.67420565145642 35.516590224225716, -82.67407465144397 35.516529224199914, -82.67402665144029 35.51650122418927, -82.67375065141918 35.51633922412797, -82.67364265140763 35.516297224108435, -82.6735326513945 35.51626322409018, -82.67340365137665 35.51624022407233, -82.67327965135779 35.51622822405714, -82.67314965133632 35.51622722404366, -82.67302165131447 35.51623122403136, -82.67160765105983 35.51635822391248, -82.67110265096889 35.51640422387019, -82.6709796509478 35.516408223858406, -82.67090165093667 35.51639622384797, -82.67081365092795 35.51635722383107, -82.67079565092696 35.51634422382651, -82.67075765092511 35.51631522381674, -82.67075265092487 35.51631122381544, -82.67070965092555 35.51626022380063, -82.67068165093039 35.516198223785075, -82.67067565093143 35.51618522378181, -82.67067265093576 35.51615322377499, -82.67066665094248 35.51610322376417, -82.67069565095939 35.51602422375112, -82.67072865097266 35.51597322374409, -82.67077065098702 35.515925223738606, -82.67084765101099 35.51585222373156, -82.67086565101654 35.51583522372994, -82.67116765110798 35.515566223706045, -82.67128465114708 35.515438223692016, -82.67134765116954 35.51535922368232, -82.67140065119102 35.51527722367099, -82.67142365120503 35.51521022365976, -82.67142265121181 35.51516522365047, -82.67140965121588 35.51512422364076, -82.6713706512171 35.515074223626634, -82.67132265121472 35.515037223614115, -82.67125965120856 35.515009223602014, -82.67121765120332 35.51499822359545, -82.67116465119643 35.51498522358738, -82.6710736511836 35.514970223574984, -82.67095865116521 35.51496522356218, -82.67083165114286 35.514973223550825, -82.67079765114357 35.51493222353902, -82.67075865114373 35.51488822352603, -82.67071665114509 35.51483422351074, -82.67071365114538 35.514829223509395, -82.67067965115017 35.51476022349185, -82.67064965115864 35.51467222347091, -82.67062865116768 35.51459122345219, -82.67061665120039 35.514364223404726, -82.67061665121071 35.514297223391075, -82.67061765121238 35.514287223389104, -82.67064465124483 35.514104223354586, -82.67066065126507 35.51399022333302, -82.67071065132542 35.51365022326882, -82.67072065133645 35.51358922325747, -82.67072465134501 35.51353722324728, -82.67074365137802 35.51334222320947, -82.67074465137883 35.5133382232087, -82.67080465143796 35.5130172231495, -82.67083065146083 35.51289622312747, -82.67084165147523 35.5128142231119, -82.67084265148296 35.5127642231018, -82.67084365148912 35.51272522309397, -82.67081565149805 35.51263622307296, -82.67078365150108 35.512582223058686, -82.6707696515024 35.51255822305241, -82.67072065150454 35.51249122303372, -82.67070465150519 35.51246922302756, -82.67068765150582 35.51244722302138, -82.67067865150625 35.512434223017806, -82.67063265150585 35.51238722300345, -82.6706136515056 35.51236822299772, -82.67059165150522 35.51234622299095, -82.67054965150383 35.51231022297929, -82.67051765149951 35.512303222974566, -82.67045365149106 35.5122892229652, -82.67027065146057 35.51228922294648, -82.67016265144342 35.512284222934376, -82.67004465142443 35.51228022292151, -82.67023465150498 35.5119602228758, -82.67040665157741 35.51167422283509, -82.67060365165277 35.51139622279858, -82.67085765175044 35.51103422275087, -82.67107165183246 35.51073022271079, -82.67124065188811 35.5105502226914, -82.67200465222803 35.509160222486344, -82.67194865222926 35.50909122246658, -82.67182565223195 35.508940222423135, -82.67111365210404 35.50900222236291, -82.67063365202145 35.50902022231752, -82.67028265197617 35.50893522226423, -82.66995465189004 35.509141222272625, -82.66961465182023 35.50922822225557, -82.66954565184324 35.50900322220265, -82.66976865193226 35.508663222156166, -82.67047165207526 35.508493222193565, -82.67120865224092 35.50821122221146, -82.67120665228423 35.507926222153245, -82.6706526522215 35.50773422205741, -82.67057765224517 35.50749822200163, -82.67055265225335 35.50741722198255, -82.67110365239873 35.50706622196741, -82.67181365256673 35.50674022197368, -82.67204365265516 35.506412221930375, -82.6716626526371 35.50611622183101, -82.67126065261824 35.50580322172611, -82.67132465268756 35.50541922165444, -82.67132465272678 35.50516322160228, -82.671348652775 35.50487422154578, -82.67138865285496 35.50439522145233, -82.67141365285529 35.50442022145994, -82.67149065285629 35.50449722148355, -82.67151665285662 35.504523221491525, -82.67182065298805 35.50399522141497, -82.6716446531106 35.503003221194874, -82.67164465316448 35.502651221123074, -82.67186865330703 35.501963221005845, -82.67183665333108 35.50177122096348, -82.67142065335742 35.501147220793754, -82.67127565338195 35.50082922071405, -82.67126065338462 35.50079522070562, -82.67103665338406 35.50055522063381, -82.670844653411 35.50017122053595, -82.66998065340442 35.49927522026494, -82.66905265336524 35.49852322001669, -82.66834865334862 35.497867219811035, -82.66809265335004 35.49757921972609, -82.66745265330978 35.49714721957264, -82.66679665326676 35.49671521941747, -82.66633265324354 35.49636321929831, -82.66596465325578 35.495883219162806, -82.66562865328314 35.4953392190176, -82.66542065333915 35.494747218875666, -82.66506865342262 35.49381921865058, -82.66438065339389 35.4932592184661, -82.66354865333405 35.49274721827668, -82.66318465332765 35.49239321816727, -82.66295665332359 35.49217121809878, -82.661595653215 35.49140321780298, -82.66079565313585 35.49105121764943, -82.66013965318588 35.49001121737038, -82.66031565327638 35.48961121730688, -82.66069965341609 35.48911521724515, -82.66079565348835 35.48874721717997, -82.66093965359298 35.48821921708718, -82.6610516536948 35.48767521698775, -82.6611316538525 35.486731216803626, -82.66121165397591 35.48601121666513, -82.66133965408038 35.48546721656734, -82.66175565426943 35.48468321645022, -82.66205965446184 35.483755216292266, -82.66213565454477 35.483295216206336, -82.66213965454854 35.483275216202635, -82.66237965462507 35.48303521617832, -82.66313165482593 35.48253921615418, -82.66389965500743 35.48218721616107, -82.66405965506821 35.48196321613175, -82.66458765528809 35.481099216009696, -82.665019655443 35.48055521594309, -82.66564365562014 35.48007521590914, -82.66631565581984 35.47949921586051, -82.66690765597698 35.4791152158428, -82.66693965605079 35.478667215754804, -82.6668436561278 35.478059215621094, -82.66671565619458 35.47748321549069, -82.6663956562391 35.47684321532758, -82.66626765632068 35.47617121517755, -82.66637965643957 35.475515215055346, -82.66642765655514 35.47481121491684, -82.6659796565956 35.4740592147178, -82.66597965671055 35.473307214564535, -82.66636365683306 35.472923214525565, -82.66716365709797 35.472059214431354, -82.66737165728414 35.47106721425059, -82.66781965751261 35.47005921409098, -82.66773965764851 35.469083213884055, -82.6676756577674 35.46823521370466, -82.66802765792364 35.46759521361024, -82.66829965804958 35.467067213530456, -82.668379658212 35.46609121333985, -82.66868365835543 35.46548321324703, -82.66875965838845 35.46534921322746, -82.66892365845882 35.46506721318677, -82.66985165875478 35.46413921309261, -82.67033165906419 35.46263521283524, -82.67041165921685 35.46172321265761, -82.67106765944317 35.460955212568244, -82.67157965965036 35.460155212457636, -82.67237965987866 35.45953121241218, -82.67332366009416 35.45914721243053, -82.6739226603104 35.45838321233608, -82.67548366087343 35.456395212090534, -82.67605966105216 35.45585121203855, -82.67762866140087 35.455275212081574, -82.67843666161984 35.45472021205113, -82.67874866170419 35.454507212039594, -82.67967666194154 35.45396321202357, -82.68018866205104 35.45380321204334, -82.68020466191197 35.454731212234016, -82.68047666187414 35.4552752123727, -82.68105266183797 35.45613921260764, -82.68115766183134 35.45629721265049, -82.68134666181913 35.45658321272814, -82.68135966181279 35.45663821274068, -82.68142766180661 35.45675321277102, -82.68148766179641 35.456885212804046, -82.68154766179218 35.45697821282915, -82.68163566178158 35.45714321287171, -82.68171566177982 35.45724221290009, -82.6817566617774 35.45730221291655, -82.6817696617653 35.45739621293699, -82.68180966175773 35.45748921296003, -82.68181666173459 35.45764821299317, -82.68185066170072 35.45790721304946, -82.68187766168255 35.45805521308234, -82.68191766166983 35.4581822131123, -82.68193066162175 35.458511213180685, -82.68196466160134 35.45868221321901, -82.68196466158271 35.45880321324357, -82.68197166157071 35.45889021326209, -82.68194466153345 35.45910521330313, -82.68195766151798 35.45922021332792, -82.68209866147014 35.45968721343747, -82.68218666144531 35.459945213499054, -82.68226666141832 35.46020921356099, -82.68234066140381 35.460385213604454, -82.68238766138737 35.46054421364168, -82.6825146613496 35.46092921373305, -82.68256866132762 35.46113221377992, -82.682635661285 35.46148421385849, -82.68274366124747 35.46184721394351, -82.68284466123404 35.46204521399419, -82.68297166122008 35.46227521405404, -82.68304566120459 35.4624572140987, -82.6831806611943 35.462671214156146, -82.68326066119009 35.46278621418773, -82.68346266119677 35.4629622142442, -82.68364366120504 35.46310521429188, -82.68389866120464 35.463385214375066, -82.68403366120022 35.463561214424665, -82.68417466119168 35.46377021448166, -82.6841776611916 35.46377421448281, -82.68436266118363 35.46402821455348, -82.68461066116427 35.46442421465947, -82.68470466114556 35.46464921471497, -82.6847926611324 35.46483121476105, -82.68489966112253 35.46501221480888, -82.68499366110885 35.46520421485764, -82.68505466109622 35.46535321489421, -82.68518166102923 35.46593021502481, -82.68522266101346 35.466078215059184, -82.68524866099682 35.46621521508974, -82.68526866099008 35.466281215105205, -82.68520166096724 35.466358215114, -82.68508166093044 35.46646821512424, -82.684993660899 35.466578215137595, -82.68487966085489 35.46674321515966, -82.68463766076847 35.467045215196364, -82.6845906607498 35.46711621520603, -82.68454366072845 35.467205215219394, -82.68448566069361 35.467370215247136, -82.68445666067545 35.46745721526187, -82.68440266061536 35.467792215324586, -82.68434966059135 35.46789121533933, -82.6843086605711 35.46797921535306, -82.68426866055773 35.4680232153579, -82.68422166053392 35.46812821537455, -82.68412766049813 35.468260215391865, -82.68391866042825 35.468490215417354, -82.68375166038274 35.46860621542392, -82.68360366033964 35.468727215433404, -82.6834486602913 35.46887521544771, -82.68335566026573 35.46894121545172, -82.68328066024661 35.46898521545301, -82.6832136602229 35.469067215462815, -82.68316666020496 35.4691332154715, -82.68310666017656 35.46925421549001, -82.68306566015127 35.46937521551043, -82.68301266011478 35.46955621554198, -82.68293866007384 35.46974321557246, -82.68289766004357 35.469897215599666, -82.68285766002272 35.46999021561453, -82.68279765999671 35.4700952156298, -82.68272365997183 35.47017721563894, -82.68263665992451 35.470392215673876, -82.68260965990248 35.47050721569452, -82.6826026598853 35.4706122157152, -82.68264265987948 35.470694215736074, -82.68266865987094 35.47077821575582, -82.68268365986603 35.47082621576714, -82.68284465985344 35.471084215836164, -82.6831536598493 35.47144721594172, -82.68334865983392 35.47176021602541, -82.68342165982513 35.47189721606084, -82.68358065987566 35.47173921604492, -82.68313265968877 35.47247521614902, -82.68316465965005 35.47276321621099, -82.68345265965885 35.47301921629265, -82.68349165955426 35.473746216444766, -82.68352265951411 35.474042216508245, -82.68357765944207 35.47457421662223, -82.68372365939193 35.475061216736464, -82.68384565938258 35.47525521678847, -82.68426465941782 35.475480216877095, -82.68578165951432 35.47649921723989, -82.68651165952883 35.47719821745704, -82.68690665953699 35.47757521757426, -82.68768465951526 35.4785632178552, -82.6880966594596 35.479376218062974, -82.68819765934687 35.4802232182459, -82.68800865918351 35.48108621840248, -82.68774465900444 35.48197121855584, -82.68762365890953 35.48246021864306, -82.68754565884736 35.48278221870078, -82.687548658746 35.483448218836784, -82.68754565874329 35.48346321883956, -82.68755465872326 35.483604218869196, -82.68760965869639 35.483839218922746, -82.68762765868134 35.48395721894856, -82.68765365865988 35.484126218985665, -82.68765065861889 35.48439121903946, -82.68765365860875 35.48446021905378, -82.6876556586033 35.48449821906173, -82.68761265858383 35.484579219073844, -82.68751565852679 35.48484621911837, -82.68746765850217 35.48495521913567, -82.68741765847253 35.48509521915903, -82.6874066584526 35.48521321918193, -82.6874086584346 35.48533321920665, -82.68742765842099 35.485443219230945, -82.68746965840973 35.48556221925956, -82.68757765839179 35.48579721931849, -82.68762465838591 35.485886219341396, -82.68763965838423 35.485914219348686, -82.68772465836868 35.486108219396854, -82.68776865835733 35.48623021942625, -82.68779965834415 35.48635021945389, -82.68780465834388 35.486357219455755, -82.68783065834246 35.486395219466246, -82.68785565834088 35.486432219476335, -82.68791265833873 35.48650821949765, -82.68791365833862 35.48651021949817, -82.68794365833843 35.48654421950816, -82.6879746583384 35.48657821951824, -82.68803965833818 35.48665021953952, -82.68807465834035 35.48667421954807, -82.68811365834267 35.48670121955751, -82.68820965837654 35.486584219543545, -82.6882596583891 35.48655621954294, -82.6884136584273 35.48647421954203, -82.68858565846641 35.48640521954548, -82.68870565849356 35.486358219548215, -82.68883765852114 35.48632121955412, -82.68902665856037 35.48627021956305, -82.68903965856293 35.48626821956398, -82.68921465859702 35.486235219575185, -82.68928065860985 35.48622321957946, -82.68945565863935 35.486220219596696, -82.68961565866054 35.48625621962046, -82.68973565867317 35.48630421964248, -82.6899016586903 35.486372219673285, -82.68996165869653 35.48639721968454, -82.69005065870866 35.48641421969713, -82.69017265872884 35.48641521970985, -82.69018465873063 35.486416219711266, -82.69027165874952 35.48638721971419, -82.69039865878308 35.48630621971067, -82.69083865891446 35.485925219678045, -82.69085365891881 35.485913219677165, -82.69107165897644 35.485773219670875, -82.69125265899467 35.48585121970526, -82.69134965900349 35.48589921972505, -82.69136665900474 35.485909219728796, -82.69144165900991 35.48595721974629, -82.69163965902064 35.48610221979606, -82.69167865902007 35.48614821980941, -82.69171665901936 35.48619421982265, -82.69177765901365 35.486298219850106, -82.69180265899887 35.48642221987791, -82.69179665895578 35.48669721993337, -82.69179365892703 35.486882219970745, -82.69178465890397 35.487023219998605, -82.69177565888184 35.48715822002521, -82.69177465884174 35.48741922007829, -82.691797658806 35.48767822013342, -82.69180365879771 35.48773922014642, -82.691848658757 35.488054220215204, -82.69193865872076 35.48838922029272, -82.69203365868711 35.48871222036833, -82.69209965865181 35.48901522043681, -82.69213565861226 35.489313220501266, -82.6921236585648 35.4896102205605, -82.6921206585529 35.489685220575545, -82.69203965849591 35.4899692206251, -82.69195965844612 35.49020822066565, -82.69194665843908 35.49024022067082, -82.69186165839272 35.4904502207049, -82.69182665837324 35.49054022071971, -82.69172365832722 35.490729220747696, -82.69153265824684 35.491047220792986, -82.69141665819772 35.49124222082083, -82.69127465813766 35.49148022085481, -82.69119865810931 35.49158322086806, -82.69111465807741 35.491700220883274, -82.69085065798514 35.49201622092071, -82.69078265796381 35.49208222092722, -82.6906916579347 35.492173220936465, -82.69054465789044 35.492303220947896, -82.69045665785856 35.492415220961696, -82.6903986578253 35.492570220987346, -82.690326657737 35.49306922108169, -82.69028765768418 35.49337222113951, -82.69024065763585 35.49363722118872, -82.69018665759887 35.493820221220446, -82.6901186575611 35.49399322124874, -82.69002765751368 35.49420422128243, -82.68991565746558 35.49439722131031, -82.68980465741605 35.49460022134038, -82.68963965734764 35.494868221378084, -82.68959565733003 35.494935221387216, -82.68951065729557 35.49506822140568, -82.68931865720297 35.495465221466944, -82.68903365710078 35.495823221510726, -82.68893865706679 35.495942221525304, -82.68889065704944 35.496003221532824, -82.68903665706316 35.49607222156183, -82.68933865708662 35.496247221628366, -82.68941865709277 35.4962942216461, -82.68958965710509 35.496399221684996, -82.68974965711463 35.496511221724234, -82.68979865711664 35.49655122173741, -82.68989265712051 35.496628221762734, -82.68990665712084 35.49664122176673, -82.69004565712486 35.49676622180646, -82.69018365712733 35.49690022184791, -82.69022365713093 35.49692022185604, -82.69032765714003 35.49697322187756, -82.69035265714365 35.49697722188089, -82.69050265716491 35.4970012219011, -82.69095765723921 35.49701022194945, -82.69158565734415 35.49700722201312, -82.69200065741413 35.49700122205435, -82.69304165758939 35.496987222157955, -82.69354865767679 35.496967222205726, -82.69424965780115 35.496916222267075, -82.69504365794613 35.49683222233118, -82.69523965798325 35.496802222345174, -82.69538965801387 35.49676522235294, -82.69551565804335 35.49670922235438, -82.69563465807376 35.49664022235253, -82.6958186581226 35.496521222347056, -82.69602965817604 35.496401222344154, -82.69622065821652 35.4963442223521, -82.69636765824443 35.49632122236245, -82.69652965827046 35.49632722238025, -82.69675665830246 35.49636522241123, -82.69682765831199 35.49638022242147, -82.69688265831917 35.49639322242981, -82.69714765835032 35.49647722247396, -82.6973296583696 35.49654922250732, -82.69746865837925 35.49663722253952, -82.69763165838789 35.49675822258084, -82.6979066584041 35.49695122264824, -82.69805865841673 35.49703422268073, -82.69826165843688 35.49712322271966, -82.69828265843884 35.49713322272383, -82.69859165846775 35.497280222785385, -82.69903665850374 35.49752922288165, -82.69918765851587 35.497614222914436, -82.69974865855515 35.49796722304379, -82.69996665857188 35.498095223092164, -82.70018465859147 35.49820422313665, -82.70040665861389 35.49829922317876, -82.70069465864582 35.49840322322944, -82.70096965867843 35.49848922327505, -82.70133865872153 35.49860922333726, -82.70146065873567 35.49864922335791, -82.70160665874957 35.49871722338674, -82.7017296587587 35.4987912234144, -82.70184965876184 35.49890122344904, -82.70197965875808 35.49906722349625, -82.70200665875674 35.49910522350671, -82.70211665875121 35.499261223549766, -82.70223765874725 35.4994182235941, -82.70239565874873 35.49958122364354, -82.70246265875123 35.499637223661814, -82.70258465875582 35.499740223695255, -82.70281465876639 35.49992122375573, -82.7029496587737 35.50002022378971, -82.70323365879388 35.50019722385481, -82.70338565880803 35.500270223885266, -82.70361265883416 35.50034622392393, -82.70391765887217 35.50042922397206, -82.70411565889565 35.50049122400491, -82.70423765890662 35.50055222402987, -82.70430865891005 35.500607224048295, -82.70433465891118 35.500628224055305, -82.70441565890994 35.500724224083164, -82.70448365890059 35.50085922411761, -82.70452565888833 35.50098522414762, -82.70456965887179 35.50114122418393, -82.70457565886555 35.50118822419412, -82.70456065885543 35.50123822420272, -82.70470265889269 35.50114922419919, -82.70471065889222 35.501161224202384, -82.7047346588688 35.50134022424133, -82.70475865887053 35.50135522424685, -82.7047926588728 35.50137722425483, -82.7048306588755 35.501401224263574, -82.70485465887698 35.5014172242693, -82.70497365891316 35.501310224259676, -82.70503365893366 35.50124122425172, -82.70511165896399 35.501128224236645, -82.70513965897472 35.50108822423142, -82.70553865914121 35.50043422413891, -82.70562465917325 35.50031822412404, -82.70570065919831 35.50023622411509, -82.70577665921738 35.500195224114535, -82.7057836592189 35.50019222411462, -82.7058436592314 35.50017622411745, -82.70590665924293 35.500169224122494, -82.70606465926835 35.500175224139866, -82.7061686592833 35.50019022415356, -82.7062326592926 35.500199224161996, -82.70629565930174 35.50020822417025, -82.70632765930641 35.500212224174305, -82.70641065931889 35.50022122418468, -82.70642765932155 35.5002222241866, -82.7064936593313 35.50023022419497, -82.70650865933189 35.50024222419898, -82.70652665933294 35.50025522420344, -82.70655365933347 35.500281224211484, -82.7065686593338 35.50029522421588, -82.70743965935239 35.50112122447336, -82.70758465936487 35.501197224503684, -82.7077766593936 35.5012182245276, -82.70801065943353 35.50121222455031, -82.70822265946006 35.501269224583645, -82.7085226594812 35.50145722465266, -82.709174659514 35.501952224820215, -82.70934565952251 35.50208222486424, -82.70985465952697 35.502607225023375, -82.7101606595363 35.50287922511012, -82.71031265955015 35.502954225140904, -82.71093765962952 35.503115225237664, -82.71105665963967 35.50317822526262, -82.71116565964081 35.50328922529648, -82.71159865959356 35.5040692254998, -82.71175665959399 35.504238225550374, -82.71193565960556 35.504357225592926, -82.71229565964633 35.504482225655295, -82.71260065968578 35.50455622570155, -82.71294865973074 35.504641225754476, -82.71318165975221 35.504754225801356, -82.71341765976885 35.50490222585565, -82.71389365982614 35.505045225933486, -82.71417265987003 35.505062225965524, -82.71442265991668 35.50502922598442, -82.7147276599798 35.50494822599899, -82.7163436603493 35.50429122603035, -82.71646866037743 35.50424322603336, -82.71666766041609 35.50420722604638, -82.71693466046194 35.50419822607187, -82.71718566051335 35.50413522608463, -82.71738166055938 35.50404722608677, -82.71822666075758 35.5036712260965, -82.7185026608211 35.503556226101324, -82.71888666090263 35.50344122611717, -82.71933366099746 35.50330722613556, -82.71955166104203 35.50325322614683, -82.71979866109263 35.503191226159394, -82.72028866119649 35.50304522617977, -82.72037366121955 35.50298722617666)))",6575,37,021,002402,370210024022,1594,1594,91,1582,1513,7,3,5,0,54,12,1242,54,1188,1235,1189,5,2,4,0,35,7,738,651,87
census_2010_blockgroups_view.fid--2dc29038_13ec899ba8f_-262b,"MULTIPOLYGON (((-82.68811665037201 35.53877223017101, -82.68842065044925 35.53859823016661, -82.68873265052866 35.538419230162134, -82.689048650609 35.53823823015755, -82.68970365077517 35.53786523014858, -82.68996065083967 35.537723230145986, -82.69023965090996 35.53756723014276, -82.69058565099792 35.537369230137784, -82.69076365104296 35.53726823013548, -82.6911996511548 35.53701223012787, -82.69155465124237 35.53682623012639, -82.69180965130626 35.536686230123905, -82.69185665131795 35.53666123012364, -82.69210765138057 35.5365252301216, -82.69252965147902 35.53634123012734, -82.69283165154641 35.53622923013537, -82.69316065161729 35.536124230147706, -82.69360465170924 35.53600623016907, -82.69374965173837 35.53597323017721, -82.69442465187416 35.53582023021512, -82.69454865188779 35.53586623023718, -82.69467665189973 35.535927230262786, -82.69468165190008 35.53593023026388, -82.69480365190647 35.53602123029495, -82.69489765190615 35.536125230325695, -82.69494965190201 35.536208230347974, -82.69508965188183 35.53649223042017, -82.69513665187434 35.53659223044537, -82.69523965185851 35.5368072304998, -82.69525565185619 35.53684023050811, -82.69531365184653 35.53696623053973, -82.695374651838 35.5370882305709, -82.69537865183739 35.537096230572935, -82.69543465182885 35.53721223060227, -82.69569665178905 35.537757230740254, -82.69574165178544 35.53782923075952, -82.69575565178428 35.53785223076562, -82.69582365178195 35.53794123079076, -82.69592565178482 35.53803323081997, -82.6960166517905 35.53809523084194, -82.6960586517942 35.53811623085049, -82.69616265180348 35.53816923087193, -82.69631565182094 35.53822123089823, -82.69650665184491 35.53827223092816, -82.6966596518641 35.538313230952156, -82.69686565189106 35.53836123098305, -82.69717065193011 35.53843723102983, -82.6974586519669 35.538510231074156, -82.6984716520972 35.538760231228856, -82.69870165212653 35.53881823126423, -82.69907865217465 35.53891423132234, -82.69921265219209 35.53894523134245, -82.69923565219523 35.538950231345815, -82.6992686521995 35.538958231350804, -82.69930465220408 35.538967231356345, -82.69932865220699 35.538974231360264, -82.69934765220944 35.53897923136312, -82.69940765221706 35.53899423137234, -82.69942865221977 35.538999231375584, -82.69945665222336 35.539006231379844, -82.69954365223454 35.5390282313932, -82.69957265223813 35.53903623139778, -82.69983565227193 35.53910123143797, -82.69989565227951 35.539117231447456, -82.70004365229778 35.539158231470914, -82.70086565240358 35.53936123159645, -82.70104365242629 35.539406231623886, -82.70118965244515 35.53944123164599, -82.70135965246737 35.53948123167155, -82.70174165251717 35.53957123172902, -82.70187265253527 35.5395952317473, -82.70204565255902 35.53962823177175, -82.70222765258441 35.53966023179687, -82.70253765262916 35.53970523183785, -82.7025446526303 35.53970523183854, -82.70289965268293 35.53974723188344, -82.70326265273832 35.53978023192734, -82.7040046528544 35.53982923201323, -82.70405565286222 35.5398332320193, -82.70434765290729 35.539856232053864, -82.70456065294093 35.539868232078156, -82.70461965295027 35.53987123208479, -82.70467165295845 35.53987423209071, -82.7047976529781 35.53988323210547, -82.70485765298726 35.53988823211264, -82.70490865299534 35.539891232118485, -82.70506265301911 35.53990323213671, -82.70511465302701 35.539908232143, -82.70518565303804 35.5399132321513, -82.70520165304029 35.53991623215354, -82.70546065307543 35.53996823219066, -82.7054866530789 35.5399732321944, -82.70554765308695 35.53998723220344, -82.70571465310869 35.540027232228695, -82.70573565311116 35.54003323223213, -82.7060646531508 35.54013223228591, -82.70625765317226 35.54020223232001, -82.70628865317605 35.540211232325014, -82.70638365318719 35.54024123234084, -82.70647265319715 35.54027323235645, -82.70634765316692 35.540334232356095, -82.70636365316335 35.540375232366095, -82.70638265316175 35.540406232374366, -82.70647165315437 35.54055123241306, -82.7065186531535 35.54060823242947, -82.70654165315312 35.54063523243732, -82.70657765315467 35.54066423244701, -82.70661665315637 35.54069523245727, -82.7067386531694 35.54074323247953, -82.70687565318681 35.540778232500706, -82.70688665318819 35.5407812325024, -82.70703565320903 35.540807232523, -82.70719665323287 35.54082623254333, -82.70761665329302 35.54089023259941, -82.70781265332212 35.540913232624156, -82.70783365332517 35.54091623262694, -82.70798665334618 35.54094523264851, -82.70814665336505 35.54099623267528, -82.7082646533784 35.54103723269566, -82.70833965338437 35.54107923271195, -82.70858665340438 35.541217232765405, -82.70877765341804 35.541335232809, -82.70888765342679 35.54139823283311, -82.70907065344078 35.541505232873625, -82.70927565345903 35.54160923291585, -82.7094476534765 35.54168223294832, -82.70945665347739 35.54168623295011, -82.70960665349475 35.541735232975384, -82.70980265352041 35.541781233004876, -82.71000765354978 35.54181223303222, -82.71013665356884 35.54182823304869, -82.71044465361396 35.541868233088366, -82.7106766536474 35.541902233119025, -82.7108136536671 35.54192223313712, -82.71108865370523 35.541972233175514, -82.71131665373676 35.54201423320736, -82.7117256537891 35.54211723327022, -82.71188865380886 35.54216523329674, -82.71188965380905 35.54216523329685, -82.71222365385229 35.54224623334751, -82.71301665395436 35.54244123346848, -82.71346165401003 35.542561233538514, -82.7136536540311 35.54263223357264, -82.71425465409442 35.54287223368307, -82.71445765411573 35.54295423372058, -82.71502065417496 35.54317923382413, -82.71532665420474 35.543317233883634, -82.71539865421164 35.54335023389771, -82.7157026542324 35.543545233968565, -82.71583865423975 35.5436452340029, -82.71597265424928 35.5437282340335, -82.71610265425707 35.54381923406535, -82.71616965426011 35.54387223408305, -82.71632465426703 35.54399523412403, -82.71641265426516 35.54410323415501, -82.71634665423836 35.5442062341693, -82.7163406542357 35.54421723417088, -82.71629265421143 35.544323234187594, -82.71621865418253 35.54443123420208, -82.71610565414707 35.54454023421275, -82.71600965411648 35.544635234222305, -82.71597665410594 35.544668234225604, -82.71587265407531 35.544755234232696, -82.71586165407217 35.544763234233244, -82.7157416540378 35.54485723424007, -82.71558765399864 35.54494523424224, -82.71543765396406 35.545008234239766, -82.71534565394437 35.545036234236036, -82.71515865390424 35.545095234228924, -82.71509865389137 35.5451142342267, -82.71495865386086 35.54516123422191, -82.71492265385191 35.5451802342221, -82.71486765383824 35.545210234222615, -82.71485065383379 35.54522023422295, -82.7147596538079 35.545290234227885, -82.71474165380178 35.54531123423026, -82.7146736537771 35.54539823424105, -82.7146186537484 35.54552523426131, -82.71458565371371 35.54571623429692, -82.71458165370638 35.54575923430523, -82.71456965368174 35.54590723433423, -82.71456865367945 35.54592123433696, -82.71455965365644 35.54606123436459, -82.7145346535873 35.546485234448475, -82.71452665356439 35.54662623447642, -82.71452165355034 35.546712234493434, -82.71451065351913 35.5469042345315, -82.71450365350783 35.54697023454424, -82.71449565349327 35.547056234560905, -82.71447765347574 35.54715123457848, -82.71445865345567 35.54726123459891, -82.7144136534266 35.547402234623064, -82.71440065341986 35.54743223462789, -82.71436365339989 35.547522234642415, -82.71428565336254 35.54768123466682, -82.71420265332232 35.54785323469347, -82.71415665329735 35.547966234711765, -82.7141266532767 35.54806823472949, -82.7141016532555 35.54817923474957, -82.71406365322252 35.54835323478117, -82.71434165326237 35.54839523481823, -82.7143456532631 35.54839523481859, -82.71452965329034 35.5484172348419, -82.71519865339272 35.54847623492254, -82.71538865342164 35.54849323494541, -82.71548365343573 35.54850523495757, -82.7155416534442 35.54851223496494, -82.71558665345073 35.54851923497095, -82.71571665346838 35.54854523498957, -82.71577465347607 35.54855823499815, -82.71580765348044 35.54856523500296, -82.71589565349176 35.54858723501644, -82.71590665349312 35.54859023501821, -82.71593965349687 35.54860123502383, -82.71630265354035 35.54871223508359, -82.71661265357726 35.548808235134885, -82.71729065365948 35.549008235245175, -82.71739465367133 35.54904423526307, -82.71754665368844 35.54909723528955, -82.71765265369832 35.54914823531073, -82.71774065370482 35.54920123533051, -82.71774965370525 35.5492082353329, -82.71777865370693 35.549229235340185, -82.71778865370729 35.54923723534283, -82.71782165370894 35.54926223535127, -82.71784965370921 35.54929123536008, -82.71794165370994 35.54938623538891, -82.71801765370898 35.54947523541476, -82.71807165370828 35.549538235433175, -82.7183566537075 35.54985323552661, -82.71843065370743 35.54993423555065, -82.71855365370887 35.5500582355886, -82.7186686537123 35.550161235621374, -82.71880365371803 35.55027023565739, -82.71893665372473 35.5503712356916, -82.71915865373946 35.55051623574389, -82.7193666537583 35.55061923578619, -82.71947765376822 35.550675235808974, -82.71975265379484 35.5508002358626, -82.71978265379786 35.55081323586841, -82.71987565380688 35.55085523588644, -82.71990665380972 35.55087023589264, -82.71997865381664 35.55090323590678, -82.72019765383763 35.55100423594983, -82.7202706538446 35.5510382359642, -82.72027565384516 35.55104023596516, -82.72029165384674 35.55104723596825, -82.72029765384724 35.551050235969406, -82.72030865384828 35.55105523597161, -82.72034165385153 35.55107023597796, -82.72035365385258 35.551076235980446, -82.7205986538759 35.55119023602881, -82.72070365388576 35.55124023604972, -82.72085665389899 35.55132023608168, -82.72098465390835 35.55139823611072, -82.72109065391408 35.551476236137454, -82.72118965391718 35.55156323616538, -82.72126865391847 35.55164023618917, -82.72128865391876 35.551660236195325, -82.72137965391758 35.55176723622642, -82.72144065391501 35.551850236249635, -82.72153365391073 35.55197923628541, -82.72161065390604 35.552093236316544, -82.72182365389321 35.55240823640259, -82.7221056538744 35.552837236519046, -82.72226965386353 35.55308623658653, -82.72238165385617 35.55325623663267, -82.7223266538459 35.55326323662845, -82.7220126537871 35.55330623660506, -82.72173665373417 35.553351236585996, -82.7214776536839 35.55339723656882, -82.72110965361078 35.55347523654713, -82.72075765353924 35.55355923652816, -82.7202176534163 35.55377423651674, -82.71976065331522 35.55393723650317, -82.71904265315807 35.5541822364796, -82.71860265305475 35.554378236474555, -82.71812865294075 35.55460623647248, -82.71770465284015 35.554802236469015, -82.71723165271891 35.555079236477084, -82.7164806525286 35.55550423648686, -82.71574665235634 35.55583023647816, -82.71478365212835 35.55627123646948, -82.71413065198709 35.556483236445864, -82.7135436518694 35.556613236412275, -82.71277665171915 35.55676023636369, -82.71204265158937 35.55680923629849, -82.7112916514593 35.55684223622833, -82.71083465138575 35.55682523617805, -82.71023065129006 35.556793236109606, -82.70941465117433 35.556662235999354, -82.70925065115327 35.55662123597415, -82.70836965103744 35.55642023584301, -82.69986664990599 35.554566234594134, -82.6982596496917 35.554219234358705, -82.69795464965112 35.55415323431408, -82.69754964959623 35.554071234255865, -82.69713864954096 35.553985234196226, -82.69661664947144 35.553872234119765, -82.69610664939883 35.55379223405115, -82.69556964931968 35.553725233982505, -82.69391964906772 35.553577233783365, -82.6935606489997 35.5536312337576, -82.69308864892218 35.5536242337078, -82.69258064883707 35.55362823365654, -82.6918086487046 35.5536542335828, -82.69154164865816 35.55366723355812, -82.69101964856509 35.553707233512746, -82.69040964845424 35.55376823346274, -82.69033564845897 35.55365723343257, -82.69030364846262 35.5535982334172, -82.69028864846425 35.55357123341018, -82.69025764847046 35.55349723339188, -82.69019564848257 35.55335123335586, -82.69016764849911 35.55321323332477, -82.69016364850334 35.55318123331784, -82.69015864850978 35.55313323330757, -82.69015464851857 35.55307223329475, -82.6901446485439 35.55289623325787, -82.69012264857443 35.55267323321007, -82.69012264857487 35.552670233209476, -82.6900706486109 35.55237923314485, -82.6899956486473 35.55206023307211, -82.68994264865883 35.55192723303956, -82.6898986486623 35.55185723302081, -82.68984964866395 35.551793233002726, -82.68979164866336 35.55173423298475, -82.6897236486606 35.551678232966395, -82.68965364865609 35.55163223294983, -82.68964464865532 35.55162723294792, -82.6895856486501 35.551597232935755, -82.68950364864179 35.55156223292019, -82.6893956486297 35.551524232901436, -82.68929764861781 35.55149523288548, -82.68927164861435 35.55148923288159, -82.68916464860058 35.55146323286532, -82.68896964857406 35.55142423283741, -82.68874364854341 35.55137923280505, -82.68848364850946 35.55131823276601, -82.68837964849702 35.55128623274881, -82.68829364848779 35.55125323273328, -82.68814564847376 35.55118423270406, -82.68809164846994 35.55115023269164, -82.68806464846799 35.5511342326856, -82.68793864846305 35.55102923265127, -82.68789064846308 35.55097723263577, -82.68786764846459 35.550942232626234, -82.6878266484673 35.550880232609394, -82.68776564847644 35.55075423257745, -82.68775164848306 35.55069623256426, -82.68774964848424 35.550686232562, -82.68771764850838 35.550494232519576, -82.6876876485548 35.55015923244821, -82.68765664859195 35.54988323238878, -82.6876386486141 35.549719232353524, -82.68762464862814 35.549612232330276, -82.68762064863235 35.549580232323336, -82.68756064867051 35.54926623225316, -82.68751964868429 35.54913223222165, -82.6874646486961 35.548995232188055, -82.68732064871817 35.548695232112216, -82.68726964872255 35.54861123208981, -82.68720664872465 35.54852923206669, -82.68714164872445 35.54846023204599, -82.68703264872008 35.54837023201642, -82.68702764871985 35.548366232015084, -82.686951648714 35.54832223199836, -82.68686264870604 35.54827723198011, -82.68676864869546 35.54824423196373, -82.68665964868207 35.54821323194625, -82.68655064866765 35.54818923193014, -82.68644564865261 35.54817323191614, -82.68603164859151 35.54812223186341, -82.68585564856838 35.548082231837206, -82.68570464855203 35.5480252318101, -82.68554964854019 35.547934231775635, -82.68543064853449 35.54784223174472, -82.68530964853612 35.547700231703345, -82.68521164854296 35.547549231662565, -82.68475764859534 35.546715231446086, -82.68454464862245 35.54630723134107, -82.68419364866328 35.54566023117329, -82.68403464868189 35.545366231097056, -82.6835346487444 35.54441523085198, -82.68352964876186 35.54429623082724, -82.68354164877275 35.5442382308166, -82.6835956488202 35.543987230770966, -82.68363764884698 35.54385823074899, -82.68366864887318 35.543721230724216, -82.68367964888225 35.543674230715794, -82.68370164890533 35.54354723069218, -82.68371564891795 35.54348023067994, -82.6837506489489 35.5433162306501, -82.6837516489497 35.54331223064939, -82.68375864895542 35.54328223064401, -82.6837766489684 35.54321723063259, -82.68380364899126 35.5430972306109, -82.6838706490458 35.54281423056004, -82.68388464905969 35.5427392305462, -82.68390964908203 35.54262023052448, -82.68418164914279 35.542519230531816, -82.68442164919867 35.54241523053515, -82.68463364925098 35.54230423053428, -82.68494064933029 35.5421202305282, -82.6849686493383 35.542098230526605, -82.68524064941529 35.541891230512206, -82.68552064949952 35.541646230491, -82.68571764956536 35.54143023046715, -82.68590164963707 35.54116223043131, -82.68607964971902 35.54082123038003, -82.68619264977839 35.54055623033763, -82.68627064982267 35.54035223030398, -82.6863096498583 35.540162230269324, -82.68636964988997 35.54002023024649, -82.68648564993399 35.539859230225545, -82.68676865002527 35.539571230195854, -82.68709465011017 35.53937123018847, -82.68764165025222 35.539038230176594, -82.68811665037201 35.53877223017101)))",6572,37,021,002503,370210025032,1976,1976,204,1933,1719,56,15,10,0,133,43,1474,109,1365,1453,1327,34,12,7,0,73,21,851,776,75
census_2010_blockgroups_view.fid--2dc29038_13ec899ba8f_-262a,"MULTIPOLYGON (((-82.57695060255907 35.72899025751281, -82.57701960257832 35.72894025750975, -82.57712760260483 35.72888525750967, -82.57720960262954 35.7288132575034, -82.57783460281789 35.728269257457015, -82.57787260284141 35.728158257438345, -82.57790860286335 35.72805525742105, -82.57794260289536 35.727885257389914, -82.57795460290203 35.72785525738502, -82.57799660292477 35.72775325736862, -82.5780506029457 35.727676257358496, -82.57813760296695 35.72763225735854, -82.57827260299631 35.727588257363394, -82.57843460301902 35.72761525738564, -82.57852860302786 35.7276592574043, -82.57872260303087 35.72784825746274, -82.57884560303289 35.72796725749962, -82.5789266030429 35.72798925751256, -82.57899360305412 35.72798925751942, -82.57910160307544 35.72796725752601, -82.57917560308877 35.7279612575324, -82.58004460326566 35.72775225757944, -82.58015960328318 35.727763257593466, -82.5801936032861 35.72778025760039, -82.58022060328649 35.727807257608745, -82.58023360328261 35.727846257617976, -82.5801866032501 35.72800525764551, -82.58001860315832 35.72841725771216, -82.57992360307604 35.72884625778979, -82.57988360303021 35.72909925783718, -82.57988360302868 35.72910925783925, -82.57991060298714 35.729406257902504, -82.57995860297811 35.72951625792982, -82.58003860297597 35.7296152579583, -82.5801606029844 35.72969225798654, -82.58030860300299 35.72973125800971, -82.58044960302486 35.72974125802622, -82.58066560305814 35.729758258051966, -82.58073860306736 35.72977725806339, -82.58103660310456 35.72985725811037, -82.58156860316137 35.73006225820693, -82.58157560316198 35.73006525820823, -82.58173060317424 35.730153258242176, -82.58181960317957 35.73021425826374, -82.58182560317974 35.73021925826537, -82.58193260317712 35.73035125830332, -82.58200660316142 35.73053225834781, -82.58204060313709 35.73072525839065, -82.58208160312516 35.73084625841953, -82.58208760312478 35.73085525842194, -82.5821286031228 35.73091225843773, -82.58216860312604 35.73093425844639, -82.58242560316383 35.730966258479384, -82.5827146032119 35.730966258509206, -82.5831056032838 35.73092225854043, -82.58335560332796 35.730906258562975, -82.58353660335545 35.73092225858487, -82.58395460342422 35.73092825862922, -82.58417460346189 35.73092125865043, -82.58434560349095 35.730917258667176, -82.58485760359333 35.730806258697385, -82.58487060359657 35.73079925869719, -82.58495160361564 35.730763258698296, -82.58503360363956 35.73069725869329, -82.58507360365473 35.73064225868613, -82.58517860371299 35.73037825864325, -82.5852076037291 35.730306258631515, -82.58530960377487 35.73012025860418, -82.58543060381201 35.73001025859427, -82.58552460383285 35.729977258597216, -82.58561960384858 35.72997725860694, -82.58566660385304 35.729999258616274, -82.58574060385702 35.73005325863495, -82.58579460385309 35.7301362586574, -82.58579460384554 35.73018525866741, -82.58585460380435 35.730515258740766, -82.58590860378784 35.73068025877998, -82.58594960378096 35.73076825880211, -82.58598960377911 35.730823258817445, -82.58599660377686 35.730845258822676, -82.58600360377456 35.73086725882782, -82.58614460376576 35.73107625888493, -82.58633360376996 35.73125125894007, -82.58634560377128 35.73125625894229, -82.58642860377982 35.731290258957806, -82.58671160382022 35.73133325899567, -82.58685960383973 35.73136625901766, -82.58696760384919 35.73142125904002, -82.58708860386415 35.73145425905918, -82.58729160388611 35.73153125909579, -82.58743260389588 35.73161925912821, -82.58755360389809 35.73173525916433, -82.5875946038914 35.7318222591863, -82.58760760388242 35.73189425920228, -82.58759460385983 35.732026259227894, -82.5875676038451 35.73209225923855, -82.58752760382986 35.73214725924559, -82.58747660380153 35.7322752592664, -82.58745360378872 35.732333259275876, -82.58741260376146 35.732465259298515, -82.58739960374061 35.73258625932181, -82.5874396037251 35.73272925935504, -82.58746660372348 35.732768259365834, -82.58754760372591 35.73283925938862, -82.58772260375336 35.73285025940894, -82.58784360377693 35.73282825941684, -82.58791160379168 35.73280625941943, -82.58807360383473 35.7327022594149, -82.58835660390575 35.73254825941266, -82.58852460395244 35.73242725940534, -82.58874060401736 35.732240259389485, -82.58878060403255 35.73218525938245, -82.58885460405601 35.73211325937534, -82.58906360410951 35.73199225937223, -82.58940060418342 35.73187725938353, -82.58946760419973 35.73184425938372, -82.58967660424399 35.73178325939284, -82.58979860426767 35.73176125940096, -82.58997960430023 35.73174525941633, -82.59018960433006 35.73177825944463, -82.59042460435819 35.731849259483354, -82.59054660436828 35.731915259509364, -82.59066760436971 35.732036259546454, -82.59072160436335 35.73213525957219, -82.59075560435294 35.73223925959684, -82.59076860433534 35.73236625962406, -82.59074160430032 35.73256325966145, -82.59070160428006 35.732651259675244, -82.59063460425696 35.73272825968405, -82.59037860418441 35.732921259696944, -82.59026360415675 35.73297625969637, -82.5899066040772 35.73310625968602, -82.58985960406663 35.73312425968485, -82.58977860404627 35.73316825968547, -82.5895226039952 35.73322325967033, -82.58930660394901 35.73328925966153, -82.58925260393572 35.73331725966162, -82.58919960392512 35.73332825965846, -82.58884860384113 35.733493259655916, -82.58876060381633 35.733559259660275, -82.58868060378435 35.73367925967651, -82.58861960375378 35.73381125969714, -82.58859960373077 35.7339382597209, -82.58863360371524 35.73407525975233, -82.58867360370742 35.73416825977535, -82.58888960372293 35.73430025982454, -82.58908460374514 35.73436625985806, -82.58915860375743 35.73436625986567, -82.58973160385285 35.734366259924755, -82.58990060387414 35.73441025995106, -82.58999460388466 35.73444325996752, -82.5900756038905 35.73449225998582, -82.59012960389185 35.734542260001604, -82.59022360388694 35.73467426003816, -82.590358603896 35.734761260069774, -82.59045360390495 35.7348052600886, -82.59059460392241 35.734844260111025, -82.59060660392373 35.734848260113026, -82.5908846039536 35.73495426016333, -82.59095260396319 35.73496526017259, -82.59112060399126 35.734965260189895, -82.59128260402501 35.73492126019763, -82.59143060405812 35.73486626020159, -82.59155860408978 35.73479926020112, -82.59216660422223 35.734598260222874, -82.59233960425976 35.734541260229044, -82.5924956042916 35.734503260237425, -82.59291960438604 35.73434926024969, -82.59301360440857 35.7343052602504, -82.59306160442162 35.73427226024863, -82.59329060449049 35.73407426023183, -82.59342560452745 35.7339802602266, -82.59378860459476 35.73393626025509, -82.5939436046359 35.733837260250816, -82.59403160466492 35.73374426024101, -82.5941126046971 35.73362326022469, -82.59434860477393 35.7333812601997, -82.59477860490423 35.73300226016675, -82.59488060494327 35.73286026014836, -82.5949546049711 35.732760260135606, -82.5950556050041 35.73265526012466, -82.59525760507684 35.732403260094095, -82.59545260513823 35.732216260076065, -82.59559360517018 35.73216126007939, -82.5956866051894 35.73213726008409, -82.59568160517433 35.732229260102294, -82.59567860516484 35.732287260113814, -82.59565760514592 35.732387260132036, -82.59562760512492 35.732490260149945, -82.59562160512236 35.732500260151284, -82.59558060510263 35.732583260163985, -82.59555960509283 35.732624260170255, -82.59549660506308 35.73274826018897, -82.59548760505854 35.73276826019209, -82.59547460505331 35.73278826019485, -82.59538660501711 35.732927260214076, -82.59522160495959 35.733121260236615, -82.5949656048878 35.73330926024857, -82.5948106048462 35.733411260253334, -82.59476360483268 35.73344826025611, -82.59466760480439 35.73352726026225, -82.59453360476255 35.73365326027411, -82.59444760473082 35.73376626028835, -82.594359604692 35.733922260311054, -82.5941546045869 35.73438026038321, -82.59407860455472 35.73450626040108, -82.59401260452977 35.734596260412594, -82.59387960449106 35.73470326042071, -82.59380260447182 35.73474426042113, -82.59366460444186 35.73478926041609, -82.59348560440684 35.7348232604046, -82.59321660435637 35.73486026038439, -82.59295560430566 35.73490726036708, -82.59267460424674 35.73498526035407, -82.5925376042178 35.735025260348074, -82.59239060418628 35.73507026034207, -82.5922236041532 35.735104260331774, -82.59197660410692 35.735138260313256, -82.59176260406564 35.7351742602986, -82.5916516040424 35.73520526029348, -82.59158160402589 35.73523626029253, -82.59152260401225 35.73526126029158, -82.59151660401061 35.73526526029182, -82.59139460397544 35.73536126029878, -82.59137560396904 35.735382260301066, -82.59133560395478 35.73543126030695, -82.5912146039126 35.73557326032344, -82.59106760385559 35.73578326035105, -82.59092860379477 35.73602626038624, -82.59086060376117 35.736170260408606, -82.59066260366185 35.736598260475375, -82.59055860360732 35.736838260513586, -82.59044360355729 35.73703826054241, -82.59036960353187 35.73712226055191, -82.59028760350675 35.73719626055854, -82.59019460347582 35.73729626056934, -82.59011160344426 35.737410260584035, -82.58999360339288 35.73761526061364, -82.58981560330469 35.737993260672326, -82.58965560321946 35.738371260732826, -82.58961860319623 35.738481260751456, -82.58959460318029 35.73855826076467, -82.58953960312826 35.73883526081542, -82.58949660307093 35.73915826087675, -82.58944060303297 35.739343260908726, -82.5894386030315 35.739351260910134, -82.58941060301416 35.73943226092371, -82.58936460298467 35.73957326094773, -82.58934260296024 35.739707260972736, -82.58932860294334 35.73980126099045, -82.58931760293113 35.73986826100302, -82.58932460292148 35.73993826101802, -82.58934960288951 35.74017126106799, -82.58935860286525 35.74033726110278, -82.58935560286207 35.74035426110594, -82.58933460283723 35.74049226113188, -82.58933260283459 35.74050726113474, -82.58929060281113 35.74061326115201, -82.58919360277498 35.74074226116831, -82.58918360277183 35.74075226116931, -82.5890156027155 35.74093526118926, -82.58883460264758 35.7411782612201, -82.58867660258542 35.74141026125112, -82.58863360256727 35.74148126126114, -82.58855360253288 35.74161726128058, -82.5884886025015 35.741749261300804, -82.58842560247125 35.741877261320376, -82.58838960245296 35.74195626133279, -82.58834960243192 35.74204926134759, -82.58824360238822 35.74221726137091, -82.58814260234983 35.74235626138878, -82.58798760230206 35.74249826140178, -82.58798160230039 35.742502261401924, -82.58789360227411 35.742577261408144, -82.58786260226493 35.74260326141026, -82.58781460224839 35.74265826141655, -82.58776060222974 35.74272126142384, -82.58771860220808 35.74281526143866, -82.58769960219797 35.74286026144579, -82.58764360216297 35.74302626147387, -82.5876296021327 35.743206261509116, -82.58763160210945 35.743358261540266, -82.58763360209882 35.74342926155499, -82.58764660208311 35.74354426157976, -82.5876766020449 35.74382326163966, -82.58767760204329 35.74383426164199, -82.5877056020196 35.74401726168218, -82.58772760199298 35.74421226172418, -82.58774460198062 35.74431026174591, -82.58774360196331 35.7444212617684, -82.58772360193821 35.74456126179485, -82.587715601922 35.74465726181364, -82.58771560191488 35.74470326182293, -82.5877176019062 35.74476126183496, -82.5877486018962 35.744859261858196, -82.5878016018895 35.74495926188398, -82.58780660188758 35.74497726188816, -82.58784260187444 35.74510026191693, -82.58791860184662 35.745361261977976, -82.58793960183263 35.745474262003114, -82.58795060182527 35.745533262016274, -82.58795460181526 35.745602262030744, -82.58796060180218 35.745693262049876, -82.58795860179252 35.74575326206192, -82.58795660178056 35.745828262077, -82.58792860174316 35.746039262117165, -82.58789860171292 35.74620226214723, -82.58788860170212 35.746261262158214, -82.58786760168462 35.74635126217434, -82.58785760167657 35.746392262181736, -82.58785060167017 35.74642626218794, -82.58782260165682 35.74648226219643, -82.58780460165009 35.746506262199496, -82.58779460164615 35.746521262201576, -82.5877756016404 35.74653726220279, -82.5877466016318 35.746562262204925, -82.58773460162914 35.74656626220448, -82.5876156016016 35.74661626220243, -82.58759360159733 35.746620262200956, -82.58754460158742 35.74663126219817, -82.5875156015817 35.74663726219643, -82.58744560156656 35.74666026219385, -82.5873016015299 35.74674126219551, -82.58722560150714 35.74680726220115, -82.58713460147553 35.74691326221332, -82.58711960146971 35.74693426221604, -82.58701960142923 35.74708826223713, -82.58679160133461 35.74745326228805, -82.58668060128079 35.74768126232301, -82.58664160126486 35.747742262331414, -82.58653660120582 35.7480102623752, -82.58648960117797 35.74813926239663, -82.58641760113082 35.74836626243549, -82.5863436010822 35.748600262475485, -82.5862926010428 35.74879926251086, -82.58628160102815 35.748882262526564, -82.58626660100904 35.74898926254684, -82.5862636009789 35.74918026258546, -82.58626560097319 35.749219262593584, -82.58627660094952 35.749384262628354, -82.58627060089664 35.749718262695794, -82.58627760087282 35.749879262729316, -82.58630760084446 35.75009426277621, -82.58633960083044 35.75021926280498, -82.58634260082943 35.75022926280726, -82.58638660081652 35.75035926283828, -82.58643860080731 35.75047426286708, -82.58647360080263 35.750542262884515, -82.5864976007995 35.75058826289638, -82.58650660079591 35.750621262904055, -82.58652860078705 35.75070226292286, -82.58654560076285 35.75087626296008, -82.58655460075103 35.75096226297844, -82.5859926006337 35.75111526295176, -82.58585360060528 35.75114926294429, -82.58571260057789 35.75117426293486, -82.5855846005542 35.75119026292496, -82.58554460054661 35.7511962629221, -82.58540560052231 35.75120326290917, -82.58528160050173 35.75120326289633, -82.5848316004311 35.75117526284428, -82.58453360038222 35.75117126281278, -82.58440260035954 35.751176262800264, -82.58427660033533 35.75119726279158, -82.58419760031894 35.75121826278767, -82.58410560029807 35.75125426278557, -82.58403360027997 35.75129326278611, -82.58396360026076 35.751342262788825, -82.58390660024165 35.751404262795646, -82.58385160022057 35.751481262805626, -82.58378460018986 35.751607262824386, -82.58373660016153 35.751738262846104, -82.58368560012653 35.751909262875735, -82.58357660002974 35.752416262967756, -82.58354159999773 35.75258526299856, -82.58340359986737 35.753277263125305, -82.58338859984934 35.753377263144195, -82.58333259981178 35.75355926317548, -82.58332459980674 35.75358326317955, -82.5832895997896 35.7536562631908, -82.58323859976946 35.7537312632008, -82.58315259973963 35.753831263212305, -82.58308559971886 35.753893263218, -82.58290659966653 35.754038263229155, -82.58283759964692 35.75409126323277, -82.58276659962624 35.75414826323716, -82.5826775995992 35.754227263243976, -82.58259759957289 35.75431026325267, -82.58254159955142 35.754389263263036, -82.58249659952868 35.754487263278286, -82.58246759950397 35.75461526330146, -82.58245659946215 35.754873263352856, -82.58246759943121 35.75508426339698, -82.58248659941329 35.75522026342665, -82.5825225993977 35.75535926345865, -82.58256559938764 35.755470263485655, -82.58264159937376 35.75564126352836, -82.5828725993443 35.756079263641446, -82.58292859933715 35.756185263668854, -82.58297959932932 35.756290263695504, -82.583034599309 35.75648026373982, -82.58304159929325 35.756589263762756, -82.58303759927729 35.75668826378248, -82.58302259926019 35.75678226380012, -82.58298659922873 35.756946263829825, -82.58297659922192 35.75697926383549, -82.58280459910259 35.757564263937006, -82.58279259909399 35.75760626394435, -82.58273659906145 35.75775626396907, -82.58285259906896 35.757832263996505, -82.58296859907539 35.7579152640254, -82.58300759907675 35.757948264036116, -82.58377859910641 35.75858426424514, -82.5840355991161 35.75879726431505, -82.58413659912206 35.75886726433974, -82.58421759912686 35.758923264359524, -82.58437359913782 35.759020264395346, -82.58444759914241 35.759070264413175, -82.58448159914435 35.75909326442136, -82.58455259914933 35.759137264437655, -82.58467659915824 35.75921326446591, -82.58489759917784 35.75932426451127, -82.58501159918782 35.75938226453489, -82.58521359920722 35.75947426457446, -82.58540859922729 35.75955426461077, -82.58580859927163 35.75969726468127, -82.58599459929316 35.759758264712765, -82.58636859933634 35.75988126477642, -82.58693159940182 35.76006326487159, -82.58698959940878 35.76008026488098, -82.58724259943926 35.76015526492236, -82.58765659949103 35.76026626498763, -82.58801059953724 35.76034826504086, -82.58849359960477 35.76043126510751, -82.58871659963663 35.76046526513744, -82.58890059966359 35.76048826516108, -82.58914859969984 35.760521265193404, -82.58924459971273 35.760541265207365, -82.58936759972786 35.76057526522702, -82.58948559974044 35.760621265248545, -82.58952959974401 35.76064526525789, -82.58960859975033 35.760689265275076, -82.58967359975438 35.76073326529072, -82.58971159975648 35.76076026530013, -82.58980759975844 35.76085026532834, -82.58989159975667 35.76095226535782, -82.58999659975018 35.76110626540003, -82.59000259974957 35.76111726540287, -82.59009359974237 35.76126126544164, -82.59005059972631 35.76131826544879, -82.5899845997055 35.76138126545484, -82.5894385995194 35.7619952655236, -82.58911059940941 35.76235226556254, -82.58897259936153 35.76251226558093, -82.5888475993147 35.762680265602285, -82.58884359931326 35.76268526560289, -82.58874059926879 35.76286126562814, -82.58867159923349 35.76301426565217, -82.58858259917774 35.76327826569678, -82.58855459914295 35.7634722657334, -82.58854359911521 35.76363926576628, -82.58854759909462 35.76377626579467, -82.58855959907493 35.7639162658244, -82.58856059901996 35.76427126589688, -82.5885415989723 35.76455826595336, -82.58850959891882 35.764868266013195, -82.58847159887308 35.76512226606104, -82.5884235988277 35.76536326610524, -82.58839259880266 35.765491266128066, -82.5883505987728 35.76563826615371, -82.58824959871382 35.76591026619871, -82.58813559865682 35.7661552662369, -82.58807559862878 35.76627126625431, -82.58783959853068 35.76665026630722, -82.58777959850067 35.76677926632735, -82.58771359845767 35.766985266362525, -82.58767659843133 35.767115266385126, -82.58763459840604 35.7672332664049, -82.58737159826556 35.7678562665047, -82.58729059821964 35.76806526653892, -82.58714859813819 35.7684372666001, -82.58706759808629 35.768685266642294, -82.58700359804047 35.76891126668164, -82.58697059802181 35.768996266695616, -82.58693059800288 35.76907526670761, -82.58688959798664 35.76913526671561, -82.58684459797168 35.769184266720934, -82.58679059795784 35.76921526672167, -82.58673259794467 35.769237266720154, -82.58666459793106 35.76925226671624, -82.58647959789845 35.769264266699594, -82.58617459784844 35.76925926666709, -82.5861345978419 35.76925826666274, -82.58601459782238 35.76925526664981, -82.58597459781573 35.76925526664567, -82.58595159781196 35.7692552666433, -82.58587859780081 35.76924826663433, -82.5857135977758 35.76923326661428, -82.58559559776015 35.769207266596794, -82.5855445977533 35.76919626658929, -82.58550359774848 35.769183266582445, -82.58545159774236 35.769167266573845, -82.58528759772517 35.769102266543705, -82.5852825977246 35.76910026654273, -82.5851255977121 35.769012266508625, -82.58505659770853 35.76896126649109, -82.58498259770589 35.768899266470804, -82.58477759770233 35.76870226640959, -82.58474559770053 35.76867926640159, -82.58470259769824 35.76864826639085, -82.58461459769057 35.76860326637261, -82.58454659768265 35.76858126636109, -82.58453959768164 35.768580266360175, -82.58449059767523 35.76856926635286, -82.58448059767386 35.76856726635143, -82.58443759766695 35.768565266346606, -82.58439859766092 35.76856226634199, -82.58430959764596 35.76856326633299, -82.58420759762689 35.768577266325345, -82.58409959760492 35.76860226631928, -82.58401659758707 35.768628266315986, -82.58378059753166 35.76873226631286, -82.58370059751356 35.76876326631094, -82.5834665974642 35.7688302663005, -82.58338859744627 35.76886226629896, -82.58333459743243 35.76889326629971, -82.58327759741486 35.768945266304414, -82.58323059739878 35.768998266310334, -82.58318059737765 35.76908126632213, -82.5831565973627 35.76915126633391, -82.58313059734226 35.76925526635238, -82.58309059731866 35.769364266370474, -82.58300459728012 35.76952026639344, -82.58290459724502 35.76963926640733, -82.58283859722344 35.76970726641439, -82.5827675972016 35.76977226642033, -82.58261259715607 35.76989926643024, -82.58242659710567 35.77002426643646, -82.58231959707932 35.77007926643664, -82.58204159700867 35.770236266439916, -82.58197459699014 35.77028326644269, -82.5819135969724 35.770332266446324, -82.58184159694896 35.77040626645398, -82.58170259689759 35.770588266476715, -82.58151559681762 35.77090226652145, -82.58144159678878 35.77100926653559, -82.58136659676256 35.77109726654578, -82.58116759669844 35.771297266566016, -82.58098459662962 35.7715442665975, -82.58089259661386 35.77154726658862, -82.58045159653574 35.77157726654919, -82.58010759647233 35.771616266521704, -82.58003659645935 35.77162426651596, -82.57976359640777 35.77166326649578, -82.57960659637939 35.77167826648267, -82.57944159635066 35.77168626646725, -82.57926259631788 35.77170526645268, -82.57918159630084 35.77172826644903, -82.57910459628467 35.77175026644557, -82.5790115962631 35.77178926644389, -82.57885259622232 35.77188126644626, -82.57866159617022 35.77201226645325, -82.57834559609013 35.77218926645667, -82.57800059600095 35.77239326646266, -82.57771659592584 35.77257226646988, -82.57748959586095 35.77274726648209, -82.5773075958073 35.7728972664939, -82.57716459576679 35.77300526650111, -82.57701759572957 35.77308726650271, -82.57687359569607 35.77314826650024, -82.57679359567999 35.77316626649565, -82.57669359565946 35.773191266490485, -82.57634059559184 35.77324826646565, -82.57587159550397 35.77331126643018, -82.57563059545791 35.77334926641303, -82.5753765954093 35.77339026639519, -82.57510759535961 35.77342226637394, -82.57494259533289 35.77341726635588, -82.57490559532815 35.77340826635024, -82.57484359531999 35.77339426634101, -82.57476559531062 35.7733712663283, -82.57467759530262 35.77332826631044, -82.57457259529488 35.77326526628675, -82.574406595296 35.77308026623196, -82.57433059530608 35.77293426619437, -82.57415959532926 35.772601266108964, -82.57399459537727 35.772115265992895, -82.57386259546493 35.77140926583545, -82.57380459550433 35.771093265765124, -82.57375059551174 35.77098826573814, -82.57368959551286 35.77091526571699, -82.57364459551265 35.770868265702816, -82.5735705955076 35.770821265685576, -82.57344459549888 35.77074226565646, -82.57317559547732 35.77059326559834, -82.57309059547036 35.77054726558023, -82.57304559546768 35.770516265569306, -82.57292359546064 35.770430265539176, -82.57290659545971 35.77041826553499, -82.57283059545856 35.770344265512065, -82.57278359545893 35.77029126549643, -82.5727375954608 35.77023026547926, -82.57269259546526 35.77015326545893, -82.57266059547173 35.77007726544012, -82.57265559547275 35.77006526543719, -82.57263059548231 35.769977265416664, -82.57262159548748 35.76993426540703, -82.57260859549459 35.76987426539341, -82.5725875955123 35.769737265363325, -82.57256559554926 35.769476265307915, -82.57255159557253 35.769311265272854, -82.57251959561344 35.76901326520884, -82.57249359563505 35.76884626517216, -82.57245159565235 35.768690265136065, -82.57231659569774 35.76825326503308, -82.5722715957091 35.76813126500358, -82.5721975957283 35.76792826495463, -82.57210759574858 35.767701264899095, -82.5720705957569 35.76760826487634, -82.57202059576271 35.76751726485262, -82.57199259576589 35.76746626483939, -82.57193159576939 35.76737926481533, -82.57162259576803 35.76705626471766, -82.57157259576779 35.76700426470191, -82.57148659576865 35.76690626467307, -82.57147159576881 35.76688926466813, -82.57139859577215 35.76678926464018, -82.57136559577523 35.76673426462561, -82.57133159578093 35.76666126460719, -82.57130859578754 35.76659426459128, -82.5713065957884 35.76658626458934, -82.571287595803 35.76647226456417, -82.57128159581971 35.76635826454037, -82.57129459584684 35.766197264508904, -82.57131759587405 35.76604626448046, -82.57137159592575 35.76577126443003, -82.57141859597735 35.765489264377436, -82.5714205959786 35.76548326437647, -82.57142859600219 35.765340264348104, -82.57141959602099 35.765209264320504, -82.57140259603167 35.765122264300985, -82.57139459603657 35.765082264292026, -82.57135459604854 35.76496226426349, -82.57134359605055 35.76493726425726, -82.57130659605697 35.76485626423695, -82.57123859606365 35.764740264206274, -82.57116259606886 35.76462526417506, -82.57103559607552 35.764446264125475, -82.5710285960759 35.764436264122665, -82.57091959608029 35.76429126408195, -82.5709015960809 35.76426826407537, -82.57089259608124 35.76425626407204, -82.57085159608337 35.764198264056034, -82.57083559608435 35.764175264049655, -82.57076359608776 35.76407626402205, -82.57065859609055 35.76394526398457, -82.5706125960917 35.7638882639682, -82.57044859609385 35.76369826391261, -82.57036659609291 35.76361726388764, -82.5702805960901 35.763543263863674, -82.57004559607378 35.76339626380949, -82.57001259607185 35.76337326380141, -82.56977459605774 35.76320926374347, -82.56969559605652 35.76313226371964, -82.5695155960575 35.76293326366047, -82.56936559606015 35.76275526360884, -82.56935359606032 35.76274126360468, -82.56910759606063 35.76247526352517, -82.56896059605448 35.76235726348595, -82.56886359604799 35.76229526346338, -82.56876659604022 35.76224126344238, -82.56847959601257 35.76211126338624, -82.56838159600196 35.76207526336882, -82.56821359598143 35.7620272633417, -82.56804959595861 35.76199826331889, -82.56786159592812 35.761993263298486, -82.56777359591301 35.76199626329004, -82.56769459589938 35.761999263282476, -82.56717759580727 35.76203826323714, -82.56716459580502 35.76203926323601, -82.56702959578148 35.76204626322344, -82.56684259575158 35.76203826320262, -82.56675759574001 35.76202126319031, -82.5666065957249 35.76195726316172, -82.56654159572149 35.761909263145306, -82.56649459572087 35.76186326313104, -82.56644359572242 35.761798263112524, -82.5664055957265 35.76173126309495, -82.56637059573315 35.761651263075045, -82.56634759574311 35.76156226305461, -82.5663305957542 35.76147226303448, -82.56630359579852 35.761158262967726, -82.56626859586656 35.760682262867185, -82.56625259588161 35.760568262842284, -82.56621659590293 35.76039226280269, -82.56619559591063 35.760320262785946, -82.5661615959181 35.76023526276507, -82.56606759592945 35.76006126271997, -82.56603359593146 35.76001226270643, -82.56590859593332 35.75986626266388, -82.56583759593357 35.75978826264066, -82.56559859592925 35.75956026256955, -82.5654265959242 35.75940826252087, -82.56513059591549 35.75914726243716, -82.56477659590794 35.75881626233326, -82.56488559593612 35.758751262331295, -82.56517959601152 35.75858026232675, -82.56521859602087 35.75856226232712, -82.56533559604814 35.75851226232893, -82.56505059606728 35.75808326221225, -82.56483359608599 35.75773026211795, -82.56470059609718 35.75751526206046, -82.5645545961145 35.75724726199076, -82.56449159612586 35.757106261955556, -82.564459596135 35.757013261933366, -82.56444259615027 35.75689626190778, -82.56443659616872 35.756771261881674, -82.56447659620112 35.75660526185197, -82.5645275962278 35.7564882618334, -82.56462559626924 35.7563262618105, -82.56496359640741 35.75579826173786, -82.56528959654283 35.75527526166491, -82.56537059657633 35.75514626164698, -82.56562859669091 35.75468426157948, -82.56572159673567 35.75449526155057, -82.56573559674341 35.75446126154512, -82.56580059677789 35.754308261520634, -82.56585759681191 35.75415026149438, -82.56589259684212 35.753993261465936, -82.56589559684723 35.75396326146015, -82.56591059687172 35.75382126143279, -82.56593859693865 35.75342026135394, -82.56595059699139 35.753093261288576, -82.56593759700974 35.75296126126041, -82.56592359701868 35.75288826124408, -82.56588159702703 35.75278926121959, -82.5658175970295 35.75270526119586, -82.56577959703104 35.75265426118153, -82.56574159703004 35.75262026117069, -82.56562159702666 35.752513261136535, -82.56561659702662 35.75250826113505, -82.5655825970255 35.75247926112559, -82.5652195970136 35.75216626102446, -82.56519159701261 35.75214226101661, -82.56512159701032 35.75208226099726, -82.56510959701036 35.75206926099334, -82.56508459701021 35.75204326098549, -82.56505859701 35.75201726097745, -82.56498359700946 35.7519392609539, -82.5649595970094 35.751914260946265, -82.56486059701125 35.751796260912066, -82.56481559701217 35.75174226089642, -82.5647475970137 35.75165926087254, -82.56460059701303 35.75150626082617, -82.56442759700779 35.7513542607774, -82.56432959700284 35.751281260752414, -82.5642765970001 35.75124226073906, -82.56414659699212 35.75115426070768, -82.56395459697822 35.75103726066403, -82.56380459696813 35.75094226062919, -82.56375459696476 35.75091026061759, -82.56361459695476 35.750824260585624, -82.56309059691769 35.750501260465796, -82.56277559689423 35.750315260395446, -82.56269959688832 35.75027126037863, -82.5625375968771 35.75017026034135, -82.56243059686841 35.750111260318306, -82.56234859686177 35.7500662603007, -82.56208559684192 35.74991226024223, -82.56176659681772 35.74972626017143, -82.56153759679997 35.74959526012115, -82.5610965967655 35.74934426002454, -82.56105259676235 35.74931726001455, -82.56095259675519 35.74925625999181, -82.5607435967392 35.74913525994559, -82.56071059673661 35.74911625993839, -82.56047159671887 35.748974259884754, -82.56046659671851 35.74897125988366, -82.5602605967007 35.74886525984082, -82.56016059669103 35.748820259821386, -82.56000959667388 35.748769259795374, -82.55975259664164 35.74870125975505, -82.55969559663498 35.74868325974549, -82.55943159660414 35.748599259701194, -82.55924959658186 35.74854725967184, -82.55870559651525 35.74839325958436, -82.55852459649307 35.74834225955536, -82.55854759650809 35.74827025954302, -82.55856259651743 35.74822625953565, -82.55859559654634 35.74807525950825, -82.55859759655041 35.748051259503626, -82.55860159655798 35.74800625949488, -82.55860059656237 35.74797725948889, -82.55859959656807 35.74793925948097, -82.55857459657216 35.74788625946759, -82.55853359657203 35.74784325945466, -82.55847959656799 35.74781125944253, -82.55839759655868 35.7477832594284, -82.55827059654156 35.74775725940999, -82.55796259649654 35.74771725937007, -82.55774159646676 35.747672259338145, -82.55746059643448 35.74757925929021, -82.55744659643278 35.747575259288006, -82.55717759640386 35.747473259239484, -82.55708059639485 35.74742725922013, -82.5570115963902 35.74738325920406, -82.5568025963832 35.74720425914598, -82.5563615963741 35.74679025901622, -82.55617059636836 35.74662225896233, -82.55590159636401 35.746362258881646, -82.55549859636152 35.74594625875545, -82.55537559636235 35.745808258714646, -82.55533659636502 35.74574925869858, -82.5552315963997 35.74541325861933, -82.5551485964128 35.745240258575556, -82.55505659641932 35.745099258537344, -82.55497959642099 35.74500625851043, -82.55488559642002 35.74491125848141, -82.55484759641965 35.74487325846974, -82.55472059641528 35.74476525843468, -82.55459459641342 35.74464225839662, -82.55451159641511 35.744542258367716, -82.55444859641267 35.74449025835065, -82.55436459640813 35.744429258329575, -82.554301596402 35.744401258317325, -82.55420059639083 35.74436525829963, -82.55398159636474 35.74429825826337, -82.55383259634094 35.74429225824677, -82.55384859634455 35.74428625824718, -82.5538995963558 35.744268258248795, -82.5539165963594 35.74426325824957, -82.5546305965182 35.74400525827062, -82.55503059660708 35.74386125828258, -82.5557845967709 35.74361325830975, -82.55607859683411 35.74352125832135, -82.55634559689413 35.74342025832827, -82.55658959695138 35.74331325833164, -82.5567685969951 35.7432232583318, -82.55712459708143 35.74304825833288, -82.55742359714903 35.74293325834023, -82.55746559715757 35.74292325834254, -82.55739059715579 35.74285425832072, -82.55724059715241 35.74271525827693, -82.5571635971495 35.74265125825601, -82.5570855971466 35.742586258234766, -82.5570535971455 35.742559258225924, -82.55695759714159 35.74248125820012, -82.55692659714047 35.74245525819167, -82.55679659713567 35.74234725815629, -82.55644059712324 35.74204525805804, -82.55632159711908 35.74194425802523, -82.5561205971134 35.741765257968034, -82.55593059710492 35.741616257918075, -82.55578559709299 35.741538257887306, -82.55566259707852 35.74149925786664, -82.55553259706137 35.74147025784737, -82.55538459703934 35.74145425782888, -82.55486459695697 35.741427257769764, -82.55476059694138 35.74141625775677, -82.5547245969366 35.74140825775145, -82.55470959693464 35.741405257749285, -82.55466259692956 35.741387257740776, -82.55461959692659 35.74136025773081, -82.55457959692637 35.74131925771834, -82.55454059692917 35.74125925770212, -82.55450059693815 35.74115825767742, -82.5544625969522 35.741027257646806, -82.55445059697254 35.74088325761625, -82.5545405970416 35.740534257554515, -82.5545705970691 35.740389257528065, -82.55457159707191 35.74037225752474, -82.55460959716277 35.73982725741763, -82.55463359725724 35.73924325730121, -82.55463259728563 35.73905925726362, -82.55462059730381 35.73892925723587, -82.55459859731984 35.73880225720771, -82.55459859732017 35.7388002572073, -82.55455259733294 35.73866825717575, -82.55447559734502 35.73850825713522, -82.55437659735645 35.73832825708831, -82.55424959737141 35.738095257027794, -82.55418059738513 35.73793325698768, -82.55412359740318 35.7377552569456, -82.55411459740917 35.73770725693485, -82.55395759752506 35.73679125673213, -82.55390559757457 35.736416256650436, -82.55390459762346 35.73610025658598, -82.55394059767171 35.735827256534094, -82.55397359769712 35.73569925651147, -82.55402959773926 35.735487256474016, -82.55410459779955 35.73517925641902, -82.55411059782224 35.73503925639116, -82.55421059786053 35.73489925637298, -82.55428059788701 35.73480325636058, -82.55438559793153 35.73462925633594, -82.55446559797225 35.734452256308195, -82.55448659798266 35.73440725630116, -82.55453159800769 35.73429425628282, -82.55464159807329 35.73398925623199, -82.55497559827023 35.733077256080776, -82.55502259829777 35.732950256059716, -82.55508659833579 35.73277325603028, -82.55514859837334 35.73259825600101, -82.55533759848545 35.7320772559144, -82.55540059852297 35.73190325588548, -82.55547559856801 35.73169325585045, -82.55570159870275 35.731066255746, -82.55577759874765 35.73085825571152, -82.55583859878446 35.730686255682755, -82.55602459889523 35.73017125559704, -82.55603459890068 35.73014625559299, -82.55608659893223 35.72999925556841, -82.55614559896802 35.72983125554032, -82.55628159905028 35.72944625547592, -82.55631159907418 35.72932425545414, -82.55635459910806 35.729152255423585, -82.55635359910859 35.72914725542244, -82.55638259913465 35.729010255397505, -82.55640459915648 35.72889325537603, -82.55640559915727 35.72888925537527, -82.5564225992012 35.728624255323055, -82.55642659921003 35.72857125531266, -82.55642259921459 35.72853725530533, -82.55640959923078 35.72841925527996, -82.55639459924915 35.728284255250934, -82.5563885992518 35.72826125524567, -82.55633059928041 35.728014255189365, -82.55625259929992 35.72780425513854, -82.55623959930328 35.72776925513005, -82.55618259931039 35.727662255102416, -82.5561305993166 35.72756625507748, -82.55607459932358 35.727461255050336, -82.55595559932952 35.72729525500428, -82.55589259933252 35.72720825498003, -82.55576259933505 35.72705225493493, -82.55562959933793 35.72689125488849, -82.55540059934148 35.72662225481002, -82.55537059934196 35.72658725479987, -82.55523959934402 35.72643325475499, -82.55547659949299 35.725726254635376, -82.55550759951184 35.72563825462069, -82.55566259960474 35.72520525454843, -82.55582659969488 35.72479925448275, -82.55601559979374 35.72436425441357, -82.556249599909 35.7238712543374, -82.5565206000364 35.72334025425714, -82.55690260021544 35.72259425414453, -82.55716860034026 35.7220742540661, -82.5579706007154 35.720514253831, -82.55823860084035 35.71999525375294, -82.55826460083604 35.72005125376705, -82.55837660083405 35.72018425380567, -82.55849360083158 35.72032525384647, -82.55857460083318 35.72040225387045, -82.55874260084062 35.7205342539146, -82.55891760085616 35.72062225395061, -82.55896960086262 35.720636253958794, -82.55911360088022 35.720677253982, -82.55926860090332 35.72069425400139, -82.55951760094904 35.720666254021396, -82.55972660098972 35.72062825403518, -82.55979360100602 35.720595254035395, -82.55993560103468 35.72056225404329, -82.56006360105859 35.72054525405297, -82.56055560113607 35.720573254109375, -82.56071060115599 35.72061125413307, -82.56084560116219 35.72071625416842, -82.56091260115988 35.72080325419306, -82.56095960114794 35.72093025422365, -82.56104760110388 35.72130925430996, -82.56116160107264 35.7216332543877, -82.56119360106915 35.72169025440255, -82.56123660106464 35.72176525442231, -82.56139760106511 35.72193525447352, -82.56159360107725 35.72206725452055, -82.56181560109452 35.72219425456932, -82.5619816011103 35.722270254601895, -82.56201760111365 35.72228725460907, -82.56241560115774 35.72243025467921, -82.56251460116444 35.72249325470222, -82.5625366011659 35.72250725470736, -82.56291460117176 35.722875254821204, -82.5630756011951 35.722897254842295, -82.56317060121091 35.72289725485208, -82.56329160122597 35.722930254871315, -82.56358160123496 35.72318325495271, -82.56367560124211 35.72323825497356, -82.56392860127164 35.72331925501609, -82.56397460127694 35.7233342550239, -82.56406660128758 35.72336425503948, -82.56412060129139 35.72339725505175, -82.56432260128756 35.72363925512185, -82.56441060129286 35.72369925514315, -82.56445060129526 35.72372725515303, -82.56453160130526 35.7237492551658, -82.56466660131747 35.72381525519315, -82.56474760132743 35.72383825520619, -82.56485460134026 35.723870255223716, -82.56494960134255 35.72395725525122, -82.5650036013311 35.72408925528374, -82.56500360131236 35.72421025530833, -82.56496960128456 35.72435325533395, -82.56484760122679 35.72459525537069, -82.56480760121329 35.724639255375465, -82.56479460120433 35.72468325538316, -82.56475360119065 35.72472725538789, -82.56474560118735 35.72474025538974, -82.56469960116631 35.724826255402505, -82.56467360114324 35.724947255424404, -82.56469360113562 35.725018255440965, -82.56474960113778 35.72506425545613, -82.56475160113801 35.7250652554565, -82.5647676011386 35.72507825546079, -82.5648216011449 35.72509525546979, -82.56489560115651 35.72510025547851, -82.56496260117099 35.725078255480895, -82.56507760120381 35.72499025547479, -82.56510060120794 35.72498825547678, -82.56527260123785 35.72497925549268, -82.56540760125529 35.72501225551334, -82.56558260126734 35.72512225555371, -82.56575760129041 35.72516125557975, -82.56611560134408 35.72519925562438, -82.56623060136285 35.72520125563659, -82.56637060138573 35.7252042556516, -82.56640560139137 35.72520525565539, -82.56661860143225 35.72517025567027, -82.5666746014429 35.7251612556742, -82.56671360145145 35.72514825567556, -82.56677560146481 35.72512825567783, -82.56700160150847 35.72508925569327, -82.56709860152709 35.72507325569993, -82.56728060156001 35.72505625571525, -82.56750060159524 35.72506525573977, -82.56768560162475 35.725073255760414, -82.56778660163735 35.725100255776354, -82.56781960163852 35.72512825578542, -82.56802260163568 35.72536425585447, -82.56812960163901 35.7254572558844, -82.5681576016267 35.72556725590965, -82.56812360160404 35.7256772559286, -82.56800860156778 35.72578725593922, -82.56797760155976 35.72580625593983, -82.56794160154989 35.725831255941195, -82.56790760154254 35.72584225593991, -82.56781360151584 35.725913255944725, -82.56777260149202 35.72602325596286, -82.56777260148002 35.72610025597857, -82.5677776014793 35.72611025598108, -82.56779160147723 35.726139255988464, -82.56779960147604 35.726155255992495, -82.56786660147992 35.72620225600906, -82.5678946014816 35.72622125601579, -82.56819060152986 35.72622725604752, -82.56842560157892 35.72616325605871, -82.5684336015806 35.72616125605909, -82.56855460160916 35.726106256060376, -82.5688106016749 35.72595725605638, -82.56906660172422 35.7259132560738, -82.56922860176823 35.7258032560681, -82.56932260178735 35.72578125607327, -82.56970060184588 35.72580925611794, -82.56987560187841 35.7257872561315, -82.5699476018936 35.72576625613457, -82.57001660190785 35.72574825613808, -82.57029360195307 35.725754256167846, -82.57038760197135 35.725737256174085, -82.57047660199197 35.72569925617556, -82.57059660201972 35.72564925617764, -82.57103460213658 35.725365256164935, -82.5710546021418 35.725353256164546, -82.57113560216126 35.725314256164936, -82.57122360217663 35.725309256172984, -82.5713376021922 35.72533125618919, -82.5714866021992 35.72544625622806, -82.5716476021987 35.72562225628042, -82.57180260217349 35.72595125636338, -82.5719786021729 35.72614425642084, -82.57211960216567 35.72634225647573, -82.5721736021671 35.72639125649126, -82.57226760217415 35.726446256512105, -82.5723356021838 35.72645725652136, -82.57240260219498 35.72645725652833, -82.57242960220069 35.72644925652943, -82.57261860224034 35.72639625653814, -82.57272660225833 35.72639625654926, -82.57282060227224 35.72640725656118, -82.57288860227503 35.72646225657936, -82.5730006022746 35.726585256616026, -82.57300960227465 35.72659425661882, -82.57319160229812 35.72663825664643, -82.57330560230521 35.72671525667387, -82.57337360230112 35.72681425670107, -82.57342660228778 35.726957256735666, -82.57348760227919 35.727078256766546, -82.57367460228349 35.72725125682113, -82.57382460228675 35.72739125686504, -82.57403360230451 35.727501256908965, -82.57429660231776 35.72769825697621, -82.5743976023149 35.72782525701243, -82.57446560230574 35.727957257046405, -82.57451960230543 35.728017257064145, -82.57464060231703 35.728072257087845, -82.57470760232135 35.72811625710366, -82.57477560232073 35.72819325712643, -82.57481560231125 35.728297257151695, -82.5748356022915 35.728446257184096, -82.57481560227284 35.728545257202185, -82.57472860223638 35.72868725722213, -82.57464760221266 35.728753257227226, -82.57453260217208 35.72889125724352, -82.57451960213412 35.729122257289255, -82.57445160209919 35.72927525731336, -82.57434460206433 35.729385257324736, -82.5741876020327 35.72942025731576, -82.57398060199091 35.72946825730417, -82.57389260196946 35.7295122573041, -82.57381860194856 35.72956725730766, -82.57365060189505 35.72973225732393, -82.57358260186251 35.72986925734486, -82.57355560185361 35.72989725734776, -82.57354460182555 35.73006725738123, -82.57354260181921 35.73010525738881, -82.5735626018124 35.730171257404244, -82.57363060181176 35.730248257427014, -82.57368360181376 35.7302922574414, -82.57383960184052 35.73028725745645, -82.57389960185317 35.73027025745916, -82.57396060187007 35.730226257456486, -82.57404760189138 35.73018225745645, -82.57416260191829 35.730132257458145, -82.5741756019212 35.730127257458435, -82.57427060194043 35.73010525746376, -82.57499760206547 35.73007825753316, -82.57544360214412 35.73005025757345, -82.5755916021721 35.7300282575842, -82.57590160223732 35.72994025759826, -82.57594160224649 35.72992425759904, -82.57617760231126 35.72975925758981, -82.57638160237887 35.72954225756661, -82.57640660238694 35.7295172575641, -82.5766896024732 35.72926425754174, -82.57688460254055 35.729039257516, -82.57695060255907 35.72899025751281)))",6457,37,021,002804,370210028042,1776,1776,132,1752,1652,10,2,6,0,82,24,1329,83,1246,1317,1252,4,2,5,0,54,12,717,677,40
census_2010_blockgroups_view.fid--2dc29038_13ec899ba8f_-2629,"MULTIPOLYGON (((-82.56328062106705 35.59445522871106, -82.56343962111521 35.59431422869865, -82.56349362113261 35.59425922869308, -82.56363762117849 35.594116228678764, -82.56382562124365 35.59389622865331, -82.56396462129703 35.5936992286274, -82.56403162132618 35.59358222861049, -82.56417662138874 35.593332228574496, -82.5642296214154 35.593216228556365, -82.5643366214683 35.59298822852087, -82.56439862149607 35.59287422850408, -82.56441762150418 35.59284222849947, -82.56446362152366 35.592765228488574, -82.56447562152891 35.592744228485486, -82.56448762153376 35.59272522848284, -82.56451162154414 35.59268422847698, -82.56452462154917 35.59266522847446, -82.56458562157499 35.59256322845996, -82.5646406215951 35.592492228451185, -82.56470962162028 35.59240322844015, -82.56486462167204 35.592234228421624, -82.56501562171927 35.592090228407876, -82.56501862172016 35.59208722840749, -82.56519862177132 35.5919492283979, -82.56556962186741 35.591725228390445, -82.56583762193138 35.591599228392276, -82.56602062197223 35.591531228397244, -82.56629262202901 35.59145522840971, -82.56662462209437 35.59138922843037, -82.56693262215116 35.59135222845452, -82.56713862218643 35.59134522847421, -82.5673026222145 35.59134022848997, -82.56767962227788 35.59133522852771, -82.56790062231913 35.59130522854434, -82.56794962232773 35.591302228548734, -82.56809662235351 35.59129322856204, -82.56814662236219 35.59129122856671, -82.56840462240751 35.59127522858995, -82.56867862245532 35.59126022861507, -82.56917462254842 35.591190228651755, -82.56943162259651 35.59115522867103, -82.56947362260505 35.59114522867324, -82.56959962263011 35.59111822868074, -82.56964262263845 35.591110228683455, -82.56968462264693 35.59110022868581, -82.56981362267261 35.59107322869353, -82.56985662268113 35.59106422869609, -82.5699746227047 35.59103822870294, -82.57033162277575 35.590961228723984, -82.57045062279946 35.59093622873107, -82.57046562280249 35.59093222873181, -82.57051362281187 35.590923228734916, -82.57052962281503 35.590920228735904, -82.57061162283142 35.59090222874069, -82.57064162283748 35.59089522874234, -82.5709816229045 35.59082622876325, -82.57109562292686 35.590804228770395, -82.57125362295815 35.5907712287799, -82.57173062305222 35.59067522880936, -82.5718896230835 35.59064322881918, -82.57198662310265 35.59062322882505, -82.57227762316023 35.590563228842754, -82.5723756231794 35.590544228849005, -82.57246562316882 35.590710228891965, -82.57248162316505 35.59075222890222, -82.57258162314118 35.59101522896595, -82.57276462309768 35.59149522908256, -82.57288162301771 35.592141229225994, -82.57293262296852 35.592515229307395, -82.5730026229014 35.593027229418844, -82.57303062287477 35.5932302294631, -82.57305862284825 35.593433229507234, -82.57309662281114 35.59371522956857, -82.57312262280188 35.59380322958916, -82.57325662275487 35.59425322969451, -82.57345362274212 35.59454822977485, -82.57348362274041 35.59459222978686, -82.57449062275909 35.59555723008671, -82.57454262275697 35.59562723010636, -82.5747506227485 35.59590623018447, -82.57488162274316 35.596082230233776, -82.57501262273783 35.59625823028307, -82.57529162272694 35.59663023038746, -82.57529662272671 35.596637230389405, -82.5756826227089 35.59716923053738, -82.57585262266939 35.59760923064448, -82.5758826226348 35.597866230699836, -82.57591262260146 35.598115230753606, -82.57592562258712 35.59822223077669, -82.57593762257265 35.59832923079973, -82.57585862255594 35.5983522307963, -82.57562262250589 35.598423230786544, -82.57554462248918 35.59844723078343, -82.57524162241994 35.59857023077731, -82.57511362239057 35.598623230774976, -82.57497962235205 35.59872823078263, -82.574857622326 35.59876623077777, -82.57431862222266 35.598855230740526, -82.57425962221144 35.59886523073652, -82.57418562219907 35.5988652307289, -82.57406462219498 35.59876123069528, -82.57403162218966 35.59876023069171, -82.57400862218607 35.598759230689176, -82.57393962217503 35.59875623068146, -82.57391762217138 35.59875623067926, -82.57380462215323 35.59875223066682, -82.57357762211656 35.59874523064209, -82.57346862209903 35.598741230630026, -82.57335662208095 35.5987382306179, -82.5718176218158 35.59880023047248, -82.5703356215603 35.59886123033269, -82.5682826210618 35.59988423033009, -82.56833162094073 35.60072323050589, -82.56835462088443 35.601113230587714, -82.5681356206744 35.602241230794796, -82.56813562065773 35.6023492308168, -82.56813662060787 35.60267423088308, -82.56813762059127 35.60278323090532, -82.56810262058576 35.60278123090135, -82.56799762056892 35.60277723088972, -82.56796362056343 35.60277623088606, -82.56784062054423 35.60276823087178, -82.5675546204989 35.60275423083957, -82.56740362047478 35.602748230822854, -82.56678062037793 35.60270523075012, -82.5664006203194 35.602675230704925, -82.5663286203078 35.60267323069711, -82.5661796202836 35.60266923068102, -82.56602362025953 35.6026572306626, -82.56592062024292 35.602654230651375, -82.56583462024743 35.602532230617726, -82.56557962026127 35.60216723051718, -82.56549462026585 35.602046230483815, -82.5654726202671 35.602014230475056, -82.56540762027092 35.60191923044904, -82.56538662027218 35.60188823044054, -82.56522162028253 35.6016432303737, -82.5648526203055 35.601096230224435, -82.56473562031583 35.60090323017315, -82.56467062032131 35.600797230144885, -82.56467062034753 35.600627230110256, -82.56468662037729 35.60045123007611, -82.5646946204082 35.600259230037864, -82.56471062046802 35.59988822996403, -82.56475162057181 35.599258229839926, -82.56464862055667 35.59924522982668, -82.56428362050272 35.599202229780495, -82.56421962049308 35.5991952297725, -82.56404262046638 35.59917822975085, -82.56403162046502 35.599175229749065, -82.56397062045737 35.59915922973956, -82.56386562044486 35.599127229722235, -82.56355062040704 35.59903322967076, -82.56344662039453 35.59900222965378, -82.56327962037446 35.59895222962642, -82.56321862036698 35.598935229616636, -82.56301462034148 35.59888022958456, -82.56272862030242 35.598826229544194, -82.56252262027297 35.59879522951674, -82.5625146202718 35.59879422951565, -82.56228662023408 35.59879322949204, -82.56227262023936 35.598743229480434, -82.56218162025402 35.59855022943177, -82.56208562026995 35.59834322937982, -82.56208362027489 35.59830922937272, -82.56209862028005 35.59829222937076, -82.56242662033661 35.59827822940163, -82.56249062034816 35.598272229407, -82.56253962035856 35.59825722940895, -82.56255962036563 35.59823322940612, -82.5625666203717 35.59820122940031, -82.56259462039321 35.59809222938095, -82.56260962039993 35.59806422937685, -82.56269962042518 35.597997229372424, -82.56269862042632 35.59798922937066, -82.56269562043181 35.5979502293625, -82.56271262048729 35.59760822929456, -82.56270962049975 35.597524229277205, -82.56270962050297 35.59750322927286, -82.5626566205125 35.59738422924325, -82.562497620514 35.59720322919005, -82.56230562051195 35.59700922913082, -82.56218262051206 35.59687622909113, -82.56181762051439 35.59646722897035, -82.56176462051481 35.59640722895275, -82.5616426205173 35.59625922891013, -82.56151362051779 35.5961172288679, -82.56139562048588 35.596197228872064, -82.56121762043672 35.596324228879595, -82.56112362041068 35.59639222888379, -82.56065162028162 35.596721228902275, -82.5603336201938 35.59694822891589, -82.56016462014705 35.597070228923386, -82.56004362011282 35.59716222892966, -82.55980062011507 35.596885228848336, -82.55975462011536 35.596834228833195, -82.55971962011547 35.59679522882163, -82.55965462011659 35.59671822879927, -82.55962062011685 35.59667922878784, -82.55957662011748 35.59662822877293, -82.559785620168 35.59652522877346, -82.56041262031941 35.596218228775406, -82.56062262036995 35.59611622877617, -82.56088762043403 35.595986228776894, -82.56115562049851 35.59585622877798, -82.5616016206083 35.59562422877662, -82.56167762062756 35.595581228775586, -82.56182962066565 35.59549722877413, -82.56193462069288 35.595434228772106, -82.5620606207253 35.595359228769816, -82.56206462072662 35.595355228769385, -82.5624456208288 35.59510222875701, -82.56244662082892 35.59510222875713, -82.56256662086305 35.59501022875076, -82.56271262090375 35.5949032287439, -82.56291362095928 35.59475922873534, -82.563142621026 35.594573228720954, -82.56318562103834 35.59453922871841, -82.56328062106705 35.59445522871106)))",6363,37,021,000200,370210002001,1071,1071,18,1038,469,557,4,2,0,6,33,728,8,720,716,374,334,2,2,0,4,12,443,423,20
census_2010_blockgroups_view.fid--2dc29038_13ec899ba8f_-2628,"MULTIPOLYGON (((-82.5265536310948 35.48950920358765, -82.52673663112218 35.489528203610284, -82.52694363115302 35.489551203636175, -82.52728663120112 35.48960820368298, -82.52729263120177 35.48961020368396, -82.52746663122414 35.489652203710385, -82.52761263124026 35.48970520373613, -82.52765063124441 35.4897192037428, -82.52777863125547 35.48978520376934, -82.52791963126599 35.48986920380093, -82.52801663127131 35.48993920382517, -82.52805263127331 35.48996520383406, -82.52814963128044 35.49002320385586, -82.52824563128931 35.49006920387503, -82.52842763131201 35.49011820390363, -82.52856863133348 35.4901302039205, -82.52859563133795 35.490130203923286, -82.52869063135344 35.49013220393346, -82.52882663137805 35.490118203944526, -82.52922563145496 35.49004820397124, -82.52950063150878 35.489994203988424, -82.52996663160137 35.48989420401584, -82.52999563160706 35.4898882040176, -82.53042263169068 35.48980420404424, -82.53076163175733 35.48973620406516, -82.53077663176035 35.48973220406583, -82.53085963177658 35.48971620407115, -82.53110263182346 35.48967320408727, -82.53137563187481 35.48963320410717, -82.531585631913 35.48961120412419, -82.53184963196026 35.48958820414661, -82.5321206320085 35.48956620416989, -82.5322096320247 35.489557204177174, -82.53229263203974 35.489548204183855, -82.53238763205697 35.48953920419173, -82.53256863209015 35.48951820420602, -82.53294563215908 35.48947620423615, -82.53346663225275 35.489428204279754, -82.5336476322843 35.4894182042963, -82.53400863234687 35.48940020432963, -82.53430763239864 35.4893852043572, -82.53445763242493 35.4893762043708, -82.53446863242691 35.48937520437169, -82.53465863246043 35.48936220438855, -82.53474663247637 35.48935320439572, -82.53519763255747 35.489311204433385, -82.53553363261878 35.48927520446051, -82.53619463273519 35.489230204519096, -82.53660463280895 35.48919220455334, -82.53695763287409 35.489149204580826, -82.5371116329023 35.48913120459297, -82.53768863301323 35.48903120463172, -82.53767463298571 35.48919620466384, -82.53767163297104 35.489288204682275, -82.53766063289204 35.48979220478368, -82.53763563286618 35.48993420480999, -82.53763063284583 35.49006120483525, -82.53762263280485 35.49032020488716, -82.53761863279298 35.49039320490162, -82.53761063276869 35.4905432049313, -82.53757663266003 35.49121520506452, -82.53756563262394 35.491439205108954, -82.53753663255326 35.49186920519348, -82.53752663253978 35.491946205208066, -82.5374956324949 35.49220520525758, -82.5374326324561 35.492390205288835, -82.53730663240249 35.49260420531944, -82.53689363225122 35.49314420538696, -82.53680563221968 35.49325520540053, -82.53663463215806 35.493472205427096, -82.53648063210582 35.49364620544674, -82.53641563208396 35.49371920545491, -82.53629863205035 35.49381220546186, -82.53618163201632 35.49390720546912, -82.53589563194383 35.49407120547321, -82.5356666318869 35.49419520547502, -82.5356306318778 35.494215205475356, -82.53544563183335 35.494305205474724, -82.53536363181367 35.49434520547448, -82.53470463166077 35.49463020546488, -82.53422363154883 35.49484020545829, -82.53350963138419 35.4951422054465, -82.53253663116108 35.495546205428944, -82.53247063114505 35.49557920542893, -82.53210863105686 35.49576320542927, -82.53207563104878 35.49578020542933, -82.53177763097086 35.495966205436574, -82.53176463096769 35.49597320543669, -82.5315636309176 35.496082205438256, -82.5313756308727 35.496172205437276, -82.53129663085362 35.496211205437106, -82.5310306307945 35.49630920542978, -82.53031063063835 35.49654920540481, -82.53014863060022 35.4966232054033, -82.52997863056007 35.49670120540175, -82.52982063051996 35.496792205403956, -82.52976963050492 35.49683520540754, -82.52967363047672 35.496915205413956, -82.5295176304245 35.497087205432905, -82.52938063037132 35.497286205459325, -82.5293516303602 35.49732720546474, -82.52931963034776 35.497374205471054, -82.52915363027302 35.49768220551665, -82.52901863019837 35.498023205572174, -82.52891063013426 35.49832420562238, -82.52881663008162 35.49856620566196, -82.52875363004603 35.49873020568889, -82.52867662999338 35.498990205733826, -82.52866662998869 35.49901020573694, -82.52863362996496 35.499129205757654, -82.52859462993648 35.499273205782984, -82.52853562987617 35.499602205843885, -82.5285186298481 35.49976720587572, -82.5285116298375 35.4998292058876, -82.5284926298059 35.50001420592329, -82.52848662979531 35.50007720593551, -82.52848162978374 35.500147205949204, -82.52846962974951 35.50035720599066, -82.5284666297381 35.50042820600484, -82.52844962971093 35.5005872060354, -82.5284056296359 35.50102920612081, -82.52840362963002 35.50106520612789, -82.5283986296045 35.50122620616018, -82.52838762956206 35.50149120621292, -82.52838762956159 35.50149420621357, -82.52841862952826 35.501745206267785, -82.52845362945037 35.50229120638242, -82.52845162944894 35.50229820638367, -82.5284316294257 35.50242820640803, -82.52836662939623 35.50255020642622, -82.52836062939386 35.50255920642746, -82.52834262938688 35.50258520643084, -82.52834162938642 35.502587206431144, -82.52831962937847 35.502615206434655, -82.5282956293691 35.50265020643931, -82.52824762935421 35.50269520644354, -82.52822262934633 35.502720206446, -82.52812862933803 35.502672206426624, -82.52789662931788 35.5025532063786, -82.52784362931048 35.502544206371375, -82.52774062929598 35.502527206357364, -82.5275206292654 35.50248920632704, -82.52701062919388 35.50240420625748, -82.52685962917081 35.50239120623932, -82.52663762913663 35.50237420621317, -82.52659462913012 35.502370206207914, -82.52653262912048 35.50236620620073, -82.5264746291152 35.502338206189066, -82.5264366291117 35.50232020618152, -82.52631162909996 35.5022612061567, -82.52588062902184 35.502305206121484, -82.52557162897484 35.50227720608409, -82.5251886289257 35.50218420602592, -82.5250856289146 35.50214520600741, -82.5248936288937 35.502074205973294, -82.52455062886548 35.50188720590006, -82.52391262881959 35.50149720575535, -82.52345962880449 35.501106205629355, -82.52297762880627 35.5005732054715, -82.52279662884703 35.50011220535923, -82.52277862884773 35.50008820535247, -82.52272462886573 35.49991220531118, -82.52260462887392 35.49972920526159, -82.5225406288742 35.49965820524059, -82.52245462886867 35.499601205220166, -82.52228162885629 35.49949520518095, -82.52216662885499 35.49937920514553, -82.52211262885446 35.4993242051288, -82.52199962885649 35.49918920508974, -82.52188462886657 35.498999205039325, -82.52183862887652 35.49888420501121, -82.52174862887865 35.49877320497939, -82.52171562888364 35.49870520496218, -82.5216406288876 35.498598204932804, -82.52154762888249 35.49853120490958, -82.52140662886875 35.49846820488232, -82.52124162884542 35.498442204860126, -82.52123462884444 35.49844120485918, -82.52091762879336 35.49843120482464, -82.52088462878794 35.49843120482122, -82.52078962877208 35.49843220481171, -82.52039262870758 35.49842320476916, -82.52021762868223 35.49840020474656, -82.51993562864368 35.49834620470669, -82.51982262862941 35.498317204689165, -82.51975562862084 35.49830120467907, -82.5195926285973 35.49827820465765, -82.51947562858345 35.49824220463832, -82.51966262866058 35.4979412045963, -82.51987962874726 35.49761020455127, -82.52009162883496 35.4972672045032, -82.52027862891322 35.49695920445972, -82.52044362899021 35.49663520441073, -82.52052362902694 35.496482204387824, -82.52066462910089 35.49615220433521, -82.52081362918747 35.495748204268274, -82.5209466292736 35.495330204196875, -82.52102162933585 35.495005204138494, -82.52110462941474 35.49458020406056, -82.52143262989294 35.49181520353175, -82.52147262995109 35.49147920346758, -82.52151463000985 35.491141203403124, -82.5217516303344 35.489279203048625, -82.52187763035396 35.48928820306337, -82.5222556304121 35.48931720310812, -82.52238263043162 35.489327203123125, -82.5224696304453 35.489332203133095, -82.52264663047261 35.489345203153825, -82.52273063048641 35.48934620316264, -82.52281863050065 35.48934820317202, -82.52288663051192 35.489348203179084, -82.52295863052348 35.48935020318683, -82.52308463054537 35.489344203198485, -82.5230916305466 35.489343203199034, -82.52316063055912 35.4893362032047, -82.52328963058036 35.48933720321815, -82.52331963058482 35.48934020322182, -82.52340963059831 35.48935020323309, -82.52357163062419 35.48935620325094, -82.52379763065917 35.48937220327735, -82.52380663066052 35.48937320327845, -82.52395363067915 35.48941020330107, -82.52395963068268 35.489393203298185, -82.52397963069376 35.489343203290076, -82.52398663069738 35.489327203287544, -82.52433563075158 35.489351203328205, -82.52459163078913 35.48938220336077, -82.52491663083585 35.48942920340363, -82.52522963088235 35.48946420344279, -82.5253786309055 35.48947420346016, -82.52560363094027 35.48949020348643, -82.52572863096071 35.48949220349962, -82.52589363098794 35.489493203516766, -82.52593363099432 35.4894942035211, -82.52621663104166 35.48949120354952, -82.52638863106884 35.48950020356899, -82.5265536310948 35.48950920358765)))",6090,37,021,002204,370210022044,881,881,16,872,831,11,8,18,1,3,9,709,12,697,704,670,11,6,14,1,2,5,433,398,35
census_2010_blockgroups_view.fid--2dc29038_13ec899ba8f_-2627,"MULTIPOLYGON (((-82.54182961551781 35.607361229134106, -82.54187261552484 35.607362229138715, -82.54199461554046 35.60739222915735, -82.54205661554778 35.607411229167596, -82.5420746155499 35.60741722917068, -82.54233361557574 35.60752822921991, -82.54247161559526 35.60755022923855, -82.54261961561734 35.607566229257, -82.54273161563576 35.607567229268724, -82.54274861563847 35.607568229270676, -82.54285661565696 35.607564229281, -82.54296461567695 35.607551229289484, -82.54303561569013 35.607542229294864, -82.54320561572004 35.6075312293101, -82.54340861575399 35.607529229330595, -82.54354761577731 35.607528229344666, -82.54374661580336 35.607573229374225, -82.54389261582087 35.60761722939825, -82.54408561584235 35.607685229431915, -82.54429261586398 35.607768229470025, -82.54453061588262 35.60790322952196, -82.54464761589001 35.607981229549885, -82.54471861589447 35.60802922956696, -82.54501261591105 35.60823822963975, -82.54512861592231 35.608290229662195, -82.54515261592533 35.608296229665946, -82.54530661594349 35.60834422969153, -82.5453486159476 35.608363229699705, -82.54551361596357 35.6084372297317, -82.54566761597738 35.60851322976305, -82.54579961598701 35.60859322979282, -82.54588561599435 35.60863822981086, -82.54590561599689 35.60864322981394, -82.54595161600285 35.60865422982092, -82.54606661600431 35.608768229855876, -82.54608461603247 35.60860522982461, -82.54609961605466 35.60847722980008, -82.54611261607958 35.60832922977126, -82.54613161611573 35.60811522972971, -82.54614661614345 35.607952229698064, -82.5463476161747 35.6079652297213, -82.54680961624638 35.60799822977558, -82.54695261626836 35.60800922979246, -82.54704261628207 35.60801722980333, -82.54715361629796 35.608034229818244, -82.5473416163244 35.608065229843824, -82.54749761634623 35.60809122986521, -82.54790461640243 35.6081652299221, -82.54796761641104 35.608177229930995, -82.5480936164296 35.608192229946994, -82.54818361642594 35.608313229980844, -82.54829261642104 35.608462230022425, -82.54851461641108 35.608766230107065, -82.54868161640353 35.60899523017087, -82.54896761639331 35.60936923027641, -82.54932561637841 35.60985223041147, -82.54953261637364 35.610106230484426, -82.54961061637178 35.610202230512, -82.54974161637027 35.610353230556214, -82.54989361636709 35.61053723060928, -82.55015961636138 35.61086123070255, -82.55016161636135 35.61086323070314, -82.55042461635753 35.61117123079289, -82.55069461635169 35.61150023088768, -82.5509716163475 35.61182623098249, -82.5509866163473 35.611843230987446, -82.55123761634134 35.612152231076095, -82.5511476163212 35.612186231073885, -82.55107561630923 35.612186231066445, -82.55083361626895 35.612187231041716, -82.55057161622433 35.61219423101626, -82.5504036161955 35.61220023100019, -82.55007861614162 35.612199230966546, -82.54930261601311 35.61219723088647, -82.54910661598043 35.61219823086646, -82.54878261592634 35.61220023083355, -82.54852661588403 35.612199230807065, -82.54852261588333 35.612199230806674, -82.54811061581383 35.61220623076577, -82.54774361575274 35.61220723072823, -82.54748461570962 35.61220823070179, -82.54735061568717 35.61220923068823, -82.54695061562008 35.612214230648156, -82.5468176155976 35.61221623063495, -82.54664761556923 35.61221723061765, -82.54640561552874 35.61221923059319, -82.54617361549062 35.61221723056896, -82.54613961548534 35.61221423056484, -82.5460836154767 35.6122102305582, -82.54597261546073 35.61219423054355, -82.54590361545068 35.61218523053466, -82.54569761542034 35.61216023050841, -82.54562961541029 35.61215223049974, -82.54561861539254 35.6122552305196, -82.54558661533913 35.612567230579835, -82.5455766153215 35.61267123059999, -82.54546261529607 35.61271323059675, -82.54530261525777 35.61278923059581, -82.5444956150645 35.613174230591184, -82.54422661499994 35.613303230589835, -82.54384561490917 35.61348223058712, -82.54283161466681 35.61396223058059, -82.54270561463663 35.6140222305798, -82.54232661454563 35.61420423057793, -82.54220761451735 35.614259230576906, -82.54220461451658 35.614261230576986, -82.54215761450155 35.61430823058168, -82.54214461449025 35.614367230592414, -82.54214961448051 35.61443623060696, -82.54217261446333 35.614572230637016, -82.54218461445713 35.614625230648976, -82.54221361444228 35.61475323067801, -82.54217461442958 35.614793230682174, -82.54207861439272 35.614929230699964, -82.5420516143822 35.61496823070522, -82.54197261435446 35.615063230716345, -82.54192161433954 35.615105230719664, -82.54172061429166 35.61519923071815, -82.54159361426301 35.61524823071511, -82.54152461424874 35.61526623071164, -82.541511614246 35.61527023071106, -82.54131761421162 35.615284230693995, -82.54130361420933 35.615284230692616, -82.5412586142019 35.61528323068775, -82.54114561418322 35.61528323067616, -82.5411256141803 35.615280230673456, -82.54108261417404 35.615275230668026, -82.54108461418589 35.61520023065293, -82.54108561418819 35.61518623065022, -82.54107761419874 35.6151092306337, -82.54106161420633 35.61504323061865, -82.5410386142119 35.61498223060384, -82.54103761421209 35.6149802306034, -82.54099861421477 35.61492023058713, -82.54089861419565 35.614936230580085, -82.54079661417707 35.61494723057184, -82.54069561415757 35.61496523056516, -82.54063961414363 35.61499523056553, -82.54052861411097 35.61508723057285, -82.5402576140127 35.61543323061542, -82.54019561398994 35.61551423062551, -82.54012961396383 35.61561223063858, -82.54004761393561 35.61570723064953, -82.53999061391993 35.615747230651856, -82.53990761390551 35.61575123064417, -82.53985461389904 35.615736230635605, -82.53981161389723 35.61570223062427, -82.53975961390002 35.61562823060392, -82.5396496139074 35.61546123055856, -82.53959561390694 35.61540623054187, -82.53945261389678 35.61531823050926, -82.53926961388208 35.615216230469635, -82.53918561387647 35.61516223045003, -82.53906861387252 35.61506223041759, -82.53897361386697 35.61499623039444, -82.53893461386657 35.614956230382276, -82.53888561387494 35.61484923035545, -82.53880361390425 35.614571230290515, -82.53877761391566 35.61446923026704, -82.53876861393819 35.614313230234345, -82.53873961393997 35.614270230222665, -82.53868761393305 35.61425923021501, -82.53863661392421 35.61426123021024, -82.53860161391488 35.61428423021125, -82.53859961390677 35.61433523022144, -82.53862561389656 35.61442923024327, -82.53862861388978 35.614476230253146, -82.53861461388533 35.614490230254574, -82.53858361387984 35.61449223025178, -82.53854561387652 35.61447323024397, -82.53850861387804 35.61442323023002, -82.53849261388453 35.61436423021634, -82.53849861389602 35.61429623020313, -82.53851161390402 35.61425823019675, -82.5385436139169 35.61420923019005, -82.53858561392802 35.61418223018886, -82.53864661394091 35.614164230191506, -82.53872661395697 35.61414623019607, -82.53881661397423 35.614131230202354, -82.53886861398561 35.61411323020395, -82.53899661401735 35.614045230203274, -82.5390966140378 35.61402023020843, -82.53911061403328 35.614064230218844, -82.53913961403555 35.61408123022531, -82.53919461404222 35.61409723023415, -82.53928361405545 35.61410723024536, -82.53938461407223 35.61410723025573, -82.53945961408543 35.61410223026248, -82.53953561410158 35.61407923026556, -82.53961661412151 35.61403723026534, -82.53971861415052 35.61395923026, -82.53984561418498 35.61387223025529, -82.53994561421129 35.61380923025274, -82.54003861423368 35.61376423025317, -82.5401626142602 35.61372523025801, -82.54024561427758 35.613702230261865, -82.54028561428575 35.61369223026391, -82.54039661430727 35.61367223027126, -82.54046361432295 35.613642230272085, -82.5405286143393 35.61360623027139, -82.5405916143564 35.61356323026916, -82.5406826143831 35.613488230263194, -82.54074261440277 35.61342523025653, -82.54082161443115 35.61332623024456, -82.54086661445324 35.61323123022981, -82.54087361446479 35.613164230216896, -82.54083861446514 35.61312423020521, -82.5408036144636 35.61309623019582, -82.54074061445735 35.61306923018388, -82.54055461443525 35.613012230153174, -82.54034261440744 35.612964230121634, -82.54003861436466 35.61291423008023, -82.53993261435048 35.61289223006481, -82.53989061434692 35.61287023005601, -82.53987661435058 35.61283123004661, -82.53987461435729 35.61278523003707, -82.53989261436575 35.61275023003177, -82.53993961437814 35.61272023003055, -82.53999661438718 35.61272323003697, -82.54013561440053 35.61278623006414, -82.54017461440513 35.61279823007055, -82.54029061442311 35.612806230084125, -82.54041161444479 35.61279623009455, -82.54062561448595 35.61275923010903, -82.54166861469568 35.612522230167976, -82.54212861478793 35.61241923019427, -82.54223561480863 35.612400230201445, -82.54235961483177 35.61238323021067, -82.54260061485921 35.61246523025217, -82.54291161489198 35.61258723030892, -82.54293861490378 35.61254023030214, -82.54296561491543 35.612493230295385, -82.54309861497204 35.61226923026346, -82.54313461498647 35.61221423025595, -82.54317561500274 35.612153230247685, -82.54319761501056 35.612126230244534, -82.54312961501206 35.61204323022064, -82.54306761501505 35.611957230196765, -82.54278261502812 35.611565230087656, -82.54269861503371 35.6114382300532, -82.54267361503528 35.61140123004314, -82.5425676150376 35.61127223000597, -82.54228361496595 35.61143123000912, -82.54196761489034 35.61158123000714, -82.54129461473484 35.61186522999584, -82.54075761460719 35.61211522999151, -82.54068761459199 35.61213822998898, -82.5406066145772 35.61214722998247, -82.54056061457227 35.612129229974016, -82.54055461457303 35.61211822997125, -82.54054461457443 35.61209822996615, -82.54056061458445 35.61205022995803, -82.54058761459386 35.61201822995425, -82.54062761460432 35.61199322995327, -82.5406776146172 35.611964229952534, -82.54073561463508 35.61191022994747, -82.54077861465136 35.611851229939944, -82.54079961466226 35.611803229932285, -82.54081761469978 35.611579229888555, -82.54082261470968 35.61152022987705, -82.54082761472625 35.611418229856824, -82.54083061473457 35.6113672298468, -82.54086761476589 35.6112042298174, -82.54092761481618 35.61094222977023, -82.54093161482923 35.610862229754325, -82.54090561483693 35.610784229735806, -82.5408356148391 35.61069422971032, -82.54075761483759 35.610620229687235, -82.5407476148373 35.61061122968437, -82.54067061483477 35.61054522966302, -82.54064261483468 35.610515229653984, -82.54063461483736 35.61048922964784, -82.54062761484134 35.61045622964046, -82.54059961482643 35.610522229651025, -82.5406016148181 35.61057822966265, -82.54068361481283 35.610701229696126, -82.54069261480522 35.610760229708994, -82.5406836147951 35.610816229719504, -82.54066761478401 35.61087122972902, -82.54063061476795 35.61093522973827, -82.54047561471619 35.61110422975671, -82.5404166146867 35.61123222977673, -82.54038561466501 35.61133922979529, -82.54034961464824 35.611409229805844, -82.54031361463629 35.61144822981012, -82.54023161460835 35.611541229820574, -82.54011761457318 35.611646229830285, -82.54004661455345 35.61169822983352, -82.53997061453327 35.61174722983569, -82.53986961450434 35.61182622984141, -82.53970161445243 35.611982229855876, -82.5395786144064 35.61214822987697, -82.53954361439158 35.61220622988522, -82.53951761438364 35.61223022988742, -82.53948861437713 35.61224122988668, -82.53944761437212 35.61222922988004, -82.53942961437383 35.61219922987206, -82.53943261438052 35.61215822986404, -82.53958661444628 35.61189822982693, -82.53967261447629 35.611796229815035, -82.53975361451046 35.61166122979586, -82.53982361454929 35.611485229767304, -82.53986861457709 35.61135322974503, -82.53991661461544 35.61115622970981, -82.53995761465359 35.61095222967252, -82.5400276147063 35.6106862296256, -82.54003461471552 35.61063322961552, -82.5400126147212 35.610573229601044, -82.53997361472655 35.61049622958142, -82.53987761473729 35.61032322953629, -82.53985061474849 35.61022122951276, -82.53985161475164 35.61020222950902, -82.5398546147582 35.610163229501374, -82.53988361477175 35.61010622949281, -82.5399566147929 35.610047229488266, -82.5401346148384 35.60994422948561, -82.540220614863 35.60987722948078, -82.54027761488292 35.60980922947286, -82.5403936149298 35.60963022944832, -82.5404376149527 35.60952922943225, -82.54044061496319 35.60946422941935, -82.54042161498249 35.609318229387696, -82.54042261499843 35.609216229367014, -82.54040961501013 35.609126229347396, -82.54040561501148 35.60911322934436, -82.54038361502168 35.60902322932376, -82.54033761502777 35.6089342293009, -82.54027761503224 35.6088402292756, -82.5402386150406 35.608744229252025, -82.54017961506182 35.60854322920509, -82.54013761507728 35.60839722917109, -82.5401456150866 35.6083452291613, -82.54041961513396 35.60833322918701, -82.54058761515451 35.608381229214054, -82.54068861516568 35.608417229231726, -82.54075861517686 35.608420229239606, -82.5408166151858 35.608424229246346, -82.54094961520875 35.60841922925899, -82.54107361523441 35.60838622926496, -82.54122561526827 35.608330229269264, -82.54154161534333 35.60818322927185, -82.54163361536735 35.60812622926968, -82.54166961538174 35.60807222926234, -82.54168061539478 35.60799922924868, -82.54167261540617 35.60791622923097, -82.54164561541532 35.607828229210256, -82.5415836154172 35.60774922918781, -82.54130061540968 35.60749322910662, -82.54119961540437 35.60741922908114, -82.54120661540874 35.60739822907761, -82.54120861540932 35.607396229077374, -82.54128161542425 35.60737822908128, -82.54145061545415 35.6073662290962, -82.54171861549975 35.607359229122295, -82.54182961551781 35.607361229134106)))",4607,37,021,000500,370210005002,657,657,12,646,627,12,1,5,0,1,11,511,9,502,506,488,11,1,5,0,1,5,351,312,39
census_2010_blockgroups_view.fid--2dc29038_13ec899ba8f_-2626,"MULTIPOLYGON (((-82.53845261980662 35.57587022237849, -82.53845261979545 35.575942222393174, -82.5384536197834 35.57602222240953, -82.53846161976335 35.57616122243864, -82.53846661975285 35.57623422245401, -82.53847261973651 35.57634722247763, -82.53849061968697 35.57668822254885, -82.53849761967065 35.57680222257276, -82.53850661964518 35.576977222609266, -82.53852761959267 35.57734122268555, -82.53853961956943 35.57750522272019, -82.53854261956421 35.577542222727956, -82.53856361955677 35.57761322274456, -82.53860061955454 35.577667222759366, -82.53860561955099 35.57769622276577, -82.53874861956524 35.577758222793086, -82.53880661956975 35.57779122280575, -82.53888461957169 35.57786222282825, -82.53894161956731 35.5779522228524, -82.53897661955992 35.57803822287345, -82.53898561954644 35.5781352228942, -82.53896461952938 35.5782232229099, -82.53896361952911 35.57822422291002, -82.5389336195122 35.57830222292275, -82.53885261948454 35.57839422293318, -82.53870261943874 35.57853022294549, -82.53812861926819 35.579019222986005, -82.53777061915949 35.579340223014576, -82.53773861915035 35.57936522301639, -82.53760761911202 35.57947222302467, -82.53731161902355 35.57972822304635, -82.53718061898445 35.57984122305598, -82.53678661886642 35.580183223085065, -82.53665661882737 35.580297223094846, -82.53648461877587 35.58044622310752, -82.53612461866763 35.58076122313462, -82.5359866186215 35.5809122231512, -82.53598561862107 35.58091422315151, -82.53584661857059 35.581092223173435, -82.53577061853976 35.58121022318965, -82.5357636185368 35.581222223191354, -82.53569461850377 35.581362223212814, -82.5356416184748 35.58149322323398, -82.53560561845268 35.58159822325168, -82.53558061843651 35.58167622326498, -82.53556761842543 35.581734223275454, -82.5355366183994 35.58187022329996, -82.53553661839896 35.581873223300526, -82.53552561836985 35.58205022333549, -82.5355216183326 35.58228822338348, -82.5355196183106 35.5824282234118, -82.53552561826046 35.582761223480155, -82.53553361820138 35.583153223560736, -82.53554861809098 35.583886223711396, -82.53554861803708 35.584237223782836, -82.53554861802407 35.58432122379992, -82.53555261800769 35.584432223822965, -82.53555561799651 35.584508223838675, -82.53559361798331 35.58463422386826, -82.53567761798045 35.584744223899285, -82.53579961798296 35.58485922393513, -82.53604461800414 35.58498522398604, -82.53645161804819 35.58513822405896, -82.53666761806986 35.585230224099874, -82.53673961807412 35.58528022411745, -82.53681561807838 35.5853342241362, -82.5369196180775 35.58545222417087, -82.53692461807734 35.58545822417259, -82.53696761807127 35.58554422419453, -82.5369876180683 35.585585224205, -82.53701561805815 35.58568122422738, -82.5370166180562 35.58569522423032, -82.5370286180423 35.585798224252486, -82.53701061802009 35.58592322427615, -82.53696961799636 35.58603322429427, -82.53691461797335 35.586123224306945, -82.53689461796696 35.58614322430897, -82.5368436179502 35.58619722431469, -82.53677661793058 35.58625222431903, -82.53674061792016 35.58628122432123, -82.53664561789562 35.58633822432308, -82.5364076178333 35.5864862243287, -82.53627961779904 35.58657122433292, -82.53625361779068 35.58659722433554, -82.53620061777346 35.586652224341215, -82.53615661775576 35.58671922435034, -82.53610961773721 35.58678922435979, -82.53605561770873 35.58691622438005, -82.53602861768597 35.58703522440156, -82.53600761766684 35.58713622441994, -82.53591061762582 35.58729822444291, -82.53574661757942 35.58742322445151, -82.53554961753251 35.58751522444999, -82.53533461749129 35.58755122443526, -82.53523461747484 35.58755022442478, -82.53516761746378 35.58755022441783, -82.53489161742193 35.587524224384204, -82.53448061735975 35.58748522433409, -82.53402861729144 35.587442224278895, -82.53371561724104 35.587432224244694, -82.53343661719353 35.5874402242176, -82.53324761715902 35.587460224202324, -82.53283861708421 35.587505224169476, -82.53266961705349 35.58752322415572, -82.53260761704117 35.58753622415203, -82.532296616979 35.587604224133926, -82.53197361691193 35.5876922241186, -82.53192861690235 35.58770622411687, -82.53179161687235 35.587753224112326, -82.53170961685382 35.5877852241104, -82.53150661680831 35.587862224105244, -82.53121561673939 35.587996224102625, -82.53090761666304 35.58816022410433, -82.53074061661931 35.5882642241084, -82.53068461660351 35.588306224111136, -82.53058561657558 35.588381224116254, -82.53043961652763 35.58853522413255, -82.5303466164867 35.58870122415681, -82.53027061644124 35.5889142241923, -82.53019261639061 35.58915922423418, -82.53014661636071 35.589303224258735, -82.52998661627068 35.589715224326156, -82.529957616284 35.589598224299344, -82.52991661630107 35.589443224263576, -82.5299136163022 35.589432224261, -82.52983661632872 35.58917722420123, -82.52976961634691 35.58898722415569, -82.52971761636132 35.58883722411979, -82.52965161637933 35.58864922407478, -82.5295736164035 35.58840822401782, -82.52938261646376 35.587811223876656, -82.52926161649913 35.58745122379098, -82.52913161652651 35.587133223712854, -82.5291296165268 35.58712922371188, -82.52896461654942 35.5868042236288, -82.52891961655345 35.58673022360912, -82.52875661656755 35.58646222353787, -82.52848861657776 35.58610722343809, -82.52845661657916 35.586064223426035, -82.52814961658422 35.58570022332038, -82.52776461658827 35.58525922319111, -82.52752861657825 35.58507022312843, -82.52732061656543 35.58492922307834, -82.52692561651958 35.58480122301182, -82.52653761646401 35.58474422296029, -82.52627161641846 35.584753222934786, -82.52621461641807 35.58469422291692, -82.52618661642825 35.58459822289456, -82.5260266164708 35.58414922278674, -82.52598761648255 35.58403122275869, -82.52595961649376 35.583928222734855, -82.52594961651099 35.5838052227088, -82.52595461653034 35.58368522268487, -82.52598361654884 35.5835962226698, -82.52597961656262 35.5835022226502, -82.52527361655302 35.58280422243575, -82.52512861655002 35.582667222392956, -82.52492961654627 35.58247722233383, -82.52482561654804 35.58235322229789, -82.52469761654699 35.582222222258075, -82.5240306165309 35.58160822206461, -82.52379861653328 35.581343221986934, -82.523177616522 35.580747221801886, -82.52277461651585 35.58035322168029, -82.52258361651361 35.58016122162163, -82.52230161651059 35.57987722153485, -82.52183761649957 35.57944922140009, -82.52172361649787 35.57933722136557, -82.52169161649752 35.57930522135582, -82.52168561649741 35.579299221354006, -82.52157261649562 35.57918922131995, -82.52153561649494 35.579153221308864, -82.52145061649371 35.579070221283224, -82.52124461649169 35.578861221219555, -82.52119561649124 35.57881122120436, -82.5207336164825 35.57837022106715, -82.52040961647913 35.578043220967324, -82.52036361647917 35.577993220952486, -82.52019061647924 35.57780622089661, -82.52010061648404 35.57767822086134, -82.5200226164774 35.57763722084493, -82.5199916164748 35.577621220838545, -82.5198226164701 35.57746922079028, -82.5198006164696 35.57744922078397, -82.51975861646841 35.57741122077184, -82.52009861655789 35.57719622076304, -82.52047061665034 35.57699622076059, -82.52063561668773 35.57693122076435, -82.5208606167386 35.57684322076953, -82.52144861686257 35.57667122079494, -82.52200561697414 35.57654722082694, -82.52247261706397 35.57646622085841, -82.5228846171405 35.57641322088996, -82.52320661719527 35.57640422092123, -82.5235766172556 35.57641122096065, -82.52362861726401 35.57641222096619, -82.52397661731715 35.57644222100801, -82.52457461740644 35.57650622108249, -82.5249986174774 35.57650222112522, -82.52520061752146 35.576433221131985, -82.52526161753995 35.57637922112724, -82.5253716175728 35.57628422111918, -82.52558561767115 35.57587622105812, -82.52602061788889 35.574930220910446, -82.52616961795559 35.574657220870115, -82.5262996180002 35.574507220852986, -82.52658061809643 35.57418522081635, -82.52680461816234 35.57399822080125, -82.52687761818385 35.57393722079641, -82.52726961829013 35.57366922078212, -82.52731861830316 35.573637220780576, -82.52806861849062 35.57322722077419, -82.52842261858584 35.57299022076234, -82.52874661866753 35.57280822075858, -82.52924561879297 35.57253122075353, -82.52990761895947 35.57216222074635, -82.52997061897506 35.57212922074611, -82.53015261901923 35.572038220746364, -82.53034961906488 35.571954220749454, -82.5306596191232 35.57190922077214, -82.53115961921034 35.57188222081802, -82.53188961933111 35.57188422089344, -82.53241461941373 35.57191322095321, -82.5325776194394 35.57192222097179, -82.53324261954305 35.57196522104883, -82.533884619645 35.57199522112084, -82.53489361983335 35.57185822119658, -82.53514361988871 35.57176822120396, -82.53676362024633 35.57119022125273, -82.53726662036631 35.57095322125612, -82.53801062055093 35.570555221251524, -82.53844462065378 35.570355221255355, -82.5390796208009 35.57008322126525, -82.53964562092962 35.56985722127743, -82.54018662103962 35.56972522130606, -82.54050662110183 35.56966622132699, -82.54088662117537 35.56959822135208, -82.54127662124829 35.569544221381186, -82.54157062130712 35.56947922139813, -82.54182562135652 35.56943322141493, -82.54204562139893 35.56939422142964, -82.54239162147348 35.569283221442596, -82.54276662155632 35.56914922145375, -82.54280162156398 35.56913722145499, -82.54393562179038 35.56888822152069, -82.54400062180333 35.56887422152452, -82.54432462186881 35.56879822154239, -82.54433962186495 35.56883922155221, -82.54435062186236 35.568868221559235, -82.54438662185355 35.56896422158246, -82.54440262184973 35.569006221592666, -82.54399162177407 35.56905522156043, -82.54378662173603 35.569081221544685, -82.54337962165793 35.569150221516914, -82.54309462160116 35.56921122150011, -82.54279462153833 35.56929622148658, -82.54277662153459 35.56930122148577, -82.54255262148527 35.56938022147881, -82.54238462144953 35.569431221471966, -82.54216862140416 35.569493221462416, -82.54175462131472 35.56962822144732, -82.54168662130115 35.569643221443414, -82.5416216212879 35.56965922144001, -82.54145062125446 35.5696922214292, -82.5402896210341 35.56987222134657, -82.54012362100212 35.569901221335435, -82.53993162096309 35.569948221325255, -82.53977162092914 35.569996221318654, -82.53954862087878 35.570083221313496, -82.53910762077865 35.570258221303774, -82.53887262072459 35.570356221299576, -82.5388976207195 35.57041622131435, -82.53894862069939 35.570602221357454, -82.53896062068321 35.5707202213827, -82.53895362066469 35.570833221404996, -82.53894062065234 35.57089922141705, -82.53893462064642 35.570931221422974, -82.53888762062121 35.57104422144111, -82.53882462059292 35.571160221458285, -82.53874462056176 35.57127622147366, -82.5386916205383 35.57137222148775, -82.53865562052016 35.571451221500084, -82.53862562050274 35.57153222151348, -82.5385656204555 35.5717742215566, -82.5384716203862 35.572123221617936, -82.53846762037684 35.57218022162911, -82.53850662037368 35.572242221645794, -82.53864762037085 35.57241322169508, -82.53868162037031 35.572453221706674, -82.53879562036943 35.57258222174462, -82.53884062036505 35.572659221764944, -82.53887762035652 35.57275422178807, -82.5388926203479 35.57282622180426, -82.5388976203381 35.572895221818804, -82.5387566203292 35.57280122178523, -82.53875062032905 35.572796221783555, -82.53854662032377 35.57261022172472, -82.53844562031546 35.57255522170325, -82.53835562030254 35.572542221691336, -82.53830862029429 35.57254522168713, -82.5382516202842 35.57254922168205, -82.53815362026143 35.57259122168056, -82.53814262025868 35.57259722168067, -82.538074620241 35.57263922168218, -82.53800462022704 35.57265422167806, -82.53794562021793 35.57265022167118, -82.53792462021512 35.572645221668, -82.53789662021126 35.57264022166409, -82.53758762018899 35.572452221594084, -82.53738462016808 35.57236922155637, -82.53730262015725 35.57235122154431, -82.53721362014541 35.572332221531305, -82.53714062013091 35.57234722152683, -82.53711162012058 35.57238322153126, -82.53711562011836 35.57240222153553, -82.53712162011547 35.572427221541176, -82.53714562011106 35.57248222155487, -82.537206620108 35.57256722157844, -82.53739962009881 35.572835221652774, -82.53743762009238 35.57291822167356, -82.53748662007865 35.57306022170748, -82.53748662007851 35.57306122170773, -82.5375516200664 35.57321022174471, -82.5375596200634 35.57323822175125, -82.53763062004373 35.57344222180001, -82.53778162000263 35.57387222190298, -82.53785161998645 35.57405322194701, -82.53792961996814 35.574256221996315, -82.53797161995769 35.574369222023655, -82.53809761992653 35.57470822210556, -82.53814061991609 35.57482222213317, -82.53820161989925 35.57499722217505, -82.53821461989608 35.575032222183495, -82.53832961986849 35.575335222256996, -82.53839161985033 35.57552022230098, -82.53841361984392 35.57558522231647, -82.53844261983127 35.57569922234266, -82.53845161980746 35.57586322237696, -82.53845261980662 35.57587022237849)))",5872,37,021,000800,370210008002,1014,1014,25,983,838,129,3,11,0,2,31,810,16,794,792,691,87,3,9,0,2,18,533,481,52
census_2010_blockgroups_view.fid--2dc29038_13ec899ba8f_-2625,"MULTIPOLYGON (((-82.5177116282349 35.49860920453209, -82.51795962826392 35.498688204573625, -82.51799262826759 35.49869920457926, -82.51814762828465 35.49875620460671, -82.518675628341 35.49895920470213, -82.51869362834292 35.4989662047054, -82.51888362836186 35.499048204741584, -82.51893462836706 35.499069204751095, -82.51872862828002 35.499414204800146, -82.51861562823309 35.49959820482598, -82.51860262822782 35.49961820482867, -82.51850262818475 35.49979120485361, -82.5183746281309 35.500004204883815, -82.51826762807542 35.500250204922864, -82.51818262802348 35.500497204964425, -82.51812262796736 35.50079820501944, -82.51809262791188 35.50112720508336, -82.51810562786655 35.50143720514767, -82.51810862785923 35.501488205158395, -82.51818762782663 35.50178620522711, -82.51826462779769 35.502058205290325, -82.51850062774521 35.50265520543595, -82.51861662769588 35.50310220553871, -82.51869662766535 35.503388205605106, -82.51869962766139 35.50341720561133, -82.51873762762638 35.50368620566996, -82.51872862757514 35.5040102057349, -82.51869462752106 35.50432620579571, -82.51861462745619 35.50466320585605, -82.51854362739576 35.50498020591321, -82.51844862732833 35.50531720597201, -82.51834862725931 35.505659206031375, -82.51828262720564 35.50593820608134, -82.51821262714797 35.50623820613516, -82.5181036270641 35.50666720621124, -82.51803262701017 35.506942206259914, -82.5179716269599 35.50720420630693, -82.51791562690784 35.50748320635791, -82.51789962688646 35.50760520638114, -82.51789362687671 35.507662206392084, -82.51789762684501 35.50787320643542, -82.51791562682575 35.508018206466765, -82.51792162681963 35.508064206476746, -82.51794862680612 35.508182206503484, -82.51797162679436 35.50828320652643, -82.51804162677426 35.508490206575715, -82.51809462676277 35.50862220660792, -82.51816862675149 35.50877520664666, -82.51826862673897 35.50896520669552, -82.51834962673142 35.50910220673175, -82.51840562672622 35.50919620675662, -82.51854162671654 35.509406206813246, -82.51860662671167 35.50950820684068, -82.518692626705 35.50964420687719, -82.51880262669678 35.50981720692357, -82.51894962668503 35.51005220698651, -82.51908262667536 35.510259207042196, -82.5192546266627 35.51052720711433, -82.51968162663516 35.511168207288534, -82.52028162659323 35.5120892075374, -82.5206196265697 35.5126082076777, -82.52067962656545 35.51270020770252, -82.52093262654945 35.51307820780532, -82.52098262654614 35.51315320782574, -82.52168562649918 35.51421920811473, -82.52193662648227 35.51460020821794, -82.52203962647248 35.51477520826413, -82.52214562645644 35.51499420831957, -82.52222162643972 35.51518520836621, -82.52225062643352 35.51525720838375, -82.52234862640633 35.51554020845145, -82.52239662638189 35.515751208499246, -82.52242062637004 35.51585420852265, -82.52248162633248 35.51616520859213, -82.52249962627378 35.51656720867579, -82.52250562618424 35.517157208796405, -82.52253762595024 35.518716209116825, -82.52253562586311 35.51928220923175, -82.52255362583611 35.51947720927329, -82.52256762581746 35.519614209302574, -82.52261862578332 35.51989120936412, -82.52268362576235 35.52009820941297, -82.52274662574993 35.52024720944968, -82.52281562574109 35.52037920948361, -82.52287562573561 35.52048020951028, -82.5229766257291 35.520631209551446, -82.52310762572459 35.520802209599665, -82.52327162572331 35.52098720965409, -82.52328962572312 35.52100820966024, -82.52340362572558 35.52111520969362, -82.5235526257316 35.52123720973373, -82.52361062573462 35.52128020974849, -82.52369162573893 35.52133920976877, -82.52379462574608 35.52140420979257, -82.52389762575302 35.52147020981656, -82.52403062576326 35.52154720984584, -82.52420562578055 35.52162320987926, -82.52442562580332 35.52171220991995, -82.52443962580493 35.52171720992237, -82.52461462582426 35.52178020995316, -82.52488062585574 35.52186220999711, -82.52478562583214 35.52191320999774, -82.52416262567704 35.522251210002636, -82.52367862555356 35.522533210010295, -82.52349962550775 35.52263821001328, -82.52270862531816 35.52301921000967, -82.5218726251151 35.523439210009286, -82.5213306249853 35.52370021000686, -82.52074262484605 35.52397221000183, -82.52010762470175 35.52422620998832, -82.51994462466428 35.524294209985435, -82.51952962456873 35.52446920997844, -82.51875962439271 35.524784209963535, -82.51866862437394 35.524808209959076, -82.5181316242627 35.52495320993346, -82.51791862422093 35.5249952099201, -82.51746862413249 35.52508520989234, -82.5167346239974 35.525173209834946, -82.5160546238818 35.52519220976898, -82.5156156238098 35.52518720972288, -82.51532762376233 35.525185209692985, -82.51484362368195 35.525186209643486, -82.51433662359794 35.5251862095915, -82.51427762358806 35.52518720958558, -82.51381262348288 35.525370209575165, -82.51330662335326 35.52566820958387, -82.51300362326944 35.52588720959728, -82.51298262326337 35.52590420959862, -82.51271662317902 35.526166209624556, -82.51266562315627 35.52625920963823, -82.512438623055 35.5266742096994, -82.51229862298737 35.526963209743776, -82.51215262291647 35.52726720979071, -82.51179562277477 35.52780520986349, -82.51067762245985 35.52864920992037, -82.51066762245677 35.52865820992118, -82.51019762232754 35.52899320994107, -82.51005962228159 35.5291432099574, -82.5097836222879 35.52880420986015, -82.50973062229062 35.528729209839454, -82.50944762230661 35.52832020972725, -82.50923262229792 35.52814420966936, -82.50869462225278 35.52785820955599, -82.50852762224213 35.52774720951631, -82.508087622214 35.527455209411784, -82.50801562220944 35.5274072093946, -82.50764962219628 35.52709820929421, -82.50735762218567 35.5268522092142, -82.50699262216031 35.52662320913019, -82.50660462213355 35.52637920904073, -82.50628662212333 35.526102208951755, -82.50605362211573 35.525900208886775, -82.5058856221175 35.52570820883046, -82.50566862211522 35.525488208763505, -82.50502062210899 35.524830208563166, -82.5048046221068 35.524611208496395, -82.5046956221073 35.52449020846063, -82.50437062210892 35.52412920835382, -82.50426262210942 35.52400920831841, -82.50402862211041 35.52375020824169, -82.50332962211388 35.522973208011976, -82.5030966221149 35.52271520793557, -82.50297862207066 35.52287620795621, -82.50290062204095 35.52298520797037, -82.50267762194152 35.523392208030266, -82.50258262189895 35.5235672080561, -82.50244162183137 35.52385520810022, -82.50233962178193 35.52406720813282, -82.50203862163687 35.52468720822808, -82.50202462162903 35.52472320823394, -82.50191062156404 35.525023208283244, -82.50171862145851 35.52550320836115, -82.50155862136322 35.52595120843589, -82.50135162129894 35.52614620845429, -82.50127062127372 35.526223208461595, -82.50101462119201 35.526479208487395, -82.50082262112822 35.526687208509976, -82.50063062106695 35.52687920852931, -82.5004706210257 35.52697520853244, -82.5001666209532 35.52711920853052, -82.49984662088053 35.527247208523725, -82.49935062078612 35.527327208489105, -82.4985506206413 35.52740720842326, -82.49800662054628 35.52743920837394, -82.49792162053211 35.52743920836516, -82.49739862044551 35.52743920831148, -82.49696662036165 35.52751920828341, -82.49666262029903 35.52759920826853, -82.49653462027547 35.52761420825838, -82.49651562027263 35.52761220825603, -82.49629262023892 35.52759120822895, -82.4961466202092 35.52762720822125, -82.49607962019658 35.52763720821639, -82.49606162019302 35.527641208215364, -82.49593362016951 35.52765620820523, -82.49583762015881 35.52762220818856, -82.49574962014606 35.527610208177, -82.49567462013238 35.52761820817099, -82.49562162012026 35.527640208169906, -82.49553762009944 35.52768520817048, -82.49550262008572 35.52773620817729, -82.4954886200709 35.52781820819251, -82.49548762007025 35.527821208193025, -82.49547962000717 35.52822320827398, -82.49546361997692 35.52840320830894, -82.49543461995748 35.52849820832527, -82.4952936199022 35.528706208353114, -82.4952306198752 35.52881420836854, -82.49516861984652 35.52893420838664, -82.49512661982325 35.52904020840388, -82.49508461980322 35.52912520841681, -82.49500861976145 35.52931520844768, -82.4949676197413 35.52940220846112, -82.4949606197375 35.52941920846386, -82.49488761970449 35.52955520848411, -82.49484161968684 35.529620208492545, -82.49478561966872 35.52967820849864, -82.49473861965545 35.52971420850114, -82.494688619643 35.52974120850144, -82.49462461962992 35.529757208498154, -82.49457261962067 35.529761208493596, -82.49450561960992 35.52975920848635, -82.49443461960229 35.529732208473575, -82.49436261959865 35.52967820845519, -82.4942926195963 35.52961820843583, -82.4942556195968 35.52957520842326, -82.49414861959806 35.52945120838707, -82.49408561959706 35.52939020836823, -82.49397761959034 35.52931720834227, -82.49374561957356 35.529176208289776, -82.49366861957058 35.52911220826883, -82.49349761956042 35.52899420822731, -82.49334461955034 35.52889520819146, -82.49317161953866 35.52878420815114, -82.49303561953307 35.52867420811478, -82.49298261953086 35.52863120810066, -82.49294561953012 35.52859620808974, -82.49290761952938 35.52856020807848, -82.49284261952968 35.52848820805722, -82.49279861953225 35.528424208039645, -82.49277661953953 35.528353208022956, -82.4927666195456 35.52830220801154, -82.492766619546 35.52830020801115, -82.49274861955058 35.528250207999136, -82.4927156195534 35.52819720798492, -82.4926816195485 35.528192207980474, -82.49266861954588 35.528195207979785, -82.49264061953963 35.528205207978885, -82.49257261951841 35.528270207985145, -82.49256661951505 35.52828620798779, -82.49255261950556 35.52833220799572, -82.49250061947288 35.52848920802231, -82.49248261945374 35.528594208041795, -82.49249561943242 35.528747208074215, -82.49250861942234 35.52882720809184, -82.49253461940313 35.52898020812564, -82.49253561939337 35.5290442081387, -82.49249761937453 35.529126208151524, -82.49245261936325 35.52915120815196, -82.49239561935487 35.52914420814475, -82.49230161934328 35.52911820812972, -82.4922216193368 35.529074208112604, -82.49213661933298 35.52900720809022, -82.49206861933571 35.52891620806474, -82.49202361934118 35.528832208043035, -82.49189261935003 35.528633207989145, -82.49176861936186 35.528422207933495, -82.49172961936863 35.528336207911984, -82.49172261937039 35.528317207907435, -82.4916926193779 35.52823620788793, -82.49164461938993 35.52810620785655, -82.4915826194099 35.52790920781008, -82.49156761941867 35.52783620779371, -82.49156161942159 35.52781020778788, -82.49152161943339 35.527690207759306, -82.49152161943361 35.52768920775915, -82.491472619435 35.527627207741475, -82.49140661942916 35.527594207728015, -82.4913176194168 35.52757820771562, -82.4911846193951 35.527576207701564, -82.4911176193825 35.527586207696714, -82.49110561938036 35.527587207695646, -82.49105261937035 35.5275952076919, -82.49095561935138 35.527614207685765, -82.49093261934674 35.52761920768443, -82.49082561932721 35.52763120767588, -82.49074761931426 35.527631207667866, -82.49071961931169 35.52761820766243, -82.49065561930568 35.52758820764972, -82.49056961930184 35.52752020762704, -82.49043061929835 35.52739320758695, -82.49035161929245 35.52734620756931, -82.49026661928765 35.52728620754837, -82.49014561928261 35.52718820751603, -82.49010861928112 35.527158207506126, -82.49002261927622 35.527097207484886, -82.48995561927343 35.52704320746706, -82.48990461927453 35.526981207449225, -82.48989661927581 35.52696420744487, -82.4898706192807 35.52690420743, -82.4898286192986 35.52674220739282, -82.48982161930714 35.52667920737924, -82.48974861930516 35.526613207358395, -82.48982661932881 35.52654320735214, -82.48987461934585 35.52648420734507, -82.4899016193589 35.526428207336394, -82.48990261936046 35.52641920733467, -82.48991461937138 35.52636120732421, -82.48991561938173 35.52629520731084, -82.48989761939426 35.526194207288455, -82.48985861940376 35.526090207263294, -82.48979161941112 35.52597020723196, -82.48970061941321 35.52585820719987, -82.48961161941381 35.52575820717041, -82.4895956194139 35.525740207165114, -82.48954061941603 35.52566720714463, -82.48952461942123 35.52561620713259, -82.48953061942879 35.52557320712448, -82.48955961943734 35.52554920712259, -82.48960661944703 35.52553620712481, -82.4896566194541 35.525544207131496, -82.48969461945676 35.52556820714033, -82.48974661945685 35.525623207156826, -82.48990961945884 35.5257862072067, -82.49007961946364 35.5259382072551, -82.49036861946948 35.52621220734045, -82.49052361947577 35.526338207382004, -82.49053261947624 35.52634520738436, -82.49075661948693 35.52651720744224, -82.4908616194946 35.526580207465926, -82.49093461950311 35.52660320747807, -82.49100861951432 35.526610207487025, -82.49109561952942 35.52660620749521, -82.49119461954959 35.52658120750025, -82.49129561957258 35.526540207502286, -82.49137961959481 35.52648620749995, -82.491438619616 35.52641220749091, -82.49156361967184 35.52618320745722, -82.4916096196891 35.52612020744911, -82.49166161970624 35.52606520744333, -82.49172761972409 35.52602020744089, -82.49180561974222 35.525986207441974, -82.49204461979322 35.52591220745147, -82.49214061981492 35.525874207453626, -82.49237361986899 35.525773207456936, -82.49243861988252 35.52575520745995, -82.49254561990314 35.52573620746711, -82.49268461992725 35.52572920747992, -82.49289961996506 35.5257152074992, -82.49299561998336 35.52569920750573, -82.49306961999913 35.52567620750868, -82.49322562003609 35.52560420751005, -82.49387462018707 35.525321207519085, -82.49395662020596 35.52528620752043, -82.49428162028379 35.525130207522075, -82.49438162030897 35.52507420752093, -82.49446162033034 35.525021207518414, -82.49455362035619 35.524952207513735, -82.49488762045512 35.52466820749033, -82.49493062046948 35.52462120748519, -82.4949856204878 35.52456120747855, -82.49501562049946 35.52451720747273, -82.49505962051929 35.52443620746083, -82.49515162056817 35.524217207425686, -82.49518762058372 35.52415420741661, -82.49522962059712 35.52411220741233, -82.49529562061436 35.5240712074108, -82.49536362062857 35.52405220741385, -82.49541862063907 35.52404320741767, -82.4955106206545 35.52404220742696, -82.49560262066866 35.524049207437756, -82.49580962069918 35.52407320746393, -82.49595262071904 35.524098207483696, -82.4961306207437 35.52413020750846, -82.49622762075823 35.52413920752028, -82.49631262077287 35.52413620752839, -82.49641462079242 35.524119207535364, -82.49649362080913 35.52409520753858, -82.49657862082796 35.524064207541045, -82.49664062084246 35.52403720754185, -82.49668262085353 35.524010207540684, -82.49670662086214 35.5239802075371, -82.4967116208672 35.52395220753188, -82.49670762087118 35.52392220752536, -82.49668662087196 35.52389420751752, -82.49665062086974 35.523870207508956, -82.49660662086552 35.52385020750037, -82.49655662085964 35.523834207491994, -82.49649462085367 35.52380620747993, -82.49643262084886 35.523771207466524, -82.49637762084708 35.52372320745104, -82.49627262084906 35.523597207414674, -82.49620362084912 35.52352220739229, -82.49613462084659 35.523464207373465, -82.49604762084013 35.52341220735396, -82.49580562081907 35.52328820730389, -82.49570162080833 35.523246207284636, -82.49564362080132 35.52322920727531, -82.4955796207913 35.52322520726782, -82.49552562078131 35.523232207263746, -82.49546562076834 35.523252207261685, -82.49540362075311 35.52328420726184, -82.49530462072704 35.52334720726449, -82.49525762071563 35.52337120726453, -82.49515162069261 35.523406207260734, -82.49503062067016 35.523422207251606, -82.49492662065262 35.5234242072413, -82.49487362064569 35.52341220723349, -82.49483062064131 35.52339420722542, -82.49479362063964 35.52336520721568, -82.49476562064132 35.523324207204475, -82.49475462064684 35.52327620719357, -82.49475762065394 35.52323320718515, -82.49476962066191 35.52319420717843, -82.49483662069949 35.5230222071504, -82.49492462074438 35.5228242071191, -82.49494662075968 35.52274820710592, -82.49495062077072 35.52268120709272, -82.49493562078827 35.52255020706456, -82.49491362079988 35.52245120704214, -82.49486762081806 35.522283207003206, -82.49484462082208 35.52223220699052, -82.49481262082386 35.52218620697784, -82.49478062082326 35.522155206968314, -82.49473862082017 35.52213020695888, -82.49468762081466 35.52211120694978, -82.49462562080593 35.522101206941414, -82.4945756207973 35.52210320693667, -82.49447462077664 35.52212920693164, -82.49431562073981 35.52219720692918, -82.4942716207302 35.522212206927634, -82.49422762072145 35.522222206925164, -82.49418262071335 35.522226206921346, -82.49413462070619 35.522221206915425, -82.49409162070121 35.522207206908135, -82.49405162069843 35.52218220689899, -82.49401662069795 35.52214720688829, -82.49399162070063 35.52210320687678, -82.49397962070903 35.522035206861666, -82.49398062071785 35.52197920685045, -82.49398462072033 35.5219672068484, -82.49400362073288 35.521906206837954, -82.49410562078101 35.5217022068069, -82.49414562079863 35.52163120679656, -82.49430862086892 35.52134920675595, -82.49445062092661 35.52112620672521, -82.49460962098496 35.52091820669918, -82.49471762102029 35.520804206687096, -82.49479662104568 35.520724206678985, -82.49502162111767 35.520498206656114, -82.49506162112993 35.520461206652705, -82.49509062114001 35.52042720664874, -82.49538662123695 35.52011520661564, -82.49547562126799 35.52000920660322, -82.49555762129994 35.519889206587294, -82.49560462132195 35.51979620657315, -82.49565362134987 35.51966720655194, -82.49567262136256 35.519605206541314, -82.4956876213723 35.51955820653331, -82.49571962139704 35.51943120651076, -82.49581862149311 35.518912206415344, -82.49585862152624 35.5187402063845, -82.4959086215596 35.51857620635632, -82.49607962166719 35.51806020626892, -82.49612762170139 35.51788920623907, -82.49617562175527 35.51759020618318, -82.49619262178426 35.51741920615014, -82.49621262184964 35.51701520607005, -82.49621362190474 35.51665720599738, -82.49620462193099 35.516476205959655, -82.49620462193442 35.516454205955114, -82.49617762199031 35.51606120587245, -82.49615662200972 35.515912205840024, -82.49613562202254 35.51580620581634, -82.4961056220344 35.51569620579088, -82.49606362204635 35.515573205761555, -82.49604262205033 35.515524205749394, -82.49600462205711 35.5154392057282, -82.49568062211566 35.51470820554631, -82.49565162212042 35.514646205530745, -82.49544762215301 35.51421320542178, -82.49517362220409 35.513585205266004, -82.49484662225353 35.512910205095196, -82.49453762229692 35.5122942049382, -82.49444162231039 35.51210220488932, -82.49437662232302 35.51195020485172, -82.494255622351 35.511637204775646, -82.49420562236469 35.511494204741446, -82.49416362237612 35.511374204712794, -82.49411362239636 35.51118820466981, -82.49409662241676 35.51103720463735, -82.49409662241904 35.51102220463431, -82.49410562244357 35.51087220460475, -82.49435662268228 35.50958720436925, -82.49436562269076 35.50954220436099, -82.49441762276636 35.509105204277496, -82.49442562277818 35.50903720426441, -82.4944896228391 35.50870920420433, -82.49455262288781 35.50845920415997, -82.49457562290871 35.50834820413975, -82.49460262294296 35.50815420410305, -82.49461462297056 35.507987204070425, -82.49460262299019 35.50784620404046, -82.49456462301045 35.50767320400135, -82.49449762302993 35.507474203954025, -82.49444962305785 35.507240203901524, -82.49443062308653 35.50703220385727, -82.49443762311708 35.506841203819135, -82.49444662312595 35.5067932038103, -82.49444662312642 35.506790203809715, -82.4944746231524 35.50665120378427, -82.49468462330852 35.505860203645, -82.49490162346196 35.505094203511526, -82.49503062355745 35.50461120342653, -82.49512662363537 35.504207203354305, -82.49516362367264 35.50400420331676, -82.4951796237004 35.50384020328502, -82.49519262373599 35.50362220324205, -82.49519462375446 35.50350420321827, -82.49520262378864 35.50329020317561, -82.49522162381342 35.503149203148894, -82.49524862384118 35.50299720312071, -82.49529262387516 35.502823203089825, -82.49546462399276 35.50224220298937, -82.49554462405537 35.50192020293209, -82.49556262407053 35.50184120291785, -82.49568962417469 35.50129920282074, -82.49576062424478 35.500918202750476, -82.49578762428887 35.50066020270086, -82.49582362437012 35.50016920260462, -82.495836624425 35.49982620253624, -82.49584762446422 35.49958220248779, -82.49586562452053 35.499234202418826, -82.4958916245686 35.49894920236354, -82.49591762459514 35.49880420233675, -82.4959326246091 35.498729202323034, -82.4959806246371 35.49859820230133, -82.49605062466478 35.49849320228716, -82.49599362466273 35.49844520227153, -82.49595262467349 35.498331202244145, -82.49591862469714 35.49814020220181, -82.49588562472674 35.49791120215192, -82.49582462478246 35.49748220205845, -82.49580262479921 35.497349202029085, -82.49577662481116 35.49724320200487, -82.49572662481887 35.49713920197862, -82.49563262482438 35.49700120194098, -82.49552662482857 35.49685920190119, -82.4953476248481 35.49653920181776, -82.49528562485953 35.49639720178258, -82.49519162486816 35.49624020174097, -82.49518162486925 35.49622220173631, -82.49511662487795 35.49609520170374, -82.49500762488336 35.495942201661464, -82.49488362488523 35.49579620161914, -82.49481362488419 35.49572720159791, -82.49478662488372 35.495701201589796, -82.4946716248751 35.49563320156426, -82.49447062485159 35.49556920153053, -82.49430262482637 35.495552201509916, -82.49412362479474 35.49556520149416, -82.49391562475708 35.495586201477124, -82.49375662472592 35.4956182014674, -82.49351662468324 35.495637201446556, -82.49337062466061 35.495627201429556, -82.49306362461772 35.495575201387524, -82.49288362459467 35.495531201360116, -82.49258362455605 35.49545920131465, -82.49221762450823 35.49537620126028, -82.49191062446872 35.495302201213775, -82.49165062443639 35.49523220117285, -82.49142962441023 35.49516420113638, -82.49114362437928 35.4950572010852, -82.49091462435992 35.49493620103716, -82.49085662435608 35.49489820102349, -82.49071662434706 35.49480620099049, -82.49055062433861 35.49468220094816, -82.49048262433654 35.49462220092905, -82.49043962433741 35.49457020091409, -82.49039162434647 35.49445920088653, -82.49035162435672 35.4943492008601, -82.49030262436503 35.49424220083329, -82.49026262436819 35.494178200816194, -82.49007362438181 35.493885200737274, -82.48996862438361 35.49376020070108, -82.48981862438148 35.49361220065554, -82.48965762437982 35.4934492006059, -82.48950762437721 35.49330420056105, -82.48934962436904 35.493187200521035, -82.4892076243567 35.49311420049169, -82.48900762434072 35.49300220044841, -82.48871362432598 35.492781200373265, -82.48860962432252 35.49269120034436, -82.48845762431912 35.49254920029988, -82.488310624319 35.49239120025267, -82.48821362432265 35.492263200216705, -82.48820062432335 35.49224420021148, -82.4880916243297 35.492085200167935, -82.48802662433906 35.49195420013468, -82.4878766243731 35.491570200041245, -82.48783362439045 35.49141020000435, -82.48780962440381 35.491297199978874, -82.48779062441942 35.49117519995215, -82.48779162442416 35.4911451999461, -82.48780262443312 35.49109919993788, -82.48781962444043 35.49106919993353, -82.48785162445054 35.49103819993048, -82.48791662446817 35.49099319992801, -82.488001624489 35.49094919992779, -82.48806262450495 35.49091119992634, -82.48814362452967 35.490837199919625, -82.48821362455001 35.490780199915186, -82.48828862457349 35.490708199908234, -82.48832762458868 35.49065119990067, -82.48834262459876 35.49060119989204, -82.48831862459282 35.49061419989223, -82.48824762458028 35.49061919988593, -82.48795662452842 35.49064319986095, -82.48785962451116 35.49065119985264, -82.48743562446613 35.49048719977586, -82.48695562445486 35.490042199636186, -82.48658562443165 35.489794199547774, -82.48616762438304 35.48966019947762, -82.48584162434496 35.489556199423035, -82.48541562429276 35.4894371993552, -82.4852466242721 35.4893891993281, -82.48505462424866 35.48933519929742, -82.4847786242149 35.48925719925323, -82.48474062421076 35.4892431992465, -82.48457462419188 35.48918719921812, -82.48432662416396 35.489101199175224, -82.48405962413389 35.48900919912916, -82.48377162410145 35.48891019907945, -82.48358162407911 35.488850199047754, -82.48333262404985 35.48877219900639, -82.48309162402168 35.488696198966196, -82.48236962393715 35.48846819884577, -82.48212962390906 35.48839219880577, -82.48201762389598 35.488356198786924, -82.48168362385675 35.48825119873131, -82.48157262384383 35.48821619871288, -82.48148262383327 35.488188198697976, -82.48141262382414 35.48817119868729, -82.48092762376139 35.48805719861434, -82.4807666237405 35.48802019859036, -82.48073862373688 35.488013198586, -82.48065462372601 35.48799319857336, -82.48062762372246 35.48798719856939, -82.48036962368911 35.487926198530474, -82.48018862366577 35.48788319850323, -82.4795936235854 35.48776519841818, -82.4793346235504 35.487714198381276, -82.47944962358626 35.487604198370796, -82.47978962369176 35.487283198340336, -82.47979662369393 35.48727619833954, -82.47991562372981 35.48717119833042, -82.47993862373697 35.487149198328375, -82.4800116237587 35.487086198323006, -82.48003562376567 35.48706619832145, -82.4800896237822 35.48701719831698, -82.48023662382916 35.48686919830197, -82.48044762389725 35.48665319827969, -82.48062162395333 35.48647519826139, -82.48087562403302 35.486229198237446, -82.48109962410184 35.4860221982183, -82.48152562422632 35.48567019819042, -82.48174662429196 35.48548119817472, -82.48180062430774 35.4854361981711, -82.48211562440098 35.48516819814895, -82.48218862442327 35.48510119814273, -82.48239762448777 35.484906198124555, -82.48261062455708 35.48468419810131, -82.48268662458453 35.48458719808939, -82.48271062459439 35.48454919808405, -82.48275462461234 35.48447919807438, -82.48280062463566 35.48437619805816, -82.48283162465871 35.48426019803772, -82.48284062467454 35.484166198019544, -82.48283662468708 35.484080198001664, -82.48281962469783 35.483992197982026, -82.48278862471078 35.48387419795484, -82.48265762474489 35.48351019786748, -82.48261962476433 35.483342197829344, -82.48260962477765 35.483244197808425, -82.48260662479017 35.483159197790826, -82.48260962480452 35.48306919777286, -82.48262062482519 35.48294619774894, -82.48272162493981 35.48230719762943, -82.48275462499714 35.48196919756414, -82.48280762512547 35.48118819741078, -82.48281062515161 35.48102119737714, -82.48280462517016 35.480894197350715, -82.4827766251914 35.480725197313454, -82.48269662521177 35.48050619726078, -82.48252162523936 35.48013719716781, -82.48250062524261 35.48009319715671, -82.48243762525237 35.47996119712341, -82.48241762525562 35.47991819711265, -82.48236462526394 35.4798071970846, -82.48234362526914 35.47975019707086, -82.48232362527446 35.47969419705746, -82.48229662528612 35.479589197033334, -82.48227262531225 35.47939219699086, -82.4822686253302 35.47927119696582, -82.48226962533987 35.4792091969533, -82.48227262535181 35.47913419693839, -82.48227962536954 35.47902619691708, -82.48228862539325 35.47888119688861, -82.48228962539817 35.47885019688236, -82.48230062544057 35.478585196829634, -82.48229762546127 35.47844719680127, -82.48228262547666 35.478330196775914, -82.4822816254771 35.47832619677503, -82.48226762548556 35.47825619675936, -82.4822286254938 35.478160196735814, -82.48221262549708 35.478121196726306, -82.48218262550375 35.47804519670773, -82.48216262550652 35.47800619669782, -82.48214462550918 35.47796919668842, -82.48205462552136 35.477792196643215, -82.48203362552442 35.477749196632274, -82.48178462555762 35.47726419650817, -82.48169462556957 35.47708919646337, -82.48158062558888 35.47684019640103, -82.48137062560522 35.476506196311654, -82.4812036256184 35.47624019624044, -82.48082562566017 35.47555919606325, -82.48046762572255 35.4747651958652, -82.48046662572837 35.4747261958571, -82.48045562580793 35.474195195748074, -82.48046262582984 35.47405919572113, -82.48046262583362 35.474035195716255, -82.48046662584515 35.473964195702244, -82.48046862584901 35.47394119569778, -82.480470625857 35.47389119568776, -82.48047962588127 35.473742195658396, -82.48048262588925 35.473693195648764, -82.4804906259137 35.473542195618954, -82.48050162592634 35.47347219560581, -82.48058962602103 35.47294919550851, -82.48066962605104 35.47283919549436, -82.48071862606946 35.47277219548578, -82.48083362610045 35.47269419548168, -82.48098462614122 35.47259119547627, -82.48098662614203 35.472588195475836, -82.48127162622903 35.47232819545219, -82.48134962626568 35.47217319542866, -82.48143362630502 35.47200719540359, -82.48148662632435 35.47193819539496, -82.48164762638253 35.471732195369604, -82.4817016264019 35.4716641953613, -82.4817946264355 35.47154519534668, -82.48186062645652 35.47147919534, -82.48195962648758 35.471383195330624, -82.48208762652473 35.47127919532261, -82.48227862657626 35.471149195315746, -82.48245962661801 35.4710721953187, -82.48268462666987 35.4709771953224, -82.48283062665075 35.47125919539471, -82.48295462663701 35.47148319545298, -82.48317862661999 35.47183619554772, -82.48362662659089 35.472510195730685, -82.48420762655344 35.47338219596743, -82.48444262653825 35.47373519606334, -82.48556262646487 35.4754241965215, -82.48589162644421 35.47591419665485, -82.48631062641537 35.47655519682814, -82.48656862639874 35.476942196933244, -82.48661562639546 35.47701419695269, -82.48713962636117 35.47780419716704, -82.48733762634866 35.47809919724728, -82.48761662633149 35.478513197360066, -82.48783662631712 35.478844197449845, -82.48849662627381 35.47984019772004, -82.4887166262593 35.4801721978101, -82.48873362625817 35.48019819781712, -82.4889126262466 35.48046719789021, -82.4890576262372 35.480685197949384, -82.48926562622674 35.48097819803026, -82.48944162621984 35.4812131980961, -82.48953262621664 35.48133219812961, -82.48974962620939 35.48161419820919, -82.48985762620562 35.48175519824893, -82.49000362620056 35.48194619830276, -82.49019362619752 35.48217119836793, -82.49020962619723 35.48219019837348, -82.4903126261968 35.48230419840719, -82.49045362619653 35.48245819845302, -82.4905376261973 35.48254419847907, -82.49080662619947 35.48282019856274, -82.49121662620634 35.48321819868572, -82.49123862620681 35.48323919869221, -82.49147962621213 35.483464198762746, -82.4916286262165 35.483597198804965, -82.49189362622388 35.48383519888059, -82.49208162623057 35.483994198932166, -82.49223562623617 35.48412419897436, -82.49239662624278 35.48425519901748, -82.49253862624833 35.48437219905591, -82.49285262626313 35.48461519913745, -82.49288862626507 35.48464119914644, -82.49305762627431 35.48476319918854, -82.49307562627531 35.484776199193085, -82.49308162627574 35.484780199194475, -82.49315362627983 35.484831199212245, -82.49317862628139 35.4848481992183, -82.49321062628327 35.48487019922605, -82.49330762628911 35.484937199249565, -82.49334062629099 35.484960199257635, -82.49335762629198 35.48497219926184, -82.49341162629528 35.485009199274934, -82.4934296262963 35.48502219927937, -82.49343962629683 35.48502919928189, -82.49347262629892 35.48505119928972, -82.49348362629952 35.48505919929249, -82.49368462631323 35.48518719933912, -82.49428762635405 35.485572199479186, -82.49437662635995 35.48562919949996, -82.49449062636809 35.4856991995258, -82.49451662636996 35.48571519953171, -82.49459462637556 35.48576319954949, -82.49462162637757 35.48577919955555, -82.4947426263818 35.485882199588836, -82.49476362638255 35.48590019959471, -82.49491562639301 35.485996199629845, -82.49519062641203 35.486169199693194, -82.49531262642012 35.48624819972175, -82.49566162644277 35.48647719980409, -82.49583962645384 35.486597199846734, -82.49604062646615 35.486734199895224, -82.49614362647247 35.486804199919995, -82.4963066264823 35.486916199959495, -82.49645162649094 35.487016199994706, -82.49679362651061 35.4872572000788, -82.49695662652002 35.48737220011888, -82.49714662653042 35.48750920016621, -82.49726362653685 35.48759420019545, -82.49770462655681 35.48794020031105, -82.49789062656536 35.48808520035962, -82.4982956265846 35.488397200464604, -82.49830962658523 35.48840820046822, -82.49894962661381 35.48891320063648, -82.49956362664327 35.48938420079528, -82.4999846266635 35.4897072009041, -82.50023462667463 35.4899042009698, -82.50055762668899 35.49015920105474, -82.50099162671017 35.49049020116662, -82.50115162671796 35.49061220120776, -82.50124562672248 35.49068420123208, -82.5014966267348 35.490875201296625, -82.50173062674621 35.4910532013569, -82.50224962677058 35.49145520149178, -82.50250062678242 35.49164920155704, -82.50262562678837 35.491745201589346, -82.50294262680362 35.49198820167123, -82.50300262680649 35.49203420168673, -82.50312962681281 35.49213020171928, -82.50316162681433 35.49215520172763, -82.50326062681918 35.49223020175301, -82.50329362682065 35.49225620176169, -82.50339562682541 35.49233520178823, -82.50341762682646 35.49235220179396, -82.50379162684442 35.4926392018907, -82.5039166268504 35.49273520192304, -82.50414862686141 35.492914201983226, -82.50423362686547 35.49297920200515, -82.50460462688497 35.493253202098934, -82.50480562689833 35.49338320214594, -82.50487062690372 35.49341820215974, -82.5051296269253 35.49355720221455, -82.50556262696941 35.49373720229557, -82.5058266269992 35.49382820234117, -82.50794762723827 35.49456020270748, -82.50865562731786 35.494805202829895, -82.50912962737112 35.49497020291205, -82.50958662742158 35.49513520299241, -82.50963462742682 35.495153203001074, -82.50988862745413 35.49524920304666, -82.51049562751804 35.49548820315747, -82.51122962759563 35.495775203291075, -82.51135562760977 35.49581920331301, -82.51178162765453 35.49598720339079, -82.51195862767256 35.496061203424006, -82.51253262773005 35.49630620353265, -82.51266362774321 35.496362203557496, -82.51279662775612 35.49642120358312, -82.51348462782349 35.496725203715485, -82.51356762783158 35.49676220373156, -82.51381962785635 35.49687320377998, -82.51390362786455 35.49691020379611, -82.51410162788405 35.496997203834134, -82.51469562794206 35.4972602039485, -82.5148946279616 35.497348203986775, -82.51505862797764 35.4974202040183, -82.51555362802613 35.49763920411357, -82.51571862804234 35.49771220414533, -82.51611962808217 35.49788520422163, -82.51634262810438 35.497981204264036, -82.51717862818946 35.49833020442068, -82.51732362820172 35.49840620445101, -82.5177116282349 35.49860920453209)))",6216,37,021,002206,370210022061,2681,2681,49,2652,2519,48,8,72,0,5,29,2244,31,2213,2226,2127,37,5,52,0,5,18,1369,1268,101
census_2010_blockgroups_view.fid--2dc29038_13ec899ba8f_-2624,"MULTIPOLYGON (((-82.71614965090727 35.565715238535205, -82.716184650924 35.565644238524314, -82.71619665093688 35.5655732385111, -82.71618965095071 35.56547523849042, -82.71615165095902 35.56538023846708, -82.71609365096687 35.56526623843801, -82.71609265096707 35.56526323843719, -82.71597865097773 35.565070238386184, -82.71545165102111 35.564215238157814, -82.71534865103145 35.564036238110795, -82.71530665103583 35.56396223809142, -82.71513065105142 35.563669238013624, -82.71510765105465 35.56362323800187, -82.71500865106738 35.563433237952935, -82.71498365107314 35.56336823793714, -82.71493865108391 35.56324923790826, -82.71489065110583 35.56305423786367, -82.7148456511742 35.562559237758094, -82.71484365117796 35.56253323775255, -82.71483865118762 35.562464237738006, -82.71482365121803 35.56225023769283, -82.7148016512622 35.56193823762696, -82.71475565134153 35.56137123750657, -82.71474565136106 35.561233237477495, -82.71472665140986 35.5608942374064, -82.71470265151657 35.56017223725666, -82.71468965166892 35.55916523704997, -82.71467265173293 35.55872923695939, -82.71466565176337 35.5585232369166, -82.71464365180582 35.558222236852984, -82.71463065186086 35.5578492367756, -82.7142876518016 35.55786323674328, -82.71412165177279 35.55787123672798, -82.71377065171097 35.557893236696465, -82.7132626516223 35.55791923664973, -82.71292065156264 35.55793723661838, -82.71278465154933 35.557876236592065, -82.71274465154943 35.55783223657899, -82.71262965153102 35.55782723656618, -82.71219965148474 35.557662236488504, -82.71209265147195 35.55762923647081, -82.71200465146146 35.557602236456255, -82.71152665138688 35.55756923640058, -82.71100265131243 35.55748623633005, -82.71044465124379 35.55732723624046, -82.70946765111687 35.55709423609291, -82.70924665108808 35.557042236059594, -82.70899165105997 35.55694823601429, -82.70876265105883 35.556707235941715, -82.70870365105256 35.55668423593103, -82.70925065115327 35.55662123597415, -82.70941465117433 35.556662235999354, -82.71023065129006 35.556793236109606, -82.71083465138575 35.55682523617805, -82.7112916514593 35.55684223622833, -82.71204265158937 35.55680923629849, -82.71277665171915 35.55676023636369, -82.7135436518694 35.556613236412275, -82.71413065198709 35.556483236445864, -82.71478365212835 35.55627123646948, -82.71574665235634 35.55583023647816, -82.7164806525286 35.55550423648686, -82.71723165271891 35.555079236477084, -82.71770465284015 35.554802236469015, -82.71812865294075 35.55460623647248, -82.71860265305475 35.554378236474555, -82.71904265315807 35.5541822364796, -82.71976065331522 35.55393723650317, -82.7202176534163 35.55377423651674, -82.72075765353924 35.55355923652816, -82.72110965361078 35.55347523654713, -82.7214776536839 35.55339723656882, -82.72173665373417 35.553351236585996, -82.7220126537871 35.55330623660506, -82.7223266538459 35.55326323662845, -82.72238165385617 35.55325623663267, -82.72243565386601 35.55325023663703, -82.72275465392472 35.55321423666231, -82.72370565409489 35.55313723674397, -82.72444765422772 35.553077236807674, -82.72520265436418 35.553007236870705, -82.72560365443854 35.55295823690179, -82.72625165456057 35.552866236949356, -82.72676065465869 35.55277923698378, -82.72697565470061 35.552739236997574, -82.72711965472857 35.552713237007026, -82.72750665480552 35.55263223703011, -82.72782065486916 35.552558237047194, -82.72825965495818 35.55245423707089, -82.72875265506023 35.55232423709485, -82.72924365516356 35.552184237116606, -82.72973465526887 35.552030237135476, -82.73152265565982 35.55142323719473, -82.73285265595132 35.55096723723787, -82.73323965603466 35.55084423725238, -82.73320165601314 35.55094323726865, -82.73306665594343 35.55125123731771, -82.73299965591357 35.55137323733569, -82.73298665590882 35.55139023733785, -82.73292765588641 35.551472237348506, -82.7328526558616 35.55155223735714, -82.73277365584036 35.551605237359894, -82.7326646558124 35.55166923736181, -82.73255865578722 35.55171823736096, -82.7322876557226 35.55184523735914, -82.73186165562258 35.55203423735398, -82.73171465558983 35.55208823735003, -82.73162465557094 35.552114237346075, -82.73158865556312 35.55212523734462, -82.73144565553463 35.5521562373363, -82.73129265550655 35.55217323732409, -82.73092565544208 35.55219523729108, -82.7307756554137 35.552217237280196, -82.73076265541104 35.55222023727944, -82.73064865538731 35.552251237274085, -82.73050365535428 35.552309237271125, -82.73041565533266 35.55235423727124, -82.73039165532681 35.552366237271215, -82.73004365523872 35.5525632372758, -82.72939065507566 35.55291723728117, -82.72893465496165 35.55316523728508, -82.72912565495407 35.55342223735702, -82.72972265492386 35.55426823759071, -82.72996565491208 35.554609237685085, -82.73007465490687 35.55476123772729, -82.73018365490313 35.55490423776761, -82.73037265488819 35.55520723784874, -82.73043865487942 35.55533623788177, -82.73049465486817 35.55547023791483, -82.73053465484416 35.55567023795974, -82.73054465481975 35.55584023799545, -82.73054265477158 35.55615223805884, -82.73056165469549 35.55666923816625, -82.73059565466552 35.556901238217094, -82.73064065464425 35.55708923826003, -82.73065665464111 35.557127238269445, -82.73072365460779 35.557417238335404, -82.7307756545892 35.55759523837707, -82.7311746544644 35.55884223867223, -82.73120165445448 35.55893623869413, -82.73141165437907 35.55965623886251, -82.73154665433121 35.56011523896993, -82.73167465429529 35.5604882390592, -82.73182665424659 35.560971239173234, -82.73188565420982 35.56127523924127, -82.73189165419745 35.561362239259594, -82.73189465418966 35.56141623927097, -82.73189865418385 35.561458239279936, -82.73189865416504 35.56158123930501, -82.73189865415655 35.56163623931621, -82.73182265413993 35.561662239313755, -82.73176865412795 35.5616812393121, -82.73161165410279 35.561675239294786, -82.73158965409736 35.56168623929481, -82.73158765409683 35.56168823929502, -82.73152065407982 35.56172623929592, -82.73143665402303 35.56200523934418, -82.73133965398152 35.5621702393679, -82.73031165353908 35.56393823962323, -82.73030565353751 35.56394223962348, -82.73024465351044 35.56405223963968, -82.73007065340383 35.56455823972503, -82.73001665337723 35.564673239743, -82.72986365332412 35.564853239764, -82.72978865329779 35.5649432397747, -82.72971465323498 35.565272239834236, -82.72959365318113 35.5654922398667, -82.7292446530588 35.56591023991617, -82.72884065290135 35.56649823999471, -82.7284246527274 35.567180240091254, -82.72821665265333 35.567437240122395, -82.72757065242246 35.568240240219986, -82.72706865221915 35.56902024032763, -82.72556565160936 35.571362240651354, -82.72506465140604 35.57214324075932, -82.72502465136058 35.57239624080688, -82.72496065132715 35.57254424083048, -82.72472865120507 35.573088240917606, -82.72447365108995 35.57356124098802, -82.72439665106256 35.573656240999526, -82.72433865104146 35.57373124100886, -82.72414365098622 35.57387924101911, -82.72407765096888 35.57392024102067, -82.72345165080586 35.57430324103462, -82.72332665077921 35.57434124102963, -82.72316865074517 35.57439124102356, -82.72235465055559 35.574743241012015, -82.72179665043222 35.574941240995244, -82.72121165029759 35.57518324098465, -82.72101065024718 35.57529324098651, -82.72096965022943 35.575364240996784, -82.72096865022885 35.57536724099727, -82.72090965018404 35.57559524103769, -82.72076165011977 35.57585324107519, -82.72064765008392 35.575963241085915, -82.72049265004622 35.57604024108578, -82.7202666500285 35.57591024103615, -82.7201096500161 35.575821241001805, -82.71956564996424 35.5755682408945, -82.71937564994609 35.57548024085718, -82.7193336499433 35.57545324084729, -82.71873964990328 35.57506924070817, -82.71866964989853 35.5750242406918, -82.71793664983959 35.57461224053266, -82.71767364981004 35.57451924048678, -82.71736464976614 35.574470240445095, -82.71701464972551 35.57435524038577, -82.71680364970628 35.57425124034294, -82.71672264969895 35.57421124032654, -82.71657764968565 35.574140240297154, -82.71618064965347 35.573919240211474, -82.71608364964563 35.57386524019053, -82.71579264962195 35.5737032401277, -82.71569564961396 35.573650240106865, -82.71558864960522 35.57359124008394, -82.71520464958347 35.5733162399885, -82.71496064957319 35.573118239923126, -82.71452564955462 35.57276723980691, -82.71417564953255 35.57253123972295, -82.71403364953497 35.572361239673775, -82.71365764952716 35.57200423956248, -82.71339464951028 35.57182823949961, -82.71277664945036 35.57154823937917, -82.7127686494493 35.571546239378, -82.71260164942798 35.571504239352315, -82.71235264938822 35.57149323932453, -82.71225864936751 35.57152623932162, -82.71213764933887 35.5715812393205, -82.71193564928177 35.571734239330965, -82.71186864926291 35.57178423933428, -82.71178064924393 35.57181223933095, -82.71161964921714 35.571812239314504, -82.71150964920214 35.57179023929871, -82.7111956491591 35.571730239254336, -82.71020464903397 35.57147023909983, -82.70999864900789 35.571416239067695, -82.7097766489828 35.571339239029214, -82.70976764898519 35.57131323902304, -82.70974164899289 35.571235239004395, -82.70973364899538 35.571210238998496, -82.70976564900072 35.57121023900177, -82.70983464901387 35.5711992390066, -82.70988264902226 35.57119723901111, -82.70992564902862 35.57120223901653, -82.70997364903477 35.57121423902393, -82.71006364904513 35.571244239039224, -82.71012964905387 35.5712592390491, -82.71016464905779 35.57127123905511, -82.71020564906387 35.57127623906036, -82.71024564907239 35.571264239061996, -82.71028164908236 35.5712382390604, -82.7103016490902 35.5712092390565, -82.71031664909914 35.57116723904947, -82.71031264910891 35.571099239035156, -82.71029664911761 35.571025239018475, -82.71024764914655 35.57078323896409, -82.71022364916384 35.57064423893328, -82.71020864918307 35.57050223890281, -82.71020464919535 35.57041823888527, -82.71026564922002 35.57032423887238, -82.71036064925178 35.57022023886084, -82.7104686492839 35.57012823885318, -82.71052464930666 35.570040238840996, -82.71056864933152 35.56992623882222, -82.7106126493493 35.569858238812905, -82.7106486493613 35.56981923880861, -82.71073364938172 35.569778238808944, -82.71082664940074 35.56975523881379, -82.71122564947653 35.56969423884224, -82.71158064954736 35.56961823886316, -82.71162364955788 35.569596238863035, -82.71168864957345 35.569565238863376, -82.71176664959567 35.56950523885911, -82.71182364961588 35.56943523885065, -82.7118946496448 35.56932423883533, -82.71195064967293 35.56920123881596, -82.71201164970661 35.56904823879103, -82.71202964972481 35.56894923877265, -82.71214664972356 35.569084238812174, -82.7122976497298 35.56920723885278, -82.7123966497367 35.569270238875724, -82.7124116497382 35.56927623887848, -82.71264564976158 35.569378238923264, -82.71292064979583 35.56945323896671, -82.71310664982269 35.569480238991275, -82.71325064984596 35.56948523900703, -82.71336764986695 35.56947523901699, -82.71353264990026 35.5694372390262, -82.71387664997646 35.5693142390363, -82.71395064999264 35.56928923903885, -82.71425265006287 35.5691592390432, -82.714347650084 35.56912423904586, -82.71437065008911 35.5691162390465, -82.71443765010713 35.56907123904424, -82.71449765012547 35.56901723903936, -82.71457965015423 35.568918239027546, -82.71461465017573 35.56881623901035, -82.71462665019075 35.56873123899428, -82.71464365020992 35.56862523897435, -82.71466165024742 35.568400238930316, -82.71471865034306 35.567839238821776, -82.71474365039383 35.56753523876235, -82.71477965044897 35.56721523870079, -82.71478965046316 35.567133238685074, -82.71482365049218 35.56698123865756, -82.71486565051926 35.56685023863515, -82.7149226505469 35.566732238616915, -82.71495965056319 35.566666238607326, -82.71505065059807 35.56653723859028, -82.715053650599 35.56653423858998, -82.71511565061827 35.566476238584556, -82.71519065064138 35.56640723857812, -82.71530065067287 35.56632123857185, -82.71551565073078 35.56617723856453, -82.71590465083496 35.56592023855193, -82.71598665085685 35.565867238549515, -82.71607265088089 35.565803238545335, -82.71612665089776 35.56575223854043, -82.71614965090727 35.565715238535205)))",6573,37,021,002504,370210025043,622,622,22,615,601,6,5,1,0,2,7,472,9,463,470,458,4,5,1,0,2,2,264,244,20
census_2010_blockgroups_view.fid--2dc29038_13ec899ba8f_-2623,"MULTIPOLYGON (((-82.60410762834923 35.59120723224182, -82.60419562835399 35.59127123226391, -82.60455862837063 35.59155523235899, -82.6049026283866 35.59182323244889, -82.60536462842177 35.59209323255132, -82.60584062847443 35.5922652326352, -82.60607062850546 35.59231223266834, -82.60632762854 35.59236523270554, -82.60663262858388 35.59240923274579, -82.60717062866145 35.59248623281674, -82.6087846288939 35.5927192330298, -82.60881362889795 35.59272423303382, -82.60932462897276 35.592790233099734, -82.60967662902429 35.59283523314509, -82.61015462909427 35.592897233206656, -82.61073762919065 35.59290023326719, -82.61077062919605 35.59290123327084, -82.6110876292577 35.59284323329149, -82.61123062928556 35.592816233300674, -82.61168962938233 35.592683233320685, -82.61168562938305 35.592674233318434, -82.61169262939146 35.59262723330964, -82.6117156294213 35.592458233277576, -82.61173762943098 35.592419233271904, -82.61177962944481 35.59237423326698, -82.61195362948932 35.592273233264315, -82.61278362969259 35.59184823326288, -82.61290962972325 35.591785233263, -82.61306962975861 35.5917282332678, -82.61324762979363 35.59169323327892, -82.61349662983095 35.59171923330987, -82.61362962984438 35.591776233335075, -82.61371462985292 35.591812233351085, -82.61392862987348 35.59191023339303, -82.61415062990048 35.59197423342888, -82.61474962998192 35.59209223351442, -82.61505363002857 35.5921172335507, -82.61569763013154 35.5921442336223, -82.6159356301663 35.592175233653, -82.616170630194 35.592249233692215, -82.6162236301988 35.592275233702985, -82.61643363021777 35.59237923374571, -82.61701063026607 35.59268823386784, -82.61715263027739 35.592768233898695, -82.6172966302888 35.59284923392998, -82.61740763029677 35.592918233955494, -82.61750763030244 35.592989233980155, -82.61756563030502 35.59303523399549, -82.61763363030798 35.59308923401347, -82.61769063030944 35.59314123402996, -82.6177956303121 35.59323723406022, -82.6178336303128 35.59327423407171, -82.61788663031255 35.59333323408915, -82.61814663031107 35.59362323417489, -82.618255630312 35.59373523420888, -82.61837163031473 35.59384323424279, -82.61846663031909 35.59391723426762, -82.61861963032624 35.594036234307566, -82.61868463032948 35.594085234324226, -82.61899363034425 35.5943232344044, -82.61931963036163 35.594562234486524, -82.61933163036247 35.59457023448941, -82.61958563037777 35.59474523455112, -82.6200606304033 35.59509223467061, -82.62033363041971 35.59528123473715, -82.62041663042524 35.595334234756436, -82.62046163042868 35.59536123476655, -82.62050263043095 35.59539023477665, -82.62107263046573 35.595780234914606, -82.62132463048023 35.595958234976735, -82.6213916304842 35.596005234993186, -82.6216786304987 35.596221235066665, -82.6219586305083 35.596461235144254, -82.62201963050968 35.59651823516214, -82.62212063051204 35.59661223519167, -82.62220063051271 35.59669423521653, -82.62221663051292 35.59671023522145, -82.62225763051251 35.59675723523521, -82.62241663051154 35.596935235287795, -82.62247963051111 35.597006235308804, -82.62286963050127 35.59749123544753, -82.62288763050095 35.59751323545391, -82.62302363049861 35.597675235500894, -82.62307463049737 35.59773823551894, -82.62322963049374 35.59792923557376, -82.62324463049347 35.597947235579, -82.6232786304916 35.59799623559244, -82.6233436304877 35.59809223561869, -82.6234166304775 35.59823723565568, -82.6234276304741 35.5982712356638, -82.623466630463 35.59838523569101, -82.62350363044855 35.5985192357221, -82.62357863040538 35.59888123580357, -82.62364263036854 35.599189235872856, -82.62366263035776 35.59928123589363, -82.62370163034251 35.59942223592635, -82.62372863033627 35.599492235943366, -82.62343363028 35.599539235922705, -82.62342263027769 35.599542235922144, -82.62312063021311 35.599635235910135, -82.62275963014098 35.59971423588915, -82.62251563009823 35.599728235866976, -82.62251363009773 35.59972923586698, -82.62221763006097 35.59964823582013, -82.62228263005424 35.59976223584997, -82.62230263005222 35.599797235859164, -82.62246963003163 35.60011123594033, -82.62253163002397 35.60022823597046, -82.62258163001778 35.60032223599481, -82.62277462999621 35.600671236085645, -82.62278662999499 35.600692236091156, -82.62303362997544 35.60108623619685, -82.62315762996678 35.601276236248225, -82.62335362995692 35.601552236324544, -82.62356662994863 35.601836236404345, -82.62363462994652 35.60192323642899, -82.62394562993659 35.60232423654262, -82.62413162993072 35.60256323661042, -82.62413262993059 35.60256523661095, -82.62424262992714 35.602706236650896, -82.62453062991533 35.60309423675953, -82.62467662990727 35.60330423681732, -82.6246876299067 35.60332023682168, -82.62484262989511 35.60356223688691, -82.62494762988743 35.60372623693109, -82.62495162988712 35.60373223693273, -82.62523162985597 35.60423723706436, -82.62524562985449 35.60426223707091, -82.62531762984334 35.60441223710885, -82.62536362983607 35.60450923713334, -82.62547962981738 35.60475623719552, -82.62550162981373 35.60480323720738, -82.62554262980736 35.6048892372291, -82.62554762980633 35.60490123723204, -82.62571462977083 35.605312237332946, -82.62579062974821 35.60554123738739, -82.62588062972902 35.605763237441856, -82.6260296296966 35.606135237532925, -82.62607062968787 35.60623623755778, -82.62616262966604 35.60647723761634, -82.6261396296493 35.606561237631034, -82.62616262964374 35.60662223764587, -82.62630262960806 35.60700523773817, -82.62636162959329 35.607165237776876, -82.62669962951473 35.608040237989826, -82.62688462949279 35.608383238078744, -82.6267796294693 35.608422238075875, -82.6267076294521 35.60845623807541, -82.62663962943428 35.60849823807696, -82.62658762941885 35.60854223808066, -82.62657762941566 35.60855223808162, -82.62654562940294 35.60860023808813, -82.62652762938998 35.608665238099505, -82.626536629381 35.60873323811429, -82.62655462937317 35.60880323813043, -82.62658262936583 35.608881238149166, -82.62659362935874 35.60893923816212, -82.6266576293348 35.60916423821454, -82.62668062931672 35.6093062382458, -82.62668662929167 35.609475238280865, -82.62668262928334 35.60952523829068, -82.62665962922715 35.60986523835757, -82.62660962912837 35.610453238472246, -82.62657362905557 35.61088723855689, -82.626488628939 35.611552238683714, -82.6264706289012 35.61177823872791, -82.62645862886426 35.61200523877289, -82.62645662883114 35.61221823881612, -82.62645562879433 35.612456238864475, -82.62648162875175 35.61276123892934, -82.62649462874697 35.61280623893981, -82.62640462873043 35.61281623893261, -82.62604162866165 35.6128712389066, -82.62595462864421 35.612890238901436, -82.62587962862914 35.61290723889726, -82.62556462856809 35.61296323887633, -82.62544362854564 35.61297823886691, -82.62534962852948 35.6129822388581, -82.62523762851109 35.61298023884618, -82.62511662849246 35.61297023883172, -82.62498762847501 35.612944238813206, -82.62488462846318 35.612910238795656, -82.6247506284501 35.61285023876969, -82.62463462844146 35.6127812387438, -82.6245376284364 35.61270923871912, -82.62442362843208 35.61261423868805, -82.62439362843071 35.61259023868011, -82.62423262842705 35.61244023863301, -82.6240196284212 35.61224823857197, -82.62363062841064 35.61189723846056, -82.62345462840793 35.61172423840725, -82.62330062840556 35.61157323836065, -82.62320362840238 35.611489238333654, -82.62312462839786 35.61143323831407, -82.62304762838998 35.611401238299635, -82.62296362837922 35.611380238286735, -82.62287662836631 35.61137023827576, -82.62275362834534 35.611373238263766, -82.62210762822997 35.611425238208014, -82.62195062820035 35.611448238196616, -82.62174062815718 35.61150123818581, -82.62129462806222 35.611636238167534, -82.62116662803483 35.61167623816257, -82.62094562799133 35.611720238148806, -82.6208266279704 35.61172723813801, -82.62072162795374 35.611722238126184, -82.62063462794124 35.611709238114685, -82.62053862792854 35.61168823810051, -82.62038062790896 35.61164423807531, -82.620355627906 35.611637238071374, -82.62020462788968 35.6115802380442, -82.62003962787408 35.611503238011586, -82.61993362786502 35.6114472379893, -82.61978962785273 35.611371237959034, -82.61975162784958 35.61135123795107, -82.61956362783535 35.6112402379091, -82.61939362782527 35.61112223786762, -82.61929662782167 35.611041237841164, -82.6191156278148 35.610890237791885, -82.61904062781197 35.61082723777126, -82.61880562780665 35.61060823770252, -82.61851162780118 35.6103262376149, -82.61839662780146 35.610200237577494, -82.61830062780523 35.610072237541544, -82.61826262780838 35.61001023752495, -82.61800762782991 35.60959523741424, -82.61790562783054 35.609481237380585, -82.6177986278286 35.609378237348594, -82.61770662782455 35.60930523732427, -82.6175786278177 35.609211237291966, -82.61742462781025 35.60909323725217, -82.61727662780304 35.6089802372139, -82.616945627789 35.60871423712572, -82.61680162778056 35.60861323709037, -82.61676362777712 35.60859423708264, -82.61668062776965 35.608553237065784, -82.6165726277556 35.608528237049526, -82.61638962772638 35.608520237029104, -82.61615862768394 35.60854623701074, -82.61615162768268 35.60854623701004, -82.61604462766361 35.60855523700083, -82.615775627617 35.608567236975674, -82.6156536275955 35.60857523696474, -82.6155506275801 35.60856423695197, -82.61545062756623 35.60854623693803, -82.61526262754234 35.60849823690892, -82.61513862752841 35.608455236887465, -82.61500362751411 35.6084022368628, -82.61436462745293 35.60810923673754, -82.61427362744428 35.60806723671959, -82.61379762739917 35.60784623662569, -82.61346162736731 35.60769023655946, -82.61323662734833 35.60757023651189, -82.61312762734016 35.60750623648767, -82.61302962733409 35.607439236463904, -82.61283862732212 35.607311236418276, -82.61273062731777 35.607222236389006, -82.61269262731719 35.6071852363776, -82.61263162731626 35.607125236359124, -82.61259062731659 35.607079236345534, -82.61256162731698 35.60704523633559, -82.61250862731951 35.606971236315125, -82.61249562732073 35.60694923630929, -82.61247162732329 35.60690723629839, -82.6124286273306 35.60681323627474, -82.61235062734946 35.606606236224536, -82.61227262736028 35.60645223618515, -82.61221862736373 35.60637123616312, -82.61216162736419 35.60630623614404, -82.6120976273636 35.60624123612425, -82.6119976273593 35.60616123609765, -82.61176262734362 35.606009236042595, -82.61106162729283 35.60558223588364, -82.61006762721885 35.60498923566081, -82.60870062711874 35.60416323535217, -82.60834162709247 35.6039462352711, -82.60782862705476 35.60363723515553, -82.60732262701487 35.60335023504505, -82.60710062699671 35.60322823499747, -82.60669062696323 35.60300323490956, -82.60652562695121 35.6029032348722, -82.60644262694548 35.60285023485292, -82.6062756269341 35.602744234814196, -82.60623562693299 35.60270823480272, -82.60614262693029 35.60262523477625, -82.60603862692905 35.60252123474437, -82.60595562692782 35.60243923471916, -82.60586962692695 35.60235223469264, -82.60572762692985 35.60218023464302, -82.60559262693401 35.60200723459393, -82.60551862693863 35.60189723456393, -82.60546062694218 35.60181123454046, -82.60537462694997 35.60166823450247, -82.60534762695248 35.601622234490335, -82.60526862696052 35.60148523445437, -82.60524262696308 35.601440234442485, -82.604929626994 35.60090123430057, -82.60488662699845 35.60082623428093, -82.6047826270058 35.600666234237615, -82.60467962700808 35.600540234201375, -82.60457062700719 35.6004282341674, -82.60444862700363 35.60031923413266, -82.60415062699326 35.60006523405035, -82.60360862697465 35.59960023389998, -82.60336562696638 35.59939223383266, -82.60313362695746 35.59919923376958, -82.60306762695546 35.59914123375096, -82.60303862695498 35.599113233742266, -82.60289462695272 35.59897223369879, -82.60279562695314 35.59886223366618, -82.6027746269535 35.59883723365896, -82.6026626269568 35.59869523361852, -82.60251062696139 35.59850123356342, -82.60197562698345 35.59778023336169, -82.60190262698774 35.59767323333239, -82.60178262700106 35.59745723327601, -82.60170162701577 35.597274233230486, -82.60159562704276 35.59698423316053, -82.60157962704407 35.59695823315359, -82.60153362704831 35.59688123313317, -82.60151862704966 35.59685623312654, -82.60158462707405 35.59676923311558, -82.60160262708506 35.59671723310683, -82.6016056270942 35.59666123309575, -82.60159862710287 35.596597233082015, -82.60159362711049 35.59654223307031, -82.60150062713929 35.596254233002085, -82.60135762717617 35.59586023290717, -82.60132962718242 35.595789232889885, -82.6012396272038 35.59555323283256, -82.60122562720586 35.59552523282539, -82.60120462720894 35.59548223281451, -82.60117562721308 35.595424232799694, -82.60113462721625 35.5953592327822, -82.60111062721836 35.595319232771665, -82.60110262721892 35.59530723276839, -82.60103662722148 35.59521923274373, -82.60096062722275 35.59512923271753, -82.60088662722248 35.595051232694075, -82.60080462722216 35.594964232667934, -82.60068562721929 35.59485423263328, -82.60047262721443 35.59465623257113, -82.60042962721383 35.594613232557904, -82.60033462721269 35.59451823252881, -82.60024062721594 35.59439523249414, -82.60017662722169 35.594289232465954, -82.60017462722178 35.594286232465144, -82.60012162722856 35.594185232439145, -82.60007662723687 35.59408223241356, -82.60004562724924 35.593968232387155, -82.60037862730294 35.59397923242359, -82.60137862746402 35.594012232533, -82.60171262751776 35.59402423256971, -82.60199862756465 35.59402823259984, -82.60208862757932 35.59403023260948, -82.60238762762641 35.59404723264364, -82.60285762770637 35.59403523268952, -82.60304362773785 35.59403123270773, -82.60311662775294 35.59401223271133, -82.60313562775882 35.5939942327097, -82.60321862776524 35.59404223272799, -82.6032826277737 35.594056232737415, -82.60341462779523 35.59405923275162, -82.60343762779885 35.59406023275407, -82.60358962782155 35.59407723277316, -82.60384562784802 35.594181232820645, -82.60397462786567 35.59420623283899, -82.60400762788436 35.59412023282482, -82.60400862790262 35.59400323280112, -82.60400162791508 35.59391423278227, -82.60398162795688 35.59362123272054, -82.60397662796697 35.593550232705574, -82.60397562796751 35.59354523270446, -82.60395662798729 35.593396232672156, -82.60395862799966 35.59331823265644, -82.60396062801146 35.59324323264148, -82.60396062801321 35.593232232639124, -82.60395362801816 35.593192232630294, -82.60393362802039 35.59315623262088, -82.60391062801885 35.59314123261549, -82.60388862801756 35.59312623261022, -82.60381062800832 35.593102232597275, -82.6037186279962 35.59308123258359, -82.60357062797843 35.59303723255942, -82.60345962796653 35.59299423253927, -82.60351562799099 35.592896232525035, -82.60354562803043 35.592672232482506, -82.60354362804036 35.59260523246867, -82.60353562812165 35.59206823235851, -82.60356062815633 35.591870232320694, -82.60361062818673 35.591726232296544, -82.60368962822112 35.591588232276514, -82.60378862825813 35.59145423225936, -82.60380262826331 35.591436232257195, -82.60394662830629 35.59131223224667, -82.60410762834923 35.59120723224182)))",6031,37,021,001400,370210014005,2611,2611,280,2518,2066,297,22,17,7,109,93,2055,181,1874,2018,1691,224,16,13,3,71,37,1241,1134,107
census_2010_blockgroups_view.fid--2dc29038_13ec899ba8f_-2622,"MULTIPOLYGON (((-82.57391762217138 35.59875623067926, -82.57393962217503 35.59875623068146, -82.57400862218607 35.598759230689176, -82.57403162218966 35.59876023069171, -82.57406462219498 35.59876123069528, -82.57418562219907 35.5988652307289, -82.57425962221144 35.59886523073652, -82.57431862222266 35.598855230740526, -82.574857622326 35.59876623077777, -82.57497962235205 35.59872823078263, -82.57511362239057 35.598623230774976, -82.57524162241994 35.59857023077731, -82.57554462248918 35.59844723078343, -82.57562262250589 35.598423230786544, -82.57585862255594 35.5983522307963, -82.57593762257265 35.59832923079973, -82.57597562248938 35.59891123092213, -82.57601462240605 35.59949423104485, -82.5760696222897 35.600309231216386, -82.57622062224868 35.60073823131929, -82.57632362223826 35.600917231366275, -82.57650762221989 35.60123523144993, -82.57681162222374 35.60153823154285, -82.57740662223082 35.60213423172535, -82.57836162224021 35.60310323202073, -82.57888162221418 35.60383323222273, -82.5792636221569 35.60461723242164, -82.57931562214888 35.60472523244893, -82.57936862214109 35.60483323247638, -82.57945462213954 35.60493623250627, -82.57972362212226 35.60533823261569, -82.5798326221151 35.60550223266027, -82.58022362204844 35.606357232874515, -82.58035262199662 35.60683223298452, -82.58026362189646 35.607387233088396, -82.5801946218694 35.60748823310184, -82.57997862178435 35.60780723314462, -82.57857962134555 35.60914723327374, -82.57854262131703 35.60929223329948, -82.57841162127755 35.60940723330944, -82.57832962125285 35.60947923331568, -82.57823262120736 35.60967023334462, -82.57812662115707 35.609882233376865, -82.57799862111855 35.609994233386566, -82.57800362110272 35.610102233409016, -82.57779862101209 35.61046923346269, -82.5777716210041 35.61049223346464, -82.57767162097382 35.61058123347245, -82.5776196209371 35.61076323350425, -82.57750362090624 35.610838233507536, -82.57729862085158 35.61097223351373, -82.57715662081368 35.611065233518104, -82.57704162078286 35.611141233521764, -82.57708062076776 35.61128123355425, -82.577197620722 35.61170423365242, -82.57723662070676 35.61184523368512, -82.57723662067318 35.61206323372952, -82.57723662066626 35.61210823373869, -82.57723562064571 35.61224023376545, -82.57723162059146 35.612588233835936, -82.57722962057125 35.61271723386197, -82.57722762053717 35.612936233906346, -82.57713462044022 35.61346523400451, -82.57701162031145 35.61416823413502, -82.57692462022004 35.61466823422793, -82.57687762015242 35.61505623430204, -82.57681362005948 35.6155902344042, -82.57673562005957 35.615505234378944, -82.57661962005989 35.615378234341115, -82.57644962002877 35.61539723432754, -82.57633662000782 35.61541123431877, -82.5762726199972 35.6154112343122, -82.57625561999436 35.61541123431043, -82.576092619977 35.615348234280916, -82.5760336199706 35.61532623427036, -82.57577961994346 35.61522823422424, -82.57568361993326 35.61519123420686, -82.57521261986854 35.615103234140584, -82.57505661985863 35.614999234103365, -82.57488061984942 35.6148692340588, -82.57478561983561 35.61485623404641, -82.57469061982188 35.61484323403398, -82.5745146197846 35.61489523402645, -82.57445361975711 35.61500823404326, -82.57347361964389 35.61468623387699, -82.57327661962535 35.61459423383804, -82.57321161961934 35.61456323382504, -82.5731066196093 35.614515233804454, -82.57303361960243 35.614481233790066, -82.57260761955892 35.61430423371021, -82.5725906195563 35.61430223370806, -82.57244461953415 35.61428923369044, -82.57240761953025 35.6142742336836, -82.5721506195036 35.61417023363597, -82.57211561950014 35.61415523362937, -82.57209261949785 35.61414523362494, -82.57175861946412 35.61400423356187, -82.57126961941569 35.61379123346831, -82.57115661940426 35.61374323344693, -82.57084361937247 35.61361223338808, -82.57042161933244 35.61341723330501, -82.56984161926819 35.61320923320308, -82.56971261925395 35.6131622331802, -82.56954561923524 35.61310323315107, -82.56752161900515 35.612415232802995, -82.56733261898466 35.61234423276915, -82.5671636189686 35.61226623273591, -82.56695661895246 35.61214823269061, -82.56682261894467 35.612054232657734, -82.5667416189398 35.611998232638, -82.56656861893451 35.61184623258925, -82.56639561893319 35.6116682325352, -82.56623761894244 35.61143823247221, -82.56619661894484 35.611378232455785, -82.56612361895318 35.611245232421204, -82.56595161897505 35.610918232336935, -82.56582761899266 35.61067023227378, -82.56570061901066 35.61041623220895, -82.56558761902383 35.6102092321552, -82.56546361903354 35.61001223210238, -82.5653216190386 35.6098262320499, -82.5651746190414 35.609650231999, -82.56500461903825 35.60948723194835, -82.56482961903255 35.609335231899365, -82.5646276190226 35.60918223184753, -82.56462261902216 35.6091792318464, -82.56426461900045 35.6089342317597, -82.56409661899082 35.60881623171837, -82.56421961902014 35.60875823171927, -82.56434461905582 35.608661231712354, -82.56440261907123 35.60862423171081, -82.56450161909287 35.60859023171402, -82.56463861912151 35.608552231720395, -82.56503561920267 35.608453231740974, -82.56518061923212 35.608418231748814, -82.56543261928279 35.608361231763034, -82.56557761931045 35.60833823177333, -82.56608261941122 35.608228231802784, -82.56601961946201 35.607830231715226, -82.56609861947943 35.6078022317177, -82.56616161949518 35.60776823171724, -82.56622561951312 35.6077212317142, -82.56629961953355 35.60766823171104, -82.56669661963873 35.607413231699915, -82.56682161967039 35.6073422316983, -82.56691961969504 35.60728823169741, -82.56703261972132 35.60723923169905, -82.56705861973803 35.607159231685415, -82.56708761975125 35.607104231677155, -82.56711861976224 35.60706623167269, -82.56714561977175 35.60703423166886, -82.56726061980355 35.60695123166379, -82.56759061989355 35.60672323165127, -82.56767061991513 35.60666923164857, -82.56775761993687 35.60662223164791, -82.56762461994012 35.606457231600665, -82.56722961995077 35.60596223145932, -82.56709761995427 35.60579723141215, -82.56724461998277 35.60577023142177, -82.56725861998555 35.605768231422765, -82.56774762007292 35.60572823146486, -82.56791162010191 35.60571623147928, -82.56790762011158 35.605649231465236, -82.567893620119 35.60558623145104, -82.56786362014739 35.605369231403685, -82.56784862015091 35.60533023139423, -82.56783362015452 35.605291231384776, -82.5677876201593 35.605210231363536, -82.56770362015979 35.605116231335785, -82.56767962016154 35.60507923132571, -82.56753462016646 35.60489123127262, -82.56725262016951 35.604567231177626, -82.56720562017313 35.60449323115772, -82.5671326201748 35.604403231131954, -82.56705362017651 35.60430723110426, -82.56700662018056 35.6042302310838, -82.56696462018633 35.604147231062534, -82.56695962019073 35.60411323105511, -82.56696562019927 35.60406423104576, -82.56693162019522 35.6040542310402, -82.5668676201938 35.603994231021474, -82.5667336202003 35.603807230969636, -82.56643662021496 35.60339223085461, -82.56623162022862 35.603082230770475, -82.5661276202334 35.60293923073068, -82.56592062024292 35.602654230651375, -82.56602362025953 35.6026572306626, -82.5661796202836 35.60266923068102, -82.5663286203078 35.60267323069711, -82.5664006203194 35.602675230704925, -82.56678062037793 35.60270523075012, -82.56740362047478 35.602748230822854, -82.5675546204989 35.60275423083957, -82.56784062054423 35.60276823087178, -82.56796362056343 35.60277623088606, -82.56799762056892 35.60277723088972, -82.56810262058576 35.60278123090135, -82.56813762059127 35.60278323090532, -82.56813662060787 35.60267423088308, -82.56813562065773 35.6023492308168, -82.5681356206744 35.602241230794796, -82.56835462088443 35.601113230587714, -82.56833162094073 35.60072323050589, -82.5682826210618 35.59988423033009, -82.5703356215603 35.59886123033269, -82.5718176218158 35.59880023047248, -82.57335662208095 35.5987382306179, -82.57346862209903 35.598741230630026, -82.57357762211656 35.59874523064209, -82.57380462215323 35.59875223066682, -82.57391762217138 35.59875623067926)))",5148,37,021,000300,370210003001,1465,1465,32,1418,1007,380,5,18,0,8,47,1188,27,1161,1161,879,254,5,15,0,8,27,639,592,47
census_2010_blockgroups_view.fid--2dc29038_13ec899ba8f_-2621,"MULTIPOLYGON (((-82.43056560299999 35.56891420987693, -82.430598602991 35.56900820989938, -82.4305986029898 35.56901620990108, -82.43060860296173 35.56920920994134, -82.4306426029493 35.5693262099686, -82.43064460294846 35.56933420997035, -82.43067960293834 35.56943720999499, -82.43072960292352 35.569587210030505, -82.43074660290813 35.56970521005628, -82.43074960290568 35.569724210060436, -82.4307516028894 35.56983221008264, -82.43074160286898 35.56995421010643, -82.43069260280899 35.57029121016979, -82.43065060276534 35.570529210213905, -82.43063560274946 35.57061621023005, -82.43062060272676 35.57074721025504, -82.43062360271836 35.57080521026718, -82.43062660271218 35.57084821027623, -82.43063160270918 35.570873210281796, -82.43067160268451 35.57107621032715, -82.4306756026827 35.57109221033084, -82.4306796026752 35.571145210342, -82.43068160267052 35.57117821034896, -82.43066860264487 35.57133021037847, -82.4306366026031 35.57156721042335, -82.43061560257539 35.571724210453134, -82.43061560251682 35.57210421053038, -82.43062960248113 35.572351210581985, -82.43062360244934 35.57255121062199, -82.43060860241361 35.57276721066438, -82.43060060240101 35.572840210678365, -82.43058560237432 35.5729972107087, -82.43054460232673 35.57326221075831, -82.43053060231315 35.57333521077174, -82.43050360228665 35.573478210798044, -82.4304936022731 35.57355521081268, -82.43048460226028 35.57362921082676, -82.43047660223209 35.57380321086132, -82.43049460220979 35.573967210896484, -82.43054360219031 35.574146210937975, -82.430578602182 35.57423821096022, -82.43068760215623 35.5745222110291, -82.43072960214424 35.57464521105849, -82.43077960211154 35.57491121111767, -82.4307876020807 35.57512021116097, -82.43079060203955 35.575390211216096, -82.43078060199828 35.57564721126729, -82.43075460194909 35.57593821132379, -82.43074360192581 35.5760782113511, -82.4307176018669 35.576432211420375, -82.43071860185225 35.57652821144001, -82.43074860183083 35.576699211477795, -82.43076760182632 35.57674921148992, -82.4307756018245 35.576769211494835, -82.43080960182019 35.57683421151154, -82.43084760181894 35.576883211525406, -82.43085260181894 35.57688821152695, -82.4308936018201 35.57692521153861, -82.4309296018209 35.57695821154907, -82.43099460182628 35.57699321156293, -82.43105660183322 35.57701521157371, -82.43119160184932 35.57705521159576, -82.43135760187019 35.57709821162159, -82.43148860188437 35.57714721164498, -82.43156460188897 35.577199211663384, -82.43160360188952 35.57723721167517, -82.43161260188974 35.5772452116777, -82.43166260188681 35.57731821169764, -82.43169160187834 35.5774042117181, -82.43168860186086 35.57751421174018, -82.43166760184343 35.57760521175646, -82.4316206018199 35.57770721177236, -82.4315566017996 35.57777021177857, -82.43075860158548 35.578302211804655, -82.43060460154236 35.578417211812194, -82.43053460151764 35.57850221182221, -82.43048260149376 35.57860121183702, -82.43046060142949 35.57899421191461, -82.43045260140376 35.57915321194613, -82.4304586013554 35.57947321201176, -82.43045360131747 35.57971321206001, -82.43044260130529 35.579781212072696, -82.43043260129478 35.57983821208324, -82.43040760127758 35.57992321209795, -82.43039660126925 35.57996521210537, -82.43024960119803 35.580270212152236, -82.43022060118558 35.58031921215914, -82.43016860116283 35.58041121217252, -82.43016060115534 35.58045121217985, -82.43020460115596 35.5804942121931, -82.43027660114633 35.58063421222899, -82.43031260113922 35.580719212249925, -82.43034860112972 35.58081921227396, -82.4303506011279 35.58083321227705, -82.4303766011131 35.58095721230492, -82.43037660109336 35.58108521233088, -82.43036360106454 35.58125821236473, -82.43026060091434 35.58212221252977, -82.43020960083963 35.58255221261188, -82.43018860081331 35.582700212639786, -82.4301386007497 35.5830592127076, -82.4301196007331 35.583146212723385, -82.43010260071756 35.583229212738416, -82.43008160070433 35.583292212749086, -82.43006060069158 35.583352212759216, -82.4300576006895 35.5833622127608, -82.42998960065556 35.583510212783956, -82.42997960065141 35.58352621278619, -82.42994760063766 35.58358121279401, -82.42992660062875 35.583616212798965, -82.42986460060234 35.58372121281398, -82.4298446005935 35.58375721281928, -82.42977660056275 35.58388321283786, -82.4297446005433 35.58397521285323, -82.42973460053148 35.5840412128656, -82.42973260052757 35.58406421287005, -82.42973460051074 35.58417521289282, -82.42974360049938 35.58425921291085, -82.42978260044538 35.58465121299449, -82.42980860040171 35.584962213060386, -82.42981060040005 35.58497521306325, -82.42982360035668 35.585270213124616, -82.42983160034173 35.58537621314691, -82.42985660032902 35.585485213171616, -82.42989660031958 35.58558921319686, -82.43000560029294 35.585879213267056, -82.43018360025005 35.58634821338067, -82.43028860022075 35.58665121345302, -82.43053460014755 35.5873902136285, -82.4305946001402 35.587502213657515, -82.43067760013783 35.58760721368739, -82.43072460014037 35.58764121369908, -82.43080060014461 35.58769521371791, -82.43118960017625 35.58790721380095, -82.4312356001802 35.58793121381056, -82.43128360018493 35.58795221381985, -82.43130460018656 35.587964213824456, -82.4313286001883 35.58797821382976, -82.43136860019192 35.58799821383791, -82.43139060019367 35.588010213842594, -82.43151260020427 35.58807221386775, -82.43173260022407 35.58818021391237, -82.43227160027214 35.58844721402205, -82.43237460027882 35.58851421404623, -82.43242160027748 35.58857321406308, -82.4324486002717 35.5886402140795, -82.43245960026343 35.588705214093814, -82.43245260023676 35.588871214126854, -82.43244760022908 35.58891521413523, -82.43240660016352 35.589296214208474, -82.43237960012146 35.589540214255315, -82.4323756001145 35.58958121426326, -82.43234360008701 35.589725214289196, -82.43231960005896 35.58988121431842, -82.4323306000349 35.590049214353755, -82.4323636000061 35.59027121440225, -82.43238759998518 35.590433214437624, -82.43238759997229 35.59051621445449, -82.43225159994745 35.590531214443516, -82.43160659982772 35.590615214394234, -82.43111659973661 35.59068021435703, -82.429267599392 35.59093021421762, -82.42903959934944 35.59096121420044, -82.42848659924893 35.591019214155374, -82.42858659925132 35.5911112141843, -82.42869759925395 35.59121321421649, -82.42888459925747 35.59139121427195, -82.42898459925952 35.591485214301294, -82.42914859926267 35.591641214349906, -82.42927259926496 35.59175921438663, -82.42967059927287 35.592135214504005, -82.42984059927015 35.59233521456215, -82.4299515992558 35.592547214616616, -82.43000159924301 35.592684214649594, -82.43004359923262 35.592796214676724, -82.43010859921233 35.592998214724474, -82.43012659920525 35.59306321473956, -82.43014659919719 35.59313721475663, -82.43016159919142 35.593190214768924, -82.43020759917258 35.59336221480855, -82.43022859916431 35.59343821482614, -82.43024059915946 35.593482214836385, -82.43027659914489 35.59361521486714, -82.43028859913994 35.59366021487746, -82.43013859911207 35.59368021486617, -82.4301305991104 35.59368221486574, -82.42969259902699 35.593753214835026, -82.42954459899862 35.59377821482495, -82.4292685989455 35.59382621480628, -82.42917959892831 35.59384221480037, -82.42872859883916 35.59393621477307, -82.42844759878278 35.59400021475714, -82.42817559872789 35.5940642147422, -82.42800259869263 35.594107214733114, -82.42789259866981 35.59413721472791, -82.4270755984997 35.5943632146898, -82.42704959849425 35.594370214688546, -82.42677059843533 35.59445321467674, -82.42666659841335 35.59448421467231, -82.42661759840274 35.594500214670475, -82.42645659836845 35.5945502146641, -82.42607059828535 35.59467421464954, -82.42552159816628 35.594857214630274, -82.4255055981627 35.5948632146298, -82.42521259809811 35.59496721462078, -82.42518859809275 35.594976214620154, -82.42495459804123 35.595059214612945, -82.42471459798794 35.59514721460617, -82.42446559793231 35.5952402145994, -82.42322459765735 35.59569121456337, -82.42272759754704 35.59587321454923, -82.42271159754362 35.59587821454861, -82.42266659753356 35.595895214547426, -82.42265159753016 35.59590121454711, -82.42263859752737 35.59590521454654, -82.4225995975188 35.59591921454536, -82.42258759751603 35.59592421454519, -82.42248459749356 35.59595921454171, -82.42217859742672 35.59606421453152, -82.4220775974044 35.59610021452845, -82.42187159736056 35.59616321452002, -82.421597597302 35.596249214509385, -82.42124959723013 35.596342214492445, -82.42115059720948 35.59636921448769, -82.42104159718744 35.59639521448174, -82.42082459714354 35.59644721447004, -82.42061659710123 35.59649821445898, -82.42017059701335 35.59658921443161, -82.42014459700813 35.59659521443009, -82.41995159697119 35.596627214416785, -82.41966259691634 35.59667321439637, -82.4194705968798 35.59670421438293, -82.41906759680519 35.5967552143518, -82.41879159675524 35.59678321432908, -82.41850059670239 35.59681321430524, -82.41837859668058 35.59682421429491, -82.4180155966153 35.59685721426425, -82.41789459659347 35.59686921425425, -82.41750459652316 35.596906214221605, -82.41682259640032 35.5969712141647, -82.41634159631192 35.59702821412672, -82.41633559631093 35.59702821412609, -82.41594859623805 35.59708521409785, -82.41592559623385 35.597088214096125, -82.41587759622479 35.59709521409256, -82.41585759622106 35.59709821409116, -82.41583559621665 35.59710321408988, -82.415419596136 35.59717921406247, -82.4153525961229 35.59719221405828, -82.41496459604558 35.59727721403557, -82.41451559595448 35.59738621401153, -82.41418659588551 35.5974802139968, -82.41400759584789 35.59753221398894, -82.4137825957998 35.597602213979975, -82.4135625957528 35.597671213971324, -82.41352659574495 35.597683213970114, -82.41322959567945 35.59778921396102, -82.41291259560835 35.59791021395301, -82.41269759555995 35.597993213947746, -82.41248659551269 35.5980732139423, -82.41243759550154 35.598093213941326, -82.41199159540238 35.5982572139287, -82.41185259537211 35.598304213924, -82.41174359534804 35.59834321392062, -82.41164059532561 35.59837821391716, -82.41151959529957 35.598417213912704, -82.411159595222 35.598534213899384, -82.41103959519599 35.59857421389514, -82.41082659515088 35.598638213886225, -82.41068659512102 35.59868121388059, -82.41032359504557 35.59878121386349, -82.41018659501755 35.598815213856284, -82.40997259497351 35.59887121384569, -82.40977959493418 35.59891921383553, -82.4095075948789 35.59898621382116, -82.40933559484453 35.599024213811205, -82.4090205947822 35.59909021379215, -82.40874559472759 35.599149213775846, -82.40836059465254 35.59922321375123, -82.40769159452515 35.59933121370433, -82.40707559440996 35.5994172136584, -82.40612659423233 35.599550213587705, -82.40515959405133 35.59968621351582, -82.4050215940253 35.599707213505866, -82.40484759399239 35.59973421349343, -82.4045035939271 35.59978821346904, -82.40391559381237 35.599901213431444, -82.40378059378587 35.59992821342302, -82.40360759375105 35.59996821341334, -82.40354859373933 35.599981213409976, -82.40337459370431 35.60002121340015, -82.40331659369257 35.60003521339697, -82.4032865937104 35.599887213363864, -82.40323159379288 35.59929421323766, -82.40322459380376 35.59921621322117, -82.40303859410517 35.59706321276457, -82.40297459420927 35.59632021260702, -82.402957594237 35.59612221256504, -82.40290659431996 35.59553021243946, -82.40288959434754 35.59533321239776, -82.40287859436572 35.59520321237018, -82.4028555944041 35.59493021231236, -82.40284559442014 35.59481521228799, -82.40283859443196 35.59473121227017, -82.40283659443857 35.59468621226085, -82.40283059444394 35.59464521225188, -82.40283059444455 35.594641212251105, -82.40282059446106 35.594523212226065, -82.40281759446677 35.59448321221762, -82.4028125944743 35.59442921220618, -82.40280859448242 35.59437221219417, -82.40279859449676 35.594268212172025, -82.40279359450415 35.59421521216072, -82.40278359453187 35.59402421212086, -82.40278159454053 35.59396621210889, -82.4027825945622 35.593827212080704, -82.40278959458186 35.5937072120571, -82.40281859460629 35.59358021203424, -82.40283159462076 35.59350021201935, -82.40284759462953 35.59346021201285, -82.40289759466602 35.59327721198081, -82.40319159469603 35.5933982120357, -82.40339259471254 35.59350621207832, -82.40354759472548 35.59358921211114, -82.40384059474977 35.59374621217321, -82.40401559476587 35.593829212208036, -82.40428159479288 35.59393921225784, -82.40452459482059 35.59402021229923, -82.40478359485266 35.594090212340184, -82.40490559486821 35.59412021235876, -82.40543759493615 35.59425021243995, -82.40562359496046 35.59429221246764, -82.40618459503382 35.59441821255099, -82.40637159505812 35.594461212578956, -82.40651059510567 35.594302212561, -82.40665259514618 35.59419221255329, -82.4067195951725 35.59409321254, -82.40674259519591 35.5939662125166, -82.406746595199 35.59395021251377, -82.40673359521216 35.59385121249226, -82.4066125952412 35.59353321241529, -82.40663259526657 35.59339021238828, -82.40668659530101 35.593225212360274, -82.40691459539809 35.592840212305546, -82.40700959545265 35.59258821226411, -82.407043595522 35.592175212183626, -82.40704459552398 35.59216321218134, -82.40709659558999 35.59179121211108, -82.40716359564027 35.591537212066434, -82.40719859566629 35.59140621204341, -82.40722559567598 35.59137221203924, -82.40727859569476 35.59130721203151, -82.4074405957674 35.591010211987836, -82.40748659579143 35.590904211971, -82.40754159581958 35.590780211951504, -82.40755259582772 35.59073921194433, -82.40762459588116 35.59047021189705, -82.40766259590917 35.59032921187237, -82.4077295959474 35.59015321184343, -82.4080085960578 35.589737211787586, -82.408032596067 35.5897032117832, -82.40813259611646 35.589489211750056, -82.4081405961205 35.589472211747406, -82.40816159615802 35.58925121170468, -82.4081675961673 35.58919721169429, -82.40814759619965 35.58896621164531, -82.40799059623619 35.588560211546636, -82.40792259625236 35.58838321150363, -82.40790159625594 35.5883372114922, -82.40788259625866 35.588299211482465, -82.40784959626248 35.588239211466956, -82.407844596263 35.58823021146456, -82.40779159630011 35.58793321139876, -82.40777259629832 35.58792421139501, -82.40772359629396 35.58790021138507, -82.40768059629215 35.587865211373575, -82.40749259628485 35.58771121132292, -82.40733359627856 35.58758121128018, -82.40704459626375 35.58736721120686, -82.40690259625228 35.58728921117643, -82.40680259624412 35.58723521115523, -82.40667959622915 35.58720021113543, -82.40655559621419 35.58716421111538, -82.4065335962115 35.58715821111189, -82.40639859620106 35.58708121108232, -82.40626459619678 35.586965211044976, -82.40624459619701 35.5869422110383, -82.40616259619856 35.586844211009904, -82.4060045962011 35.586658210955875, -82.4059955962013 35.58664721095272, -82.4059345962132 35.58650421091736, -82.40589459621168 35.58647121090653, -82.4056795962253 35.58615221081956, -82.4056335962355 35.58603721079153, -82.40554459625557 35.58581121073644, -82.40552959627995 35.585637210699495, -82.40552459628793 35.585580210687496, -82.40545759632244 35.58528421062037, -82.40547059634835 35.5851302105905, -82.40547159634934 35.5851252105895, -82.40553859638506 35.584965210563944, -82.40555859640871 35.58483321053916, -82.40551859641565 35.5847452105172, -82.40526259640981 35.5845092104429, -82.40520859641606 35.58441021041721, -82.40511459645815 35.5840362103315, -82.40502759647435 35.583838210282366, -82.40496059647518 35.583761210259794, -82.40477159651665 35.583289210144486, -82.40473859655185 35.58302521008747, -82.40471959655565 35.582980210076336, -82.40460359657874 35.58270621000878, -82.4040865965686 35.5822172098562, -82.40401859657607 35.58209620982464, -82.40395159659036 35.581931209784216, -82.4038445966387 35.58150320968627, -82.40375059675547 35.58064520950222, -82.403709596769 35.58051320947119, -82.40356259678028 35.580282209409155, -82.40352159679122 35.580167209381635, -82.4034815967914 35.580123209368594, -82.40337359680751 35.579903209312725, -82.4030045968345 35.57933220915875, -82.40278859683771 35.5790792090851, -82.40249959683332 35.578798208998286, -82.40217659681362 35.578579208920594, -82.4020965968038 35.578557208907846, -82.4020555968022 35.57852320889673, -82.40198859679283 35.578512208887595, -82.40163859673837 35.57849020884716, -82.40104759670237 35.57808920870489, -82.40096559670017 35.578015208681364, -82.40074459669472 35.57781420861779, -82.40071759669698 35.57777020860615, -82.4006505966927 35.57772620859032, -82.40056959669535 35.57762220856084, -82.40015259667214 35.57732520845756, -82.39994459669711 35.57694020835797, -82.39982359669742 35.57680820831869, -82.39952759668991 35.57653920823359, -82.39941959668225 35.576473208209094, -82.39883959668437 35.57583720802021, -82.3982485966865 35.57518920782773, -82.39713459668864 35.57398020746753, -82.39709159668821 35.5739372074544, -82.39648359668153 35.57332820726809, -82.39690959681543 35.572916207228246, -82.39733159691858 35.57270020722777, -82.39797759705957 35.572478207249155, -82.3992155971984 35.57290620746347, -82.39928459720613 35.57293020747546, -82.40011459733984 35.572953207565476, -82.4006375974328 35.57291120761076, -82.40116059752796 35.57285520765319, -82.40183659766213 35.57271020769326, -82.40200759766896 35.572849207739125, -82.40228659770123 35.572939207786106, -82.40296859779056 35.57309120788716, -82.40375259793304 35.57300820795098, -82.40382159799245 35.57269720789483, -82.40390559808284 35.57220020780257, -82.40436059817921 35.57206320782155, -82.40502359830073 35.57198620787409, -82.4055545983778 35.572056207942886, -82.40608459847431 35.57199920798589, -82.40651259855375 35.5719432080185, -82.40688659865887 35.57166220799991, -82.40723459878245 35.57123420794875, -82.40725559879301 35.57118820794155, -82.40741759887311 35.57084220788795, -82.4078745990118 35.57043220785163, -82.40826659913186 35.570074207819225, -82.40864159925859 35.569654207772544, -82.40898159934413 35.56946420776888, -82.40944459947477 35.56911320774518, -82.40953359950088 35.569039207739294, -82.41028159966993 35.56874520775652, -82.41095259983607 35.56838720775279, -82.41150959998883 35.5679942077302, -82.41199060012127 35.567651207709964, -82.41231060024765 35.56717420764602, -82.41267660040528 35.56654420755567, -82.4127226004162 35.56652220755594, -82.41281460046213 35.56632320752498, -82.41346260078264 35.56493820731019, -82.4145586011825 35.56351920713461, -82.41462960120832 35.56342820712342, -82.41621660160416 35.56256220711066, -82.41762060195275 35.56180720710168, -82.41875760215984 35.56168420719358, -82.41893260219173 35.561665207207746, -82.42042060253891 35.56100920722745, -82.42337060306863 35.56073820747563, -82.42690160402526 35.55832020734731, -82.43165360493965 35.55748820766681, -82.43373360501535 35.55923220823509, -82.43697460562264 35.55877120847458, -82.43701860552149 35.55947520862222, -82.43715060521814 35.56158820906513, -82.43719560511697 35.562293209213024, -82.43696060503312 35.56258520924821, -82.4367316049141 35.56311220933182, -82.43637560479591 35.56349720937348, -82.4363216047598 35.563673209403674, -82.43624060472102 35.5638382094289, -82.4361776047023 35.56389220943338, -82.43613360468896 35.563931209436745, -82.43585760461619 35.564107209444174, -82.43569660456589 35.56426120945888, -82.43542660447376 35.56456920949376, -82.43530560442316 35.564767209521506, -82.43488260427448 35.56527820958192, -82.43457260417594 35.56558520961243, -82.43425660408464 35.56583820963138, -82.4340016040197 35.565986209635184, -82.43381360396657 35.56612920964492, -82.43363760390694 35.56632720966704, -82.4335306038604 35.566514209694034, -82.43342960382678 35.56662420970608, -82.43297260369522 35.56698720973286, -82.43240760355351 35.56730020973833, -82.43213160349086 35.56741020973228, -82.43190260343435 35.56753120973335, -82.43184060341777 35.567572209735296, -82.43101460319512 35.568130209763765, -82.43091460316164 35.56824020977581, -82.43084660312846 35.56838220979771, -82.43080660308968 35.56859120983604, -82.43072560305157 35.56875120986029, -82.43063160301917 35.568861209872956, -82.43056560299999 35.56891420987693)))",6521,37,021,003002,370210030024,831,831,35,826,770,25,4,1,0,26,5,667,29,638,663,617,19,4,1,0,22,4,392,336,56
census_2010_blockgroups_view.fid--2dc29038_13ec899ba8f_-2620,"MULTIPOLYGON (((-82.55263860485924 35.6880222466657, -82.55258560484005 35.688089246673904, -82.55239160477763 35.68828424669366, -82.55230060474778 35.68837924670356, -82.5517116045528 35.68900724677084, -82.55146460446929 35.68928124680117, -82.55140660444994 35.689344246808005, -82.55130460441364 35.68946924682296, -82.55104260431992 35.689793246862, -82.55100160430338 35.68985624687054, -82.55091960426985 35.68998524688842, -82.5507966042138 35.690215246922584, -82.55066860415043 35.690487246964814, -82.5506686041501 35.69048924696513, -82.55058360410438 35.690693246997945, -82.5504796040455 35.69096224704204, -82.55046860404117 35.690978247044065, -82.55033960396716 35.69131824710004, -82.55025760391291 35.69158124714517, -82.550165603844 35.691927247206145, -82.55010460378591 35.692237247263016, -82.55006860373646 35.692518247316464, -82.55006660373397 35.69253224731911, -82.5499996036128 35.693243247456955, -82.54998060358288 35.69341624749024, -82.54996160355073 35.69360324752636, -82.54992960349408 35.69393524759071, -82.54991360346452 35.69410924762443, -82.54989160342878 35.694316247664375, -82.54985560336706 35.69467624773392, -82.54983660332326 35.69493924778557, -82.54982160328854 35.695147247826355, -82.54979160322428 35.6955302479012, -82.54974960311887 35.69616624802637, -82.5497456031125 35.69620324803354, -82.54968760301452 35.69677424814383, -82.54956560284501 35.69773824832755, -82.54951760277719 35.6981252484014, -82.54943760268429 35.69863924849776, -82.5493526026236 35.698940248550294, -82.54930160259755 35.699053248568035, -82.54923360256585 35.6991852485879, -82.54916560253649 35.69930224860469, -82.54883060238946 35.69989224869038, -82.54873160234759 35.700056248713594, -82.54863460231047 35.70019224873126, -82.54862560230578 35.70021224873442, -82.54865760231023 35.70021824873894, -82.54870760231564 35.70023724874796, -82.54900960233222 35.70045424882323, -82.54910860233943 35.70051424884562, -82.54914660234256 35.70053424885362, -82.54918660234601 35.70055524886203, -82.54926360235368 35.70058824887669, -82.54934660236327 35.700615248890735, -82.54943660237502 35.700636248904274, -82.54955760239338 35.700647248919026, -82.54997860245872 35.70067724896846, -82.55019760249222 35.7006962489949, -82.5506946025713 35.70071924905074, -82.55097460261373 35.700745249084825, -82.55101060261919 35.70074924908942, -82.55123160265096 35.70078124911871, -82.55142660267998 35.70080324914327, -82.55158860270522 35.700814249162136, -82.55161760270968 35.70081624916555, -82.55190960275655 35.70082724919782, -82.5519916027685 35.70083824920857, -82.55200960277095 35.70084124921103, -82.5520946027811 35.70086724922507, -82.55218260278889 35.70091124924307, -82.552287602795 35.70098424926874, -82.55238060279872 35.70106024929378, -82.55246160280502 35.70110624931155, -82.55248460280686 35.70111924931655, -82.55260360281827 35.70117324933974, -82.55269560282909 35.70120224935522, -82.55281560284438 35.7012322493736, -82.55310160288325 35.70128824941447, -82.55328960290876 35.70132524944135, -82.5535006029386 35.70135924947005, -82.55366360296267 35.70137924949093, -82.55381660298787 35.7013802495068, -82.55384960299317 35.70138124951046, -82.5542546030635 35.701362249548325, -82.55477160314992 35.701359249600934, -82.554850603163 35.70135924960906, -82.55493160317755 35.70135224961598, -82.5549526031814 35.70135024961773, -82.55505260320172 35.70132624962314, -82.555083603209 35.70131224962353, -82.55512760321946 35.701292249624004, -82.55517260323201 35.70125924962188, -82.55517760323315 35.70125724962206, -82.55524760325716 35.70117724961286, -82.55531660328735 35.70105624959537, -82.55535060330125 35.70100324958812, -82.55540960332438 35.70091724957662, -82.55548760333039 35.70096224959382, -82.55573760333431 35.701205249669144, -82.55574060333439 35.70120824966996, -82.55590860333369 35.70139324972496, -82.55615460330257 35.70185824984496, -82.55621460328331 35.70204724988962, -82.55620360323837 35.7023252499451, -82.55621960323174 35.70238524995897, -82.55622660322956 35.70240724996417, -82.5562886032276 35.702486249986656, -82.55645560323836 35.70259625002626, -82.55654160324042 35.70267525005119, -82.55660460324215 35.70273225006926, -82.55666860324023 35.70281325009242, -82.55670160323515 35.70288125010964, -82.55671460323319 35.70290825011643, -82.55671560322787 35.70294325012368, -82.55669960321221 35.703027250139144, -82.55672260321465 35.70303625014337, -82.55687560322059 35.70316225018476, -82.55693760322733 35.70318525019583, -82.55704160324228 35.70320025020958, -82.5571286032579 35.703193250217105, -82.55722560327843 35.70316425022122, -82.5572806032918 35.70313725022144, -82.55736360331183 35.70309725022187, -82.55750360335061 35.70299625021561, -82.5576386033926 35.70287025020389, -82.55767960340611 35.70282725019933, -82.55770560341456 35.702800250196574, -82.55778060343744 35.702733250190605, -82.55783360345212 35.70269525018833, -82.55790960346954 35.70266425018987, -82.55799360348604 35.702648250195274, -82.5582366035266 35.70264725022009, -82.55835460354572 35.70265025023281, -82.55859860358511 35.70265825025955, -82.55878760361587 35.70266225027986, -82.5589856036477 35.70266925030168, -82.55949860372971 35.70269025035882, -82.5598336037825 35.7027092503972, -82.56014960383396 35.70271625043111, -82.5602486038499 35.70271925044199, -82.56053760389578 35.70273325047458, -82.56053760389521 35.70273725047541, -82.56053760388573 35.702798250487795, -82.56053860385863 35.70297425052369, -82.56053960385053 35.70302825053482, -82.5605346037763 35.70350225063081, -82.56053360374872 35.70367925066675, -82.56053260374175 35.70372325067564, -82.56053260372131 35.70385525070253, -82.5605326037143 35.70390025071173, -82.56053160369872 35.70400025073192, -82.56053160365197 35.704302250793425, -82.56053160363628 35.704403250814, -82.56053460361609 35.70453725084161, -82.5605386035907 35.704705250876266, -82.56052860357958 35.7047662508876, -82.56052860355297 35.70493825092261, -82.56052960353226 35.7050732509502, -82.56052960351333 35.70519525097508, -82.56052960345659 35.70556225104979, -82.56052960343742 35.70568525107485, -82.5605286034037 35.70590225111897, -82.56052560330227 35.706554251251426, -82.56052560326847 35.70677225129581, -82.56052460326102 35.70682025130551, -82.56052460323815 35.70696725133539, -82.56052460323065 35.70701625134541, -82.56052360320984 35.70714925137241, -82.56052360319084 35.70727225139745, -82.56052060314755 35.70754825145332, -82.56052060312702 35.707681251480395, -82.56051960310869 35.707798251504094, -82.56051960307558 35.70801225154771, -82.56051860305418 35.70814925157549, -82.5605186030359 35.70826725159952, -82.56051760302847 35.708314251609, -82.56051760300615 35.70845825163835, -82.56051760299873 35.70850625164804, -82.56051660299241 35.708546251656145, -82.56051560298124 35.70861725167051, -82.56052260291644 35.70904325175793, -82.56052160289629 35.70917225178411, -82.56051560275691 35.71006625196558, -82.5605176027033 35.71041425203661, -82.5605256026537 35.71074325210444, -82.56056160262335 35.710978252155996, -82.56060960260292 35.71116125219825, -82.56062260259812 35.711206252208704, -82.56069660257549 35.7114322522624, -82.56076760256032 35.71160625230515, -82.56084260255197 35.71174025234014, -82.56086960255183 35.71177025234901, -82.56099960257767 35.711743252356904, -82.56128360262831 35.711721252381665, -82.5617896027185 35.71168225242583, -82.5624556028346 35.71164725248732, -82.5625356028489 35.71164125249435, -82.56292160291676 35.711617252529265, -82.56295360292222 35.711616252532345, -82.56313460295404 35.711605252548715, -82.56368060304963 35.71157425259864, -82.5638626030813 35.71156525261558, -82.56351060296359 35.711947252657104, -82.56350560296215 35.7119512526574, -82.56318360285118 35.71232225269983, -82.56274960269965 35.71283425275941, -82.56248660260641 35.71315425279743, -82.56237560256689 35.713290252813685, -82.56215960248818 35.7135662528477, -82.56200060243033 35.713769252872616, -82.56173460233131 35.71412325291732, -82.56166960230684 35.714211252928564, -82.56131460217239 35.71469825299113, -82.56098460204471 35.71516825305287, -82.56053560186454 35.71584925314526, -82.56047560184034 35.71594125315782, -82.56016160171052 35.71644225322755, -82.5599146016038 35.716866253288465, -82.5594866014181 35.71760525339486, -82.55919960128556 35.71815325347685, -82.55897260118036 35.71858825354204, -82.55891860115558 35.718690253557234, -82.5587566010808 35.71899925360348, -82.558703601056 35.71910225361904, -82.55860960101285 35.719280253645636, -82.55834760089132 35.719783253721, -82.5583306008835 35.71981525372581, -82.55823860084035 35.71999525375294, -82.55820360084631 35.71991925373392, -82.55809860086414 35.719691253676636, -82.55806360087018 35.71961525365746, -82.55800160088086 35.719479253623405, -82.5579346008817 35.71940225360087, -82.55790760088573 35.71934725358685, -82.55779960088447 35.719239253553816, -82.55740160087974 35.71884225343191, -82.55725360087392 35.71872125339199, -82.5567366008468 35.718341253261364, -82.55663360084154 35.71826525323534, -82.55643860082611 35.718155253192755, -82.5563466008207 35.71809125317026, -82.55626360081575 35.718034253150094, -82.55604860079794 35.71791825310431, -82.55578460077604 35.71777625304823, -82.55554160074762 35.71769925300751, -82.55518460070105 35.71761625295382, -82.55507360068539 35.71759825293878, -82.55498260067259 35.71758325292628, -82.55484160064923 35.71758325291179, -82.55473360062777 35.717605252905095, -82.55458560062178 35.71748525286541, -82.55450460061435 35.71744625284912, -82.55424860059983 35.71726525278596, -82.55411960059516 35.717157252750674, -82.5539186005876 35.7169902526959, -82.5536216005679 35.71679825262627, -82.55350760056434 35.716699252594346, -82.55343260055868 35.71665525257768, -82.5533316005581 35.716550252545844, -82.55327760056278 35.71646225252239, -82.55314360055755 35.716352252486146, -82.55300860053929 35.71632525246675, -82.55279960050362 35.7163312524465, -82.55238860041328 35.716473252433005, -82.55224760038894 35.71647925241973, -82.5521626003732 35.716489252413, -82.55203860034997 35.71650625240374, -82.5519576003399 35.716484252390856, -82.55178260032181 35.716413252358386, -82.5515936003057 35.71631425231878, -82.55147760030107 35.7162202522876, -82.55143860027768 35.71632925230583, -82.55139960025336 35.716444252325225, -82.55131560021225 35.71661925235221, -82.55129860020527 35.716646252355936, -82.55123860017976 35.71674625237008, -82.55119060015971 35.71682425238107, -82.55112760013313 35.716928252395746, -82.55104860009986 35.71705825241405, -82.55099960007966 35.717136252424886, -82.55089560003668 35.71730225244799, -82.55072659996641 35.717574252485946, -82.55059259990816 35.71780625251941, -82.5505785999019 35.717831252523006, -82.55048059986464 35.71796725254063, -82.55041259983854 35.718062252552976, -82.55040759983697 35.71806725255347, -82.55021359976867 35.718300252580896, -82.55017259975365 35.71835325258752, -82.55009759972596 35.71845125259974, -82.54998259968353 35.71860125261845, -82.54984159963509 35.71876325263685, -82.5498045996239 35.71879525263959, -82.54958259955545 35.71899925265825, -82.54937459949404 35.71917225267205, -82.5491285994246 35.719356252684136, -82.54894559937682 35.71946825268812, -82.54871259931905 35.719591252689185, -82.54867959931076 35.719609252689445, -82.5483745992364 35.719762252689165, -82.54831459921971 35.71980525269174, -82.54829459921426 35.719819252692474, -82.54823659919823 35.719860252694886, -82.54821759919274 35.71987525269599, -82.54819759918696 35.71989125269712, -82.54806059914404 35.72002125270949, -82.5478845990855 35.720210252729856, -82.54766459901391 35.72043625275322, -82.54751759897196 35.72054925276111, -82.54740159894416 35.72060425276036, -82.54725459891243 35.720651252754706, -82.54709959888056 35.72069025274666, -82.54683259882863 35.72073925272918, -82.54641359874675 35.72081825270209, -82.54515859850343 35.721042252618396, -82.54491159845024 35.72112025260879, -82.54471359840586 35.721194252603475, -82.54446359834677 35.72130725260066, -82.5443205983074 35.721407252606376, -82.54418459826476 35.72153725261878, -82.54406559823258 35.72161725262285, -82.54382859817753 35.721718252618935, -82.54370559814748 35.72178025261889, -82.54352459810174 35.72188125262081, -82.54335859806096 35.721966252621016, -82.54320759802559 35.72203225261891, -82.54303459798354 35.722118252618586, -82.54276559791492 35.722272252622226, -82.5421825977723 35.722567252622156, -82.54160659763113 35.72286025262247, -82.54145059759567 35.72292225261897, -82.5413455975754 35.722940252611856, -82.5412065975531 35.72293525259653, -82.5410675975332 35.72291425257789, -82.54074259749065 35.72284025252935, -82.54059059746912 35.722816252508835, -82.54021759741637 35.72275625245817, -82.53975059732959 35.722815252421995, -82.53914959721806 35.72289025237531, -82.5391265972131 35.72289725237444, -82.53759259691388 35.723183252274545, -82.53679159672508 35.72354225226509, -82.53519859638337 35.72403825220185, -82.53494759632342 35.724156252200004, -82.53447059624611 35.72414325214815, -82.53425859620982 35.724150252127814, -82.5342085962017 35.724149252122395, -82.53416559617517 35.72427425214344, -82.53440359615689 35.72464725224394, -82.53463459613936 35.72500825234123, -82.53533659605941 35.726276252671695, -82.535640596025 35.72682425281457, -82.53481759589351 35.72679025272285, -82.53383159573768 35.72673825261064, -82.5333075956385 35.726816252572476, -82.53286459556097 35.726841252531905, -82.53226659548366 35.72669825244114, -82.53197559545904 35.72654525238008, -82.53149859547187 35.725951252209924, -82.53098059547357 35.72538525204131, -82.53084859547393 35.72524125199841, -82.52993459545011 35.724415251735984, -82.5289835954316 35.72351525145475, -82.52846459540412 35.72313625132415, -82.52781959532707 35.722941251217954, -82.52715859523136 35.72285025113131, -82.52663559512784 35.72295725109919, -82.5260495950071 35.72310825106946, -82.52536259488295 35.72317225101164, -82.52433359468354 35.72335625094306, -82.52348659450513 35.72359825090506, -82.52236459432906 35.723532250775875, -82.52184159421978 35.72367625075132, -82.52125759407174 35.724005250758125, -82.52052859389725 35.72434925075295, -82.52010359382622 35.72435225070972, -82.51920859368103 35.724329250612826, -82.5187665935935 35.72442025058569, -82.51838959348808 35.724696250603024, -82.51785159332744 35.72515625064129, -82.51731059321625 35.7252932506133, -82.51676759313469 35.72523725054595, -82.51666959311555 35.725256250539715, -82.5159645929763 35.72539825049593, -82.5152325928437 35.72546925043491, -82.51471859273491 35.72562025041261, -82.51450459266948 35.72581325042987, -82.51427959261237 35.72594025043255, -82.51402659257003 35.72594225040684, -82.51362559253502 35.72573825032397, -82.5133505925542 35.72532025021051, -82.51287059260764 35.72446124998619, -82.51253759261651 35.72404724986759, -82.51216459262658 35.72358224973452, -82.51208259262123 35.723529249715234, -82.51151759258364 35.723166249583166, -82.51113959254131 35.72303424951733, -82.51072759249507 35.72289124944574, -82.51000359238652 35.722815249355584, -82.50919759226896 35.72271024925111, -82.50844359218509 35.72244324911908, -82.50741659207985 35.72202224892747, -82.50661559201566 35.72157824875451, -82.50637059199173 35.721470248707305, -82.50615559194524 35.72153924869913, -82.50611859193711 35.721552248697954, -82.50561759178024 35.72202724874299, -82.50511359165012 35.72232624875183, -82.5047365915495 35.72257124876289, -82.50460059154153 35.72247724872972, -82.50459659158662 35.72218224866928, -82.50485059174915 35.72140624853759, -82.5052435919347 35.72063024842012, -82.50559459209974 35.719942248316315, -82.50662159257404 35.71798224802331, -82.50765359299108 35.7163982478073, -82.50861859334184 35.715169247656654, -82.50883059341857 35.71490124762401, -82.50920459355648 35.71441224756308, -82.50967459363841 35.714387247606375, -82.5101875937607 35.71414824761064, -82.51033159379233 35.71409824761532, -82.50973959393842 35.712521247233354, -82.5092955940357 35.711417246962895, -82.50924259405605 35.71122924691912, -82.50924259407208 35.711126246898196, -82.50924159408801 35.71102224687696, -82.5092985941418 35.71073624682459, -82.50944259427635 35.71002224669414, -82.50951559439834 35.70931324655741, -82.50948759443567 35.709042246499315, -82.50946259444756 35.708938246475626, -82.509384594454 35.708813246442105, -82.50927959448492 35.70850124636777, -82.50922559451796 35.708230246307096, -82.50922459454696 35.70804224626868, -82.50927659457814 35.70789624624433, -82.50930159460476 35.7077512462175, -82.5093255946281 35.70762624619449, -82.50940159466012 35.70750124617687, -82.50947859468906 35.70739724616365, -82.50978459479491 35.707042246122974, -82.50998859485777 35.70685524610587, -82.51014159490248 35.706730246096214, -82.51021759492785 35.70664824608736, -82.51029459495693 35.70654324607393, -82.51037059498233 35.706460246064836, -82.51044759502432 35.706272246034516, -82.5105235950691 35.70606424600003, -82.510572595103 35.705898245971355, -82.51062259513694 35.70573224594267, -82.51067659515438 35.705678245937285, -82.51075059516788 35.70567024594327, -82.51082159517877 35.70567624595186, -82.51087759518586 35.705690245960405, -82.51098059519322 35.70575324598393, -82.51108559519717 35.70584024601245, -82.51110059519662 35.705859246017795, -82.51112359519465 35.7058972460279, -82.51115859518701 35.70598424604919, -82.51120959517928 35.7060882460756, -82.51123459517046 35.706172246095356, -82.51123459515095 35.706298246121, -82.51115359504038 35.7069252462402, -82.51115159498163 35.70730224631675, -82.51127859497038 35.707511246372356, -82.51145559491232 35.70807524650539, -82.51158159485534 35.70857824662078, -82.51165759484532 35.708724246658285, -82.51170759484063 35.708808246680526, -82.51188659483458 35.709039246746016, -82.51191159482264 35.7091432467698, -82.5119365948107 35.709247246793545, -82.51196159480506 35.70931024680888, -82.51198459472786 35.70983324691769, -82.51198459470832 35.70995924694333, -82.51206059469835 35.71010524698085, -82.51211059469361 35.7101892470031, -82.51213059469369 35.71021024700948, -82.51218759469351 35.710272247027994, -82.51226359469966 35.71031424704436, -82.51231559470159 35.710357247058425, -82.51236659470375 35.71039824707208, -82.51241659470547 35.71044024708572, -82.51246859471094 35.71046124709541, -82.51251959471612 35.710482247104935, -82.51259559472872 35.71048224711275, -82.51264759474071 35.7104612471138, -82.51287359479336 35.71036324711719, -82.51395059508921 35.70960824707452, -82.51402659512127 35.70948324705693, -82.51410259515302 35.70935924703949, -82.5141785951852 35.709233247021714, -82.51429659527807 35.708760246937594, -82.51440859536723 35.70830524685657, -82.51445759538723 35.70822824684595, -82.51460859544814 35.707997246814415, -82.51465959546837 35.707921246804254, -82.51478759552003 35.70772524677756, -82.51483859554443 35.70762224676191, -82.5148485955487 35.70760524675941, -82.5149225955779 35.70749624674485, -82.51503059561578 35.70736724672974, -82.51516259566355 35.70720024670934, -82.51552259577842 35.706845246674256, -82.51557259579758 35.706775246665096, -82.51565759582968 35.706659246650304, -82.51579559587995 35.706482246628404, -82.51582659589135 35.70644224662353, -82.51604559597438 35.70614124658479, -82.51616559601455 35.70601024657054, -82.51629359605717 35.705872246555664, -82.51630459606062 35.70586224655476, -82.51645959611562 35.70567324653219, -82.51654459614393 35.705581246522264, -82.51671659619095 35.70546224651574, -82.51688259623776 35.70533824650761, -82.51696559626193 35.70527124650256, -82.51701759627859 35.70521924649735, -82.51711259631278 35.7051002464829, -82.51728159637814 35.70486024645143, -82.51744759644207 35.70462524642075, -82.51756459648362 35.70448224640371, -82.5176935965229 35.704367246393595, -82.51778959654798 35.7043082463915, -82.51795359658718 35.7042312463927, -82.51810559662304 35.70416224639434, -82.51819659664548 35.70411524639412, -82.51828759667036 35.70405224639065, -82.51837359669547 35.70398224638534, -82.51849359673383 35.70386324637346, -82.51853859675023 35.703805246366265, -82.51856859676252 35.70375824635981, -82.5186485967947 35.70363624634322, -82.51866159680081 35.70361124633946, -82.51874459683829 35.70345824631688, -82.51879759686567 35.70333824629796, -82.51882959691075 35.70308124624892, -82.51882959691207 35.703072246247125, -82.51884059694176 35.702893246211794, -82.51890559697144 35.702771246193684, -82.51893359698391 35.70272024618615, -82.51898859700744 35.70262724617287, -82.51922659710087 35.70227924612659, -82.51925959711356 35.70223324612061, -82.5193765971571 35.70207724610091, -82.51956259723275 35.70178824606133, -82.51964259726412 35.7016712460457, -82.51973059729833 35.701545246029085, -82.52009459743664 35.701042245964246, -82.5201525974607 35.700949245951264, -82.52018759747904 35.70086824593843, -82.52022359750332 35.700750245918144, -82.52030059757058 35.70039824585436, -82.5203035975726 35.70038824585269, -82.52035659761782 35.7001532458103, -82.52039059765926 35.69992224576683, -82.5203945976706 35.69985324575311, -82.52037359768713 35.69972424572478, -82.52034359769603 35.69963424570333, -82.52029059771117 35.69948024566652, -82.52016959773718 35.6991822455934, -82.52006759775892 35.69893224553202, -82.52003059777118 35.698813245504, -82.52002959777151 35.69881024550321, -82.51997159780085 35.69855824544596, -82.5199665978055 35.6985232454384, -82.51992159784444 35.698223245372716, -82.51988459786389 35.69805824533522, -82.5198795978655 35.69804224533153, -82.51984359788054 35.69790624530015, -82.51977659789642 35.69773224525778, -82.51971059790836 35.69758424522087, -82.51965759791581 35.69747924519406, -82.51957259793514 35.69726324514131, -82.51954459794953 35.697140245113395, -82.51952059796612 35.69700724508383, -82.51951259798044 35.69690624506246, -82.51948559801639 35.69664524500656, -82.51946559804509 35.69643824496239, -82.51944359805691 35.69633824493977, -82.519403598069 35.696217244910976, -82.51938259807247 35.69617224489974, -82.51934359807916 35.69608724487836, -82.51924259808902 35.69591524483295, -82.519173598098 35.69578324479903, -82.51916459809976 35.695762244793805, -82.51898959813326 35.695358244693544, -82.51884459815511 35.695061244618145, -82.51868759817184 35.6947852445458, -82.51852159818353 35.69453124447698, -82.51844959818867 35.69442124444721, -82.51828159820504 35.694135244371665, -82.51840459822758 35.69412124438149, -82.51840859822846 35.694120244381715, -82.51868259828106 35.69407424440055, -82.51878559830236 35.69404724440568, -82.51891059832788 35.69401624441226, -82.51894459833484 35.694007244413875, -82.51914859837821 35.693946244422506, -82.5192065983904 35.693930244425225, -82.51942259843769 35.69385624443243, -82.51964759849076 35.693755244435074, -82.5198295985367 35.693653244433044, -82.52004659859129 35.69353324443094, -82.52020159863407 35.69342324442452, -82.52032159866701 35.6933392444198, -82.52058759874497 35.69312124440294, -82.52064559876277 35.69306824439807, -82.52078759880602 35.69294124438681, -82.52091259884556 35.6928202443751, -82.52128959896436 35.69245724434007, -82.52138459899423 35.69236624433132, -82.52141559900389 35.69233724432858, -82.52146059901798 35.692294244324444, -82.52159759906061 35.69216624431255, -82.5216435990747 35.692124244308744, -82.52228359927354 35.69152624425296, -82.52257959935895 35.69129224423583, -82.52291059944609 35.691084244227575, -82.52340759956539 35.69084724423054, -82.52408659971732 35.690594244248985, -82.52424859975348 35.69053424425344, -82.52428259976129 35.690520244254074, -82.52438559978421 35.69048224425694, -82.5244205997919 35.69047024425814, -82.52452759981608 35.690429244260784, -82.52485159988844 35.69030924426977, -82.52495959991255 35.69026924427278, -82.52516959995921 35.690193244278866, -82.52536560000264 35.69012324428481, -82.5258026000997 35.68996524429767, -82.5259826001395 35.6899012443032, -82.52601460014618 35.689892244304666, -82.526478600242 35.68977124432782, -82.52652860025219 35.68975924433057, -82.52705660035343 35.689671244366956, -82.52764260045636 35.68963524442002, -82.52790860049998 35.68963924444826, -82.52805460052375 35.68964224446395, -82.52838760057365 35.68967724450529, -82.52851060059203 35.689690244520676, -82.5285836006026 35.689700244530194, -82.52917160068765 35.689782244607436, -82.5292526006992 35.68979424461827, -82.52936760071569 35.689811244633546, -82.5294866007328 35.6898282446492, -82.5298446007839 35.68988224469713, -82.52996460080097 35.68990124471336, -82.53020960083606 35.68993724474586, -82.53094660094166 35.690046244843955, -82.53119260097681 35.69008324487681, -82.53143060101085 35.6901182449085, -82.53209360110581 35.690216244996684, -82.53214560111323 35.69022424500368, -82.53238360114656 35.690264245036374, -82.53280960120661 35.69033424509452, -82.53296160122854 35.6903552451144, -82.53320560126366 35.690390245146666, -82.53337760128832 35.69041524516946, -82.5338326013528 35.69048724523106, -82.53418960140628 35.69052524527548, -82.53450860145801 35.69053324530995, -82.53470660149436 35.6905112453259, -82.53471060149504 35.69051124532631, -82.53500660155449 35.690444245343095, -82.53526560161382 35.69033924534849, -82.53534260163146 35.69030824535005, -82.5356126016991 35.69016024534771, -82.53565160171028 35.69013024534571, -82.53577460174495 35.69003824533964, -82.53590660178624 35.68991324532778, -82.5360336018315 35.68975724530903, -82.53646460200487 35.689099245219545, -82.53670660210204 35.68873124516955, -82.53676360212512 35.68864324515746, -82.53699960220797 35.6883612451244, -82.5370786022325 35.688287245117436, -82.53723960228193 35.68814124510431, -82.53757160237403 35.68790224508992, -82.53790460245787 35.687718245086664, -82.53821660253045 35.687583245091304, -82.53856660260877 35.68745324510089, -82.53858660261318 35.68744624510153, -82.53914060273267 35.687269245122586, -82.53923460275311 35.687238245125926, -82.53951860281435 35.68714724513661, -82.53961360283475 35.68711724514028, -82.53988560289373 35.68702824515021, -82.53994360290613 35.6870102451525, -82.54035560299374 35.68688624516968, -82.5404726030186 35.68685124517461, -82.54071360306706 35.68679724518843, -82.54099360312313 35.68673524520462, -82.54150960322299 35.68664424523926, -82.54190960329638 35.68659924527133, -82.54199160331103 35.68659224527836, -82.54239760338378 35.68655824531315, -82.54277560344998 35.686536245347604, -82.54309460350578 35.68651824537683, -82.54404860367394 35.68645624546248, -82.54501460384398 35.68639424554925, -82.54602260402123 35.68633124564028, -82.54719660422847 35.68625324574523, -82.54736060425705 35.686244245760264, -82.54747360427682 35.68623824577066, -82.54761060430063 35.68623124578341, -82.54781560433699 35.68621624580148, -82.547929604357 35.686209245811725, -82.54819560440421 35.686190245835284, -82.54833360442849 35.686181245847656, -82.5488646045214 35.686151245896205, -82.54926960459333 35.6861212459318, -82.54954960464049 35.68611724595982, -82.54976860467737 35.68611424598179, -82.54995460470506 35.68613524600522, -82.550108604728 35.686152246024484, -82.55011060472829 35.68615224602472, -82.55044460477066 35.6862372460764, -82.55056460478399 35.68628024609746, -82.55071360480038 35.686334246123856, -82.55073860480313 35.68634324612824, -82.55093160481896 35.68644824616949, -82.55105560482905 35.68651624619608, -82.55127660484114 35.68667524625124, -82.55147460484766 35.6868462463064, -82.55152060484816 35.68689224632056, -82.5516956048502 35.6870672463742, -82.55172360485047 35.687095246382746, -82.55188360485205 35.687257246432274, -82.55244960485747 35.6878302466072, -82.55263860485924 35.6880222466657)))",6464,37,021,002703,370210027033,2292,2292,67,2264,2207,16,12,13,10,6,28,1871,39,1832,1852,1812,14,7,11,4,4,19,1135,1010,125
census_2010_blockgroups_view.fid--2dc29038_13ec899ba8f_-261f,"MULTIPOLYGON (((-82.71999064742778 35.592547244400905, -82.7200946474467 35.59253724440951, -82.7219786478889 35.591702244432334, -82.72279964804626 35.59156824448915, -82.72407564829078 35.591361244577676, -82.72670464882054 35.59076424472538, -82.72943364940608 35.589913244831415, -82.73138264986822 35.58901924484875, -82.73184764997839 35.58880624485294, -82.73321365029761 35.588210244871306, -82.73413565050885 35.58783524488932, -82.7342476504497 35.58834224500417, -82.73458465027227 35.5898632453491, -82.73469765021329 35.59037024546399, -82.73525865027713 35.59056324556091, -82.73527765027917 35.59057024556424, -82.73646165040645 35.59102724577876, -82.73692665045859 35.59119224586005, -82.73748665052116 35.591392245958254, -82.73777565048002 35.591974246106616, -82.73789065045185 35.59228224618126, -82.7379106504231 35.5924912462259, -82.73803265038018 35.59290324632245, -82.73805265030929 35.593386246423044, -82.7380256502795 35.59355124645398, -82.7378576502042 35.593859246499576, -82.73772365015735 35.59401824651826, -82.73742765008774 35.59415024651484, -82.73724565003381 35.594304246527635, -82.73709164997507 35.594519246555734, -82.73672864987492 35.59477724657111, -82.73636864976595 35.59509624659935, -82.73616164970329 35.59527924661549, -82.73597964964522 35.59546024663373, -82.73585764957863 35.59576124668258, -82.73576664954467 35.595883246698214, -82.73561364949343 35.596051246716776, -82.73558364946678 35.59619224674245, -82.73551464942936 35.5963602467697, -82.73543064939892 35.59646724678287, -82.73537264938315 35.59650724678507, -82.73523264934784 35.596585246786695, -82.73507964930359 35.59670724679584, -82.734789649202 35.597054246836954, -82.73469864916264 35.59721124685962, -82.73465264913804 35.597321246877364, -82.7346376491215 35.597413246894554, -82.73462964911185 35.597466246904624, -82.7344766490255 35.59786324696985, -82.73444964900987 35.59793524698184, -82.73435164895429 35.59819124702402, -82.73430464892367 35.59833924704937, -82.73428064891797 35.598350247049105, -82.73401264884521 35.59853324705898, -82.73371364876034 35.59876124707487, -82.73350464870657 35.598884247078566, -82.73321564863714 35.59902224707707, -82.73270364851794 35.59924324706971, -82.73236864842428 35.59948924708554, -82.73223664839077 35.599564247087315, -82.73202364834258 35.59964624708222, -82.73176964828416 35.599751247077606, -82.73137964818777 35.59995524707921, -82.73138764817165 35.600069247103285, -82.73138064816803 35.60008524710584, -82.7313066481244 35.60028824713973, -82.73123064808676 35.60045124716515, -82.73117664805916 35.60057224718434, -82.73108264801216 35.6007762472163, -82.7309626479519 35.60103824725738, -82.73093364793074 35.601144247276096, -82.73092764791332 35.6012512472973, -82.73095464789394 35.60140624733172, -82.73095764789282 35.60141724733419, -82.73101964786976 35.601634247384816, -82.73104964785821 35.601742247409945, -82.73114164782352 35.60206724748564, -82.73115464781885 35.602112247496144, -82.73117464781248 35.60217524751113, -82.73117964781085 35.60219124751486, -82.73119464780576 35.60224024752641, -82.73120064780423 35.60225724753049, -82.73124864778887 35.602409247566435, -82.73125664778576 35.60243824757311, -82.73137064774158 35.60284924766866, -82.73140664772612 35.60298924770093, -82.73145464770566 35.603174247743574, -82.73148764769182 35.60330024777263, -82.73152464767291 35.603463247809685, -82.73167864759466 35.604139247963396, -82.7317296475834 35.60426824799489, -82.73175964758023 35.604321248008844, -82.73180564757585 35.60439924802948, -82.73188264757317 35.60450024805792, -82.73194264757488 35.6045542480751, -82.73149564744386 35.60492224810436, -82.73051964715725 35.60572824816874, -82.73015864705056 35.60603124819353, -82.73003264701305 35.60613824820246, -82.7299706469946 35.60619124820688, -82.72971864691924 35.60640824822532, -82.72940264682278 35.60669324825106, -82.72899964669408 35.60709324829135, -82.72792664635104 35.60816124839922, -82.72750264621673 35.60857524844021, -82.72720364612832 35.608826248460716, -82.7269366460526 35.60902924847476, -82.7268096460196 35.609105248477285, -82.72667164598398 35.60918824847998, -82.72632464589768 35.60937324848214, -82.72592864580264 35.6095622484801, -82.72534564566263 35.60984024847707, -82.72504564559208 35.60997424847364, -82.72493664556593 35.610026248473034, -82.7246826455048 35.61014824847195, -82.72429564541086 35.610339248471206, -82.72389564531568 35.610525248468115, -82.72301864509848 35.61098724847246, -82.72268964501455 35.611176248477285, -82.72238864494035 35.61133224847821, -82.72206264485806 35.61151424848193, -82.72202164484754 35.611538248482624, -82.72181064479332 35.61166224848628, -82.7210696446057 35.61207924849535, -82.7206036444871 35.612345248501825, -82.72036764442699 35.61248024850516, -82.71984464428819 35.61281624852005, -82.71927364412645 35.613249248549785, -82.71902864405688 35.61343624856287, -82.71900164404909 35.613457248564345, -82.71884764400546 35.61357424857251, -82.71831164385223 35.613989248602095, -82.71804364377529 35.614199248617496, -82.71670364339306 35.61523224869078, -82.71616764323998 35.615647248720464, -82.71608664321688 35.615709248724784, -82.71584464314795 35.615895248737914, -82.71576464312497 35.6159582487425, -82.71563564308823 35.6160572487495, -82.71524964297822 35.61635424877048, -82.71512164294148 35.61645424877774, -82.71444964274944 35.61697424881489, -82.71427064269672 35.61712324882692, -82.71419064267306 35.61719024883238, -82.71395064260062 35.61740124885084, -82.71369464251738 35.61766524887837, -82.71346864243776 35.61793824891092, -82.71322764235289 35.61822824894531, -82.71294564225813 35.61853924897983, -82.71283864222454 35.618641248989626, -82.71266164217518 35.6187702489979, -82.71223064206092 35.61904624900992, -82.71198864200373 35.61915624900752, -82.71183664197007 35.619210249002926, -82.71151264189787 35.619328248993746, -82.71095664178227 35.61947724896719, -82.71080064174988 35.61951924895972, -82.70996164157555 35.6197432489194, -82.70969964152098 35.619814248906906, -82.70941964146017 35.61990624889695, -82.70920364141172 35.61998724889135, -82.70901164136532 35.62008124889086, -82.70862464126647 35.62030424889659, -82.70819764113946 35.62066724892681, -82.70776664100593 35.621068248964455, -82.7073076408634 35.62149724900478, -82.70712164080916 35.621648249016516, -82.70692764075265 35.621805249028625, -82.70658864066131 35.62203224904017, -82.70495264021943 35.623132249096656, -82.70440764007205 35.623499249115575, -82.70426264003086 35.62361024912341, -82.70383063990748 35.62394424914714, -82.70374663988335 35.62401024915203, -82.70369763986636 35.624067249158614, -82.70362363984107 35.62415124916815, -82.70340263976519 35.62440524919723, -82.70332963973992 35.624490249207106, -82.7033336397298 35.62456024922177, -82.70334863969953 35.62477324926675, -82.70335363968945 35.624844249281786, -82.70344163967657 35.625023249327285, -82.70383863965566 35.625589249483454, -82.70411863962671 35.626080249612286, -82.70420863960061 35.62634724967605, -82.70425363957655 35.626552249722444, -82.70432463953904 35.62687324979516, -82.70453763948595 35.627448249934325, -82.70464463944259 35.62784625002646, -82.70461863940818 35.62804125006354, -82.70456263937568 35.62819225008858, -82.70417863922327 35.628766250166215, -82.70388063911912 35.62912025020791, -82.70298863885087 35.62989725027488, -82.70293163883215 35.629957250281215, -82.70289563881809 35.630009250288126, -82.7028696388056 35.63006225029625, -82.70285563879555 35.63011225030505, -82.7028496387743 35.63024425033138, -82.70286963876761 35.63030925034661, -82.70292763875517 35.63045325038196, -82.70310563872755 35.63082525047607, -82.7032196387054 35.63109225054225, -82.70329063868752 35.631285250588846, -82.70336763865942 35.63155125065104, -82.70363763856056 35.632485250869244, -82.70406963849777 35.63336125109221, -82.70423363854258 35.63324725108577, -82.70458463864868 35.632938251058775, -82.70478763871436 35.632731251037406, -82.70479663871711 35.63272325103662, -82.70500763877956 35.63254625102225, -82.70516663882388 35.63243025101495, -82.70528663885072 35.63238625101819, -82.7054286388794 35.63235325102609, -82.70564363891923 35.63232725104278, -82.70596563897321 35.63232525107548, -82.70612863899825 35.63233925109509, -82.70627263901531 35.632384251119, -82.70640363902511 35.63246225114836, -82.7065426390325 35.63256425118341, -82.70723863905253 35.633188251382094, -82.70727863905365 35.633224251393514, -82.70761763906441 35.63352125148885, -82.7078676390684 35.63376625156451, -82.70794463907079 35.633834251586315, -82.70799163907206 35.63387625159971, -82.7080856390748 35.633960251626476, -82.7081316390751 35.634008251641, -82.70817663907556 35.63405425165498, -82.70824863907599 35.63412925167762, -82.70851063906875 35.63446025177205, -82.70854963906412 35.63453225179069, -82.70867663904913 35.63476725185166, -82.70879963902324 35.63506825192572, -82.70888363899415 35.63534825199145, -82.70893863896333 35.6356082520501, -82.70897863893164 35.63585725210505, -82.70906463890941 35.63609425216215, -82.70915463890191 35.636240252201155, -82.70917363890037 35.63627125220942, -82.70928963889556 35.63642825225332, -82.70930463889589 35.63644225225779, -82.70941663889835 35.63654725229063, -82.7095966389136 35.636643252328675, -82.70952663886665 35.63687225236824, -82.7092306386954 35.63766425249936, -82.70918263865954 35.63784525253143, -82.70921063864725 35.63795525255671, -82.70928463865192 35.63800425257431, -82.70957363869921 35.63801025260515, -82.70975563871697 35.63809225264059, -82.70995063872496 35.63825125269296, -82.71013263872823 35.63842725274763, -82.71034163874012 35.638576252799396, -82.71044863873516 35.63872425284055, -82.71046863872155 35.63883425286511, -82.71042263870294 35.6389052528748, -82.71028763867712 35.638927252865436, -82.71005863862877 35.63899325285548, -82.70997163860316 35.63906525286121, -82.70990363857845 35.63915225287196, -82.70999763856267 35.6393562529232, -82.70995763854164 35.639449252938086, -82.70988963852112 35.6395092529433, -82.70982963850247 35.63956525294863, -82.7097496384654 35.63971925297178, -82.70963463842945 35.63982825298225, -82.70947963839251 35.63990025298101, -82.70927163834695 35.639971252974185, -82.70899563829323 35.64002125295606, -82.70890763827009 35.64007625295822, -82.70888063824957 35.640180252976656, -82.70892163822934 35.64035625301671, -82.70892863820164 35.64054325305558, -82.70883363816475 35.640680253073775, -82.7086166381019 35.640853253086846, -82.70853763807882 35.640917253091764, -82.70830863801959 35.64105425309622, -82.70815463798625 35.64110425309061, -82.70785163794929 35.641016253041535, -82.70771663793442 35.64096625301751, -82.70758863791224 35.64097225300559, -82.7072186378268 35.64112625299902, -82.70707063780219 35.64112625298381, -82.70690263778008 35.641087252958634, -82.70664663775939 35.64094525290339, -82.70636363771989 35.64089525286421, -82.705562637583 35.64091725278646, -82.70525263753811 35.64087325274566, -82.70480863748857 35.640714252667706, -82.70451263745862 35.640588252611614, -82.70435063744786 35.640483252573546, -82.70423663746179 35.64026925251818, -82.70407463746778 35.640055252457906, -82.70383863746474 35.63981925238559, -82.70351563744237 35.63961525231078, -82.70307863741598 35.639313252204445, -82.70285663739334 35.63922025216264, -82.7025596373523 35.639165252120954, -82.70235163732175 35.6391382520941, -82.70192063724484 35.63917125205663, -82.70162463720068 35.63913825201944, -82.70131463716586 35.639028251965215, -82.70117963714513 35.63901725194909, -82.70105863712156 35.639039251941185, -82.70095163709355 35.639105251943626, -82.70091063707316 35.63919325195742, -82.70088363704755 35.63933025198254, -82.70083663702619 35.639418251995714, -82.70076263700972 35.63944525199365, -82.70069563700099 35.63942925198348, -82.70064863699906 35.63939125197087, -82.70056063699205 35.6393412519517, -82.70043963697529 35.63931925193471, -82.70027163694641 35.6393252519187, -82.69990763687817 35.639374251891375, -82.69963163682277 35.63943525187549, -82.69946263678274 35.63951225187386, -82.69942963677477 35.63952825187377, -82.69926863673099 35.63963825187962, -82.69916063669699 35.63974225188972, -82.6989656366543 35.639808251883224, -82.69871663660606 35.639852251866586, -82.69812463648367 35.64000625183722, -82.69786863643421 35.640050251819964, -82.69761963639515 35.640034251791164, -82.69745063637644 35.63997325176134, -82.69726963636393 35.63985825171934, -82.69710163634278 35.639814251693096, -82.69696663632102 35.63980925167824, -82.69675763628037 35.63984725166452, -82.69653563623146 35.63992425165749, -82.69629363618358 35.63997325164258, -82.6961186361569 35.639957251621404, -82.6956466360901 35.63988025155721, -82.69554263606938 35.63990225155099, -82.69541163604323 35.63993025154332, -82.695303636027 35.63991925153006, -82.69510163599926 35.63988025150125, -82.69502163598484 35.63988725149455, -82.69498063597743 35.63989125149113, -82.6948326359477 35.63992425148263, -82.694657635905 35.640012251482624, -82.69450963584396 35.64024825151559, -82.69430763578394 35.64041925152965, -82.69417963571446 35.64073225158036, -82.69408163565235 35.64102925163088, -82.6940246356158 35.64120525166095, -82.69391363554718 35.64153025171582, -82.69386963554476 35.64149825170479, -82.69373863553761 35.64140325167193, -82.69369563553514 35.64137225166119, -82.69362163553578 35.64128825163649, -82.69361163553643 35.641273251632406, -82.69355063554065 35.64118025160719, -82.69350563554968 35.64107225158054, -82.69346563556573 35.64092525154646, -82.6934646355666 35.64091825154497, -82.69345163558417 35.64079025151745, -82.69342863561569 35.640561251468434, -82.69344263564912 35.640359251428634, -82.69344763565974 35.640295251416184, -82.69347263568632 35.64015025138913, -82.69349863570692 35.64004425137014, -82.69351963572889 35.6399242513479, -82.69352963575484 35.63976625131666, -82.69354763577782 35.63963725129225, -82.69354963579289 35.63954125127287, -82.69358863583764 35.63929325122632, -82.69363563586566 35.639162251204354, -82.69365863588085 35.639088251191694, -82.69368463589763 35.639007251177794, -82.69376163594299 35.638796251142686, -82.69381163596842 35.63868525112517, -82.6938346359803 35.63863325111693, -82.69385863599736 35.638548251102065, -82.69389663602372 35.63841825107941, -82.6939486360515 35.638294251059484, -82.69401463608341 35.638158251038504, -82.6940236360865 35.638148251037485, -82.69411163611406 35.63806425102932, -82.69413063611921 35.63805125102863, -82.69421763614275 35.63799225102554, -82.69433163617208 35.63792525102357, -82.69436363618021 35.63790725102321, -82.69440263619012 35.63788525102275, -82.69496663632272 35.637634251029354, -82.69497963632598 35.63762725102931, -82.69519363637754 35.63752425103027, -82.69512763639511 35.63733825098554, -82.69499863646159 35.63676725085592, -82.69494163647752 35.63660225081641, -82.69493563647913 35.63658525081231, -82.69487863649863 35.63639725076808, -82.6948626365207 35.63623625073361, -82.69488263655167 35.63605725069921, -82.6949256365923 35.635839250659146, -82.69490363665801 35.635389250565176, -82.69484263669789 35.63506425049261, -82.69478663672517 35.634826250438245, -82.69471963675286 35.63457425038016, -82.6946146367717 35.63433825032117, -82.69450663678236 35.6341522502721, -82.69449363678366 35.634129250266106, -82.69430163678187 35.63393325020639, -82.69427563678039 35.633915250200104, -82.69416263677321 35.63383925017307, -82.69396263676082 35.633703250124704, -82.69381963675367 35.63359525008806, -82.69355963673475 35.6334362500289, -82.69347863672859 35.633389250011085, -82.69323963671023 35.63324924995792, -82.69316863670336 35.63321724994418, -82.69283263667097 35.633064249878466, -82.69253663664163 35.632934249821616, -82.69223963661463 35.632788249761305, -82.69220663661213 35.632769249754055, -82.69199363659456 35.63265224970838, -82.69189463658553 35.6326042496884, -82.69178163657496 35.632550249665776, -82.69170863657163 35.63249324964672, -82.69167063656978 35.63246424963685, -82.69156663655997 35.63241524961624, -82.69145363654332 35.63240124960174, -82.69126363650841 35.63242224958659, -82.69108563647238 35.63246324957667, -82.69101263645764 35.63248024957255, -82.69087963642794 35.63252924956899, -82.69072563639354 35.632586249564746, -82.69059263636301 35.63264024956216, -82.69048563633845 35.632684249560114, -82.69016463627402 35.63275524954162, -82.6898626362196 35.632782249516126, -82.68968863618997 35.63278624949911, -82.68965063618336 35.63278824949557, -82.68938263613632 35.63280324947123, -82.68910263608744 35.632818249445506, -82.68885563604405 35.63283224942299, -82.68864963600434 35.632867249408974, -82.68852763597761 35.632909249405074, -82.68838163593988 35.63299624940776, -82.68831763592108 35.63304924941205, -82.68824763590014 35.633109249417124, -82.68811263585881 35.63323124942816, -82.6881086358577 35.633234249428305, -82.68804263583861 35.633287249432335, -82.68801863583145 35.63330724943393, -82.68784263578576 35.633414249437685, -82.68782663578243 35.63341824943692, -82.68774663576511 35.63344424943402, -82.6877436357621 35.63346024943689, -82.68772763575485 35.63349024944144, -82.68765963572244 35.63362724946236, -82.68762263571095 35.633661249465504, -82.68753263568328 35.633744249473196, -82.68724863560999 35.633912249478314, -82.68723763560769 35.63391524947777, -82.68710763557837 35.63396524947461, -82.68695563554583 35.63401224946862, -82.68678563551408 35.634034249455695, -82.68658963548152 35.63403324943528, -82.68638363545067 35.63401124940968, -82.68612063541315 35.63397024937435, -82.68587463537948 35.633923249339496, -82.6854206353172 35.63383624927515, -82.68516863528353 35.633782249238244, -82.68515263528153 35.63377824923582, -82.68477463522994 35.63370424918192, -82.68455963520263 35.63364924914869, -82.68437763518054 35.63359524911898, -82.68435563517828 35.63358624911487, -82.68416963515826 35.6335152490813, -82.68410263515172 35.63348524906827, -82.68399163514076 35.63343624904693, -82.68392763513442 35.63340824903463, -82.68365663510684 35.63329424898355, -82.68362963510401 35.63328324897861, -82.68354763509663 35.63324224896179, -82.68344563508752 35.63319124894093, -82.68314163506042 35.63303824887852, -82.68307763505469 35.63300624886541, -82.68304063505148 35.63298724885779, -82.68294463504334 35.632936248837545, -82.68286763503671 35.63289624882143, -82.68267563501405 35.632835248789284, -82.6826396350089 35.63283024878461, -82.68258663500116 35.6328232487777, -82.68253263499149 35.63282724877297, -82.68244463497577 35.63283424876534, -82.68242563497199 35.632838248764244, -82.68234063495491 35.632857248759485, -82.68224663493108 35.63291024876053, -82.68217463491021 35.63296824876497, -82.68215163490262 35.632992248767565, -82.68207963487849 35.63307124877623, -82.68203563486394 35.63311824878136, -82.68191863482454 35.633247248795605, -82.68190363481963 35.63326324879732, -82.68186163480502 35.63331224880303, -82.68173763476237 35.633455248819416, -82.6816016347154 35.633613248837726, -82.68136063463444 35.633878248866985, -82.68123363459158 35.6340192488827, -82.68119963458034 35.634055248886575, -82.68110063454702 35.63416424889862, -82.6810676345359 35.63420124890277, -82.68098763450948 35.63428624891186, -82.68098363450801 35.63429124891253, -82.68074463442998 35.63453924893853, -82.68066363440339 35.634624248947624, -82.68036463430445 35.63494324898191, -82.68012363422336 35.63520924901137, -82.6799526341656 35.635399249032616, -82.67944663399246 35.63597624909832, -82.67926563393368 35.63616224911764, -82.67912663389508 35.63626224912371, -82.67885063382404 35.63642524912866, -82.67840663371574 35.63664824912849, -82.67829463369227 35.636679249123326, -82.6782126336749 35.6367032491198, -82.67805063364412 35.63672824910831, -82.67774363359237 35.63673224907756, -82.67753263355623 35.63673824905712, -82.67750463355067 35.63674424905551, -82.67737663352553 35.636769249047425, -82.67717863348291 35.63683124903976, -82.67701163344425 35.63690224903714, -82.67674963337758 35.637051249040546, -82.6765816333327 35.637161249045775, -82.6764346332872 35.63729724905836, -82.67624363322591 35.63748924907801, -82.6761616331981 35.637581249088285, -82.67611263318159 35.63763524909427, -82.67607363316866 35.63767724909882, -82.67605163315969 35.637711249103475, -82.67591363310497 35.63791724913136, -82.67573863302643 35.63823824917878, -82.67557863294623 35.638585249233095, -82.67533363279912 35.639275249348586, -82.67529563276861 35.63943224937676, -82.67527263274184 35.63958124940477, -82.67524263269526 35.6398512494567, -82.67521163267175 35.63997024947777, -82.6751666326509 35.64005724949091, -82.67509763262579 35.640145249501785, -82.675021632599 35.64023724951269, -82.6748766325537 35.640374249525784, -82.67458863246408 35.64064424955128, -82.67455763245434 35.640674249554195, -82.67450363243704 35.640728249559636, -82.6744896324325 35.64074224956108, -82.67448963243363 35.64073524955963, -82.67436663244607 35.64052124950335, -82.67433063244856 35.64046624948847, -82.67417163245896 35.640227249423376, -82.67411863246222 35.6401482494019, -82.67396263247248 35.63991324933795, -82.67391063247591 35.639835249316704, -82.67377963248451 35.63963724926283, -82.67349663248407 35.63933424917208, -82.67295363248321 35.63875324899783, -82.67278363248148 35.63858024894512, -82.6721786324755 35.63796524875767, -82.67214163247492 35.6379292487465, -82.67167763246785 35.637473248605936, -82.67163463246729 35.63743024859276, -82.67096663246222 35.6367412483837, -82.67089763246163 35.63667024836213, -82.67053963245786 35.636308248251574, -82.67035663245568 35.63612424819523, -82.67020163245407 35.63596724814729, -82.66987363245056 35.63563524804601, -82.66943163245287 35.63514224790006, -82.66900863248722 35.634462247718076, -82.6689866324891 35.63442624770842, -82.6685246325319 35.63364924750263, -82.6684656325373 35.63355024747641, -82.66814463256652 35.63301324733399, -82.66758563261777 35.63207624708559, -82.66721763266294 35.631385246906945, -82.66720663266433 35.63136424690149, -82.66695963270436 35.63083724676871, -82.66694963270508 35.63082224676465, -82.66700363271315 35.63082824677144, -82.6670896327266 35.63083324678128, -82.66743063278572 35.630818246813185, -82.66754163280487 35.63081424682378, -82.66782063285522 35.63078924684732, -82.66800463289115 35.63075424685912, -82.66824463294161 35.63068624686985, -82.66852063300094 35.63059924688047, -82.66883163306889 35.630494246890954, -82.66885263307333 35.63048824689192, -82.66928663316905 35.63033624690549, -82.66988663330142 35.63012524692406, -82.670279633388 35.6299882469365, -82.67080163350353 35.62980224695212, -82.67129763361456 35.629618246965535, -82.67155063366975 35.629533246974205, -82.67168963369829 35.6294982469813, -82.67172863370618 35.62948924698345, -82.67186763373219 35.629470246993925, -82.67199163375412 35.62946224700496, -82.67215563378062 35.62946724702283, -82.6723226338057 35.62948524704366, -82.67242163382069 35.62949524705588, -82.6727926338746 35.62954624710432, -82.67319963393352 35.62960324715773, -82.6735856339904 35.629651247207114, -82.67399463405252 35.62969024725709, -82.67420963408694 35.62969924728097, -82.67438363411459 35.6297082473007, -82.67468463416559 35.62970224733035, -82.67479463418503 35.62969524734016, -82.67485763419593 35.62969224734605, -82.67503563422726 35.629681247362086, -82.67512763424399 35.629672247369655, -82.67523863426386 35.62966324737928, -82.67549663431147 35.62963324739962, -82.67550063431227 35.629632247399876, -82.67571663435393 35.62959524741448, -82.67591563439727 35.62952924742144, -82.67609263443873 35.62945124742371, -82.67623863447632 35.629365247421156, -82.67632763449896 35.629314247419835, -82.67646363453501 35.629227247416104, -82.67657963456594 35.62915224741269, -82.67677963462434 35.628989247400014, -82.67679863462959 35.62897524739912, -82.67692763466978 35.6288542473877, -82.67701563469977 35.62875424737629, -82.67708963473142 35.628629247358454, -82.67739963488124 35.62799124726017, -82.67749463492697 35.62779724723035, -82.67757463496501 35.627636247205736, -82.67762163498753 35.62754124719124, -82.67766463500791 35.62745524717812, -82.67775663505417 35.62725424714657, -82.67780163507634 35.627159247131836, -82.67793563513824 35.62690224709317, -82.67803663517738 35.62675724707396, -82.67807463519185 35.62670424706707, -82.67810763520166 35.626676247064786, -82.67824663524358 35.626554247054116, -82.67842163529058 35.626438247048426, -82.67861063533765 35.62633724704724, -82.67884763539375 35.626229247049594, -82.67909663545109 35.62612624705415, -82.67923963548314 35.626072247057834, -82.67967763558092 35.6259112470699, -82.67975363559819 35.625881247071604, -82.67998363564972 35.62579524707763, -82.68006063566699 35.62576624707971, -82.68014363568565 35.62573524708183, -82.68020263569923 35.62571024708281, -82.68040863574682 35.62562424708641, -82.68049563576858 35.62557724708575, -82.6805806357923 35.62551524708187, -82.68060063579932 35.625491247079005, -82.6806686358223 35.62541524707047, -82.68069063583307 35.62536924706341, -82.68028163577114 35.62532924701323, -82.67980463570125 35.62526724695173, -82.67970863568723 35.6252542469392, -82.67763263538275 35.62498624667143, -82.67676863525577 35.62487624656038, -82.67611563515963 35.624794246476604, -82.67579163511445 35.62473724643175, -82.67559763508942 35.624690246402224, -82.67545363507284 35.62464224637773, -82.67526763505462 35.624559246341654, -82.67512463504323 35.62447824631049, -82.67506863504005 35.62443824629661, -82.67499363503578 35.62438524627807, -82.67481063502989 35.624225246226715, -82.67465163503176 35.624041246172915, -82.6744196350412 35.62372924608547, -82.67419663504268 35.623478246011366, -82.67396363503222 35.623294245949936, -82.67373663501701 35.62314724589668, -82.67332663497821 35.62295624581571, -82.6732896349743 35.62294124580881, -82.67311863495604 35.62287524577787, -82.67293463493642 35.62280324574429, -82.67255363489454 35.62266324567657, -82.6719566348295 35.62244024556985, -82.6717886348112 35.62237724553979, -82.67131663475985 35.622200245455325, -82.67019163463888 35.62176924525197, -82.66949863456361 35.6215082451276, -82.66873463448049 35.62122224499091, -82.6685716344624 35.621163244962176, -82.66827763442978 35.621057244910354, -82.66808463440456 35.621012244881456, -82.66807763440356 35.621011244880435, -82.66790763437878 35.6209882448583, -82.66822463449654 35.62056624480487, -82.66853263462252 35.62008124473763, -82.66877163473833 35.61958724466142, -82.66890163483264 35.61911524457856, -82.66895263487743 35.618879244535655, -82.66898663490731 35.618722244507126, -82.66906263497688 35.618352244439535, -82.66917663507348 35.617848244348515, -82.6692226351051 35.61769224432137, -82.6694596352891 35.616753244154324, -82.6695816353762 35.61631924407842, -82.66962763540806 35.61616224405104, -82.6696806354398 35.61601324402613, -82.66974963547473 35.615861244002225, -82.66983363551165 35.61571224398053, -82.66992463554719 35.6155792439627, -82.67001663558084 35.61546024394791, -82.67013063561868 35.615338243934794, -82.67015363562477 35.615323243934085, -82.6703216356744 35.61518224392258, -82.67048963572303 35.61504824391243, -82.67071063578443 35.614888243902534, -82.67093163584482 35.614735243893996, -82.67129063593845 35.61451424388575, -82.67150363599383 35.61438524388138, -82.6719236361009 35.61414424387534, -82.6726786362965 35.61369024386023, -82.67301363638026 35.613508243857545, -82.67306063639188 35.61348324385722, -82.67338663647136 35.61331924385727, -82.67368663656643 35.613026243828294, -82.67394563667024 35.61263224377457, -82.67406663672836 35.6123852437366, -82.67410963674618 35.612316243726944, -82.6741416367584 35.61227124372105, -82.67417663677111 35.61222624371547, -82.67425263679745 35.61213724370519, -82.67427063680356 35.612117243702976, -82.67439163684324 35.61199024368946, -82.6746506369256 35.61173524366401, -82.6747036369429 35.611680243658306, -82.67480063697398 35.611583243648404, -82.67563363710222 35.611651243747765, -82.67645063724756 35.61159024381914, -82.676816637325 35.61148324383488, -82.67686563733433 35.611476243838524, -82.67690763734315 35.61146424384035, -82.67697463735983 35.61142824383988, -82.67699663736606 35.6114112438387, -82.67702763737711 35.611373243834144, -82.67708263740013 35.611283243821404, -82.67720763746478 35.61099824377613, -82.67728763751226 35.61077624373911, -82.67731763753372 35.61066924372036, -82.67743963762862 35.61018424363404, -82.6774916376657 35.60999924360163, -82.67758763772098 35.60974424355952, -82.67764063774453 35.60964824354532, -82.67772363777571 35.60953524353079, -82.67780263780332 35.609441243519804, -82.67792063784269 35.60931324350583, -82.6780116378725 35.609218243495725, -82.678118637907 35.60910924348458, -82.6784886380274 35.608727243444605, -82.67865463808401 35.608539243423316, -82.67872963811233 35.608436243410004, -82.67876563812892 35.60836724339968, -82.67881963815805 35.60823624337845, -82.67885563818622 35.608092243352765, -82.67890963825107 35.60772924328437, -82.67892163826087 35.60767824327516, -82.67895563828856 35.607535243249544, -82.67903863835389 35.60720024318974, -82.67905763837126 35.60710824317293, -82.67908363839372 35.6069902431515, -82.67908863839838 35.606965243146945, -82.67910963842006 35.60684724312502, -82.67911863842916 35.60679724311578, -82.67917163847666 35.60654624307004, -82.67918463848665 35.606495243060934, -82.67921663850967 35.60638024304078, -82.67893263848097 35.606259242987, -82.67877863846536 35.60619424295799, -82.67858163844241 35.6061302429247, -82.67834463841201 35.60607124288835, -82.67809263837651 35.60602924285394, -82.67804163836894 35.60602324284748, -82.67773563832323 35.60598924280915, -82.67720563824268 35.60593924274459, -82.67708063822359 35.60592824272958, -82.67675863817256 35.60591124269307, -82.67654163813916 35.60589324266715, -82.67582963802738 35.60584924258507, -82.67561463799464 35.605829242559004, -82.6754586379709 35.60581524254016, -82.67523963793988 35.605779242510295, -82.67509063792008 35.605747242488505, -82.67496763790372 35.605720242470426, -82.6748016378816 35.605684242446074, -82.6747226378709 35.605668242434646, -82.67450063783383 35.60566924241211, -82.67438663781333 35.60567924240242, -82.67426463779049 35.60569524239313, -82.6741266377611 35.60573724238758, -82.6739296377214 35.60578224237652, -82.67380663769646 35.605811242369796, -82.67363963766493 35.605835242357536, -82.67352863764431 35.605849242349066, -82.67344263762816 35.60586124234266, -82.6731956375843 35.605879242320995, -82.67308463756437 35.60588824231149, -82.67291563753503 35.60589624229572, -82.67260163748365 35.60589024226231, -82.67249163746662 35.60588224224938, -82.67243563745869 35.605873242241834, -82.67234963744616 35.60586124223055, -82.67220463742726 35.605827242208775, -82.67204663740922 35.605773242181534, -82.67157363735944 35.60558524209469, -82.6714156373434 35.605518242064804, -82.671225637326 35.605426242026574, -82.67109263731291 35.605367242000874, -82.67097663729834 35.60533624198266, -82.67091363728828 35.605333241975565, -82.67086363727874 35.60534124197214, -82.67080763726801 35.605350241968225, -82.67075363725675 35.60536524196569, -82.67070363724503 35.60538724196509, -82.67065663723243 35.605418241966554, -82.67062163722144 35.6054522419699, -82.67061363721872 35.60546124197091, -82.6705726372037 35.60551424197753, -82.67054163719041 35.60556724198517, -82.67051263717579 35.60563124199527, -82.67047563715141 35.60574924201548, -82.67039463709098 35.60605424206933, -82.67015363690335 35.607013242240114, -82.67002863679684 35.60757024234082, -82.66999363676655 35.60772924236965, -82.66988863666585 35.60827024246914, -82.66985163663925 35.608403242492464, -82.66980663661208 35.608531242513884, -82.66976063658852 35.60863424253025, -82.66970763656371 35.60873824254596, -82.66948063646947 35.609105242597494, -82.66933863641081 35.6093332426294, -82.66918863634353 35.6096082426701, -82.66909763629512 35.60982424270477, -82.66906163627355 35.60992524272164, -82.66903663625403 35.61002524273944, -82.66900363621812 35.61022324277645, -82.66899863618751 35.610416242815276, -82.66900763616752 35.61055624284473, -82.6690396361402 35.610768242891204, -82.6691116361174 35.610994242944706, -82.66921563609093 35.61127824301329, -82.66925863607497 35.611429243048455, -82.66927763606368 35.61152324306953, -82.66928763604837 35.61163324309302, -82.66928463602838 35.61176024311855, -82.66927263600608 35.61189224314418, -82.66925963598976 35.61198424316168, -82.66925363598165 35.6120302431704, -82.66922363596164 35.61212824318731, -82.66920563594964 35.612186243197314, -82.6691486359234 35.61229524321367, -82.66908063589872 35.6123822432244, -82.66901263587641 35.61245324323193, -82.668923635851 35.61252224323684, -82.66881163582171 35.61259124323945, -82.66868063578984 35.61265724323943, -82.66841363573069 35.61275224323139, -82.66808463566012 35.61285524321861, -82.66773063558419 35.61296524320474, -82.6673416355016 35.61308124318846, -82.66695263541885 35.61319824317235, -82.66660063534414 35.61330324315769, -82.66644263531147 35.61334424314982, -82.66639663530182 35.61335724314779, -82.66619163526335 35.61338524313242, -82.66601363523178 35.61339824311679, -82.66579563519528 35.61339924309466, -82.66563663517009 35.61339124307669, -82.66496063507273 35.613292242987136, -82.66486263505875 35.61327724297403, -82.66433863498322 35.61320124290482, -82.66425863497179 35.61318924289413, -82.66420163496352 35.61318124288667, -82.66402063493707 35.613157242863146, -82.66394163492546 35.61314724285299, -82.66335063483906 35.613069242776476, -82.66297163478431 35.613015242726576, -82.66221463467723 35.612892242623815, -82.66185363462753 35.61282424257295, -82.66146563457556 35.61274224251634, -82.66023863441784 35.61244024232894, -82.66010963440196 35.612404242308344, -82.65942663431623 35.61222224220109, -82.65930963430063 35.612197242184074, -82.6591866342825 35.61218224216838, -82.65908063426527 35.61217924215688, -82.65891763423743 35.61218424214118, -82.65876463420994 35.61219724212807, -82.65862863418434 35.61221624211798, -82.65845563415097 35.61224624210641, -82.65828963411748 35.612284242097125, -82.65815963408996 35.6123222420915, -82.65804463406326 35.612371242089736, -82.65793763403492 35.61244024209278, -82.65785663401034 35.61251224209916, -82.65783163399968 35.61255424210511, -82.65780963399015 35.61259224211066, -82.65780163398499 35.612617242114894, -82.65778663397445 35.61266924212396, -82.65778463396052 35.61275824214185, -82.65779463395168 35.61282624215675, -82.6577996339485 35.61285224216257, -82.65781063394368 35.612895242172456, -82.65783563393445 35.61298224219282, -82.65786863392627 35.613071242214346, -82.65793363391042 35.613244242256194, -82.65796963389874 35.61335924228336, -82.65800963388186 35.61351224231863, -82.65802863387076 35.61360524233959, -82.65805363385671 35.613723242366184, -82.65806363384837 35.61378824238046, -82.6580806338344 35.61389724240443, -82.6580826338337 35.613904242406065, -82.65810763380122 35.614142242457135, -82.6581116337888 35.614227242474826, -82.65811863377284 35.61433824249817, -82.6581186337527 35.614469242524855, -82.65811463374726 35.61450024253083, -82.65809963372112 35.61465424256064, -82.65806963368438 35.61486024259955, -82.65804163366106 35.61498124262131, -82.65802963365036 35.61503824263177, -82.65800063363005 35.61513824264917, -82.65798463361847 35.61519624265931, -82.65787963356085 35.61545724270176, -82.65775063349832 35.61572424274295, -82.65773963349275 35.61574824274671, -82.65765463345333 35.615912242771415, -82.65756663341507 35.616066242793714, -82.65741763335608 35.61628824282367, -82.65711063324743 35.616662242868415, -82.65660963307285 35.617254242937676, -82.6565356330468 35.61734324294823, -82.65620263292939 35.61774624299618, -82.65606663288305 35.617900243013594, -82.65598663285552 35.61799224302414, -82.65579763279592 35.618175243041975, -82.6556206327431 35.618327243054836, -82.6554656326965 35.61846224306648, -82.65537363266834 35.61854524307389, -82.65527563263527 35.61865424308606, -82.65521163261187 35.61873724309641, -82.65516463259368 35.6188042431052, -82.65515463258956 35.61882024310746, -82.65506763255047 35.61898024313114, -82.65501763252503 35.6190912431486, -82.6549836325054 35.61918224316372, -82.65495163248376 35.61928824318204, -82.65489663243805 35.61952524322469, -82.65488563242828 35.61957724323415, -82.65487063241311 35.61965924324935, -82.65481463233839 35.6200842433302, -82.65480863233256 35.62011524333594, -82.65473863225982 35.62051224340966, -82.65472363224934 35.62056424341866, -82.65460463223374 35.62053724340097, -82.65459163223186 35.62053524339921, -82.6544596322126 35.62051724338198, -82.6544136322059 35.62051124337604, -82.65430863218505 35.620533243369806, -82.65420563215886 35.62059224337123, -82.65419263215526 35.62060124337175, -82.65413663214 35.62063924337373, -82.65409363212856 35.62066724337503, -82.65391263212302 35.62050824332402, -82.65380963212367 35.62039224328977, -82.6535656321154 35.62018224322192, -82.65350363211341 35.62012824320456, -82.6533406321108 35.619969243155474, -82.65315263211028 35.61976924309541, -82.65299763211296 35.61958424304177, -82.6529186321175 35.619469243010236, -82.65286163212083 35.6193862429875, -82.6526586321292 35.619112242910774, -82.65255763213214 35.61898424287436, -82.65221363214164 35.61855024275054, -82.6521966321421 35.61852924274455, -82.65214163214353 35.61846024272487, -82.65190263214444 35.61819624264648, -82.65174163214334 35.61802924259595, -82.65171663214394 35.61799824258702, -82.65158963214634 35.617845242542785, -82.65158863214637 35.6178442425425, -82.65144863214677 35.61769024249674, -82.65143363214683 35.617673242491755, -82.65126963214588 35.6175022424401, -82.65117863214375 35.61741824241359, -82.65117663214355 35.61741724241317, -82.65109663214176 35.61734224238975, -82.65102963213941 35.6172852423712, -82.65081063213199 35.61709624231022, -82.6500416320955 35.61650224211021, -82.64983663208571 35.61634424205697, -82.64923363205864 35.61586824189809, -82.64757263199031 35.61451624145209, -82.6470876319672 35.61414224132605, -82.64652063193996 35.61370624117902, -82.64617763192244 35.61344924109145, -82.64608163191647 35.613384241068296, -82.64592463190662 35.61327824103063, -82.64565163188556 35.61312024097037, -82.6453966318619 35.612998240919374, -82.64530463185325 35.61295524090113, -82.64505463182748 35.61285224085446, -82.64481063180024 35.61276524081172, -82.64454963176857 35.612689240769406, -82.64405463170249 35.61258324069701, -82.6438256316696 35.6125492406666, -82.64357263163204 35.612520240634716, -82.64331963159356 35.61249624060382, -82.64310763156011 35.612484240579676, -82.64303163154813 35.61248024057106, -82.64271263149628 35.61247224053665, -82.6424466314517 35.6124742405098, -82.64233863143316 35.61247824049949, -82.64232163143016 35.61247924049801, -82.64218563140682 35.61248424048503, -82.6421636314029 35.61248524048298, -82.6418686313511 35.61250324045631, -82.64177963133507 35.612511240448804, -82.64164463131053 35.61252424043768, -82.64162163130645 35.61252624043564, -82.64146963127808 35.61254624042417, -82.64136463125833 35.61256124041641, -82.64095063117931 35.6126272403874, -82.64094563117847 35.61262724038687, -82.64077363114426 35.612663240376584, -82.64060963111145 35.61269924036707, -82.64042263107378 35.61274224035662, -82.64012463101172 35.61282324034254, -82.63996363097793 35.61286824033517, -82.63969063092006 35.61294924032361, -82.63963263090766 35.612967240321396, -82.63864563069552 35.61327824028347, -82.63831663062483 35.613382240270866, -82.63819663059898 35.613420240266265, -82.6378976305365 35.61350324025251, -82.63775163050573 35.61354524024604, -82.6374786304497 35.613614240232046, -82.63714463038323 35.6136852402122, -82.63676863031203 35.6137412401851, -82.63661763028449 35.61375724017287, -82.6365126302651 35.613769240164544, -82.63618463020596 35.61379924013697, -82.63609863019086 35.61380424012912, -82.6359666301677 35.61381224011723, -82.63584063014609 35.613816240105095, -82.63575563013131 35.61382024009721, -82.63559963010518 35.61382124008144, -82.63542863007648 35.61382324006421, -82.6351346300282 35.61381924003322, -82.63511663002515 35.61381924003137, -82.6349796300033 35.61381324001606, -82.63490162999092 35.61380924000731, -82.63487862998709 35.61380924000495, -82.63485562998324 35.61380924000258, -82.63467062995466 35.61379523998068, -82.63461062994524 35.61379123997372, -82.63459362994284 35.6137892399716, -82.63442662991766 35.61377223995095, -82.63433862990428 35.61376423994033, -82.63409862986859 35.61373623990997, -82.63392662984384 35.61371123988721, -82.63383962983124 35.61369923987583, -82.63376162982027 35.61368623986518, -82.6335786297943 35.61365723984046, -82.63351462978554 35.61364423983126, -82.63333562976136 35.613608239805565, -82.63302062972018 35.61353523975832, -82.63281062969271 35.613487239726986, -82.63278362968931 35.61348023972275, -82.63254262965891 35.61341723968516, -82.63226462962547 35.613334239639734, -82.63191162958962 35.61318523957314, -82.63185162958332 35.613161239562096, -82.63163662956036 35.61307823952315, -82.6313846295362 35.61296323947385, -82.63092762949753 35.6127202393774, -82.63078862948674 35.612640239346824, -82.63046662946323 35.61244523927406, -82.63025462944965 35.612304239223576, -82.63004462943829 35.612151239170785, -82.6299376294331 35.61206923914316, -82.62984062942844 35.611994239117834, -82.62936962941083 35.61160023898923, -82.62911862940432 35.61137123891682, -82.62877762939928 35.611035238813365, -82.62875462939893 35.61101323880654, -82.62856962939819 35.61081823874779, -82.62810762940337 35.61028523859179, -82.62792362940897 35.61005023852504, -82.6275466294266 35.60952823837993, -82.62737162944073 35.60924723830476, -82.62727962944835 35.60909823826495, -82.62722062945335 35.60900223823931, -82.62704562947147 35.608695238158816, -82.62688462949279 35.608383238078744, -82.62669962951473 35.608040237989826, -82.62636162959329 35.607165237776876, -82.62630262960806 35.60700523773817, -82.62616262964374 35.60662223764587, -82.6261396296493 35.606561237631034, -82.62616262966604 35.60647723761634, -82.62607062968787 35.60623623755778, -82.6260296296966 35.606135237532925, -82.62588062972902 35.605763237441856, -82.62579062974821 35.60554123738739, -82.62571462977083 35.605312237332946, -82.62554762980633 35.60490123723204, -82.62554262980736 35.6048892372291, -82.62550162981373 35.60480323720738, -82.62547962981738 35.60475623719552, -82.62536362983607 35.60450923713334, -82.62531762984334 35.60441223710885, -82.62524562985449 35.60426223707091, -82.62523162985597 35.60423723706436, -82.62495162988712 35.60373223693273, -82.62494762988743 35.60372623693109, -82.62484262989511 35.60356223688691, -82.6246876299067 35.60332023682168, -82.62467662990727 35.60330423681732, -82.62453062991533 35.60309423675953, -82.62424262992714 35.602706236650896, -82.62413262993059 35.60256523661095, -82.62413162993072 35.60256323661042, -82.62394562993659 35.60232423654262, -82.62363462994652 35.60192323642899, -82.62356662994863 35.601836236404345, -82.62335362995692 35.601552236324544, -82.62315762996678 35.601276236248225, -82.62303362997544 35.60108623619685, -82.62278662999499 35.600692236091156, -82.62277462999621 35.600671236085645, -82.62258163001778 35.60032223599481, -82.62253163002397 35.60022823597046, -82.62246963003163 35.60011123594033, -82.62230263005222 35.599797235859164, -82.62228263005424 35.59976223584997, -82.62221763006097 35.59964823582013, -82.62251363009773 35.59972923586698, -82.62251563009823 35.599728235866976, -82.62275963014098 35.59971423588915, -82.62312063021311 35.599635235910135, -82.62342263027769 35.599542235922144, -82.62343363028 35.599539235922705, -82.62372863033627 35.599492235943366, -82.62370163034251 35.59942223592635, -82.62366263035776 35.59928123589363, -82.62364263036854 35.599189235872856, -82.62357863040538 35.59888123580357, -82.62350363044855 35.5985192357221, -82.623466630463 35.59838523569101, -82.6234276304741 35.5982712356638, -82.6234166304775 35.59823723565568, -82.6233436304877 35.59809223561869, -82.6232786304916 35.59799623559244, -82.62324463049347 35.597947235579, -82.62322963049374 35.59792923557376, -82.62307463049737 35.59773823551894, -82.62302363049861 35.597675235500894, -82.62305263050652 35.59765523549984, -82.62309163051468 35.59764423550155, -82.62315263052419 35.597648235508665, -82.62316563052627 35.59764923551017, -82.6234086305626 35.5976752355404, -82.6235616305852 35.59769423555996, -82.62360163059083 35.59770023556533, -82.62369763060471 35.59771423557799, -82.62370363060467 35.59772123558003, -82.62383163061153 35.59781423561212, -82.62448463069568 35.597973235711564, -82.62470663071814 35.59806723575355, -82.6248176307214 35.59816623578504, -82.62484163072217 35.598187235791826, -82.62491563072592 35.59824223581056, -82.62520163074352 35.598437235879636, -82.62599563083064 35.59872923602066, -82.62629863085392 35.59890523608761, -82.62680363090064 35.59914723618873, -82.62732763094921 35.59939823629364, -82.62740163095611 35.59943323630836, -82.62812063104603 35.59962623642147, -82.62817263105123 35.59964823643131, -82.6284846310821 35.59978523649124, -82.62882963113053 35.59984323653846, -82.62917063117831 35.59990123658535, -82.62935463119952 35.59996223661662, -82.62937163119386 35.60001723662955, -82.62937263119359 35.60002023663019, -82.62941263118421 35.60012423665554, -82.62943963118057 35.60017723666917, -82.6294486311794 35.6001942366735, -82.6294716311784 35.600226236682445, -82.62953263117716 35.600300236703724, -82.62960663118002 35.60036123672379, -82.62971963118869 35.600427236748786, -82.62982563119827 35.6004792367703, -82.62983463119902 35.600484236772196, -82.63005963122154 35.600581236815046, -82.63036163125089 35.600717236873784, -82.63066963128162 35.60085023693248, -82.63091663130773 35.600947236977575, -82.63104563132185 35.60099523700065, -82.63113963133182 35.60103123701756, -82.63138463135604 35.60113923706478, -82.63144963136133 35.60117523707876, -82.6315736313715 35.60124323710531, -82.63160163137304 35.6012632371123, -82.63175963138197 35.601376237151506, -82.63195863139322 35.60151823720088, -82.63203863139944 35.60156423721845, -82.63219163141116 35.601653237252314, -82.6323176314212 35.60172423727964, -82.63243663143066 35.601791237305555, -82.63254663143849 35.601859237330764, -82.63265063144414 35.60193523735683, -82.63268063144514 35.601961237365224, -82.63279163144892 35.602056237395985, -82.63293163147158 35.602060237411195, -82.63309063149718 35.60206623742868, -82.6333536315412 35.60206423745525, -82.63349463156484 35.60206323746959, -82.63356963156805 35.60212323748949, -82.6337036315777 35.6022052375199, -82.63404663161357 35.602343237583234, -82.63447763166782 35.60245623765052, -82.6345006316707 35.60246223765408, -82.63513663175084 35.602629237753376, -82.63557363179564 35.602810237835136, -82.63595063182284 35.60304123792088, -82.63704763192823 35.60354223813552, -82.63738063194866 35.60376923821603, -82.6376996319682 35.60398723829313, -82.63791463198963 35.60408023833413, -82.63813663200116 35.604245238390575, -82.63829363201648 35.60431523842094, -82.63889663207522 35.6045862385381, -82.63932763214183 35.60461923858902, -82.63936463214563 35.604634238595864, -82.63943563215284 35.60466423860926, -82.63960363215381 35.60483923866216, -82.63991263219827 35.60488423870304, -82.64061263227426 35.605147238828515, -82.64086163230638 35.60520823886652, -82.64103663233284 35.60522523888788, -82.64168263244797 35.60517523894402, -82.64198563250937 35.60510423896062, -82.64255663264615 35.604832238963816, -82.6429676327445 35.60463723896623, -82.64362663287942 35.604473239000484, -82.64435763301472 35.60438423905735, -82.64654963342042 35.60411823922816, -82.64728163355569 35.604030239285294, -82.64741963359388 35.60393123927921, -82.64743663359826 35.603921239279, -82.64794063372246 35.603659239277306, -82.64810963376397 35.60357223927695, -82.64821763378868 35.603528239279015, -82.64825163379638 35.6035152392799, -82.64835563381976 35.603475239282396, -82.64846163384368 35.603434239284866, -82.64854063386309 35.60339423928491, -82.64864563388832 35.60334323928529, -82.6487316339104 35.60329323928393, -82.64893163396128 35.60317823928095, -82.64899263397682 35.60314323928007, -82.64907963399891 35.603094239278995, -82.6494136340897 35.60286523926663, -82.64953363412555 35.602762239257984, -82.64967563416758 35.60264223924815, -82.64975863419153 35.60257623924317, -82.6502746343396 35.602172239213736, -82.65081263449188 35.60176423918585, -82.65086863450637 35.601730239184604, -82.65135263463121 35.601442239175604, -82.65167263469681 35.6013622391922, -82.6517096347043 35.60135323919416, -82.65186763473616 35.601317239202984, -82.65222563478498 35.60138723925402, -82.65257463481997 35.6015372393204, -82.65261563482368 35.60155723932865, -82.65291163485 35.60170623938934, -82.65307263486001 35.601815239428156, -82.6536076349143 35.602041239529086, -82.65402963498933 35.60201023956606, -82.65438663508303 35.60178723955726, -82.65446363510256 35.60174323955617, -82.65472863516945 35.60159523955321, -82.65518363528916 35.60130923954158, -82.65581763545114 35.60094223953186, -82.65688963570294 35.60046523954459, -82.65794263590493 35.600291239617235, -82.6589796360844 35.60024623971438, -82.65924763613785 35.600188239730095, -82.65979163624648 35.60007123976207, -82.66024663636118 35.59981723975698, -82.66073563650392 35.59941823972577, -82.66153563668877 35.59908223973942, -82.66268763698136 35.598426239723885, -82.66415963732969 35.59775423973785, -82.66440163739155 35.597614239734234, -82.66451963742178 35.59754523973228, -82.66532763762757 35.597081239720595, -82.66668763799179 35.59618523967742, -82.66753563824605 35.59544923961442, -82.66876763861349 35.59439323952545, -82.67010263901462 35.59322923942514, -82.67047963912718 35.592905239397766, -82.67161563949094 35.59176923928272, -82.67287963989067 35.59053723916122, -82.67377964015486 35.5897932391019, -82.67388764018634 35.589705239095025, -82.67478364034531 35.58964123917384, -82.67566364051143 35.58951323923802, -82.67689564075098 35.58928923931878, -82.67780764090769 35.58925723940566, -82.67812764093883 35.589401239467875, -82.67828764094583 35.589529239510334, -82.67833164094927 35.58955423951994, -82.67873564098107 35.58978523960846, -82.67932764102551 35.59013723974097, -82.67993564108491 35.59040923985872, -82.67993864108539 35.59040923985903, -82.6805436411763 35.59047323993408, -82.68129564132363 35.59032923998187, -82.68217564148723 35.59021724004928, -82.68307164161439 35.59036124017045, -82.68367964166893 35.590665240294776, -82.68386964168283 35.59078024033779, -82.68433564171666 35.59106524044357, -82.68497564175681 35.59149724059729, -82.68555164184532 35.591545240666164, -82.68812764238979 35.59079324077694, -82.68851164245382 35.59079324081635, -82.68876764249889 35.59077724083933, -82.68900764253635 35.59079324086718, -82.68921564256607 35.59082524089508, -82.68943964260332 35.59082524091801, -82.68975964266158 35.5907932409443, -82.69019164274333 35.590729240975556, -82.69062364283003 35.590633241000276, -82.69095964289332 35.59058524102489, -82.69135964298208 35.59044124103658, -82.69171164306036 35.59031324104656, -82.6922236431407 35.59034524110553, -82.69268764322291 35.59031324114667, -82.69305564326459 35.59044124121049, -82.69332764329504 35.590537241257884, -82.69381464336084 35.590637241328224, -82.69387164336845 35.59064924133654, -82.69436764342889 35.59079324141676, -82.69463964344966 35.590953241477216, -82.69488064345778 35.59116124154432, -82.69504064344262 35.59143324161622, -82.69528064340392 35.59194524174525, -82.6953606433632 35.592297241825214, -82.6954886433157 35.59274524192964, -82.69568064326899 35.59325724205372, -82.69596864333171 35.593161242063694, -82.69609664337756 35.593001242044245, -82.69609864338032 35.5929852420411, -82.6961446434421 35.592633241974056, -82.69611264347861 35.5923612419153, -82.69614464352823 35.59207324185992, -82.69619264358045 35.59178524180606, -82.69625664363531 35.591497241753956, -82.69627564364843 35.591432241742616, -82.69635264370048 35.59117724169853, -82.69638464374519 35.590921241649575, -82.69643264380265 35.590599241588926, -82.69648064384045 35.59040524155423, -82.69667264389734 35.590243241540904, -82.6968976439423 35.59019424155401, -82.69715364396556 35.590320241605916, -82.69723364396185 35.590431241636786, -82.6973136439312 35.59071724170327, -82.69737764390777 35.59093924175511, -82.69744164387937 35.59119324181342, -82.697452643869 35.59127324183093, -82.69747464384838 35.59143124186535, -82.6975386438272 35.59163824191409, -82.69765064380452 35.59190724198041, -82.69769864378557 35.59208224202108, -82.69776264376934 35.59225724206331, -82.69779464372844 35.59255824212793, -82.69803564373447 35.59278024219799, -82.69833964376329 35.59292224225804, -82.6985636437788 35.59306424230998, -82.69885164381228 35.593158242358626, -82.69915564384114 35.593300242418785, -82.69937964385907 35.5934262424675, -82.69970064389311 35.59355224252605, -82.69994064392111 35.593630242566555, -82.70011364394284 35.59367624259371, -82.70029264396526 35.59372424262181, -82.70083664407363 35.593609242654146, -82.70091664410943 35.593463242632524, -82.70088464413367 35.59327024258993, -82.700869644151 35.59314124256209, -82.70070964415912 35.59291524249961, -82.70059764417023 35.59272124244851, -82.70048564418127 35.59252824239769, -82.70048564422093 35.59227024234511, -82.70050164426571 35.591996242290904, -82.70050164427394 35.59194224227994, -82.70050164429549 35.59180224225134, -82.70058564435065 35.59153424220524, -82.7005986443586 35.591496242198886, -82.70088664444147 35.59126924218208, -82.70109464450084 35.591108242170584, -82.70131864456799 35.590914242153964, -82.70152664463244 35.590720242135724, -82.70179964470776 35.5905262421242, -82.70202364475513 35.59046024213371, -82.70231164480101 35.59047424216606, -82.70234364480422 35.59048824217223, -82.7024876448182 35.59055324220028, -82.70270464484494 35.59061424223492, -82.70288864486515 35.59068224226764, -82.70319764489176 35.59084424233239, -82.70327264490147 35.59086224234371, -82.70353964494613 35.59086124237085, -82.70378164498301 35.59088324240013, -82.70388764499901 35.59089424241329, -82.70438564506978 35.59097324248046, -82.70454364509055 35.59100924250395, -82.70472164511851 35.59102024252447, -82.70483664513924 35.59101024253423, -82.70496664516402 35.590990242543405, -82.70502064517436 35.59098124254718, -82.70515264520243 35.59094124255257, -82.70536664524765 35.590879242561876, -82.70558564529537 35.590806242569386, -82.70562264530581 35.59077824256747, -82.70566764532072 35.590730242562316, -82.70569664533737 35.59065324254954, -82.70576264541842 35.59019724246336, -82.70580164551092 35.58963724235312, -82.70582664555322 35.58938924230514, -82.70583864558638 35.589186242265015, -82.70586564561128 35.58905324224061, -82.70591364563658 35.58894024222246, -82.70599164566428 35.58884524221109, -82.70610164569621 35.58875624220426, -82.70613264570457 35.58873524220312, -82.70622864572985 35.5886752422007, -82.70633164575784 35.588604242196844, -82.70640064578186 35.58852324218739, -82.70644364580191 35.58843924217469, -82.70651564583875 35.58827724214903, -82.70659264587128 35.588149242130804, -82.70673764592273 35.587971242109305, -82.70686664597103 35.58779724208716, -82.70695864600383 35.58768324207325, -82.70706464593133 35.58827024220386, -82.70708164592044 35.588359242223724, -82.707134645878 35.588693242297275, -82.70716564585685 35.588864242335305, -82.70720364584413 35.58898824236446, -82.70726964583426 35.58912424239898, -82.70736764583118 35.58925024243472, -82.70750964583758 35.58936324247232, -82.70771964585055 35.589506242523086, -82.70798664587008 35.589668242583414, -82.70813364588084 35.58975824261687, -82.70824764588521 35.58985324264787, -82.70832064588103 35.58995924267701, -82.70835764586991 35.59007224270386, -82.70836264586627 35.5901012427103, -82.7083766458554 35.590187242729286, -82.70838464582609 35.5903862427707, -82.7083526457918 35.590575242805905, -82.7081916456961 35.59102324288074, -82.70817264567205 35.591159242906535, -82.70822464565457 35.591329242946564, -82.7083236456514 35.59145724298277, -82.7084536456559 35.59156924301894, -82.70859864566694 35.59165424305121, -82.70971764579737 35.592019243240294, -82.71014164585876 35.59207924329601, -82.71027964588036 35.592088243312, -82.71047164591035 35.59210124333429, -82.71084164595842 35.59218924339015, -82.7115076460273 35.592463243514324, -82.71176664605895 35.59253824355616, -82.7120656461009 35.59258924359719, -82.71228464613849 35.59258224361825, -82.71255964619614 35.59250524363066, -82.71278464625154 35.59238824362997, -82.71295464630154 35.592247243618566, -82.71348764647674 35.5916852435586, -82.71356464650623 35.59157624354425, -82.71366964655914 35.591346243508134, -82.71376964662497 35.59102624345309, -82.71387164668141 35.59076924341112, -82.71394764673124 35.59052724336957, -82.71398664681078 35.59005224327674, -82.71404964684747 35.589881243248286, -82.71421864690376 35.58969824322831, -82.71447264697014 35.58954124322229, -82.71465264701533 35.589442243220596, -82.71478264704788 35.5893712432195, -82.71501064710387 35.58925424321895, -82.7152146471496 35.58917824322435, -82.71542164718436 35.58917624324518, -82.71569864722701 35.589199243278195, -82.71602364727596 35.589233243318446, -82.71643564733917 35.589268243367854, -82.71692064741548 35.58929724342349, -82.7171776474554 35.58931624345365, -82.71742264749011 35.589356243486925, -82.71775264752542 35.589484243546835, -82.71789864753868 35.58955624357653, -82.71802464754143 35.58967524361366, -82.71816964753972 35.58984324366278, -82.71827264753401 35.589992243703726, -82.71829864752391 35.59008624372556, -82.71827364750052 35.59021124374852, -82.71823164747867 35.59030824376397, -82.718104647411 35.59061124381275, -82.71806664737917 35.590777243842744, -82.71808364735723 35.59093824387732, -82.71820064730726 35.591390243981536, -82.71819764726825 35.591641244032346, -82.71823964725469 35.59177524406402, -82.71830764725493 35.59184724408563, -82.71845264727212 35.59189224410971, -82.71899564734639 35.59199824418697, -82.71935964740027 35.592042244233234, -82.71944864740908 35.59208124425035, -82.71965264741432 35.5922682443094, -82.71994964743406 35.59246224437943, -82.71998664743145 35.59251924439482, -82.71999064742778 35.592547244400905)))",6356,37,021,002605,370210026052,3490,3490,233,3420,3151,111,21,32,7,98,70,2666,144,2522,2619,2438,76,14,26,5,60,47,1780,1444,336
census_2010_blockgroups_view.fid--2dc29038_13ec899ba8f_-261e,"MULTIPOLYGON (((-82.7542046621186 35.53393223594809, -82.75442166215286 35.53394423597272, -82.75477066220793 35.533965236012705, -82.7550726622517 35.534007236052254, -82.7552896622831 35.53403823608073, -82.7554466623043 35.53407123610357, -82.75573366234258 35.534133236145486, -82.75591766236576 35.53418223617431, -82.75607366238519 35.53422523619906, -82.75678766246835 35.534459236319854, -82.75726666252201 35.53463023640375, -82.7608276629206 35.53590323702772, -82.76201566305349 35.536328237235985, -82.76244166310133 35.53647923731035, -82.7636876632413 35.536922237528124, -82.76371966324477 35.53693423753391, -82.76414266329063 35.537095237610046, -82.76462866334604 35.53726223769383, -82.76608766351208 35.53776623794586, -82.7665746635676 35.53793423802997, -82.76646366351807 35.53813623805986, -82.7661976633986 35.53862723813273, -82.76616566337339 35.53875723815602, -82.76611266333009 35.53898223819655, -82.76611166332957 35.53898423819682, -82.76604266327423 35.539270238248136, -82.76583666310746 35.54013523840352, -82.76583566310626 35.540142238404904, -82.76591466307669 35.54042123846985, -82.7659236630732 35.54045423847747, -82.7659506630622 35.540555238500865, -82.76595966305841 35.540589238508744, -82.76599066304685 35.54069923853433, -82.76580766301768 35.54069023851385, -82.7654076629522 35.540682238471284, -82.76463566282331 35.540683238392475, -82.76438066278014 35.54068823836741, -82.76371766266479 35.5407192383059, -82.76333166259654 35.54074523827175, -82.7629476625275 35.5407782382392, -82.76255866245675 35.540816238207185, -82.7621696623849 35.54086223817673, -82.7613326622276 35.54097823811477, -82.7608806621426 35.54104123808137, -82.75943166187024 35.54124323797434, -82.75792266158382 35.54147123786651, -82.75680966137435 35.54162723778444, -82.75673566136635 35.54159923777114, -82.75308866067677 35.54213323750697, -82.75279766062197 35.54217423748552, -82.7517376604105 35.5424012374234, -82.74912365988763 35.5429712372722, -82.74888565983521 35.54305423726477, -82.7485506597613 35.543172237254545, -82.7481926596695 35.543382237260744, -82.74775265954682 35.54370423728145, -82.74749565947036 35.54392423729998, -82.74690865928548 35.54449223735577, -82.74569865890388 35.54566723747164, -82.74382665831719 35.54746023764581, -82.74374865829405 35.547526237651276, -82.743043658085 35.54812423770108, -82.74259465795186 35.548504237732665, -82.74253765793615 35.548545237735205, -82.74232065787837 35.54868623774172, -82.74209565782033 35.548820237746106, -82.74176165773771 35.54899623774777, -82.74153765768415 35.54910223774648, -82.74131665763282 35.549197237743236, -82.74107365757786 35.54929123773749, -82.74084965752876 35.54936823773029, -82.7404756574493 35.54948023771485, -82.74009765737233 35.54957123769477, -82.7399536573436 35.54960223768631, -82.73959065727334 35.549666237662244, -82.73931365722088 35.549707237642245, -82.73894265715165 35.549755237614065, -82.73715165682 35.54997223747497, -82.73651665670018 35.55006423742876, -82.73587165657585 35.550174237385164, -82.73538165647905 35.5502732373552, -82.735111656425 35.550332237339546, -82.73475265635234 35.55041623731994, -82.73472265634602 35.55042423731852, -82.73438165627623 35.55050923730102, -82.73412365622251 35.550579237288886, -82.7336276561181 35.550721237267034, -82.73323965603466 35.55084423725238, -82.73285265595132 35.55096723723787, -82.73152265565982 35.55142323719473, -82.72973465526887 35.552030237135476, -82.72924365516356 35.552184237116606, -82.72875265506023 35.55232423709485, -82.72825965495818 35.55245423707089, -82.72782065486916 35.552558237047194, -82.72750665480552 35.55263223703011, -82.72711965472857 35.552713237007026, -82.72697565470061 35.552739236997574, -82.72676065465869 35.55277923698378, -82.72625165456057 35.552866236949356, -82.72560365443854 35.55295823690179, -82.72520265436418 35.553007236870705, -82.72444765422772 35.553077236807674, -82.72370565409489 35.55313723674397, -82.72275465392472 35.55321423666231, -82.72243565386601 35.55325023663703, -82.72238165385617 35.55325623663267, -82.72226965386353 35.55308623658653, -82.7221056538744 35.552837236519046, -82.72182365389321 35.55240823640259, -82.72161065390604 35.552093236316544, -82.72153365391073 35.55197923628541, -82.72144065391501 35.551850236249635, -82.72137965391758 35.55176723622642, -82.72128865391876 35.551660236195325, -82.72126865391847 35.55164023618917, -82.72118965391718 35.55156323616538, -82.72109065391408 35.551476236137454, -82.72098465390835 35.55139823611072, -82.72085665389899 35.55132023608168, -82.72070365388576 35.55124023604972, -82.7205986538759 35.55119023602881, -82.72035365385258 35.551076235980446, -82.72034165385153 35.55107023597796, -82.72030865384828 35.55105523597161, -82.72029765384724 35.551050235969406, -82.72029165384674 35.55104723596825, -82.72027565384516 35.55104023596516, -82.7202706538446 35.5510382359642, -82.72019765383763 35.55100423594983, -82.71997865381664 35.55090323590678, -82.71990665380972 35.55087023589264, -82.71987565380688 35.55085523588644, -82.71978265379786 35.55081323586841, -82.71975265379484 35.5508002358626, -82.71947765376822 35.550675235808974, -82.7193666537583 35.55061923578619, -82.71915865373946 35.55051623574389, -82.71893665372473 35.5503712356916, -82.71880365371803 35.55027023565739, -82.7186686537123 35.550161235621374, -82.71855365370887 35.5500582355886, -82.71843065370743 35.54993423555065, -82.7183566537075 35.54985323552661, -82.71807165370828 35.549538235433175, -82.71801765370898 35.54947523541476, -82.71794165370994 35.54938623538891, -82.71784965370921 35.54929123536008, -82.71782165370894 35.54926223535127, -82.71778865370729 35.54923723534283, -82.71777865370693 35.549229235340185, -82.71774965370525 35.5492082353329, -82.71774065370482 35.54920123533051, -82.71765265369832 35.54914823531073, -82.71754665368844 35.54909723528955, -82.71739465367133 35.54904423526307, -82.71729065365948 35.549008235245175, -82.71661265357726 35.548808235134885, -82.71630265354035 35.54871223508359, -82.71593965349687 35.54860123502383, -82.71590665349312 35.54859023501821, -82.71589565349176 35.54858723501644, -82.71580765348044 35.54856523500296, -82.71577465347607 35.54855823499815, -82.71571665346838 35.54854523498957, -82.71558665345073 35.54851923497095, -82.7155416534442 35.54851223496494, -82.71548365343573 35.54850523495757, -82.71538865342164 35.54849323494541, -82.71519865339272 35.54847623492254, -82.71452965329034 35.5484172348419, -82.7143456532631 35.54839523481859, -82.71434165326237 35.54839523481823, -82.71406365322252 35.54835323478117, -82.7141016532555 35.54817923474957, -82.7141266532767 35.54806823472949, -82.71415665329735 35.547966234711765, -82.71420265332232 35.54785323469347, -82.71428565336254 35.54768123466682, -82.71436365339989 35.547522234642415, -82.71440065341986 35.54743223462789, -82.7144136534266 35.547402234623064, -82.71445865345567 35.54726123459891, -82.71447765347574 35.54715123457848, -82.71449565349327 35.547056234560905, -82.71450365350783 35.54697023454424, -82.71451065351913 35.5469042345315, -82.71452165355034 35.546712234493434, -82.71452665356439 35.54662623447642, -82.7145346535873 35.546485234448475, -82.71455965365644 35.54606123436459, -82.71456865367945 35.54592123433696, -82.71456965368174 35.54590723433423, -82.71458165370638 35.54575923430523, -82.71458565371371 35.54571623429692, -82.7146186537484 35.54552523426131, -82.7146736537771 35.54539823424105, -82.71474165380178 35.54531123423026, -82.7147596538079 35.545290234227885, -82.71485065383379 35.54522023422295, -82.71486765383824 35.545210234222615, -82.71492265385191 35.5451802342221, -82.71495865386086 35.54516123422191, -82.71509865389137 35.5451142342267, -82.71515865390424 35.545095234228924, -82.71534565394437 35.545036234236036, -82.71543765396406 35.545008234239766, -82.71558765399864 35.54494523424224, -82.7157416540378 35.54485723424007, -82.71586165407217 35.544763234233244, -82.71587265407531 35.544755234232696, -82.71597665410594 35.544668234225604, -82.71600965411648 35.544635234222305, -82.71610565414707 35.54454023421275, -82.71621865418253 35.54443123420208, -82.71629265421143 35.544323234187594, -82.7163406542357 35.54421723417088, -82.71634665423836 35.5442062341693, -82.71641265426516 35.54410323415501, -82.71632465426703 35.54399523412403, -82.71616965426011 35.54387223408305, -82.71610265425707 35.54381923406535, -82.71597265424928 35.5437282340335, -82.71583865423975 35.5436452340029, -82.7157026542324 35.543545233968565, -82.71539865421164 35.54335023389771, -82.71532665420474 35.543317233883634, -82.71502065417496 35.54317923382413, -82.71445765411573 35.54295423372058, -82.71425465409442 35.54287223368307, -82.7136536540311 35.54263223357264, -82.71346165401003 35.542561233538514, -82.71301665395436 35.54244123346848, -82.71222365385229 35.54224623334751, -82.71188965380905 35.54216523329685, -82.71188865380886 35.54216523329674, -82.7117256537891 35.54211723327022, -82.71131665373676 35.54201423320736, -82.71108865370523 35.541972233175514, -82.7108136536671 35.54192223313712, -82.7106766536474 35.541902233119025, -82.71044465361396 35.541868233088366, -82.71013665356884 35.54182823304869, -82.71000765354978 35.54181223303222, -82.70980265352041 35.541781233004876, -82.70960665349475 35.541735232975384, -82.70945665347739 35.54168623295011, -82.7094476534765 35.54168223294832, -82.70927565345903 35.54160923291585, -82.70907065344078 35.541505232873625, -82.70888765342679 35.54139823283311, -82.70877765341804 35.541335232809, -82.70858665340438 35.541217232765405, -82.70833965338437 35.54107923271195, -82.7082646533784 35.54103723269566, -82.70814665336505 35.54099623267528, -82.70798665334618 35.54094523264851, -82.70783365332517 35.54091623262694, -82.70781265332212 35.540913232624156, -82.70761665329302 35.54089023259941, -82.70719665323287 35.54082623254333, -82.70703565320903 35.540807232523, -82.70688665318819 35.5407812325024, -82.70687565318681 35.540778232500706, -82.7067386531694 35.54074323247953, -82.70661665315637 35.54069523245727, -82.70657765315467 35.54066423244701, -82.70654165315312 35.54063523243732, -82.7065186531535 35.54060823242947, -82.70647165315437 35.54055123241306, -82.70638265316175 35.540406232374366, -82.70636365316335 35.540375232366095, -82.70634765316692 35.540334232356095, -82.70647265319715 35.54027323235645, -82.70638365318719 35.54024123234084, -82.70628865317605 35.540211232325014, -82.70625765317226 35.54020223232001, -82.7060646531508 35.54013223228591, -82.70573565311116 35.54003323223213, -82.70571465310869 35.540027232228695, -82.70554765308695 35.53998723220344, -82.7054866530789 35.5399732321944, -82.70546065307543 35.53996823219066, -82.70520165304029 35.53991623215354, -82.70518565303804 35.5399132321513, -82.70511465302701 35.539908232143, -82.70506265301911 35.53990323213671, -82.70490865299534 35.539891232118485, -82.70485765298726 35.53988823211264, -82.7047976529781 35.53988323210547, -82.70467165295845 35.53987423209071, -82.70461965295027 35.53987123208479, -82.70456065294093 35.539868232078156, -82.70434765290729 35.539856232053864, -82.70405565286222 35.5398332320193, -82.7040046528544 35.53982923201323, -82.70326265273832 35.53978023192734, -82.70289965268293 35.53974723188344, -82.7025446526303 35.53970523183854, -82.70253765262916 35.53970523183785, -82.70222765258441 35.53966023179687, -82.70204565255902 35.53962823177175, -82.70187265253527 35.5395952317473, -82.70174165251717 35.53957123172902, -82.70135965246737 35.53948123167155, -82.70118965244515 35.53944123164599, -82.70104365242629 35.539406231623886, -82.70086565240358 35.53936123159645, -82.70004365229778 35.539158231470914, -82.69989565227951 35.539117231447456, -82.69983565227193 35.53910123143797, -82.69957265223813 35.53903623139778, -82.69954365223454 35.5390282313932, -82.69945665222336 35.539006231379844, -82.69942865221977 35.538999231375584, -82.69940765221706 35.53899423137234, -82.69934765220944 35.53897923136312, -82.69932865220699 35.538974231360264, -82.69930465220408 35.538967231356345, -82.6992686521995 35.538958231350804, -82.69923565219523 35.538950231345815, -82.69921265219209 35.53894523134245, -82.69907865217465 35.53891423132234, -82.69870165212653 35.53881823126423, -82.6984716520972 35.538760231228856, -82.6974586519669 35.538510231074156, -82.69717065193011 35.53843723102983, -82.69686565189106 35.53836123098305, -82.6966596518641 35.538313230952156, -82.69650665184491 35.53827223092816, -82.69631565182094 35.53822123089823, -82.69616265180348 35.53816923087193, -82.6960586517942 35.53811623085049, -82.6960166517905 35.53809523084194, -82.69592565178482 35.53803323081997, -82.69582365178195 35.53794123079076, -82.69575565178428 35.53785223076562, -82.69574165178544 35.53782923075952, -82.69569665178905 35.537757230740254, -82.69543465182885 35.53721223060227, -82.69537865183739 35.537096230572935, -82.695374651838 35.5370882305709, -82.69531365184653 35.53696623053973, -82.69525565185619 35.53684023050811, -82.69523965185851 35.5368072304998, -82.69513665187434 35.53659223044537, -82.69508965188183 35.53649223042017, -82.69494965190201 35.536208230347974, -82.69489765190615 35.536125230325695, -82.69480365190647 35.53602123029495, -82.69468165190008 35.53593023026388, -82.69467665189973 35.535927230262786, -82.69454865188779 35.53586623023718, -82.69442465187416 35.53582023021512, -82.69543265207467 35.535606230274695, -82.69758965250371 35.53514923040242, -82.69794065256902 35.535104230429184, -82.69831365263451 35.535082230462834, -82.69847465266157 35.53508023047889, -82.69858065267944 35.53507923048956, -82.69886565272479 35.53509223052141, -82.69915865276857 35.53512523055808, -82.69950065281877 35.5351692306021, -82.70008365290383 35.53524723067765, -82.70048865296273 35.5353022307304, -82.70081965301563 35.535317230767326, -82.70110765306491 35.53530823079495, -82.70184665319545 35.53525923086064, -82.70243465329911 35.53522123091306, -82.70258265332517 35.53521223092638, -82.70302665340284 35.53518723096678, -82.70317565342887 35.53517923098039, -82.70327465344661 35.5351712309889, -82.70357265349988 35.53514723101449, -82.7036726535176 35.53514023102329, -82.70397865357113 35.53512323105118, -82.70405665358491 35.535118231058114, -82.70530465380499 35.535037231169326, -82.70754765420043 35.534893231369615, -82.70997365462884 35.53473323158534, -82.71020165466955 35.53471523160498, -82.71036965469938 35.53470323161974, -82.71088065478905 35.53467323166588, -82.7112056548453 35.534659231696345, -82.71183665495138 35.5346522317595, -82.7119356549666 35.53466023177128, -82.71223265501247 35.534684231806565, -82.71233265502791 35.53469223181846, -82.71257165506243 35.53472623184984, -82.71283365510027 35.53476423188446, -82.71315065514372 35.5348252319293, -82.71328665516111 35.53485923195015, -82.71352165519104 35.53491923198639, -82.71376865521991 35.534999232028, -82.71451065530638 35.5352412321533, -82.7147586553353 35.53532223219524, -82.7156876554436 35.535624232351886, -82.71579465545716 35.53565223236851, -82.71610565549662 35.53573323241686, -82.71616665550444 35.5357482324262, -82.71639565553481 35.535798232459825, -82.71694465561048 35.53590123253702, -82.71756265570342 35.535966232613546, -82.71802065577681 35.53598523266426, -82.71839465583841 35.5359892327034, -82.71889065592352 35.53597323275092, -82.71921865598213 35.535947232779115, -82.7194856560319 35.53591223279936, -82.71976765608531 35.53587023281962, -82.72010365615003 35.53581323284243, -82.72126065638496 35.535537232904595, -82.72200365653629 35.53535723294388, -82.72242265662129 35.53525723296636, -82.72593265733671 35.53440323315143, -82.72769565769708 35.533967233242905, -82.72881265792523 35.533692233301196, -82.72959265808448 35.533500233341805, -82.72985965813984 35.533429233354674, -82.73007365818253 35.53338323336719, -82.73042065824993 35.53332023338978, -82.73082765832821 35.533252233417635, -82.73083965833031 35.53325123341869, -82.73145465844229 35.53318923346897, -82.73194565852693 35.533170233515285, -82.73227165858138 35.53316923354843, -82.73278265866419 35.53318423360385, -82.73324265873288 35.53323623366146, -82.73372165880228 35.53330423372437, -82.73423965887184 35.533413233799614, -82.73457665891435 35.533502233852275, -82.73502765897126 35.533621233922666, -82.73579665906813 35.533825234042915, -82.73598865909314 35.533870234071756, -82.73636365914192 35.53396023412849, -82.73656365916693 35.53401423415996, -82.73675465919058 35.53406723419035, -82.73805265935789 35.53438623438817, -82.73831065939112 35.534450234427645, -82.73942665953145 35.53474823460263, -82.73975665957524 35.534821234651226, -82.74012365962682 35.5348832347015, -82.74047065968068 35.534909234742265, -82.74072365972197 35.534915234769414, -82.74104465977763 35.53490023479921, -82.74139765984125 35.534869234828975, -82.74177465991356 35.53480723485491, -82.741988659957 35.53475623486638, -82.74207565997459 35.53473623487126, -82.74230166002138 35.53467623488206, -82.74249566006365 35.53461123488868, -82.74327066022857 35.534377234920285, -82.74346566027076 35.534314234927386, -82.74358566029657 35.534276234931916, -82.74393066036748 35.53418823494927, -82.74406066039273 35.53416523495785, -82.7442636604316 35.53413223497185, -82.74450266047505 35.534108234991415, -82.74467366050582 35.534093235005884, -82.74501266056679 35.53406423503469, -82.74591066071676 35.53406123512595, -82.74632366078569 35.53406123516813, -82.74659866083282 35.53405223519447, -82.74737866096626 35.534029235269614, -82.74742566097406 35.5340302352746, -82.74770166101881 35.53403823530447, -82.74785566104522 35.53403323531912, -82.74831666112402 35.53402023536368, -82.74847166115039 35.53401623537876, -82.74924066127981 35.534008235455744, -82.74979766137338 35.5340032355118, -82.75019066144087 35.53399023554929, -82.75154766167061 35.533966235683216, -82.75190566173116 35.53396023571864, -82.75231766180059 35.53395523575977, -82.75269466186423 35.533950235797285, -82.75382666205503 35.53393623591021, -82.7542046621186 35.53393223594809)))",6559,37,021,002503,370210025031,1978,1978,61,1963,1891,14,17,9,0,32,15,1593,37,1556,1581,1534,10,13,6,0,18,12,941,838,103
census_2010_blockgroups_view.fid--2dc29038_13ec899ba8f_-261d,"MULTIPOLYGON (((-82.59726463156471 35.56289822577453, -82.59727163156471 35.56290622577684, -82.59728763156447 35.56292522578239, -82.5973646315625 35.5630212258098, -82.5977506315948 35.56322822589154, -82.59782463160303 35.56325422590444, -82.59831363165785 35.56342622598974, -82.59855563169494 35.56344622601854, -82.59875663173004 35.563435226036916, -82.59895563176855 35.563400226050184, -82.5995486318997 35.56318722606767, -82.5998656319601 35.56313722608997, -82.59988463196358 35.563135226091596, -82.60019063201196 35.563151226126216, -82.6005026320474 35.5632572261798, -82.60071263206207 35.56338922622819, -82.6008516320615 35.563543226273794, -82.60114263201773 35.56414322642595, -82.60126063200958 35.56432322647462, -82.60162663201162 35.5647062265902, -82.60172563200355 35.56486522663274, -82.60188463196073 35.565316226740855, -82.60204963193057 35.56569022683392, -82.60226463190105 35.56611522694254, -82.60244263183213 35.56675622709134, -82.6025446317962 35.56710022717189, -82.60261463177397 35.56732022722389, -82.60265363177318 35.56736822723762, -82.60274763177506 35.56745722726541, -82.6028806317877 35.5675192272917, -82.60311363182409 35.56753422731869, -82.60339163187714 35.56748922733803, -82.60385763197952 35.56732722735279, -82.6039246319946 35.567301227354434, -82.60408163203 35.56724022735806, -82.60444963211917 35.56705822735876, -82.6049006322406 35.56675522734332, -82.6051876323306 35.5664802273167, -82.60530763236802 35.56636622730586, -82.60556263244798 35.56612222728234, -82.60582963252081 35.565936227271784, -82.60608863257464 35.56586622728417, -82.60676063270428 35.565749227329206, -82.6069726327518 35.56566922733468, -82.60715463280057 35.56554822732872, -82.60727463284084 35.565416227314095, -82.60734063287688 35.56525322728773, -82.60744863291336 35.565132227274184, -82.60772163298417 35.56496622726839, -82.60775763299343 35.56494522726777, -82.60814063306817 35.56487322729239, -82.60855163314147 35.56484022732784, -82.60866063315439 35.56487422734599, -82.60888063318025 35.56494422738278, -82.60896863319283 35.56495722739444, -82.60902163320037 35.56496522740153, -82.60918163322326 35.564989227422814, -82.60923563323107 35.56499722742996, -82.60921263321552 35.565073227443115, -82.60919263320119 35.56514522745575, -82.60914663316909 35.565304227483416, -82.60912563315361 35.56538222749715, -82.60904063313663 35.56540122749221, -82.6081976329643 35.56561122744854, -82.60807263293908 35.56564022744162, -82.6075626328355 35.56576222741424, -82.60727263277843 35.565820227396244, -82.60671563265885 35.565996227374946, -82.60652963261298 35.56609322737564, -82.6062946325483 35.566260227385555, -82.60607263248467 35.5664342273982, -82.60551963232447 35.56687922743209, -82.60534563227097 35.56703922744679, -82.60528663224487 35.56714522746236, -82.6052766322403 35.56716422746521, -82.60532463222366 35.56732422750267, -82.60543063221857 35.56747222754371, -82.60556363221407 35.567645227592585, -82.60567363220882 35.56779822763505, -82.60572463219836 35.56792122766539, -82.60573063217264 35.56809522770137, -82.60571963215808 35.56817822771716, -82.60571363215055 35.568220227725064, -82.60569663212561 35.568364227752696, -82.60564663209028 35.568540227783345, -82.60561963207903 35.56858422778954, -82.60555463205148 35.568693227805106, -82.60538763200226 35.568833227816505, -82.60496663188161 35.569163227840484, -82.60470363180596 35.569371227855896, -82.60455263175517 35.56953822787443, -82.6042996316512 35.56994122793047, -82.60418163160733 35.57009922795061, -82.60403863156363 35.57022822796221, -82.60379863149988 35.57038422796929, -82.60360663144735 35.570518227976905, -82.60340863139177 35.5706662279867, -82.60336363137685 35.570714227991886, -82.60326363134318 35.57082522800424, -82.60316363129319 35.57104222803815, -82.60303763121966 35.57138422809493, -82.6029936311945 35.571500228113976, -82.60298263118779 35.571532228119366, -82.6028156311221 35.57177922815254, -82.60278563111272 35.571808228155426, -82.6026986310845 35.57189722816463, -82.60268763108107 35.571908228165704, -82.6026556310706 35.57194122816912, -82.60264563106709 35.57195322817052, -82.60262163105949 35.571977228173, -82.60255263103632 35.57205322818138, -82.60253363102991 35.572074228183716, -82.60252963102866 35.57207822818408, -82.60247163101036 35.57213422818952, -82.60232263096293 35.57228222820443, -82.60230163095613 35.57230322820651, -82.60224663093798 35.57236222821289, -82.60210463089163 35.572510228228445, -82.60167863075243 35.57295522827536, -82.60153763070612 35.57310422829128, -82.6014416306746 35.57320522830201, -82.6012616306174 35.573383228319756, -82.6011476305794 35.57350722833326, -82.60111063056726 35.57354622833743, -82.60077163045723 35.57389522837372, -82.60061163040417 35.574067228392344, -82.60039063033295 35.57429222841547, -82.60032963031347 35.5743532284217, -82.60022263027507 35.57448722843801, -82.60010863023145 35.5746472284589, -82.59999363018301 35.574838228485945, -82.5998796301278 35.57507422852224, -82.59961963000892 35.57556622859582, -82.59956762998388 35.57567322861225, -82.59942962991624 35.575964228657355, -82.59931862986603 35.576170228687964, -82.59922162983072 35.57629522870345, -82.5991846298169 35.5763452287098, -82.59901862976828 35.57648222872073, -82.59882862971868 35.57659922872502, -82.59875562970078 35.5766372287253, -82.59867162968007 35.57668122872565, -82.5986026296629 35.57671822872603, -82.59842462961775 35.576819228728375, -82.59834362959691 35.57686722872986, -82.59794862949698 35.57709022873471, -82.59757462940232 35.5773022287395, -82.5974176293609 35.577401228743526, -82.59731062932832 35.57749822875235, -82.59721062929262 35.57762222876732, -82.59709162925314 35.57775022878118, -82.59698762922065 35.57784922879064, -82.59689162919332 35.57792322879587, -82.59688362919091 35.57793022879644, -82.5967586291566 35.57801822880158, -82.59657662911087 35.57811922880347, -82.59650262909317 35.57815422880305, -82.59639462906728 35.578206228802514, -82.59617462901917 35.578281228795184, -82.59607962899995 35.578303228789935, -82.59595162897395 35.57833422878307, -82.5957386289342 35.57836222876694, -82.59551662889588 35.57837222874617, -82.59519462884187 35.57837522871374, -82.59486662878581 35.57838522868208, -82.59473662876337 35.578391228670014, -82.59461162874163 35.57839722865841, -82.59444262871158 35.578410228643754, -82.59429962867891 35.57846822864085, -82.59429562867855 35.57846622864007, -82.59425962867546 35.5784472286325, -82.59424862867446 35.57844222863028, -82.5941086286625 35.578368228600816, -82.59368862862665 35.578148228512966, -82.59354862861451 35.578075228483776, -82.59339062860134 35.57799022845026, -82.59305962857344 35.57781422838037, -82.59291162855877 35.57775022835221, -82.59285062855261 35.57772422834058, -82.59274562854081 35.577687228322326, -82.59267162852808 35.57769022831534, -82.59254062851168 35.57765522829482, -82.59203462844837 35.577520228215334, -82.59193262843483 35.577498228200405, -82.59174562840998 35.57745822817304, -82.59172762840696 35.577458228171196, -82.59169962840244 35.57745722816808, -82.59161762838934 35.577454228159084, -82.59159062838492 35.5774532281561, -82.59159262840068 35.577353228136005, -82.59159662841004 35.57729622812475, -82.5916196284525 35.57704522807606, -82.59162262848648 35.576827228031945, -82.5916256285109 35.57667122800049, -82.59163362858293 35.57621222790787, -82.59163862862235 35.575961227857285, -82.59164962867706 35.57561722778837, -82.59165962879884 35.574836227630286, -82.5916606288013 35.57482122762738, -82.5916606288694 35.57437822753716, -82.59166362891817 35.57406422747354, -82.59166762897752 35.57368222739619, -82.59167462906444 35.573124227283245, -82.59167662907788 35.57303922726616, -82.59167862911326 35.57281122721999, -82.59168162914776 35.57259022717525, -82.59168362916657 35.572470227150994, -82.59168562924762 35.57194522704428, -82.5916846292499 35.571929227040975, -82.59167862928261 35.57170922699558, -82.59167762928602 35.57168622699079, -82.59167562929638 35.57161722697654, -82.5916756292997 35.571595226972036, -82.59167462930675 35.57154822696239, -82.59166662935051 35.57125522690191, -82.5916406294999 35.57025522669559, -82.5916396295027 35.570236226691655, -82.59162962954233 35.56996722663582, -82.59163062955321 35.56989722662165, -82.5916316295719 35.56977722659735, -82.59163262958049 35.56972222658623, -82.59162662962643 35.569417226523505, -82.59162462964434 35.56929822649906, -82.59162362964585 35.56928722649677, -82.59162362965057 35.5692562264904, -82.59162362965215 35.56924622648841, -82.59161962968467 35.56903022644403, -82.59161962969456 35.568966226430945, -82.59161962972301 35.56878122639329, -82.59162662974879 35.56862122636146, -82.59170562983321 35.56815722627504, -82.59170962983704 35.56813622627114, -82.59174462986489 35.56799322624566, -82.59176262988784 35.56786322622106, -82.59175162995675 35.56740322612628, -82.59175762997027 35.567321226110174, -82.59176462998437 35.56723722609379, -82.59179063000848 35.56710822607018, -82.5918166300282 35.56700822605252, -82.59195663010766 35.56664222599237, -82.59203763016123 35.56638122594748, -82.59206563019264 35.56620722591499, -82.59207263021857 35.56604622588292, -82.59206963025561 35.56580222583286, -82.59206563026396 35.56574322582053, -82.59203263033365 35.56525422571754, -82.59203363034166 35.56520322570725, -82.59203463035308 35.56513022569244, -82.5920356303534 35.56512922569236, -82.59206863037159 35.565046225678834, -82.59213763039332 35.5649792256723, -82.59216563040005 35.564966225672485, -82.59223263041575 35.56493622567324, -82.59233863043579 35.56492022568088, -82.59264763048604 35.56492722571406, -82.5936186306435 35.564952225818736, -82.59389663068983 35.564951225847075, -82.59398063070383 35.5649512258557, -82.59431363075784 35.56495922589143, -82.59432563076794 35.56490622588194, -82.59431263077876 35.56482222586348, -82.59430963078167 35.56480022585862, -82.59416963080645 35.5644872257806, -82.59414663080975 35.56444122576883, -82.59408663081885 35.56431722573742, -82.5940466308252 35.564232225716076, -82.59393563084357 35.563993225655985, -82.59392763084462 35.56397722565189, -82.5938886308511 35.56389322563082, -82.59438963095907 35.56373222564941, -82.59491263107142 35.56356622566928, -82.59589563128218 35.56325722570714, -82.59619663134667 35.56316322571893, -82.5963966313901 35.56309622572585, -82.59651863141664 35.563055225730004, -82.59668663145315 35.5629992257358, -82.59688663149625 35.56293522574328, -82.59700963152251 35.5628972257482, -82.5971326315492 35.56285622575249, -82.59720863156544 35.562833225755554, -82.59720863155815 35.56288022576515, -82.59726463156471 35.56289822577453)))",5946,37,021,001100,370210011002,1690,1690,53,1653,1564,53,6,10,0,20,37,1406,34,1372,1385,1325,38,4,7,0,11,21,833,774,59
census_2010_blockgroups_view.fid--2dc29038_13ec899ba8f_-261c,"MULTIPOLYGON (((-82.60380562979731 35.581466230226916, -82.60383162979929 35.58148123023266, -82.60390862980563 35.581523230249154, -82.60392262980614 35.581535230253, -82.60410362981774 35.581655230296015, -82.6041186298187 35.58166523029958, -82.60430862982676 35.58181823035022, -82.60460762983722 35.582073230432826, -82.60477362984298 35.582215230478866, -82.60490262984614 35.58233423051627, -82.60496862984792 35.58239423053528, -82.60519262986014 35.58255623059126, -82.60533962987351 35.5826282306211, -82.60542462988116 35.582670230638314, -82.60549662988701 35.582710230653824, -82.60560362989588 35.58276823067663, -82.60577262990947 35.58286223071316, -82.60592962992438 35.58293523074408, -82.6060206299329 35.58297823076218, -82.60603662993324 35.58299323076688, -82.60617462993537 35.583128230808526, -82.60637262993869 35.583321230868165, -82.60657662994353 35.583509230927426, -82.60659662994408 35.58352823093334, -82.6067356299462 35.5836642309753, -82.60695762994953 35.58388223104243, -82.60709662995164 35.58401923108467, -82.60745862995637 35.58437923119513, -82.60757762995975 35.58448623122909, -82.60763562996355 35.584524231242774, -82.60769962996767 35.5845662312579, -82.60791262998741 35.58466823130054, -82.60793562998721 35.58469423130819, -82.60811163000577 35.58476423134053, -82.60811663000594 35.58476823134187, -82.60830063002226 35.58486123137971, -82.60838863002827 35.58491723140014, -82.60850263003583 35.5849912314269, -82.60901563006543 35.5853532315533, -82.60916163007676 35.585437231585395, -82.60919563007936 35.585457231593, -82.60930963009237 35.58549523161238, -82.60939163010293 35.585515231624896, -82.60945463011298 35.58551823163193, -82.60945963011393 35.58551723163226, -82.60925563003774 35.58579223166728, -82.60886362990044 35.5862612317226, -82.60884562989393 35.58628423172547, -82.60842862975677 35.586725231772455, -82.60813862966663 35.58699823179824, -82.60776462954942 35.58735623183286, -82.60732162942466 35.58768823185498, -82.60672062925435 35.588146231886626, -82.60596362903948 35.58872523192682, -82.60571062896894 35.588910231938556, -82.60495162875718 35.58946723197401, -82.60469962868667 35.58965323198606, -82.60442962860992 35.589860232000554, -82.60362162837973 35.59048423204468, -82.60335262830294 35.59069223205952, -82.60270262812142 35.59117023209004, -82.600754627577 35.59260423218211, -82.60010562739542 35.59308323221306, -82.60006262738352 35.593114232214944, -82.59993262734764 35.59320723222053, -82.59989062733575 35.593239232222736, -82.599735627362 35.592901232138054, -82.59966862736943 35.59278023210646, -82.59962662737122 35.59272323209062, -82.59959362737273 35.59267823207802, -82.59944162736593 35.59255823203795, -82.59927062734869 35.592485232005544, -82.59914062733299 35.592447231984494, -82.59894762730531 35.59241823195883, -82.5988176272849 35.592410231943816, -82.59864962725575 35.59241823192817, -82.59820362717645 35.59245223188928, -82.59797562713426 35.592480231871605, -82.59774362709119 35.59250923185377, -82.59740262702587 35.59256623183032, -82.59723162699314 35.59259423181848, -82.59708662696515 35.5926192318086, -82.5968776269292 35.59262723178886, -82.59671762690587 35.592606231768116, -82.59664662689548 35.59259723175901, -82.59654762688203 35.59257723174481, -82.59634862685513 35.59253723171617, -82.59616562683016 35.59250223169024, -82.59606462681643 35.59248223167586, -82.59575162677287 35.5924272316325, -82.5956396267563 35.59241423161837, -82.59554962674297 35.59240323160689, -82.59543562672619 35.592389231592314, -82.59531062670779 35.592374231576414, -82.595094626676 35.59234723154876, -82.59503962666783 35.59234123154185, -82.59498162665969 35.592331231533876, -82.59490062664855 35.59231623152257, -82.59480862663585 35.5922992315096, -82.59472962662647 35.592275231496636, -82.59461562661386 35.59223423147662, -82.59456862660842 35.59221823146852, -82.59450762660174 35.59219623145775, -82.59420162657104 35.59206523139962, -82.59404162655416 35.59200223137041, -82.59384862653343 35.59192823133553, -82.59376162652407 35.591895231319896, -82.59357562650332 35.591829231287306, -82.5934216264853 35.59178023126152, -82.59336662647844 35.59176523125283, -82.59301862643507 35.59167123119797, -82.59295162642437 35.59166823119052, -82.59298262644172 35.59158923117759, -82.59308462649301 35.591366231142686, -82.59316862654559 35.59111523110016, -82.59321962659916 35.59082223104569, -82.59322062660162 35.59080723104274, -82.59328362669409 35.59027423094065, -82.5932956267336 35.590030230892204, -82.59329462678807 35.589675230819864, -82.59326462684899 35.58924723072959, -82.59323762687858 35.589025230681635, -82.59318562690055 35.58882623063574, -82.59315362690575 35.58875823061866, -82.59301262691814 35.58852523055672, -82.59283762692968 35.58826123048497, -82.59280162693153 35.5882102304709, -82.59258662694324 35.587902230386135, -82.59243062694655 35.58771223033145, -82.59231062694707 35.587579230292015, -82.59224962695016 35.58749323026821, -82.59224062695066 35.58748023026466, -82.59217362695566 35.58737523023635, -82.59216362695692 35.58735623023155, -82.59212462696277 35.587276230211216, -82.59207762697318 35.587158230182375, -82.59202062700412 35.586895230122984, -82.59201862700571 35.586882230120054, -82.59200462702607 35.5867352300887, -82.59199062704556 35.586593230058405, -82.59198562705365 35.58653523004604, -82.59199362708382 35.58634823000877, -82.59200862711381 35.58616922997381, -82.59202162713767 35.5860282299465, -82.59202662714861 35.58596222993353, -82.5920316271577 35.58590822992305, -82.59205062718296 35.585765229895905, -82.59205962719442 35.58570022988357, -82.59206562720176 35.5856592298759, -82.59207762721971 35.585555229855906, -82.59212962729511 35.58512122977288, -82.59214762732029 35.584977229745455, -82.59216262734012 35.58486422972396, -82.59218062737622 35.58464922968201, -82.59218962739234 35.584554229663624, -82.59218762742414 35.58434522962083, -82.5921796274396 35.584236229597835, -82.59214962746938 35.58401022954872, -82.59209962749455 35.58379222949921, -82.59206762750738 35.583674229471896, -82.59198462754256 35.583356229398625, -82.59216562757277 35.58335522941697, -82.59226762758891 35.58336022942844, -82.59255662763465 35.583375229461254, -82.59311662772541 35.58339022952168, -82.59340062777136 35.583398229552486, -82.59370462782182 35.58339822958371, -82.59392562785835 35.583399229606535, -82.59406162788262 35.58338822961834, -82.59410862789251 35.583375229620486, -82.59412562789595 35.583371229621406, -82.59418162790828 35.583351229623126, -82.59425262792577 35.583314229622815, -82.59431962794494 35.58326222961912, -82.59448662799882 35.58309222960162, -82.59450262800472 35.583071229599, -82.59465762805948 35.58288222957642, -82.59468962807271 35.58283122956931, -82.59464762806898 35.58281022956078, -82.59457962806457 35.5827652295446, -82.59442762806611 35.5825912294936, -82.59435262806664 35.58250622946863, -82.59412062807026 35.58223222938895, -82.59371262807112 35.58178622925623, -82.59347162807185 35.581521229177554, -82.59352862808271 35.581512229181556, -82.59380062812738 35.58151522921007, -82.59397162815483 35.58152122922889, -82.59430162820755 35.581535229265604, -82.59437962822219 35.58152422927136, -82.59445162823924 35.58149122927203, -82.59446862824885 35.581447229264825, -82.59448162826202 35.58137522925148, -82.59452762834582 35.580880229155426, -82.59454962840742 35.58050322908089, -82.59455062841076 35.58048322907689, -82.5945786284632 35.580172229016505, -82.59457362847559 35.58008622899844, -82.59454362847754 35.580041228986246, -82.59450162847405 35.580018228977195, -82.59452762852068 35.57974322892387, -82.59453562853481 35.57966022890776, -82.5945596285981 35.579274228831636, -82.59458062863065 35.5790852287953, -82.59460662866027 35.57892122876469, -82.59463262868776 35.57877022873656, -82.59464462870835 35.57864922871307, -82.59490462873109 35.578782228766876, -82.59546362878 35.5790682288825, -82.59567862879653 35.579193228930045, -82.59570762879875 35.57921022893643, -82.5959206288112 35.579359228988665, -82.59611762882159 35.57950422903844, -82.59637362883522 35.57969222910297, -82.59663862885095 35.579876229167624, -82.59671862885658 35.579926229185986, -82.59692762887131 35.58005622923394, -82.59703062887903 35.58011722925691, -82.597187628891 35.58020922929182, -82.59734562890418 35.580294229325276, -82.59745162891305 35.580351229347805, -82.59769362893488 35.58047022939691, -82.59793762895681 35.58059122944654, -82.59813662897915 35.58066122948121, -82.59835962900866 35.58071022951405, -82.59845762902248 35.58072622952742, -82.59872462905999 35.58077122956394, -82.5989886290981 35.580808229598595, -82.59935362915088 35.58085922964639, -82.59958562918561 35.580884229675334, -82.59978562921773 35.580891229697286, -82.60005262926043 35.58090222972692, -82.60021562928648 35.58090922974505, -82.60056762934212 35.580927229784834, -82.60070662936297 35.58094222980216, -82.60086962938728 35.58096022982257, -82.60100262940593 35.5809822298407, -82.60116862942911 35.58101122986367, -82.60140362946107 35.58105722989718, -82.6015376294792 35.581084229916414, -82.60169562950131 35.58111122993816, -82.60176262951062 35.58112322994747, -82.60207062955479 35.5811682299882, -82.6021716295701 35.58117823000061, -82.60233162959403 35.58119523002051, -82.6025196296239 35.58120423004157, -82.60303662970566 35.58123123010018, -82.60308462971271 35.58123723010632, -82.60327162973961 35.581264230130934, -82.60338262975384 35.58129123014787, -82.60349962976873 35.58132123016605, -82.6036996297891 35.581405230203664, -82.60370562978957 35.581408230204815, -82.60380562979731 35.581466230226916)))",4585,37,021,001200,370210012001,858,858,37,832,761,36,1,10,5,19,26,713,26,687,703,654,26,1,8,2,12,10,429,402,27
census_2010_blockgroups_view.fid--2dc29038_13ec899ba8f_-261b,"MULTIPOLYGON (((-82.41442656635243 35.788248252798034, -82.41497056645377 35.788177252839866, -82.41745456691429 35.78786625303349, -82.41758356693839 35.787849253043326, -82.41805756702861 35.787774253077075, -82.41840656709634 35.78771125310042, -82.41890356719624 35.78759925312897, -82.41943756730554 35.787466253157135, -82.4196025673393 35.78742525316584, -82.41969256735801 35.787401253170316, -82.42045956751636 35.787201253208934, -82.42071556756912 35.787135253222, -82.42098956762581 35.78706325323565, -82.42181356779584 35.786849253277374, -82.42208856785255 35.78677825329129, -82.42278956799719 35.78659625332674, -82.42282456800407 35.78658925332894, -82.42304356804651 35.78655025334369, -82.42323656808274 35.786523253358126, -82.4236415681533 35.78650125339553, -82.42378956817821 35.78649925341046, -82.4238355681858 35.786499253415144, -82.42415956823643 35.78651925345276, -82.42501056837143 35.78655925354886, -82.42509656838666 35.78655325355651, -82.4251065683883 35.78655325355753, -82.42525756841474 35.786544253571385, -82.4255135684596 35.78652925359475, -82.42585556852086 35.78650025362424, -82.42609756856645 35.78646525364212, -82.4261405685745 35.78645925364532, -82.4264845686437 35.78638125366504, -82.42681156871261 35.786287253679745, -82.42704856876219 35.7862212536908, -82.42760056887731 35.786070253717185, -82.42762556888272 35.7860622537181, -82.42896356916403 35.78568125377894, -82.42935456924485 35.78557925379862, -82.4297725693309 35.78547225382006, -82.42993256936505 35.78542325382668, -82.42997956937515 35.78540825382847, -82.43012156940547 35.78536525383444, -82.43016956941561 35.78535125383657, -82.43052856949231 35.78524125385128, -82.43128656965106 35.785029253886464, -82.43158856971475 35.784942253899985, -82.43263056993372 35.784646253947535, -82.43333857008142 35.78445225398126, -82.43401657022444 35.78425625401152, -82.43471657037082 35.78406225404434, -82.43585157060947 35.78373925409596, -82.43686857082312 35.78345125414254, -82.43727357090759 35.783340254161836, -82.4373995709339 35.7833052541677, -82.437711570999 35.783220254182666, -82.43778057101325 35.783202254186165, -82.43790857103932 35.7831712541931, -82.4383045711203 35.78307325421409, -82.43931657132009 35.78286825427697, -82.43991257143756 35.78274925431436, -82.4423025719016 35.78231625447332, -82.44356457214965 35.7820682545532, -82.44370257217672 35.78204225456226, -82.44447757233631 35.78184325460182, -82.44495357243927 35.78168925461967, -82.44513857247934 35.781629254626665, -82.44518357248968 35.78161025462744, -82.44586057264571 35.781330254640466, -82.44608657269767 35.78123725464486, -82.44698757291948 35.780773254643584, -82.44713057295749 35.78068125463963, -82.44793757317103 35.78017025461906, -82.4481905732343 35.780033254617365, -82.44846957329901 35.77991525462217, -82.448866573384 35.779792254638245, -82.45040757370035 35.779403254718275, -82.4515555739359 35.77911425477809, -82.45221257407078 35.77894825481226, -82.45228157408492 35.7789312548159, -82.45303357424149 35.77872725485216, -82.45333657430939 35.778614254860415, -82.45412157449411 35.778264254870294, -82.45441657456331 35.77813425487435, -82.45475557463625 35.778027254887625, -82.45486757466048 35.77799125489189, -82.4549755746815 35.77797125489901, -82.4551455747146 35.77794025491029, -82.45565457480744 35.77788625495182, -82.4558815748489 35.7778622549704, -82.45636357493544 35.777820255011704, -82.45685157502302 35.77777825505358, -82.45723157508985 35.77775425508789, -82.45749257513441 35.77774625511323, -82.45774657517663 35.77774625513948, -82.45781257518692 35.7777502551471, -82.45798257521331 35.777762255167104, -82.45823257525095 35.777787255197985, -82.45829457525946 35.77779825520667, -82.45832357526353 35.777803255210664, -82.45841357527584 35.77782025522352, -82.45844357527982 35.777826255227765, -82.45846357528254 35.77783025523066, -82.4585235752902 35.77784525523989, -82.45854457529293 35.77785025524304, -82.4586315753042 35.77787025525618, -82.458857575331 35.7779392552935, -82.45918757536778 35.7780552553512, -82.4593975753877 35.77815125539248, -82.45961457540619 35.77826425543787, -82.45982557542109 35.77839325548587, -82.45993357542704 35.77847025551269, -82.46000257543068 35.77852025553002, -82.46016657543699 35.77865525557438, -82.46034957543954 35.77883425562971, -82.46053857543822 35.779044255692014, -82.46075057543153 35.7793132557686, -82.46111657541302 35.779823255910195, -82.46126557540696 35.780021255965856, -82.46149457539497 35.78034225605492, -82.461763575383 35.78070625615667, -82.46200257537038 35.781042256249705, -82.46220757536237 35.78131325632608, -82.4626725753379 35.781966256506976, -82.46275657533448 35.78207825653836, -82.46294257532692 35.78232525660786, -82.46326557531576 35.78274125672584, -82.46344157531638 35.78292525678147, -82.46354057531913 35.783013256809596, -82.46366857532392 35.783119256844444, -82.46378157532911 35.78320625687379, -82.46380657533034 35.783225256880264, -82.46397157534123 35.78333125691885, -82.46419557535928 35.78345425696705, -82.4643735753748 35.783544257003726, -82.46441257537913 35.78355825701063, -82.46450857538944 35.78359425702788, -82.46464257540394 35.78364425705187, -82.46489157543331 35.783721257093255, -82.46507957545735 35.78376725712202, -82.46526357548221 35.78380425714862, -82.46546857551238 35.78382925717484, -82.46569457554695 35.78384825720208, -82.46595157558866 35.78385425722981, -82.46616157562403 35.783851257250895, -82.4664605756755 35.7838392572794, -82.46669257571637 35.783824257300274, -82.46820057598175 35.783728257436536, -82.46933357618133 35.78365525753871, -82.47008957631422 35.783608257607305, -82.47053957639592 35.78356325764464, -82.47084557645292 35.78352325766812, -82.4711995765214 35.78346125769201, -82.47153657658923 35.78338525771139, -82.47186857665882 35.7832922577268, -82.4722205767352 35.783177257739716, -82.47266057683422 35.7830102577512, -82.47294957689901 35.78290225775916, -82.47372057707423 35.78259925777714, -82.47379257709058 35.78257125777888, -82.47383557710032 35.78255425777988, -82.47409257715807 35.78245725778657, -82.47418357717855 35.7824232577891, -82.47430057720453 35.782381257792665, -82.47444357723654 35.78232825779661, -82.47462357727642 35.782263257802015, -82.47487857733158 35.78218125781162, -82.47492457734145 35.782167257813576, -82.47502557736273 35.78213825781808, -82.47530957742279 35.782055257830564, -82.47573757751178 35.781940257851375, -82.47601857756953 35.78186925786594, -82.47660957769043 35.781723257897305, -82.47701657777264 35.7816292579202, -82.47782257793669 35.781435257963984, -82.47815457800303 35.78136325798356, -82.47848057806551 35.781310258006485, -82.4787835781209 35.781277258031054, -82.47903957816642 35.78125825805366, -82.47905357816877 35.781258258055146, -82.47933057821555 35.78125325808272, -82.47961757826211 35.78126025811376, -82.47983057829563 35.78127225813818, -82.48006657833047 35.78130025816828, -82.48017057834586 35.78131225818147, -82.48032257836728 35.781337258202264, -82.48067757841451 35.781412258254186, -82.48072157842013 35.78142325826096, -82.48088157844055 35.78146325828563, -82.48106857846258 35.78152125831672, -82.48129057848759 35.78159725835511, -82.48157757851807 35.78170825840735, -82.48186657854545 35.78184025846412, -82.48257357861071 35.78217625860549, -82.482752578627 35.78226225864152, -82.48317557866564 35.78246625872674, -82.48379757872236 35.782765258851775, -82.48491957882497 35.78330425907738, -82.48557057888567 35.78360925920664, -82.48567057889558 35.783652259225704, -82.4857715789056 35.78369625924511, -82.48601757893276 35.78378425928842, -82.48632557897005 35.78387325933839, -82.48640957898102 35.78389225935091, -82.48647957899023 35.78390825936138, -82.48665157901347 35.78394225938608, -82.48666557901545 35.783944259387894, -82.48675257902808 35.783956259399396, -82.48677957903212 35.783959259402806, -82.48686257904403 35.78397125941373, -82.48689057904805 35.78397525941748, -82.48689857904264 35.78401825942705, -82.48690557902991 35.78410825944614, -82.48692057900323 35.78429525948569, -82.48699857889825 35.78505325964806, -82.4870125788812 35.785178259674886, -82.48704157885832 35.785356259714185, -82.48707757883845 35.78552225975159, -82.48712557882584 35.785654259783456, -82.4871825788144 35.785789259816816, -82.48727057880413 35.785949259858484, -82.48733157879852 35.786050259885336, -82.48742857879483 35.786177259921224, -82.48755557879512 35.7863112599616, -82.48771157879914 35.786452260006385, -82.48789457880852 35.78658726005279, -82.48814357882702 35.78673426010839, -82.488374578848 35.78684626015506, -82.4891585789233 35.7871992603079, -82.48938057894446 35.78730026035133, -82.49006557900962 35.78761326048585, -82.49014557901744 35.787648260501264, -82.49073057907425 35.78790826061459, -82.49073657907472 35.78791126061578, -82.49098057910224 35.78799526065812, -82.49122057913137 35.78806426069692, -82.49150057917059 35.78811126073536, -82.49182357922082 35.78813326077323, -82.49239557931465 35.78814126083396, -82.49255957934035 35.788151260852906, -82.49262057934915 35.7881602608611, -82.49269557935983 35.788171260870996, -82.49283757937626 35.7882172608951, -82.49294557938696 35.78826426091577, -82.49302957939003 35.78833426093877, -82.49313757939007 35.78844926097325, -82.49315157938794 35.788477260980365, -82.49316557938617 35.78850426098733, -82.49318257938398 35.788536260995606, -82.49319957937847 35.788590261008366, -82.4932095793754 35.78862026101553, -82.49321857937228 35.78865026102257, -82.4932255793635 35.78871426103631, -82.49322757936132 35.78873026103974, -82.4932175793427 35.78883926106096, -82.49317557932062 35.78893626107626, -82.49314457930817 35.78898326108265, -82.49311857929715 35.789026261088786, -82.49308657928671 35.789059261092234, -82.4930265792672 35.789120261098404, -82.49295757924438 35.789193261106085, -82.49284157920904 35.78929626111507, -82.49277857918977 35.78935326112019, -82.49266457915495 35.78945526112918, -82.49258057912974 35.78952726113516, -82.49209357898295 35.7899502611709, -82.49199757895025 35.790058261182956, -82.49196357893838 35.7900982611876, -82.49184257889134 35.790271261210286, -82.49181857888004 35.790318261217394, -82.49176757885536 35.79042226123336, -82.49174957884618 35.79046226123961, -82.49172857883505 35.790511261247374, -82.49171157882614 35.790550261253614, -82.4916625787931 35.790710261281085, -82.49163957876318 35.79087826131288, -82.49163057873487 35.79105026134697, -82.49163257872324 35.79112726136282, -82.49165657859288 35.791990261540974, -82.4917005784532 35.79293526173788, -82.49170357844187 35.79301126175366, -82.49173057834847 35.79364026188446, -82.49173557833126 35.793756261908555, -82.49174657829377 35.79400926196116, -82.49174357827796 35.794107261980805, -82.49174057825927 35.79422426200432, -82.49173757824788 35.79429426201831, -82.49173757824413 35.794318262023204, -82.4917195782122 35.79450426205913, -82.49171357820023 35.79457426207283, -82.491711578197 35.79459326207639, -82.49164757813097 35.79494926214227, -82.49156757806392 35.79529426220423, -82.4913955779328 35.795953262320566, -82.491354577905 35.79608826234383, -82.49130957787368 35.79624126237035, -82.49117857780458 35.79654526241864, -82.49100357772036 35.79689926247263, -82.49046657747108 35.797927262626374, -82.49013457732609 35.798504262709514, -82.48996357725677 35.79876726274535, -82.48954157709427 35.7993602628225, -82.4893345770155 35.79964526285911, -82.48909657692278 35.79998726290406, -82.48900757688878 35.80011026291996, -82.48863157674384 35.800640262988985, -82.48840057665353 35.80097326303285, -82.48820457657831 35.80124726306834, -82.48811757654188 35.80138826308804, -82.48811257654032 35.801393263088514, -82.48801257649426 35.80158226311673, -82.48795157646452 35.80170826313603, -82.48755757645549 35.80134526302147, -82.48664657643506 35.80050426275616, -82.48587057638746 35.799982262569756, -82.48572457638006 35.79987326253245, -82.48516957627048 35.79998526249794, -82.48474357622341 35.799832262422726, -82.48425857614235 35.79983526237322, -82.48306757593953 35.79986726225672, -82.48233557581554 35.799882262184134, -82.48228057580607 35.79988426217882, -82.48203757577456 35.799827262142145, -82.4819305757616 35.7997962621248, -82.48175257574891 35.79968826208439, -82.48137757573046 35.79940626198829, -82.4811535757192 35.799239261931085, -82.48096457569972 35.799163261896084, -82.48073057567011 35.79910326185971, -82.4802495756092 35.79898126178521, -82.48010957558982 35.798956261765674, -82.47916757542534 35.79900726167867, -82.47841357529953 35.799011261601564, -82.47788757521431 35.79899726154441, -82.47773257519708 35.798942261517155, -82.4775105751726 35.79886226147794, -82.47723157514558 35.79873826142395, -82.47690657510856 35.798629261368134, -82.47673457508841 35.79857526133934, -82.4764375750454 35.79853426130032, -82.47617057500852 35.79848626126298, -82.47594957497537 35.79846326123544, -82.47579357495218 35.798446261215844, -82.47537657484605 35.798682261220776, -82.47501457477024 35.79878326120394, -82.47447157462713 35.799123261217005, -82.47389857454189 35.7990592611448, -82.47387257453799 35.799056261141445, -82.47372557451878 35.799023261119586, -82.47297057434578 35.79932826110355, -82.472476574272 35.7992752610418, -82.47144657413249 35.79907226089402, -82.47124757408056 35.79919326089807, -82.4709005739728 35.799515260927706, -82.47054357388237 35.799715260931514, -82.46999857375805 35.799932260919356, -82.46944457364742 35.80005126088628, -82.46841557345809 35.80016926080395, -82.46803957338196 35.80025726078301, -82.46783857332674 35.8003972607907, -82.46766257327806 35.800522260797955, -82.4673415731869 35.800765260814195, -82.4671765731397 35.800892260823055, -82.46670057302433 35.80112526082129, -82.4663435729313 35.80134226082847, -82.46580757280975 35.80155126081563, -82.46558957276973 35.801575260797925, -82.46527857271478 35.80159626077015, -82.46484957262622 35.80170726074837, -82.4651325726591 35.801798260796126, -82.46503657263818 35.801830260792705, -82.46493657258515 35.80206426082997, -82.46471557246556 35.80259626091545, -82.46451457233536 35.80321726102093, -82.4644145722863 35.80342626105312, -82.46432457223983 35.803628261084924, -82.46433257220937 35.80383226112725, -82.46430057218356 35.803964261150824, -82.46460857201738 35.80535926146646, -82.46472057199311 35.805634261534045, -82.46472857196768 35.805806261569806, -82.46474357191458 35.80616326164401, -82.46470357186627 35.80643026169422, -82.46469557184038 35.8065882617255, -82.46468357181763 35.80672126175136, -82.46472357179346 35.80691926179574, -82.464783571773 35.807114261841654, -82.46476057172761 35.80738126189363, -82.46471857169787 35.807527261918935, -82.4646905716817 35.80760126193117, -82.46458857165247 35.80768026193664, -82.46437857156745 35.808002261980484, -82.46419557138252 35.808994262163374, -82.463895571251 35.809518262238974, -82.46337057113134 35.80972626222704, -82.4626785710167 35.8097242621551, -82.46208557091587 35.80973926209686, -82.46147257080057 35.80982626205121, -82.46079957068905 35.80982426198121, -82.4607605706825 35.80982426197714, -82.46074657068073 35.80982126197508, -82.46027557060442 35.809808261923735, -82.45951157054783 35.809357261753014, -82.45863857047047 35.80892326157443, -82.45784157042117 35.80839026138356, -82.45754957040415 35.80818826131228, -82.45741457038991 35.80813526128761, -82.45726957037492 35.80807726126076, -82.4572415703708 35.80807326125708, -82.45711257035268 35.808052261239446, -82.45678557030956 35.807980261191005, -82.45612557020488 35.80794926111648, -82.45490356998566 35.80805326101125, -82.4540335698968 35.80769626084867, -82.45402756989084 35.80772826085464, -82.45294556965086 35.80811526082145, -82.4517045693993 35.80840726075253, -82.45096756920249 35.80888426077337, -82.44997456899341 35.80916826072851, -82.44879456870069 35.809788260732596, -82.44821156857107 35.80999926071524, -82.4478775684718 35.810280260737876, -82.44714256829485 35.81063226073342, -82.44677556821198 35.81077326072417, -82.44440356800921 35.80954726022951, -82.44405656798287 35.80934626015275, -82.44379756797828 35.80910026007592, -82.44203356769667 35.809027259878675, -82.44057656746435 35.80896625971557, -82.44057556746903 35.80893525970917, -82.43921856726914 35.80877225953568, -82.43579656676441 35.80836525909897, -82.4355455667246 35.80835325907056, -82.43542056670158 35.808368259060686, -82.43512656662811 35.808526259062454, -82.43491956656864 35.808687259073736, -82.43487456655649 35.80871725907523, -82.4348005665367 35.808765259077326, -82.43465156649592 35.808868259082836, -82.43449056643394 35.80909425911222, -82.4343745663842 35.80929025914006, -82.43420956631876 35.809534259172594, -82.4338465662011 35.80990225920999, -82.43369756616163 35.80999725921389, -82.43342056609134 35.81015325921692, -82.43313556602057 35.81030325921798, -82.43281956593637 35.81050725922676, -82.4325565658542 35.81075425924982, -82.43228156575661 35.8110872592891, -82.43188656561871 35.811551259342615, -82.43159556552737 35.81182725936863, -82.43120456543207 35.81202225936784, -82.43073856534033 35.81211425933842, -82.43039656527894 35.81214425930907, -82.43009356522289 35.81218125928529, -82.42981756517096 35.81222025926462, -82.42961856512724 35.81228925925814, -82.42940856507458 35.81240325925959, -82.4291315650038 35.812562259263316, -82.42890556495487 35.81263525925477, -82.4276335645925 35.813605259320425, -82.427316564502 35.81384825933709, -82.4270495644413 35.81395325933081, -82.426768564407 35.813874259285626, -82.42420756395977 35.81401625904967, -82.42391656391396 35.814000259016225, -82.42287256375002 35.81394025889605, -82.42204856362056 35.81389325880124, -82.42086856339102 35.81410925872311, -82.42033456335535 35.813770258598936, -82.42007456333788 35.81360525853846, -82.41981856332077 35.813442258478794, -82.4189525631754 35.813453258391455, -82.41807156305441 35.813291258267355, -82.41748156293387 35.81343625823583, -82.41710156285974 35.813507258211, -82.41634156268788 35.81380125819216, -82.41613256264787 35.81383525817742, -82.4156385625534 35.81391525814259, -82.41466456237515 35.81402125806339, -82.41422056226675 35.81424425806281, -82.41358356211116 35.81456425806192, -82.41314256200354 35.81478525806127, -82.41296956197047 35.814813258049035, -82.41235356187131 35.814793257981236, -82.41179656178167 35.81477525791994, -82.4114225616311 35.81534325799676, -82.41108656152645 35.815656258025626, -82.41072556143475 35.81586025802977, -82.41033056135964 35.81592225800151, -82.41015956129965 35.81612425802489, -82.40995556125043 35.816223258023896, -82.40942456106573 35.81684225809483, -82.40919456098521 35.81711325812614, -82.40899956087745 35.81759725820434, -82.40882356079862 35.81791525825083, -82.40871556075845 35.81805825826875, -82.4084825607009 35.81817925826923, -82.40812056061107 35.81837025827057, -82.40777856052961 35.81852825826731, -82.40763456049524 35.81859525826604, -82.40753556047468 35.818622258261264, -82.40682256032579 35.81881825822737, -82.40592356018202 35.81878325812719, -82.405162560065 35.81872425803643, -82.40459755993635 35.81894825802361, -82.40407155979524 35.81929325803923, -82.40378355972503 35.81943725803869, -82.4034285596814 35.81933925798203, -82.40306855975398 35.818491257772365, -82.40273655981477 35.817748257586956, -82.40256955980978 35.81760225754, -82.40256555980912 35.817602257539555, -82.40213455973289 35.81763325750127, -82.40183755966996 35.8177202574882, -82.40139155957104 35.81788025747454, -82.4005905594285 35.817942257404354, -82.39948255922498 35.81806825731526, -82.3984725590166 35.818330257263966, -82.39765955883306 35.81864225724328, -82.39711455871021 35.81885025722916, -82.39617355850912 35.81913825719031, -82.39518355831156 35.819352257131406, -82.3940065581068 35.81941325702195, -82.39340255797676 35.819604256998254, -82.39318455791681 35.8197572570068, -82.39280655781147 35.82003025702316, -82.39204255761466 35.820479257035394, -82.39010955715658 35.821360257014376, -82.38963355705893 35.821480256989474, -82.38929755699455 35.821535256965916, -82.38860555688005 35.82153325689387, -82.3879035567551 35.821588256832456, -82.38753655668194 35.82166725681044, -82.38713155661986 35.8216342567618, -82.38671755656422 35.821551256702115, -82.3863215564999 35.82154225665929, -82.38602455643695 35.82163025664641, -82.38517055621524 35.82214325666225, -82.38469955609156 35.82243525667285, -82.38448555603532 35.82256825667778, -82.38396955590214 35.82287325668637, -82.38310655568 35.82337925669988, -82.38208255540869 35.82402925672598, -82.38190455536918 35.82409325672057, -82.38162755532595 35.82407625668848, -82.38072155524674 35.82362125650212, -82.38024855520634 35.823377256403546, -82.37951055516129 35.82288225622654, -82.37923455514202 35.82271225616338, -82.3788735551908 35.82201625598459, -82.37860155526039 35.82128125580697, -82.37850055531867 35.82080025569875, -82.37845755534362 35.820595255652655, -82.37795755534289 35.82006825549381, -82.37738655530518 35.819703255360466, -82.37686355523132 35.81962125528968, -82.37604355512481 35.81943225516632, -82.37483655501929 35.81882625491824, -82.37450155498162 35.81871125486016, -82.37429455497373 35.81854225480436, -82.37380155497374 35.818018254646795, -82.37361455497681 35.81780025458318, -82.37343855492855 35.8179222545897, -82.37327855488451 35.81803425459595, -82.37183555452219 35.81882325460689, -82.37162555447766 35.818885254597774, -82.37104355432815 35.819225254606586, -82.37094655430302 35.81928325460835, -82.37059955419144 35.819629254642756, -82.37010555406684 35.81990325464731, -82.36950355393424 35.820113254627614, -82.36928655389748 35.82011825460617, -82.36864055378804 35.82013325454237, -82.36861355378348 35.82013425453976, -82.36849555376341 35.82013725452815, -82.36788355364696 35.8202332544843, -82.36768655359417 35.8203622544901, -82.36740855351917 35.82054725449892, -82.3668455533528 35.82101525453572, -82.36621255315231 35.821627254594624, -82.36613655313 35.82168925459929, -82.36607455311184 35.82174025460321, -82.3659455530916 35.82173225458826, -82.36528955299983 35.8216242544984, -82.36432955286526 35.82146625436685, -82.36349655274863 35.8213292542528, -82.36334355272717 35.82130425423183, -82.36328955271942 35.8212962542246, -82.36287955265374 35.82128225417931, -82.36272555262879 35.82127825416258, -82.36257355260433 35.82127325414582, -82.36229255255923 35.82126425411489, -82.36212355252465 35.82130625410596, -82.36197655249433 35.82134425409841, -82.36189755249765 35.821239254068885, -82.36189355249925 35.82122425406547, -82.36177955254692 35.820798253967084, -82.36175955255531 35.82072325394974, -82.3617445525633 35.82065625393462, -82.36168155259644 35.82037725387133, -82.361267552636 35.81968325368745, -82.36105655264218 35.81942025361216, -82.3607845526503 35.81907925351472, -82.36001455262085 35.81845025330718, -82.35959055263366 35.817918253155085, -82.35917655265196 35.81736125299906, -82.35880055265258 35.816958252878194, -82.3583075526035 35.81674925278477, -82.35791255254772 35.816687252731214, -82.35752755249331 35.81662725267912, -82.35667855237644 35.816474252560134, -82.35652055236301 35.8163922525271, -82.35620355233628 35.81622725246081, -82.35601455232339 35.816109252417206, -82.3555055523039 35.815693252279964, -82.35508955231604 35.815174252131435, -82.35393955235187 35.81372325171758, -82.35312755235176 35.8128622514585, -82.35311255235023 35.81285625145574, -82.35306955234537 35.812841251448226, -82.35305555234386 35.81283625144574, -82.35253555228765 35.81264425135287, -82.35225755225034 35.81258825131277, -82.35357355247467 35.81254825144087, -82.35452955260017 35.8127592515827, -82.35600155280046 35.813038251791845, -82.35678755293213 35.8130292518714, -82.35728155306104 35.81272825186136, -82.35761155314135 35.812564251862256, -82.35839455330321 35.81235825190139, -82.35867955337396 35.81220725190029, -82.3586885534312 35.811850251828616, -82.35850655340468 35.81182725180513, -82.3583045533702 35.81183325178549, -82.3582585533693 35.81179025177193, -82.35812555334948 35.81177625175533, -82.35781555328671 35.81184925173807, -82.3574555532119 35.81194625172053, -82.35717655316093 35.811976251697736, -82.35702955313165 35.81200825168899, -82.35693555310877 35.81205525168875, -82.35682655307873 35.812131251692996, -82.35661855302585 35.81224925169541, -82.35653155300744 35.8122752516917, -82.35639655298539 35.812273251677304, -82.35598755292622 35.81221825162377, -82.35570555288722 35.81216825158442, -82.35543755285624 35.81208225153915, -82.35517755283253 35.81195825148704, -82.35484455280013 35.81181225142292, -82.35466655278515 35.81171925138559, -82.35450655277344 35.81162425134972, -82.3541565527494 35.81140625126917, -82.35396155273948 35.81126325121994, -82.35372255273047 35.81106725115538, -82.35362655272924 35.81097325112628, -82.35355055273193 35.81087525109854, -82.35341255274243 35.81066125104075, -82.35332355274738 35.81053525100591, -82.35321655274824 35.81041625097072, -82.35310055274336 35.81032425093992, -82.3529265527334 35.810203250897395, -82.35271755272416 35.81004025084267, -82.35242955270287 35.8098712507785, -82.35194955267153 35.809562250666005, -82.35194355267117 35.809558250664566, -82.35180355266355 35.809458250629774, -82.35164155265015 35.809372250595494, -82.35123655260878 35.80920725052007, -82.35108355259685 35.80912125048673, -82.3509755525933 35.809029250456824, -82.35089355259564 35.80892725042759, -82.35083955260092 35.80883625040359, -82.3508295526092 35.808772250389495, -82.35084055262355 35.80869225037439, -82.35087355264372 35.80859825035873, -82.35104455272378 35.80826625030894, -82.35109655274596 35.80817925029669, -82.35126655280679 35.80797025027176, -82.35133055283112 35.8078822502605, -82.35147055287038 35.80777925025408, -82.35158255289639 35.807731250255976, -82.35168755291758 35.807707250261934, -82.35184055294135 35.80771725027979, -82.35193455295541 35.807727250291585, -82.35205055297456 35.80772725030355, -82.35216755299786 35.80770225031062, -82.35233755303888 35.807620250311594, -82.35250455308261 35.80751725030789, -82.35265655311635 35.80746225031253, -82.35270955312625 35.80745525031658, -82.35279255314074 35.80745025032414, -82.35289655315562 35.80746525033791, -82.35317355319795 35.80748825037132, -82.35358055326618 35.80748325041239, -82.35367555328331 35.807474250420405, -82.35388155332778 35.80740825042837, -82.35397955335196 35.807357250428154, -82.354078553379 35.80728925042451, -82.35426555343705 35.807115250408565, -82.35440955348636 35.80695225039028, -82.35450055353576 35.806732250355076, -82.3545045535572 35.80659925032847, -82.35447255360761 35.806242250252616, -82.35443555363112 35.80605225021014, -82.35441055363758 35.80598425019375, -82.35437555364133 35.80592325017776, -82.35431255363879 35.80587225016084, -82.35419755362693 35.805826250139596, -82.35372555356511 35.80572125006939, -82.35358555354924 35.80567425004534, -82.35345755353647 35.80562025002115, -82.3532585535191 35.8055202499802, -82.353157553513 35.80545224995592, -82.35308255351318 35.805371249931696, -82.35305655352178 35.80528824991215, -82.35306655354063 35.805178249890886, -82.35314755357324 35.80505524987421, -82.35334455362806 35.80491324986575, -82.35342755365942 35.8048002498514, -82.35347655370695 35.80454724980502, -82.35350955373316 35.80441424978145, -82.35356455375984 35.80430224976442, -82.35362955378586 35.80420424975124, -82.35374255382644 35.80406424973445, -82.35374555383376 35.80402024972584, -82.35373255384849 35.803912249702556, -82.35370155385597 35.80383124968288, -82.35358655386624 35.80364324963274, -82.35354555387335 35.80355424961043, -82.35355255388448 35.80349024959813, -82.35362055390013 35.8034622495995, -82.35373155391663 35.803474249613444, -82.35392855394258 35.80351724964259, -82.3540505539626 35.8035182496554, -82.35433755402046 35.80345224967173, -82.35463855408888 35.803333249678666, -82.35498955417812 35.803134249674585, -82.35541955428194 35.80292524967662, -82.3556485543341 35.80283424968185, -82.35566255433766 35.80282624968164, -82.35574655435877 35.802780249681035, -82.35583155438327 35.802713249676245, -82.35584555440478 35.80259024965264, -82.35581655441587 35.80248824962896, -82.35579055442251 35.802418249612046, -82.3557075544337 35.80225824957092, -82.35570555443873 35.80222424956378, -82.35570355444443 35.802185249555656, -82.35572755446195 35.80209824954044, -82.35586155448948 35.8020642495475, -82.35605255452084 35.80206624956761, -82.35631755455881 35.80210424960278, -82.35647455458403 35.80210924962002, -82.35659755461018 35.80207224962525, -82.3566845546348 35.80200724962103, -82.35672455465155 35.80194224961202, -82.35675355467089 35.8018492495961, -82.35677355469447 35.801719249571704, -82.35682155471893 35.8016132495552, -82.35690055474656 35.801520249544446, -82.35703055478095 35.80143724954101, -82.357363554851 35.80134224955618, -82.3576285549066 35.80126724956842, -82.35773355492807 35.80124124957397, -82.35785055495074 35.80122024958179, -82.35798055497433 35.80120724959266, -82.35806955498892 35.80120824960207, -82.35821855501322 35.801210249617874, -82.35834855503889 35.80118424962602, -82.35847555506678 35.80114024963022, -82.35861355510245 35.801058249627886, -82.35870855512904 35.80098824962347, -82.35873955513767 35.800966249622206, -82.35892855520271 35.80075024959795, -82.35904255524039 35.80062924958514, -82.35913855526525 35.800572249583496, -82.35926355529166 35.8005352495889, -82.35929455529711 35.80053324959174, -82.35952955534562 35.80047224960362, -82.35970355538315 35.80041624961021, -82.35999655545618 35.80025924960868, -82.3600905554872 35.800160249598264, -82.36015755551371 35.800061249585085, -82.36019555553956 35.79993624956361, -82.36023155557201 35.79976624953279, -82.36027455560925 35.79957324949802, -82.36029955562651 35.799489249483585, -82.36037355565665 35.79937424946783, -82.36049855568993 35.79929424946454, -82.36061755571447 35.79926324947052, -82.36069455572377 35.79928524948298, -82.36072655572437 35.79931524949239, -82.36071855571682 35.7993552494997, -82.36062755568425 35.79946724951304, -82.36050255564152 35.79960824952874, -82.36045955561629 35.79972424954785, -82.36041555556231 35.800024249604235, -82.36037655552865 35.80019824963564, -82.36030655549075 35.80036724966266, -82.36018555544499 35.80053224968366, -82.36001555539177 35.80069224969862, -82.35987055535044 35.80080324970618, -82.35986355534837 35.800809249706674, -82.35978855532343 35.80088924971513, -82.359737555305 35.80095324972285, -82.35970955528946 35.801023249734236, -82.3597085552753 35.801113249752376, -82.35977855524773 35.80136424981063, -82.35979755524306 35.80141424982279, -82.35982855523167 35.80152024984757, -82.35983855521373 35.8016462498741, -82.35971155515801 35.801868249906185, -82.35966755513202 35.801988249926005, -82.35965755511474 35.802088249945236, -82.35970655510492 35.80220324997364, -82.35978155510048 35.80231125000339, -82.36001155510593 35.8025212500699, -82.36006255510075 35.802608250092774, -82.3600635550866 35.802700250111585, -82.36005055506978 35.80279425012939, -82.36004655505583 35.80287925014624, -82.36005555504771 35.80294125015973, -82.36008255504221 35.8030052501756, -82.36011655503974 35.80305725018963, -82.36018755504519 35.80309725020511, -82.36027855505749 35.803115250218184, -82.36036155507907 35.80306525021663, -82.36054355514476 35.8028372501892, -82.36059055517326 35.802704250167025, -82.3605955551911 35.80259525014535, -82.36058255520405 35.80249825012427, -82.36063355522923 35.80239125010789, -82.36072055526616 35.802247250087575, -82.36078755530261 35.80208425006139, -82.36087155540285 35.80153024995747, -82.36091555543992 35.80134024992348, -82.36095855546132 35.801248249909236, -82.36101955548475 35.80116324989824, -82.36111755551077 35.80110024989563, -82.36123255553674 35.80105624989852, -82.36135955555888 35.80104924991025, -82.36151155558173 35.80106424992905, -82.3617985556207 35.80111924996991, -82.36186955563247 35.80111924997729, -82.36194855564554 35.80111924998549, -82.36207355566984 35.801096249993776, -82.36223755570674 35.801034249998125, -82.3623785557469 35.80092624999074, -82.36247755577801 35.80083224998194, -82.36254755581089 35.80069524996134, -82.36257155582601 35.80062424994936, -82.3626165558461 35.80054324993758, -82.36272655590886 35.80025724989081, -82.36276755593494 35.800134249870034, -82.3628135559612 35.80001424985046, -82.3629475560143 35.799816249824076, -82.3630265560358 35.799762249821285, -82.36307155604793 35.799732249819876, -82.36318155607448 35.79967924982047, -82.36335255611249 35.799617249825545, -82.3635305561452 35.799596249839716, -82.36354655614785 35.79959624984133, -82.36421655625827 35.79960024991152, -82.36437455628504 35.79959624992703, -82.36456255632152 35.79956224993962, -82.36472355635492 35.79951924994755, -82.36517955645172 35.79938324996715, -82.36528055647301 35.79935424997167, -82.36567755655544 35.79924724999098, -82.36571455656251 35.79924124999357, -82.36584755658754 35.7992222500035, -82.36611455663333 35.79921225002916, -82.36674555673653 35.799221250096224, -82.36676755674 35.79922225009872, -82.36700055677652 35.79923525012544, -82.36711355679535 35.799235250137144, -82.36725555682337 35.79920625014597, -82.36739055685824 35.799126250143736, -82.367492556891 35.79902425013346, -82.36768255697008 35.79871925009118, -82.3677735569942 35.79866125008878, -82.36787255702293 35.79858225008301, -82.36790955704286 35.79849325006873, -82.36790655706706 35.798335250036374, -82.36790955708273 35.79823825001695, -82.36793755709806 35.79816925000583, -82.36799955712081 35.79808924999596, -82.36812355715665 35.797991249988904, -82.36823455718692 35.79791524998489, -82.36843155724601 35.797745249970724, -82.36851155727494 35.797645249958734, -82.36854155729408 35.79755424994336, -82.36854755731024 35.797457249924264, -82.36850555731948 35.79735324989877, -82.36844555732452 35.797257249873084, -82.3683735573269 35.79716524984693, -82.36835455732891 35.79713224983818, -82.36832155733256 35.79707324982281, -82.36832255734697 35.7969822498044, -82.36837955736749 35.796911249795905, -82.3685035573977 35.7968492497961, -82.36863155743279 35.796760249791326, -82.36868255745901 35.79664624977339, -82.36870655748174 35.796526249751516, -82.36876855750916 35.796416249735564, -82.36888955753898 35.796353249735326, -82.36896855754622 35.79639124975114, -82.36903955754401 35.796480249776614, -82.36904655753871 35.79652224978589, -82.36902955752055 35.796620249804, -82.36897755748548 35.79679024983319, -82.36888955745931 35.79686424983906, -82.36886155745076 35.79688924984134, -82.36875055741976 35.7969702498463, -82.36871955739528 35.797094249868266, -82.3687915573885 35.7972142499001, -82.36889955738266 35.79736624994219, -82.36894955737023 35.79749924997438, -82.36896355735134 35.79763525000345, -82.36887555729079 35.79793025005427, -82.36886455725994 35.79811625009094, -82.3688895572108 35.79845825016301, -82.36885355718158 35.79860725018963, -82.36884755717972 35.7986132501902, -82.36872355713554 35.79876425020807, -82.36852755707352 35.798954250226394, -82.36846755704335 35.799083250246454, -82.3684675570395 35.79910825025151, -82.36846655703023 35.79916625026315, -82.3684935570276 35.79921225027527, -82.3685535570313 35.79925225028963, -82.36857155703244 35.79926425029397, -82.36866555704565 35.79927925030673, -82.36875255706478 35.799249250309636, -82.36885055709469 35.79916125030191, -82.36888555711876 35.79904425028177, -82.36891055713618 35.79895925026706, -82.36893055714978 35.798893250255695, -82.36897855717393 35.798789250239544, -82.36903755720365 35.79866125021959, -82.36916855725563 35.79846725019377, -82.36942455735087 35.79812825015132, -82.36949855738285 35.79800225013344, -82.36953255739719 35.79794625012558, -82.36972555748673 35.7975772500705, -82.36990255756386 35.79727025002645, -82.37001355760195 35.79714425001236, -82.3701525576407 35.79704325000621, -82.37030455768607 35.796914249995716, -82.37048655773911 35.796767249984676, -82.37065955778665 35.79664624997797, -82.37089055784028 35.79654824998193, -82.37105855787568 35.79649924998939, -82.37122955791111 35.79645424999796, -82.37154755798275 35.796332250006095, -82.37161055799933 35.79629325000467, -82.37169455802118 35.796242250003004, -82.37176355804998 35.796131249987496, -82.37174055806666 35.79599924995831, -82.37167755807374 35.79588724992904, -82.37159455808742 35.795711249884675, -82.37157655810574 35.79557424985498, -82.37166055812813 35.7955202498527, -82.37168255813158 35.79552124985516, -82.37182955815493 35.795528249871836, -82.37204855817093 35.79565824992092, -82.37225155817886 35.79582324997546, -82.37244655818546 35.7959882500292, -82.37254055819184 35.79604725005086, -82.37269455820861 35.79610325007821, -82.37292755823614 35.796174250116714, -82.37297755824363 35.79617925012292, -82.37306855825737 35.79618825013414, -82.37325055829098 35.79616625014851, -82.37352555835304 35.79606025015547, -82.37371155839692 35.795976250157636, -82.37390355845001 35.79584025014985, -82.37429155858523 35.79538525009755, -82.37445355864043 35.795203250077265, -82.37453755866481 35.79513625007239, -82.37465055869033 35.7950932500753, -82.3749645587453 35.79507425010397, -82.37529055879915 35.795075250137906, -82.37548955884063 35.79502025014735, -82.37561555887554 35.79493125014221, -82.37581055893621 35.79474925012553, -82.37594655898799 35.7945612501013, -82.37598155900648 35.794480250088455, -82.37614155905553 35.79433525007549, -82.37634055910559 35.79422625007401, -82.3766385591654 35.794159250091205, -82.37668855917443 35.79415425009537, -82.37683655920074 35.79414325010841, -82.37701655924131 35.794074250113, -82.37716655927893 35.79399225011186, -82.37727755930983 35.79391225010708, -82.37753055936756 35.79381025011254, -82.37769055939572 35.79380025012712, -82.37787055942388 35.79381125014794, -82.37809455945616 35.79384225017744, -82.37823755947691 35.79386125019606, -82.37841155950312 35.79387825021756, -82.37847155951289 35.79387925022391, -82.3788795595783 35.79389325026898, -82.37909955961509 35.79389125029136, -82.37951455968276 35.79389825033568, -82.3796095596993 35.793893250344524, -82.37992255975342 35.793879250374076, -82.37998855976572 35.79387025037903, -82.38020755980644 35.79384225039604, -82.3804245598483 35.79380425041076, -82.38059355988486 35.79374925041708, -82.380702559909 35.793710250420375, -82.38084055993954 35.79366125042476, -82.3811255600052 35.79354325043025, -82.38144256007708 35.793419250437815, -82.3817515601518 35.79326825043913, -82.3820935602402 35.793065250433216, -82.3824535603316 35.79286125042899, -82.38265256037968 35.79276425042986, -82.38268256038607 35.79275525043115, -82.38287956042751 35.792699250440144, -82.38340256052827 35.792609250476, -82.38351556055004 35.79258925048355, -82.38372856059095 35.792553250498266, -82.38385656061611 35.79252825050649, -82.38397056063845 35.79250625051377, -82.38406856065761 35.79248725052004, -82.38440956073175 35.79237425053234, -82.38481256081342 35.79227925055473, -82.38491456083388 35.792256250560605, -82.38545956093968 35.792157250596865, -82.38574156099013 35.79213325062116, -82.38623056107201 35.79212825067069, -82.3864595611083 35.7921392506967, -82.38666056113237 35.792198250729484, -82.38683356115395 35.79224425075668, -82.38697456117231 35.79227625077779, -82.38711756119851 35.79226025078936, -82.38735556125604 35.7921442507904, -82.3873705612606 35.79213125078926, -82.38762056133328 35.79193025077429, -82.38778256137157 35.79185725077629, -82.38796056141214 35.79178625078018, -82.38813556144939 35.79173325078752, -82.38816056145464 35.7917262507887, -82.38837456150176 35.79165125079555, -82.38882356160445 35.791470250805254, -82.38895556163726 35.791400250804664, -82.3890975616756 35.79130525079997, -82.38934456174616 35.79111525078692, -82.38949556179048 35.79099125077733, -82.38968156184478 35.790841250766064, -82.3898295618898 35.790709250754624, -82.39019356198273 35.79050025074974, -82.39021356198712 35.790493250750444, -82.39041056202988 35.790428250757564, -82.39081656211313 35.79032625077886, -82.39101556215932 35.790241250782174, -82.39119956220394 35.79015125078283, -82.3913065622344 35.79006925077729, -82.39156656232323 35.789776250744644, -82.39170356237369 35.78959825072259, -82.39197556246422 35.78930625069135, -82.39226356253937 35.78913025068534, -82.3924425625791 35.789066250690894, -82.39256956260604 35.7890282506963, -82.3927495626395 35.78900525071029, -82.39321456272297 35.788964250750006, -82.39348656277306 35.788932250771644, -82.3935185627794 35.78892525077357, -82.39365556280637 35.788898250782175, -82.39401556288307 35.78878925079725, -82.39414156291316 35.78873025079836, -82.39466256305457 35.78837725078044, -82.39483256309724 35.788284250779114, -82.39491356311491 35.78825625078181, -82.39493356311955 35.788248250782225, -82.39499456313308 35.788226250784064, -82.39501556313748 35.78822025078504, -82.39502556313978 35.78821625078523, -82.39521356317536 35.78818825079894, -82.39538856320625 35.78817625081464, -82.39560056323718 35.78820325084216, -82.3957205632541 35.78822225085835, -82.39595856328754 35.78826125089088, -82.39613456331507 35.788271250911144, -82.39633156334921 35.78826225092973, -82.39669756341422 35.78823425096187, -82.39716056349549 35.78820525100384, -82.39770256359184 35.78816425105158, -82.3978505636177 35.78815525106501, -82.39818656367626 35.78813725109611, -82.39856256374107 35.78812125113175, -82.39864656375569 35.78811725113961, -82.39890756379795 35.78812325116784, -82.39938056387474 35.78813425121897, -82.39972156392653 35.788164251260355, -82.39994256395883 35.78819225128892, -82.3999735639634 35.78819625129291, -82.40027256400298 35.78826025133678, -82.40028156400405 35.78826325133835, -82.40052556403369 35.78833225137762, -82.4005435640359 35.78833725138051, -82.40084256406845 35.78844725143379, -82.40115356410037 35.78857325149162, -82.40123156410675 35.78861525150818, -82.40141456412198 35.78871225154685, -82.40145456412459 35.788738251556275, -82.40166756413818 35.788877251606564, -82.40186756414762 35.78903025165829, -82.40188656414838 35.78904525166338, -82.4020275641531 35.7891652517023, -82.40210856415563 35.789235251724925, -82.40250056415667 35.789645251848825, -82.40291656415062 35.79012725198983, -82.40296756414995 35.79018625200706, -82.40318056415107 35.79040525207368, -82.40327256415355 35.79048725209986, -82.40336756415604 35.79057225212697, -82.40350156416292 35.79067125216098, -82.40353556416468 35.79069625216957, -82.40373956418262 35.79079825221137, -82.40392956420273 35.790871252245864, -82.40411156422324 35.79093325227726, -82.40432856425413 35.790966252306475, -82.40435456425782 35.790970252309926, -82.40456456428879 35.79099525233677, -82.40462256429825 35.79099625234293, -82.40476356432126 35.79099825235798, -82.40490356434559 35.790991252370986, -82.4050835643795 35.79096525238433, -82.40513956439051 35.79095425238792, -82.40521756440573 35.79093925239294, -82.40539956444468 35.79088325240031, -82.4055475644776 35.79082925240467, -82.40567356450715 35.79077425240652, -82.40581456454235 35.79069825240567, -82.40599456458907 35.790590252402275, -82.40623656465276 35.7904382523964, -82.40653856472798 35.79027725239488, -82.40655656473234 35.79026825239498, -82.40692656482254 35.790083252395625, -82.40700756484087 35.79005225239767, -82.40828956513185 35.789549252427975, -82.40853256518672 35.78945525243401, -82.40947556539902 35.78909725245872, -82.40997756551023 35.788917252474, -82.41046656561191 35.788785252497775, -82.41086056568915 35.788709252523034, -82.411346565781 35.7886362525585, -82.41210856592265 35.78853925261753, -82.4122705659526 35.78851925263026, -82.41291456607173 35.78844025268072, -82.41355756619053 35.78836225273142, -82.41363856620573 35.78835125273754, -82.41442656635243 35.788248252798034)))",6332,37,021,002900,370210029002,697,697,12,691,680,0,0,0,1,10,6,548,6,542,544,540,0,0,0,0,4,4,319,275,44
census_2010_blockgroups_view.fid--2dc29038_13ec899ba8f_-261a,"MULTIPOLYGON (((-82.50576559612674 35.69413424308199, -82.50601759616406 35.694163243113785, -82.50607559617261 35.69417024312119, -82.50661659625302 35.69423124318943, -82.50698459630864 35.69426624323445, -82.50721259634295 35.6942892432626, -82.50730859635817 35.69429424327352, -82.50763659641005 35.694311243310764, -82.50780559643864 35.69430724332734, -82.50795959646454 35.69430524334278, -82.50831859652773 35.69428224337512, -82.50867859659462 35.69423624340285, -82.50898959665614 35.69417224342188, -82.5092785967158 35.69409724343642, -82.50930359672081 35.6940912434377, -82.50960359678521 35.69399724344952, -82.50962559678999 35.693990243450386, -82.50975059681849 35.693940243453085, -82.50992059685734 35.69387124345653, -82.51029659694515 35.69370724346194, -82.51062159702192 35.69356024346544, -82.5114165972094 35.69320224347457, -82.51163959725884 35.6931222434812, -82.51192559731636 35.69305724349747, -82.51222459737076 35.69302624352199, -82.51254959742258 35.69304024355829, -82.51279659745742 35.69308024359185, -82.5133555975293 35.693215243676974, -82.51348859754646 35.69324724369712, -82.51427859764674 35.69344724381924, -82.51452159767744 35.693509243856894, -82.51507059774725 35.693647243941506, -82.51580859784107 35.6938332440554, -82.5162075978911 35.69393824411789, -82.51667459795169 35.69404724418822, -82.51683659797368 35.69407924421138, -82.51695859799025 35.69410324422882, -82.51705059800271 35.69412124424201, -82.51745359806375 35.694159244291235, -82.51746459806557 35.694159244292365, -82.51778359811732 35.694167244326835, -82.51813759817864 35.69415124436014, -82.51828159820504 35.694135244371665, -82.51844959818867 35.69442124444721, -82.51852159818353 35.69453124447698, -82.51868759817184 35.6947852445458, -82.51884459815511 35.695061244618145, -82.51898959813326 35.695358244693544, -82.51916459809976 35.695762244793805, -82.519173598098 35.69578324479903, -82.51924259808902 35.69591524483295, -82.51934359807916 35.69608724487836, -82.51938259807247 35.69617224489974, -82.519403598069 35.696217244910976, -82.51944359805691 35.69633824493977, -82.51946559804509 35.69643824496239, -82.51948559801639 35.69664524500656, -82.51951259798044 35.69690624506246, -82.51952059796612 35.69700724508383, -82.51954459794953 35.697140245113395, -82.51957259793514 35.69726324514131, -82.51965759791581 35.69747924519406, -82.51971059790836 35.69758424522087, -82.51977659789642 35.69773224525778, -82.51984359788054 35.69790624530015, -82.5198795978655 35.69804224533153, -82.51988459786389 35.69805824533522, -82.51992159784444 35.698223245372716, -82.5199665978055 35.6985232454384, -82.51997159780085 35.69855824544596, -82.52002959777151 35.69881024550321, -82.52003059777118 35.698813245504, -82.52006759775892 35.69893224553202, -82.52016959773718 35.6991822455934, -82.52029059771117 35.69948024566652, -82.52034359769603 35.69963424570333, -82.52037359768713 35.69972424572478, -82.5203945976706 35.69985324575311, -82.52039059765926 35.69992224576683, -82.52035659761782 35.7001532458103, -82.5203035975726 35.70038824585269, -82.52030059757058 35.70039824585436, -82.52022359750332 35.700750245918144, -82.52018759747904 35.70086824593843, -82.5201525974607 35.700949245951264, -82.52009459743664 35.701042245964246, -82.51973059729833 35.701545246029085, -82.51964259726412 35.7016712460457, -82.51956259723275 35.70178824606133, -82.5193765971571 35.70207724610091, -82.51925959711356 35.70223324612061, -82.51922659710087 35.70227924612659, -82.51898859700744 35.70262724617287, -82.51893359698391 35.70272024618615, -82.51890559697144 35.702771246193684, -82.51884059694176 35.702893246211794, -82.51882959691207 35.703072246247125, -82.51882959691075 35.70308124624892, -82.51879759686567 35.70333824629796, -82.51874459683829 35.70345824631688, -82.51866159680081 35.70361124633946, -82.5186485967947 35.70363624634322, -82.51856859676252 35.70375824635981, -82.51853859675023 35.703805246366265, -82.51849359673383 35.70386324637346, -82.51837359669547 35.70398224638534, -82.51828759667036 35.70405224639065, -82.51819659664548 35.70411524639412, -82.51810559662304 35.70416224639434, -82.51795359658718 35.7042312463927, -82.51778959654798 35.7043082463915, -82.5176935965229 35.704367246393595, -82.51756459648362 35.70448224640371, -82.51744759644207 35.70462524642075, -82.51728159637814 35.70486024645143, -82.51711259631278 35.7051002464829, -82.51701759627859 35.70521924649735, -82.51696559626193 35.70527124650256, -82.51688259623776 35.70533824650761, -82.51671659619095 35.70546224651574, -82.51654459614393 35.705581246522264, -82.51645959611562 35.70567324653219, -82.51630459606062 35.70586224655476, -82.51629359605717 35.705872246555664, -82.51616559601455 35.70601024657054, -82.51604559597438 35.70614124658479, -82.51582659589135 35.70644224662353, -82.51579559587995 35.706482246628404, -82.51565759582968 35.706659246650304, -82.51557259579758 35.706775246665096, -82.51552259577842 35.706845246674256, -82.51516259566355 35.70720024670934, -82.51503059561578 35.70736724672974, -82.5149225955779 35.70749624674485, -82.5148485955487 35.70760524675941, -82.51483859554443 35.70762224676191, -82.51478759552003 35.70772524677756, -82.51465959546837 35.707921246804254, -82.51460859544814 35.707997246814415, -82.51445759538723 35.70822824684595, -82.51440859536723 35.70830524685657, -82.51429659527807 35.708760246937594, -82.5141785951852 35.709233247021714, -82.51410259515302 35.70935924703949, -82.51402659512127 35.70948324705693, -82.51395059508921 35.70960824707452, -82.51287359479336 35.71036324711719, -82.51264759474071 35.7104612471138, -82.51259559472872 35.71048224711275, -82.51251959471612 35.710482247104935, -82.51246859471094 35.71046124709541, -82.51241659470547 35.71044024708572, -82.51236659470375 35.71039824707208, -82.51231559470159 35.710357247058425, -82.51226359469966 35.71031424704436, -82.51218759469351 35.710272247027994, -82.51213059469369 35.71021024700948, -82.51211059469361 35.7101892470031, -82.51206059469835 35.71010524698085, -82.51198459470832 35.70995924694333, -82.51198459472786 35.70983324691769, -82.51196159480506 35.70931024680888, -82.5119365948107 35.709247246793545, -82.51191159482264 35.7091432467698, -82.51188659483458 35.709039246746016, -82.51170759484063 35.708808246680526, -82.51165759484532 35.708724246658285, -82.51158159485534 35.70857824662078, -82.51145559491232 35.70807524650539, -82.51127859497038 35.707511246372356, -82.51115159498163 35.70730224631675, -82.51115359504038 35.7069252462402, -82.51123459515095 35.706298246121, -82.51123459517046 35.706172246095356, -82.51120959517928 35.7060882460756, -82.51115859518701 35.70598424604919, -82.51112359519465 35.7058972460279, -82.51110059519662 35.705859246017795, -82.51108559519717 35.70584024601245, -82.51098059519322 35.70575324598393, -82.51087759518586 35.705690245960405, -82.51082159517877 35.70567624595186, -82.51075059516788 35.70567024594327, -82.51067659515438 35.705678245937285, -82.51062259513694 35.70573224594267, -82.510572595103 35.705898245971355, -82.5105235950691 35.70606424600003, -82.51044759502432 35.706272246034516, -82.51037059498233 35.706460246064836, -82.51029459495693 35.70654324607393, -82.51021759492785 35.70664824608736, -82.51014159490248 35.706730246096214, -82.50998859485777 35.70685524610587, -82.50978459479491 35.707042246122974, -82.50947859468906 35.70739724616365, -82.50940159466012 35.70750124617687, -82.5093255946281 35.70762624619449, -82.50930159460476 35.7077512462175, -82.50927659457814 35.70789624624433, -82.50922459454696 35.70804224626868, -82.50922559451796 35.708230246307096, -82.50927959448492 35.70850124636777, -82.509384594454 35.708813246442105, -82.50946259444756 35.708938246475626, -82.50948759443567 35.709042246499315, -82.50951559439834 35.70931324655741, -82.50944259427635 35.71002224669414, -82.5092985941418 35.71073624682459, -82.50924159408801 35.71102224687696, -82.50924259407208 35.711126246898196, -82.50924259405605 35.71122924691912, -82.5092955940357 35.711417246962895, -82.50973959393842 35.712521247233354, -82.51033159379233 35.71409824761532, -82.5101875937607 35.71414824761064, -82.50967459363841 35.714387247606375, -82.50920459355648 35.71441224756308, -82.50883059341857 35.71490124762401, -82.50861859334184 35.715169247656654, -82.50765359299108 35.7163982478073, -82.50662159257404 35.71798224802331, -82.50559459209974 35.719942248316315, -82.5052435919347 35.72063024842012, -82.50485059174915 35.72140624853759, -82.50459659158662 35.72218224866928, -82.50460059154153 35.72247724872972, -82.5047365915495 35.72257124876289, -82.50402659137026 35.72296724877026, -82.50372159129147 35.723148248775615, -82.50277759104729 35.723712248793085, -82.50115259061323 35.7247702488408, -82.50077659050855 35.725043248857624, -82.49983759024613 35.72572924890043, -82.49983759024691 35.72572424889934, -82.49894359006589 35.72593424884988, -82.49824458994591 35.72595924878288, -82.49759058983763 35.72595724871501, -82.49655458968604 35.72582524858132, -82.4948705894387 35.72561724836533, -82.49462858940295 35.72558824833442, -82.49192258894779 35.725625248062926, -82.49098558875849 35.725843248010655, -82.49026158857836 35.7262292480145, -82.48917458827968 35.726991248057416, -82.48823358798076 35.727911248147606, -82.48758658776187 35.728629248226916, -82.48688258750782 35.729513248334165, -82.48647258734685 35.730112248413775, -82.48579258712685 35.73080224848409, -82.48482958685157 35.731546248536084, -82.4837195865489 35.7323092485768, -82.48309658637125 35.7327872486098, -82.48279058627485 35.733081248638015, -82.48273758625334 35.73316324864922, -82.48232158608332 35.733813248738564, -82.48228958607018 35.73386424874562, -82.48193658592294 35.734435248825434, -82.48121158571405 35.735005248866656, -82.48056658553986 35.735437248887955, -82.4800685854159 35.73570324889068, -82.47975058529748 35.736126248943926, -82.47941958514389 35.73676224903915, -82.47898358514473 35.73629024889812, -82.47888158514499 35.73617924886509, -82.477460585095 35.73498124847472, -82.47716558508449 35.73473324839379, -82.47565058498841 35.73373224803384, -82.47521958492982 35.73364824797227, -82.47516658492265 35.73363824796475, -82.47425258477278 35.73362624786801, -82.4733975846543 35.733475247749084, -82.47249958458133 35.73298524755675, -82.47201558454181 35.73272224745332, -82.47093558442184 35.73234024726411, -82.47022658434584 35.73207124713623, -82.4701235843348 35.732032247117736, -82.4698555843061 35.73193024706933, -82.46837058413209 35.73146424682127, -82.46768058403268 35.731366246730154, -82.4682515840471 35.73188424689441, -82.46996658409006 35.733441247388164, -82.47053858410446 35.733960247552716, -82.47065158412617 35.73394124756057, -82.47079558414578 35.73396924758109, -82.47099358416806 35.73403724761532, -82.47112258417707 35.73411724764498, -82.4711995841807 35.7341762476649, -82.47125858417928 35.734248247685635, -82.4712715841765 35.734280247693505, -82.47128758417365 35.73431524770227, -82.47131058416605 35.734389247719655, -82.47132058416318 35.734418247726644, -82.47136658415106 35.734545247757204, -82.47140858414814 35.73460924777456, -82.47148558415071 35.73467524779596, -82.47156158415503 35.73472824781456, -82.4716585841648 35.73476924783287, -82.47176458417744 35.73480124785037, -82.47197658420745 35.73483424787892, -82.47222958423167 35.73494924792842, -82.47238858424495 35.73503324796193, -82.47263158426237 35.73518124801711, -82.4726805842646 35.73521924802989, -82.47277558427072 35.73528124805232, -82.472958584284 35.73539124809362, -82.4730445842886 35.73545424811528, -82.47309158428124 35.735551248139835, -82.47309858426921 35.73563624815786, -82.47308958425282 35.73573224817647, -82.47309258424843 35.73576424818327, -82.47312858420314 35.73609424825414, -82.47315758419123 35.73620224827913, -82.47319758418482 35.736286248300296, -82.47327158418507 35.736363248323606, -82.47336358419324 35.736409248342454, -82.4733965841958 35.73642824834977, -82.47344958419936 35.73646224836215, -82.47343958419697 35.73646624836192, -82.47338758418051 35.73651724836697, -82.4733455841607 35.736599248379285, -82.47328158412684 35.736749248403214, -82.47326758412126 35.73677024840597, -82.47318358408573 35.736909248425576, -82.47313958405597 35.737054248450555, -82.473112584042 35.73711524846025, -82.47309658403384 35.73715024846569, -82.47304758401194 35.7372392484787, -82.47299458399418 35.737297248485056, -82.47292858397914 35.73732324848351, -82.47283758396453 35.737320248473495, -82.47251058391986 35.73725824842719, -82.47219758387686 35.73720024838308, -82.47215258386959 35.737199248378275, -82.47180758381293 35.73719524834181, -82.47143358373825 35.7372762483197, -82.47143058373776 35.73727624831944, -82.47087158361752 35.73745324829772, -82.47058058355259 35.73756024828948, -82.47049158352658 35.73763224829491, -82.47039758349362 35.737744248307976, -82.47029558346493 35.73782024831298, -82.47013458343125 35.73786524830544, -82.46995558339762 35.737890248292075, -82.46976258336231 35.73791124827644, -82.4696915833516 35.737904248267725, -82.46962958334552 35.737877248255835, -82.46962558334997 35.73784424824869, -82.46962858336013 35.737782248236364, -82.46967758338674 35.73766324821722, -82.4697765834401 35.73742524817901, -82.4698145834663 35.737297248156935, -82.4698225834805 35.73721424814085, -82.46981858348909 35.73715424812823, -82.46976258349446 35.73706024810334, -82.46970358349414 35.73699924808488, -82.46968058349401 35.73697524807757, -82.46962758349235 35.736929248062715, -82.46962358349231 35.736925248061496, -82.46957658349311 35.73687024804547, -82.4695135834955 35.736787248022075, -82.46950358349619 35.736772248018035, -82.4694735834982 35.736727248005735, -82.46942558349966 35.73666624798841, -82.46941558350008 35.736653247984734, -82.46933058349086 35.73662124796945, -82.46932558348232 35.7366712479791, -82.46924558345103 35.73678724799441, -82.46910858341403 35.736879247998985, -82.46906458340185 35.73691024800079, -82.46887658335638 35.737002248000046, -82.46870258331855 35.73706024799392, -82.46846558327125 35.737111247979875, -82.46809258319864 35.73718024795545, -82.46780158314195 35.737234247936385, -82.46774458312953 35.737253247934355, -82.46751358307958 35.73732824792575, -82.46742258305792 35.737370247924915, -82.46728958302602 35.73743324792398, -82.46706658296763 35.73757124792908, -82.46692358292323 35.73770424794136, -82.46682358288174 35.737864247963586, -82.46672758283532 35.73806124799379, -82.46672158283214 35.738075247995965, -82.46665858279401 35.73825324802572, -82.46658358276065 35.73838824804542, -82.46656658275293 35.73841924804992, -82.46644758271803 35.738517248057676, -82.46624258266966 35.73860924805515, -82.46621358266269 35.738623248055, -82.46596558260288 35.738743248053886, -82.4656575825252 35.73891424805688, -82.46518958239402 35.73925924807868, -82.4651475823821 35.73929124808088, -82.46493858232687 35.7394232480862, -82.46484658230119 35.73949024809035, -82.46467358228116 35.739434248061094, -82.46450658226166 35.739381248033034, -82.46428758224177 35.739275247988914, -82.46418458223602 35.73920224796341, -82.46412158223242 35.739158247947955, -82.46404458223047 35.73908824792578, -82.46407058225223 35.73897624790568, -82.46409758230948 35.73863624783929, -82.46407658234031 35.738415247792126, -82.46408958236616 35.738262247762385, -82.46404958237498 35.73816324773814, -82.46383358235614 35.738053247693436, -82.46369758233938 35.7380162476719, -82.46245158218416 35.73768424747578, -82.46242558218287 35.737664247469006, -82.46220958215802 35.73759324743232, -82.46195358213436 35.73747224738122, -82.46166958212315 35.7372412473049, -82.46153558211296 35.73716324727523, -82.46127858208729 35.73705424722661, -82.46117158207272 35.73703324721127, -82.46085458205015 35.736840247139234, -82.4606785820416 35.73670724709405, -82.46021058202955 35.73628424695966, -82.46019358202912 35.73626924695489, -82.4600255820422 35.73600524688382, -82.45976158209588 35.735377246728895, -82.45958958210616 35.73512724666021, -82.45957358210724 35.73510324665371, -82.45945158210408 35.73499324661881, -82.4593265821008 35.73488024658287, -82.45914158209605 35.73471324652981, -82.45901558209016 35.7346162464971, -82.45886358208294 35.7345002464578, -82.45879758207997 35.73444924644061, -82.45852858205754 35.73430624638375, -82.45840658204405 35.73426224636223, -82.45751758192456 35.734082246233875, -82.45738258190899 35.734038246210964, -82.45701858185615 35.73398924616343, -82.4570125818555 35.73398724616241, -82.45678958182859 35.73392224612617, -82.45625058176608 35.733748246035184, -82.45558258168359 35.733566245929225, -82.454746581602 35.73319824576809, -82.45454458159084 35.73305424571792, -82.45413358156001 35.732813245626545, -82.45389058154612 35.73264324556686, -82.45363458151898 35.732544245520295, -82.45337858148861 35.73246624547798, -82.45306858144043 35.73244524544173, -82.45290658142024 35.7324022454163, -82.45231358133813 35.732297245333775, -82.45197658129916 35.73218824527674, -82.45161858127257 35.73197724519691, -82.45144458125966 35.73187424515796, -82.45122858125102 35.7316992451001, -82.45101258125462 35.731445245026116, -82.45091758126429 35.73128124498301, -82.45087758126105 35.73125924497439, -82.45072258127276 35.731018244909365, -82.45052058127183 35.73080824484583, -82.45033158127902 35.730560244775894, -82.45009758127166 35.7303572447105, -82.4499445812817 35.73012924464833, -82.44983058128915 35.72995924460193, -82.44945558137023 35.729036244375486, -82.4493365814236 35.72856524426744, -82.44930758142735 35.72851024425333, -82.44908458145748 35.728077244142234, -82.44904658146488 35.72798924412041, -82.44881958148919 35.7275902440158, -82.44875758149598 35.727480243987, -82.44857458152269 35.7271122438933, -82.44846758153837 35.72689724383851, -82.44820358157725 35.72636424370288, -82.44800058160725 35.725954243598565, -82.44743758151274 35.72596124354189, -82.44644858133546 35.7260462434571, -82.4458015812193 35.72610324340199, -82.44437858093255 35.72643024332157, -82.44388158081156 35.72667824332069, -82.44383158079913 35.726705243321064, -82.44327058065767 35.72701724332662, -82.44252358047689 35.72738324332391, -82.44162758046771 35.72648524304889, -82.44006858039752 35.72527124264109, -82.4395535803913 35.72476124248419, -82.43915158042518 35.72411324231098, -82.43871858050113 35.72316124207265, -82.43827358057233 35.72222724183678, -82.43762458057533 35.721514241624895, -82.43688358051591 35.72110524146526, -82.43560158037992 35.72061124123244, -82.43442158024378 35.720228241032856, -82.43429858022522 35.7202162410177, -82.4330695800389 35.720103240867914, -82.43209957986011 35.720219240791394, -82.43095957964599 35.72038124070662, -82.43032857954181 35.720378240640876, -82.43009857952937 35.720212240583436, -82.42999157952468 35.720128240555304, -82.42974957955197 35.71969424044206, -82.42964657956372 35.71950824039366, -82.42915657961022 35.718685240175716, -82.4287995796343 35.71814824002971, -82.42876657964003 35.71807624001168, -82.4285035796855 35.71750223986782, -82.4284205797217 35.71718023979382, -82.4285165798222 35.71663523969288, -82.42856757989661 35.71621023961171, -82.42849757992785 35.71593423954834, -82.42808857990237 35.71566123945073, -82.42713157988857 35.71472823916221, -82.42665057991736 35.71402823897033, -82.42657057992211 35.7139122389384, -82.42592957993236 35.71316123871957, -82.42562357990555 35.71300723865672, -82.42519557983418 35.713010238613144, -82.42514757982526 35.713016238609406, -82.42494857978822 35.713042238594156, -82.4240695796245 35.71315823852705, -82.42327057948519 35.713202238453555, -82.42224357932503 35.713137238334326, -82.42168957926543 35.71292923823484, -82.42121157924865 35.71252723810386, -82.42046757929025 35.7114642378109, -82.42021157930722 35.711081237706665, -82.42004357931823 35.71083123763847, -82.41973657930122 35.710612237562295, -82.41850257918392 35.71005023732069, -82.41828557918495 35.70981223724987, -82.41754157921935 35.70879523696637, -82.41709757921384 35.708356236831364, -82.41551757913325 35.707188236430824, -82.4143475790737 35.706322236134056, -82.41324857897592 35.705778235910074, -82.4129065789732 35.705430235804045, -82.41266657899223 35.705051235702214, -82.41250557900497 35.70479723563398, -82.41199957906645 35.703860235391346, -82.4117995790748 35.70359323531644, -82.4113505790287 35.70341023523288, -82.41085857899311 35.703114235121944, -82.41069157898109 35.70301323508412, -82.41068257898041 35.70300823508222, -82.40988057888397 35.70277323495168, -82.40806357863424 35.702442234696974, -82.40744257854794 35.70233523461107, -82.406944578518 35.70199623449077, -82.40638857850689 35.701474234327286, -82.40527857848706 35.70041623399771, -82.40526257848671 35.70040123399305, -82.40524257848634 35.70038223398715, -82.40520757848246 35.70037023398103, -82.40518757848002 35.700364233977794, -82.40468657842266 35.70019923389249, -82.40416957836334 35.70002923380463, -82.403158578232 35.69979623365295, -82.40264557816535 35.69967823357605, -82.4018995780436 35.69966623349662, -82.40058057782798 35.69964723335661, -82.39966157767539 35.69965023326241, -82.39891657755147 35.699653233186154, -82.39900957757897 35.69957523317989, -82.3991745776249 35.69945523317257, -82.3992985776577 35.69937623316929, -82.39963757774319 35.69918723316582, -82.39977957777683 35.69912223316726, -82.3998105777838 35.699110233168064, -82.4001305778554 35.69899023317669, -82.40069657797525 35.69882223320089, -82.40077657799341 35.69879023320268, -82.40084557801065 35.69875323320225, -82.40091657803016 35.698703233199446, -82.40095957804331 35.69866423319602, -82.40099157805683 35.69861123318845, -82.40100457806689 35.69856023317953, -82.40100457807758 35.69849123316545, -82.40099157808523 35.698428233151354, -82.40096057808846 35.698374233137116, -82.40091757808898 35.698325233122695, -82.40087157808601 35.698295233111914, -82.40082057808074 35.69827423310236, -82.40072057806658 35.698259233089054, -82.40061157804921 35.69825423307675, -82.40051857803196 35.69826623306961, -82.40038957800579 35.6982972330626, -82.4002965779858 35.69832723305905, -82.39984357788529 35.69849123304563, -82.39952457781848 35.69858123303106, -82.39944757780368 35.69859423302567, -82.39926157776772 35.698627233013205, -82.39917757775311 35.698632233005554, -82.39907057773615 35.69862723299351, -82.39899057772462 35.69861623298303, -82.3988795777127 35.69857423296308, -82.39880357770691 35.698530232946275, -82.39875957770604 35.69848923293337, -82.39873357770657 35.69845823292435, -82.39871457770835 35.69842623291592, -82.39870557771283 35.69838723290707, -82.39870757772084 35.69833823289732, -82.39871657772858 35.698298232890096, -82.39872857774816 35.698184232868215, -82.39935057786535 35.69809323291386, -82.3994465778881 35.69804923291483, -82.40034957810002 35.697647232926286, -82.4006315781611 35.69755423293654, -82.40102957823363 35.69751123296881, -82.40154057830489 35.6975982330393, -82.40168657832513 35.69762323305938, -82.40224957839256 35.69779023315146, -82.40278857845706 35.69795023323959, -82.40290057847743 35.697938233248685, -82.40349057858421 35.69788023329778, -82.40393057869083 35.6976622332989, -82.40467457890418 35.6970812332576, -82.40520757905692 35.6966662332282, -82.40535357909873 35.69655223322016, -82.40631457933469 35.69605723321871, -82.40755857962185 35.695534233240735, -82.40805857975953 35.69518023322034, -82.40841757989647 35.69468123315596, -82.40872858019664 35.69307723286203, -82.40926358047761 35.691836232665, -82.40927258048463 35.69180123265883, -82.40936558055421 35.691451232597316, -82.40942258062944 35.691027232517044, -82.40939758071332 35.69045923239895, -82.40913158095039 35.688645232002784, -82.40919558102411 35.68823823192673, -82.4093895811245 35.687798231857315, -82.41008658137261 35.686942231755275, -82.4108025815913 35.68629623169775, -82.41123258168179 35.68617223171689, -82.41158058173404 35.686207231759965, -82.41237558183411 35.686411231883405, -82.4128885819236 35.68638223193042, -82.4133655820412 35.68613323192902, -82.41426558230216 35.68541123187511, -82.41468558244131 35.684962231827164, -82.4153135827158 35.683862231668314, -82.41600958295406 35.68306923157889, -82.41618558303597 35.68272823152779, -82.41632858317453 35.6819872313919, -82.41645158323543 35.68172523135128, -82.41655058326711 35.68162723134163, -82.41667558330425 35.68152023133275, -82.4168245833448 35.68141823132733, -82.41706058340472 35.68128423132451, -82.41727958346578 35.68112423131458, -82.41733758348603 35.6810552313065, -82.41739258350735 35.68097623129612, -82.4174605835415 35.68082923127324, -82.41747558356103 35.68071923125243, -82.4174455835867 35.680521231209106, -82.41738858360631 35.68033323116501, -82.41728058363172 35.68005423109711, -82.41718258366289 35.67974823102483, -82.41709358368313 35.67952223096976, -82.41690958373553 35.678987230841955, -82.41689058375776 35.67882323080669, -82.41690658378673 35.67865323077385, -82.41695558381723 35.67850823074941, -82.41701558384077 35.678421230737904, -82.41709358386638 35.67833923072923, -82.41720658389615 35.67826823072649, -82.41732158392415 35.678210230726584, -82.41741758394308 35.678190230732426, -82.41754958396682 35.67817823074359, -82.41775558400033 35.67818223076558, -82.41804058404088 35.67822523080374, -82.41854958410786 35.678337230879, -82.4187785841404 35.67837223090969, -82.41891058415801 35.67840023092906, -82.41907258418182 35.67841923094961, -82.41926258421165 35.67843023097143, -82.41927058421277 35.678431230972414, -82.41939658423476 35.678424230984, -82.41955358426554 35.678393230993905, -82.41969858429707 35.678345230999184, -82.41984858433345 35.67827023099936, -82.41995658436535 35.678180230992155, -82.42005158439932 35.678062230977964, -82.42013358443695 35.67790723095492, -82.42018258446787 35.677760230930105, -82.4201845844934 35.67759723089717, -82.4201475845838 35.676974230766696, -82.42017558463257 35.676689230711744, -82.42025758468503 35.67643823066916, -82.42033758471966 35.67630023064936, -82.42049958478025 35.676082230621724, -82.4206875848422 35.675883230600675, -82.42086458489715 35.67571723058513, -82.42105558495207 35.675567230574416, -82.42125658500554 35.675437230568676, -82.42140958504271 35.67536123056895, -82.42161558508904 35.67528223057416, -82.4217885851258 35.67523023058141, -82.42198158516378 35.67519123059339, -82.42220458520408 35.675169230611935, -82.42243558524349 35.67516223063433, -82.42269158528512 35.67516723066169, -82.42299558533021 35.675201230700026, -82.42322158536226 35.67523623073044, -82.42349558540022 35.675284230768405, -82.42377558543643 35.67535023081072, -82.4240165854642 35.675428230851395, -82.42404058546701 35.67543623085555, -82.42423058548837 35.675501230888365, -82.42448358551468 35.675602230934956, -82.42472058553567 35.67572023098337, -82.42473958553711 35.67573123098756, -82.42483958554514 35.67578623100901, -82.42496358555188 35.67587523103989, -82.42508658555464 35.67598923107577, -82.42518058555292 35.67610123110821, -82.42527058554394 35.67625523114884, -82.42533458553136 35.6764052311859, -82.42541258549157 35.67674523126308, -82.42543558546056 35.67697023131115, -82.42548858542841 35.67723423137027, -82.425555585366 35.67770923147374, -82.42556258536172 35.677744231481576, -82.42561258533097 35.67799623153803, -82.42567758531773 35.67815123157618, -82.42574958530838 35.6782882316115, -82.42583258531046 35.67836423163547, -82.42589058531406 35.67840223164917, -82.42595158531826 35.67844123166336, -82.42608958533198 35.67850023168961, -82.42623058535055 35.67853123171047, -82.42639758537581 35.67854623173073, -82.42653458539935 35.67854123174379, -82.42667458542562 35.67852123175419, -82.42714158551615 35.678436231785106, -82.42733458555193 35.67841223180013, -82.42750158558032 35.67840723181632, -82.42769358561043 35.67841823183831, -82.42782658562955 35.67843723185592, -82.42806458565502 35.67852723189876, -82.42828958567533 35.6786372319443, -82.42849358569181 35.678749231988135, -82.42868458570868 35.67884423202718, -82.4288955857288 35.67894023206836, -82.42902758574418 35.67898223209059, -82.42922058577102 35.67901523211714, -82.42937758579771 35.679011232132545, -82.42953858582909 35.678980232142855, -82.42967158585785 35.678937232147746, -82.42972758587115 35.678911232148266, -82.42978858588701 35.67887423214702, -82.42989958591714 35.67879823214305, -82.43001958595356 35.67869123213371, -82.43010558598361 35.678589232121816, -82.43017058600628 35.67851323211308, -82.43049858612885 35.67807223205723, -82.43069358619465 35.67785623203343, -82.43093358627155 35.67761623200936, -82.4312905863755 35.67732723198744, -82.4316065864579 35.6771332319805, -82.43196758654472 35.67695923198237, -82.43235358663252 35.676805231990905, -82.43261058668841 35.6767192319999, -82.43278758672437 35.67667623200942, -82.43308658677827 35.676648232034545, -82.43335958682403 35.67664523206202, -82.43361058686192 35.676669232092856, -82.43385158689514 35.67671223212643, -82.43420258694233 35.676783232177016, -82.4344295869739 35.67682223220836, -82.4346465870082 35.67683323223299, -82.43482258704056 35.67681223224685, -82.43496058706931 35.676774232253365, -82.43512558710894 35.67669523225426, -82.43525658714472 35.67660423224929, -82.4353335871702 35.67652223224057, -82.43543158721039 35.67636723221915, -82.43549458724624 35.67620323219229, -82.43567858738747 35.6754882320659, -82.43575358743055 35.675290232033404, -82.43583258746476 35.67515423201391, -82.43594058750163 35.675031232000016, -82.43604058753156 35.674945231992815, -82.43620358757255 35.67485523199132, -82.43636158760845 35.67479223199481, -82.4365015876366 35.67476023200276, -82.43672558767672 35.67474123202199, -82.43695058771242 35.674751232047186, -82.43710458773425 35.67477523206799, -82.43732058776334 35.67481823209894, -82.43751558778762 35.674870232129685, -82.43767958780552 35.674930232158694, -82.4378675878241 35.67501123219459, -82.43806658784239 35.675106232234484, -82.43826058785912 35.67520623227473, -82.43883858790316 35.675540232402255, -82.43921458793005 35.67576923248766, -82.43939458794506 35.675865232525666, -82.43959958796087 35.675982232570554, -82.43976558797675 35.676057232602886, -82.43991858799356 35.67611223262993, -82.44009358801642 35.67615223265607, -82.44024058803743 35.67617423267572, -82.44041258806433 35.67618423269542, -82.44061958810059 35.67617223271435, -82.44077058812968 35.676145232724444, -82.4409275881618 35.67610623273274, -82.44105858819015 35.67606323273742, -82.44122658822933 35.67599023273989, -82.44137958826711 35.6759102327394, -82.44142158827731 35.67588923273949, -82.44182558838166 35.67564723273188, -82.44200858843078 35.675526232726156, -82.44219558848205 35.67539523271883, -82.44235758852918 35.67526423270889, -82.44253658858483 35.67509623269317, -82.44264058862507 35.6749472326736, -82.44273358866769 35.67477223264757, -82.44279758871144 35.67455823261067, -82.44282658874847 35.67435023257134, -82.44284458878931 35.67410523252343, -82.44287458883608 35.6738352324716, -82.44291058887674 35.67361123242977, -82.44294958891186 35.67342623239614, -82.44306158898164 35.67309523234043, -82.44319558905023 35.67279523229323, -82.44348158919189 35.672187232199086, -82.44358558924283 35.6719692321655, -82.44364158927607 35.67181423213975, -82.44365958930626 35.67163923210602, -82.44362158932279 35.67149123207199, -82.4435145893277 35.67134523203129, -82.44340158932442 35.67124523199931, -82.4432285893094 35.671157231963605, -82.44259358923256 35.670973231860785, -82.44241358921363 35.6709032318279, -82.44235858920773 35.670882231817984, -82.44220358919733 35.670783231781876, -82.44207058920091 35.670618231734665, -82.44201358921912 35.67043923169242, -82.44200058925148 35.67021623164568, -82.44203858929399 35.669982231602035, -82.44210158934565 35.66971623155451, -82.44217158939793 35.66945323150816, -82.44223458945227 35.66916923145697, -82.44228058950071 35.668906231408194, -82.44229758954027 35.66866823136157, -82.44230058957658 35.66843723131486, -82.44232558961612 35.668208231270924, -82.44236058965244 35.66801123123448, -82.44244558969731 35.66781223120278, -82.44262458976563 35.66756223117042, -82.44274658980422 35.66744423115906, -82.44290758984738 35.66733723115384, -82.44309158989014 35.66725823115673, -82.44320458991395 35.66722523116163, -82.44339458995138 35.6671872311735, -82.44359958998785 35.66717123119139, -82.44384659002554 35.66719223122117, -82.44412359006354 35.66724323126, -82.44518559019494 35.667531231428015, -82.44527859020643 35.667557231442885, -82.44569959025976 35.66766323150788, -82.44600959030063 35.66773123155364, -82.4462035903293 35.667753231578125, -82.44643259036542 35.66776523160414, -82.44667959040876 35.667750231626556, -82.44684859044139 35.66772023163788, -82.44700259047382 35.66767523164459, -82.44720759052133 35.66758823164797, -82.44724159053021 35.66756723164729, -82.44736559056294 35.66748823164393, -82.4475295906109 35.667354231633645, -82.44768759066109 35.66719923161836, -82.44781059070732 35.66703223159706, -82.44791859075521 35.666838231568775, -82.4480415908148 35.66658523153006, -82.44829659095635 35.66594323142574, -82.44857759110639 35.665275231318915, -82.44874059117949 35.66497723127515, -82.4488985912386 35.66476423124805, -82.44911359130721 35.664551231226945, -82.4493465913748 35.66436423121289, -82.44999459155565 35.66388923118311, -82.45021559161906 35.66371623117068, -82.45044059169345 35.66347623114502, -82.45059459175464 35.663246231114165, -82.4506995918138 35.662976231070154, -82.4507575918811 35.662603231000254, -82.45076459193098 35.662288230936916, -82.45076259193898 35.662234230925705, -82.45075559196911 35.66203223088389, -82.45072959201805 35.66168823081124, -82.45068759205438 35.66140823075004, -82.45062559208777 35.66112623068629, -82.45052359212201 35.66079523060846, -82.45038859214861 35.660478230530074, -82.4501975921737 35.66011223043603, -82.44999659218891 35.65979823035147, -82.44976959220062 35.659479230263166, -82.44949759220692 35.65914723016774, -82.44925359221412 35.65883923007994, -82.44904859222393 35.65855623000125, -82.44885859224622 35.65820822991095, -82.4487075922721 35.65787922982851, -82.44862259230953 35.65754622975197, -82.44862359235998 35.657221229686044, -82.44877259244421 35.656836229623075, -82.44893959250338 35.656632229598806, -82.4491845925729 35.65644522958599, -82.44943159263339 35.65631922958589, -82.4496715926865 35.656233229593134, -82.45030059281953 35.65604722962006, -82.45059059288198 35.655954229631035, -82.45084159294579 35.65581022962758, -82.4510175930041 35.6556222296075, -82.45115459306142 35.65539822957606, -82.45126359311725 35.65515422953775, -82.45138559317583 35.65490622949986, -82.4515515932378 35.65468322947163, -82.45176859330428 35.65448622945388, -82.45206759337958 35.65431922945076, -82.45247059346582 35.65419422946682, -82.4530385935751 35.65409622950541, -82.45337259363025 35.654097229540014, -82.45362959366504 35.654147229576694, -82.45383859368494 35.654243229617734, -82.45407159369623 35.654420229677704, -82.45423959369252 35.6546242297365, -82.45439859368075 35.654870229802945, -82.45454159366786 35.6551072298658, -82.45474959365717 35.6553992299466, -82.45494159365548 35.65561623001054, -82.4552195936656 35.65584823008636, -82.45545659367711 35.65602823014736, -82.45600659371551 35.65636923027339, -82.45621159372692 35.65651523032419, -82.45640459373296 35.656683230378185, -82.45657259372965 35.656884230436354, -82.4566855937243 35.657040230479744, -82.4568025937077 35.65727323053919, -82.4568785936853 35.65749923059302, -82.45691159365556 35.65772723064276, -82.45691959352338 35.658590230819065, -82.45694059348725 35.65884623087326, -82.45700059346423 35.659059230922765, -82.45709159345603 35.65921023096284, -82.45721259345855 35.659323230998325, -82.45741659347152 35.65945823104676, -82.45793859351238 35.65975323116051, -82.4581525935244 35.659905231213436, -82.45829959352852 35.66003623125526, -82.45831859352899 35.660053231260704, -82.45847359352337 35.66025623131795, -82.4586205935113 35.660491231380846, -82.45875359349647 35.66073023144311, -82.45887459348813 35.66091323149285, -82.45901059348398 35.66108623154207, -82.45917659348628 35.661249231592265, -82.45936959349433 35.661404231643665, -82.45966159351114 35.66160823171528, -82.45992959352786 35.661787231779265, -82.46017859354085 35.66197023184217, -82.46039159355007 35.662139231898486, -82.46056659355382 35.6623022319496, -82.46074759355197 35.66250823201014, -82.46089559354523 35.66271023206646, -82.46102859353178 35.66294023212697, -82.46176259327842 35.66536423269552, -82.46178559327264 35.66542623271049, -82.46183059326077 35.66555123274054, -82.46185259325712 35.6655982327524, -82.46188459325194 35.665666232769496, -82.46195959324453 35.66579423280329, -82.46216759323897 35.66605323287736, -82.46229959324107 35.66618123291696, -82.46251759325234 35.666342232972184, -82.46266659326291 35.66643323300601, -82.46286259328016 35.666532233046354, -82.46305059329906 35.66661123308178, -82.46380859338036 35.666898233218284, -82.46427859343196 35.6670682333013, -82.46461059346855 35.667188233359866, -82.46487659349982 35.66727123340415, -82.46521159354336 35.667348233454376, -82.46546159358054 35.66737623348582, -82.4656915936187 35.66737623350953, -82.46596659366905 35.667345233531556, -82.4662255937214 35.66728423354582, -82.46652359378649 35.66718323355597, -82.46721959395238 35.666857233561345, -82.46771959407012 35.66663223356712, -82.46817559417052 35.66647223358154, -82.4683845942139 35.66641523359153, -82.46858159425292 35.666374233603456, -82.46886459430667 35.66633023362364, -82.46919459436803 35.66628723364891, -82.46935559439694 35.66627323366268, -82.46953159442658 35.66627023368014, -82.46972659445525 35.666294233705116, -82.46987359447455 35.66632723372695, -82.47004759449236 35.66639823375939, -82.4702115945033 35.66650323379756, -82.4703375945061 35.666620233834365, -82.47042459450216 35.666739233867524, -82.4704305945019 35.66674723386979, -82.47050859449118 35.66690023390894, -82.47071759445267 35.66737323402672, -82.47083959443239 35.6676352340926, -82.47098459441668 35.66789223415976, -82.47105959441146 35.66800623419065, -82.47120559441025 35.66817023423907, -82.47139659441972 35.668314234288026, -82.47160259443963 35.66840623432793, -82.47167759444953 35.66842223433896, -82.47181659446805 35.66845223435942, -82.47204859450599 35.668455234383835, -82.472234594542 35.668422234396374, -82.47235759456883 35.668380234400416, -82.47258259462133 35.66828223440371, -82.4728725946916 35.66813923440448, -82.47316959476427 35.667987234404166, -82.47317859476641 35.66798323440426, -82.47356359485539 35.66782123441097, -82.47394259494035 35.66767823442096, -82.47462359509055 35.667437234442055, -82.47479659512979 35.66736923444609, -82.47505159519272 35.667236234445284, -82.47524859524533 35.66710723443937, -82.47542259529934 35.666944234424165, -82.47559659536122 35.666731234398775, -82.47571559541517 35.66651023436604, -82.47590459550784 35.66611323430477, -82.47604959558187 35.66579023425396, -82.4761565956267 35.665615234229406, -82.4762725956716 35.66544923420761, -82.47643659572594 35.665274234188914, -82.47659959577325 35.6651432341791, -82.47672459580617 35.66506423417585, -82.47683059583383 35.664999234173536, -82.47716959591828 35.66481623417126, -82.47753359600748 35.664630234170886, -82.47780659607581 35.66448123416874, -82.478053596139 35.66433723416484, -82.4781275961592 35.66428623416208, -82.47824259614576 35.66449623421665, -82.4782855961336 35.664621234246574, -82.47829259611822 35.66472823426905, -82.47828259610328 35.66481423428549, -82.47829259608498 35.66494323431275, -82.47832159608123 35.66499823432697, -82.47835959608341 35.665025234336326, -82.47840359608823 35.66504123434413, -82.47845659609655 35.66504423435015, -82.47846859609903 35.66504123435084, -82.47851259610755 35.665033234353686, -82.47856759612156 35.66500123435282, -82.47863659614322 35.664935234346565, -82.4790815963072 35.66435223427387, -82.47916359633989 35.664229234257185, -82.47923259636426 35.664145234247286, -82.47931159638857 35.664073234240796, -82.47939159640465 35.66405523424529, -82.47948059641799 35.66406423425634, -82.47954359642144 35.66410923427195, -82.47957059641296 35.664193234291794, -82.47955659639821 35.664273234306634, -82.47947759635868 35.66444423433333, -82.47937859631486 35.664621234359096, -82.47924659624955 35.664902234402675, -82.47918459621594 35.66505323442699, -82.47915359619282 35.66516923444739, -82.47914659618456 35.66521523445606, -82.47913759617315 35.66527923446814, -82.47913659614885 35.665435234499796, -82.47914059613393 35.66553623452075, -82.47914359612108 35.6656222345385, -82.47916259609573 35.66580623457793, -82.47917159606556 35.666011234620555, -82.47916559605386 35.66608023463389, -82.47914959604398 35.66612723464185, -82.47914459604053 35.666144234644854, -82.4791125960261 35.66620323465355, -82.47903859600292 35.666273234660096, -82.47871259592102 35.66645323466314, -82.47841159584146 35.66664523467121, -82.4782325957896 35.666788234681874, -82.47815359576273 35.66687723469183, -82.47813159575416 35.666909234696064, -82.47799959570328 35.66709623472049, -82.47790059566573 35.66723323473817, -82.47781659563874 35.667317234746626, -82.47773259561542 35.6673782347504, -82.47761059558516 35.66744323475103, -82.47744259554655 35.66751223474775, -82.47724459550496 35.667569234738956, -82.47698459545173 35.66763423472536, -82.47680959541557 35.6676802347167, -82.47662659537647 35.66773723470944, -82.47648159534297 35.66779823470695, -82.47635159530769 35.66788623471138, -82.47626059528024 35.66796623471833, -82.47617659524977 35.66807323473147, -82.47612259522442 35.66817923474739, -82.47598559514093 35.66857223481325, -82.47593959511545 35.6686872348319, -82.47586359508395 35.668809234848865, -82.4757875950549 35.66891623486281, -82.47568059502113 35.669019234872756, -82.47558159499533 35.66908023487494, -82.47549759497784 35.66910323487106, -82.47539759495822 35.66912223486456, -82.47523059493305 35.66910623484414, -82.47508559491368 35.669076234823024, -82.47495559489431 35.66906123480664, -82.4748395948747 35.669064234795286, -82.47481559487058 35.66906523479304, -82.4747235948524 35.66908423478737, -82.47467359484253 35.66909423478421, -82.47448459480007 35.669166234779404, -82.47434659476407 35.66925023478234, -82.47433859476203 35.66925523478253, -82.47431859475638 35.6692702347835, -82.47426159473983 35.669316234786976, -82.47425159473681 35.669325234787806, -82.47424459473436 35.66933323478875, -82.47414759470192 35.66943923480025, -82.47405159466186 35.66959523482209, -82.47394559462124 35.66974423484148, -82.47386959459621 35.669824234849976, -82.47384759458889 35.66984823485254, -82.4737005945487 35.66995023485815, -82.4735375945095 35.67002923485746, -82.47334659446878 35.670087234849554, -82.47311659442803 35.6701042348293, -82.47283659437984 35.67011523480265, -82.4724635943132 35.67014623477057, -82.47228359428317 35.670147234752285, -82.47211859426079 35.67011523472874, -82.47208759425814 35.67009923472224, -82.47197859424851 35.67004423469984, -82.47166859422663 35.66985323462907, -82.47154359421278 35.66980923460726, -82.4713945941913 35.669788234587585, -82.47124259416218 35.66981323457707, -82.47112659413428 35.669869234576495, -82.47100259410057 35.66995423458095, -82.47089959407364 35.67001823458344, -82.47081359405237 35.670063234583694, -82.47064459401449 35.670127234579276, -82.47046759397702 35.6701792345716, -82.46999159387597 35.67032223455167, -82.46963359380153 35.670419234534506, -82.46948959376148 35.67052423454103, -82.46933859371626 35.67065423455193, -82.46927759369562 35.6707222345595, -82.46916759365608 35.67086023457618, -82.46906459361765 35.670998234593654, -82.46899959358872 35.67111523461077, -82.4689465935636 35.67122123462687, -82.46892259354465 35.67131723464394, -82.46890659352478 35.67142923466499, -82.46890159348833 35.671659234711285, -82.46886259344589 35.671891234754476, -82.46882859342358 35.671999234772905, -82.46869259335304 35.67230923482193, -82.4686655933433 35.67234323482612, -82.4685955933107 35.67247923484658, -82.4685375932884 35.672561234857255, -82.46842359325717 35.67264023486158, -82.46841359325428 35.67264823486223, -82.46831559323431 35.672672234856975, -82.46818059321333 35.67266323484124, -82.46805959319838 35.67263023482202, -82.46792359317928 35.67260823480355, -82.46776259314804 35.6726372347929, -82.46759459310864 35.67271223479076, -82.4674195930588 35.672846234799984, -82.46735359303909 35.67290323480484, -82.46726359301223 35.67298023481118, -82.4671565929778 35.67308823482215, -82.46708659294562 35.67322123484197, -82.46705859292085 35.67335123486556, -82.46706859290623 35.6734562348879, -82.46712459289371 35.67359723492233, -82.46719559288518 35.67372823495634, -82.46723559287399 35.67384323498381, -82.46722859285494 35.67395923500669, -82.46717759282912 35.67407123502423, -82.4671045927991 35.67418723504029, -82.46705559277306 35.67430223505866, -82.46701659274653 35.67443223508105, -82.46698859272428 35.674546235101374, -82.46694059269804 35.674664235120474, -82.46684359266666 35.67476323513056, -82.4667095926284 35.67486623513773, -82.46662659260214 35.6749472351456, -82.46658259257948 35.675046235161204, -82.4665935925629 35.67516523518656, -82.46660959254903 35.67527223520997, -82.46660959252876 35.67540323523664, -82.46657959251012 35.67549123525139, -82.46652359248706 35.67558023526376, -82.46644159246088 35.675662235272, -82.46631659243232 35.6757122352692, -82.46615159239792 35.67575723526144, -82.46592359235258 35.67580623524791, -82.465795592328 35.67582823523914, -82.4657175923127 35.6758432352342, -82.46557859228828 35.67585223522167, -82.46543259226439 35.67585023520625, -82.46521959223354 35.67582123517842, -82.46507959221113 35.67581623516301, -82.46499759219392 35.6758392351592, -82.46492959217503 35.6758882351621, -82.46490659216431 35.67593323516887, -82.46490859216162 35.67595223517301, -82.46491159215572 35.67599423518188, -82.4649945921594 35.676059235203645, -82.46514759217746 35.67610623522898, -82.46535259220295 35.6761612352613, -82.46596359227675 35.67633923536043, -82.46606059228988 35.67635823537429, -82.46617559230546 35.67638123539077, -82.46632059232692 35.67639723540897, -82.46651659236294 35.67637523542467, -82.46667759239854 35.67631723542954, -82.46684859243757 35.6762482354331, -82.46704859248432 35.67616023543576, -82.46717959251326 35.67611423543995, -82.46731359253914 35.67609023544888, -82.4674265925589 35.67608423545935, -82.46756159257845 35.67610223547683, -82.46775959260326 35.67615423550788, -82.46807159264124 35.6762432355581, -82.46829059266655 35.67631423559505, -82.46846859268506 35.67638523562795, -82.46859559269521 35.67645623565539, -82.46884459271274 35.676609235712206, -82.46927459273671 35.676915235818754, -82.46949759274477 35.67710223587974, -82.46955759274684 35.67715323589629, -82.46967359274656 35.67727923593392, -82.46981559274363 35.677450235983315, -82.47036059274686 35.67801323615401, -82.47072659275229 35.67837023626435, -82.47075559275264 35.6783992362732, -82.47087059275735 35.678492236303995, -82.47108259277282 35.678619236351636, -82.4712535927905 35.67868823638334, -82.4716105928362 35.678776236437976, -82.4718765928713 35.67883423647716, -82.47213859290174 35.678918236521305, -82.47221359291035 35.678943236534124, -82.47262059295483 35.679092236606365, -82.47290959298647 35.67919723665744, -82.47324659302042 35.679339236721084, -82.47347959304147 35.679452236768135, -82.47354059304698 35.67948223678049, -82.47362259305089 35.67954523680178, -82.47383059306465 35.679679236850475, -82.47392959307173 35.6797392368728, -82.47402859307986 35.67979323689404, -82.4741235930886 35.67983823691299, -82.4745655931327 35.68002723699691, -82.4748435931627 35.68013123704677, -82.47496459317824 35.68016023706511, -82.47508159319523 35.680176237080445, -82.475220593217 35.680184237096356, -82.47560359327936 35.68019223713753, -82.4757195932968 35.68020323715168, -82.47594559333021 35.68023023718042, -82.47610459335195 35.68026023720297, -82.47613659335614 35.68026723720768, -82.47643759340102 35.68030023724535, -82.47661159343028 35.68029723726272, -82.47676059345797 35.68027823727421, -82.4770295935108 35.68022523729113, -82.47709059352263 35.680214237295196, -82.4771005935246 35.68021223729577, -82.47727159355533 35.68019723731038, -82.47731959356352 35.680195237314905, -82.47739259357579 35.680194237322254, -82.47741459357965 35.68019323732433, -82.4775535936011 35.680203237340635, -82.47768459361963 35.680224237358395, -82.47782759363824 35.680257237379855, -82.47797359365457 35.680308237405306, -82.47857759372181 35.68052123751087, -82.47873959374046 35.6805742375383, -82.47896859376574 35.680656237578575, -82.479166593789 35.680718237611636, -82.47942659381835 35.680807237656474, -82.4796675938463 35.68088523769722, -82.48008359389425 35.681021237767744, -82.48021659390749 35.681078237792995, -82.48022759390788 35.681087237795985, -82.48030059391071 35.681147237815736, -82.48030559391087 35.68115223781728, -82.48036359390649 35.681242237841566, -82.48040359389967 35.68132923786337, -82.4804205938912 35.681402237879986, -82.48042259389058 35.681408237881435, -82.48043559387902 35.68149723790082, -82.48046359385442 35.68168623794215, -82.48053759379822 35.68212823803972, -82.48054759378306 35.68223723806293, -82.48054759376448 35.68235723808732, -82.48053859374298 35.682486238112574, -82.4805295937336 35.68253723812206, -82.48052059372267 35.682598238133544, -82.48051059369872 35.682742238161815, -82.48051359368732 35.68281923817777, -82.48056059367165 35.68297023821336, -82.48059559366581 35.68304523823222, -82.48064559366038 35.68313423825545, -82.48083859364618 35.68343323833614, -82.48108459363496 35.68376923842986, -82.48117459362973 35.683899238465614, -82.48126759362643 35.684020238499805, -82.48132359362043 35.68411923852568, -82.48138459361093 35.68424623855783, -82.48142359360136 35.68434923858282, -82.4814865935761 35.684580238636286, -82.48155859353949 35.684894238707585, -82.48162159351934 35.68509123875418, -82.48173359350298 35.685317238811685, -82.48176459350086 35.68536423882444, -82.48181159349767 35.6854352388437, -82.48192659349463 35.68557823888462, -82.48204159349493 35.68569923892112, -82.48218459349812 35.68583223896293, -82.4822845934976 35.68594223899556, -82.48238159349255 35.686079239033425, -82.48242559348544 35.686172239056916, -82.48244659348214 35.68621623906804, -82.48249359347177 35.68633323909667, -82.4825825934468 35.686590239158136, -82.48268359341827 35.686882239227906, -82.48274359340438 35.687036239265474, -82.48284759337605 35.687331239336146, -82.48303559332604 35.68785523946218, -82.48310859330707 35.68805623951052, -82.48319159328692 35.688275239563644, -82.48320659328306 35.68831623957352, -82.4832545932715 35.68844223960413, -82.48327059326768 35.688484239614375, -82.48328959326327 35.6885332396263, -82.48330959325898 35.68858223963826, -82.48335359325092 35.688681239662955, -82.483375593247 35.68873023967522, -82.4834075932408 35.68880423969358, -82.4834635932305 35.688931239725186, -82.48350159322166 35.689029239749026, -82.48352259321655 35.689084239762416, -82.48353459321542 35.68910423976764, -82.48357459321143 35.689173239785866, -82.48359959320888 35.689216239797204, -82.48366159320682 35.6892962398198, -82.48373259320995 35.68935223983851, -82.48374159321033 35.689359239840876, -82.48380759321793 35.689381239852125, -82.48386759322456 35.689402239862574, -82.48395659323893 35.6894052398724, -82.48398059324276 35.68940623987503, -82.4841875932794 35.68939123989339, -82.48441259332186 35.68935823990979, -82.48456459335044 35.68933623992098, -82.48494859342291 35.689280239949156, -82.48559859354175 35.68920924000176, -82.48576159357097 35.68919524001571, -82.48588159359242 35.68918524002599, -82.48612759363522 35.68917224004874, -82.48622059365012 35.6891762400591, -82.48632759366427 35.689199240074856, -82.48652759368781 35.68926124010807, -82.48668659370094 35.68934724014198, -82.48781259378791 35.68999224038917, -82.48811659381377 35.69015124045291, -82.48835459383191 35.6902892405055, -82.48858659385061 35.69041724055542, -82.48886159387581 35.690549240610615, -82.48901759389078 35.69061924064089, -82.48911659390025 35.69066424066028, -82.48941959392783 35.69081124072149, -82.48958659394177 35.69090024075674, -82.48969059395282 35.690940240775575, -82.48993959398452 35.69100224081388, -82.49014259401578 35.69101824083803, -82.49017659402105 35.69102024084196, -82.49027859403655 35.69102924085428, -82.49031259404175 35.69103224085838, -82.4903755940515 35.69103724086588, -82.49053259407843 35.69103124088093, -82.49054659408077 35.69103124088231, -82.49080359412316 35.69103324090917, -82.49110759417238 35.69104124094216, -82.49119259418386 35.69105824095442, -82.49122059418752 35.69106424095847, -82.49136259420057 35.69113224098698, -82.49139159420227 35.691152240994, -82.49145459420599 35.69119624100951, -82.49154559421007 35.69126724103329, -82.49156859421026 35.691290241040306, -82.49166459421183 35.691383241069104, -82.49184059421741 35.69153624111842, -82.49196859421728 35.691674241159674, -82.49205759421929 35.69175624118556, -82.49209359422014 35.69178924119595, -82.49219359422426 35.69187024122275, -82.49223359422656 35.6918982412326, -82.49230659423091 35.6919482412503, -82.49237959423513 35.69199924126812, -82.49245659424236 35.692035241283406, -82.49254059424932 35.69208024130119, -82.49261959425573 35.69212324131813, -82.49265059425834 35.69214024132477, -82.49266359425953 35.6921462413274, -82.49276959426953 35.692195241348244, -82.49280159427282 35.69220824135421, -82.49284859427767 35.69222724136288, -82.49304859429805 35.69231024140038, -82.49319159431202 35.6923732414279, -82.49322859431514 35.692392241435634, -82.49344159433325 35.69250424148037, -82.49366059435332 35.69260924152431, -82.49375159436273 35.692646241541226, -82.49385259437408 35.692681241558745, -82.4939835943906 35.69271424157893, -82.49439759444887 35.692782241635435, -82.49447759445994 35.6927962416465, -82.49480559450458 35.69285924169317, -82.49495359452484 35.69288724171414, -82.49504959453786 35.69290624172784, -82.49522959456097 35.69295024175536, -82.49533559457264 35.69298824177404, -82.49538859457822 35.69300924178371, -82.49548859458854 35.69304924180218, -82.49552859459256 35.693066241809774, -82.49562559460202 35.69310924182852, -82.49581759461918 35.693204241867626, -82.49605259464025 35.693320241915416, -82.4963115946651 35.69343724196595, -82.49669759470517 35.69359224203727, -82.49699559473595 35.693713242092635, -82.49727559476487 35.693826242144446, -82.49738959477658 35.69387324216571, -82.49777759481756 35.694024242236466, -82.49803259484352 35.69413024228427, -82.49812059485411 35.694156242298675, -82.49841059488872 35.69424324234624, -82.49844559489281 35.694254242352045, -82.49856059490806 35.69427924236901, -82.49873159493043 35.69431824239458, -82.49901659496874 35.694376242435744, -82.49916959498924 35.69440824245799, -82.4993435950125 35.694444242483286, -82.4994725950369 35.69442524249273, -82.49959459506583 35.69436924249387, -82.49987359514016 35.694188242485794, -82.5000545951846 35.69409524248555, -82.50013759520208 35.69407124248923, -82.500174595209 35.694066242492, -82.50031359523463 35.69405024250306, -82.50051059526353 35.69407424252828, -82.50070559528899 35.6941192425575, -82.5010055953236 35.69421724260835, -82.50129159535422 35.694326242660004, -82.50154559538042 35.69442924270717, -82.50195459542385 35.69458724278143, -82.50217859545052 35.69465524281834, -82.50231159546964 35.69467424283591, -82.502425595489 35.69467124284704, -82.50250859550671 35.694646242850496, -82.50274559556121 35.69454824285498, -82.50302859563705 35.694362242846324, -82.50311659566249 35.694292242841115, -82.50324359569821 35.69419724283492, -82.50341659574684 35.69406924282668, -82.5035695957892 35.693959242820036, -82.50368659581929 35.69389024281804, -82.50376959583681 35.69386624282176, -82.50382759584681 35.69386424282729, -82.50392059585893 35.69388524284119, -82.50400759586469 35.693941242861555, -82.50410259586255 35.69405724289494, -82.50413459585815 35.69412024291103, -82.50427759588622 35.69409224292005, -82.5044435959176 35.69406724293207, -82.50445359591949 35.69406624293293, -82.5048475959879 35.694046242969485, -82.50527159605366 35.69407624301925, -82.5053835960703 35.69408924303347, -82.50569659611666 35.694125243073, -82.50576559612674 35.69413424308199)))",6504,37,021,002703,370210027032,1323,1323,7,1303,1270,14,8,11,0,0,20,1082,3,1079,1070,1057,3,6,4,0,0,12,661,580,81
census_2010_blockgroups_view.fid--2dc29038_13ec899ba8f_-2619,"MULTIPOLYGON (((-82.47480260768846 35.586031217904974, -82.47490360769854 35.58607421792412, -82.47494460770258 35.586092217932006, -82.47505560771512 35.586130217951094, -82.47514260772493 35.58616021796617, -82.4751706077283 35.58616821797068, -82.47550560776885 35.58626521802484, -82.4755206077709 35.58626821802706, -82.47563860778597 35.586297218045054, -82.47582660781019 35.58634221807348, -82.47603660783903 35.58638121810306, -82.47624560786853 35.5864142181312, -82.47625760787032 35.58641521813265, -82.47655260791386 35.586450218170135, -82.47676160794596 35.586467218195075, -82.47695760797686 35.58647721821728, -82.47732860803832 35.586477218255446, -82.47806560816365 35.586456218326866, -82.47814760817771 35.58645321833468, -82.47818360818366 35.586453218338384, -82.47877960828386 35.586444218397794, -82.47891160830571 35.5864442184114, -82.47919360835218 35.586446218440784, -82.4793076083707 35.5864482184529, -82.47938460838321 35.586450218461295, -82.47943960839277 35.5864472184663, -82.47948760837001 35.58664621851178, -82.47951960834757 35.58682621855164, -82.4795206083471 35.58683021855254, -82.47953760831952 35.58702821859451, -82.47953860829377 35.587196218628776, -82.47952660826522 35.58736821866252, -82.47949960823289 35.587549218696566, -82.47947260820852 35.58767821872005, -82.47941260816518 35.587895218758, -82.47938660814869 35.587974218771386, -82.47934760812285 35.588100218792974, -82.47925560807062 35.58834021883235, -82.4792206080514 35.588427218846434, -82.4791176079941 35.58868821888893, -82.47908360797494 35.5887762189033, -82.47897560791466 35.589051218948114, -82.47881060782177 35.589476219017556, -82.47866160773445 35.58988221908483, -82.47859160769292 35.590077219117326, -82.47857160767616 35.59016421913293, -82.47856960767479 35.59017121913419, -82.47853360764515 35.59032421916159, -82.47851260761367 35.59050621919639, -82.4785066075896 35.59065621922631, -82.47850860756587 35.59081221925821, -82.47852060754283 35.59097421929241, -82.47857060750522 35.59127221935813, -82.47861860748547 35.59145221939967, -82.47866660747243 35.59158821943226, -82.47870160746456 35.59167721945398, -82.47876360745076 35.59183321949209, -82.47879560744809 35.59188521950595, -82.47894760744025 35.59209921956504, -82.47896260743973 35.59211921957072, -82.47899060743829 35.59215821958152, -82.47908960743376 35.59229421961933, -82.47917360743196 35.59239621964872, -82.4792716074323 35.592499219679766, -82.47952560743839 35.59273321975346, -82.47965560744433 35.59283421978735, -82.47985660745765 35.5929642198345, -82.48006460747355 35.593084219880254, -82.4802526074906 35.59317621991827, -82.48056660752253 35.59330621997699, -82.48081460755161 35.59338422001839, -82.48100560757526 35.59343622004856, -82.48126960760885 35.59350222008917, -82.48176860767651 35.593600220160376, -82.48192360769718 35.5936322201828, -82.48232460774908 35.59372722024341, -82.48260060778598 35.5937842202834, -82.4826646077945 35.59379822029277, -82.48363760792184 35.594018220437576, -82.48365560792463 35.59401922043962, -82.48380260794343 35.59405522046205, -82.48405360797523 35.59411922050087, -82.48410660798217 35.594131220508785, -82.48403760794254 35.594314220538884, -82.48393160788079 35.59460022058617, -82.4838126078215 35.59485722062623, -82.4838096078198 35.59486522062748, -82.48372560777993 35.59503322065308, -82.48359860775413 35.595064220646265, -82.48359760775388 35.59506522064636, -82.48323460767176 35.59520722063796, -82.48320060766392 35.5952212206373, -82.48311560764375 35.59526122063673, -82.4829796076115 35.59532422063551, -82.48289760759204 35.59536222063487, -82.48275360755595 35.595441220636054, -82.4826696075346 35.59548922063718, -82.48246260748489 35.59558922063628, -82.48230060744802 35.59565422063281, -82.48211260740848 35.59570922062469, -82.48189560736476 35.59575922061255, -82.48166960732148 35.59579722059702, -82.48160460730946 35.595805220591984, -82.48150060729 35.59581922058412, -82.48121360724181 35.59582322055542, -82.48120160724002 35.59582222055396, -82.48095660720266 35.59580122052456, -82.48086460718893 35.59579122051304, -82.48068760716222 35.59577422049137, -82.48046660712774 35.5957602204658, -82.48026160709453 35.59575522044366, -82.48007660706142 35.595771220427906, -82.47991860702999 35.5958052204186, -82.47986260701764 35.59582522041687, -82.47979060700152 35.59585222041492, -82.47971260698247 35.595892220415074, -82.47964760696661 35.595925220415154, -82.47956160694451 35.595976220416674, -82.47950160692903 35.596012220417876, -82.47946560691949 35.59603522041878, -82.47918360684392 35.59622222042779, -82.47918160684327 35.59622422042801, -82.47909260681882 35.59628722043163, -82.47894060677702 35.596394220437794, -82.47878960673418 35.59651022044587, -82.47860060667144 35.59671422046789, -82.47833960657935 35.5970312205055, -82.47829560656355 35.59708622051214, -82.4779716064477 35.59748922056085, -82.47787560641144 35.597621220577786, -82.47777860637193 35.59777322059877, -82.47763160630252 35.59806522064296, -82.47756660626679 35.59822722066922, -82.47745860620007 35.598544220722594, -82.47720360600313 35.599547220900334, -82.47710060593151 35.59990122096171, -82.47709060592675 35.59992122096474, -82.47706860591508 35.599973220973126, -82.47704660590446 35.60001822098001, -82.47695960587393 35.60012322099236, -82.47691960586185 35.60015822099544, -82.47687560585008 35.60018722099678, -82.47675460582117 35.60024522099608, -82.47662760579252 35.60029422099298, -82.47653560577236 35.60032622099006, -82.47640060574219 35.60037622098633, -82.4763486057305 35.60039622098507, -82.47620960569915 35.600450220981806, -82.47610760567609 35.60049022097938, -82.47605760566461 35.60051122097849, -82.47560960555981 35.60070922097268, -82.47546060552494 35.6007752209708, -82.4754596055185 35.6008162209791, -82.47545960551399 35.60084522098495, -82.47544560549932 35.60092522099974, -82.47544160549648 35.60093922100217, -82.47543060548851 35.60097922100924, -82.47541860547973 35.6010232210169, -82.47539160545635 35.60114622103914, -82.47531360539693 35.60144722109239, -82.47523260533468 35.601764221148464, -82.47504960519794 35.60245422126997, -82.47497460513642 35.6027722213269, -82.4749576051215 35.60285122134123, -82.47489860506634 35.60314522139497, -82.47485360503141 35.60332322142658, -82.47477060497266 35.603615221477405, -82.47470960492254 35.60387422152379, -82.47470560488676 35.6041022215697, -82.47470560487048 35.60420822159128, -82.47470460485057 35.604336221617174, -82.47470860483344 35.60445122164099, -82.47470360479237 35.60471222169353, -82.4747026047921 35.60471322169364, -82.47469460477134 35.60483922171849, -82.4745776047406 35.60491222172129, -82.4745506047328 35.60493422172298, -82.47437260467566 35.605113221741036, -82.47385760450338 35.60567722180276, -82.4737496044688 35.605785221813626, -82.47365260444084 35.605862221819365, -82.47362560443277 35.60588522182122, -82.4735036043998 35.605968221825556, -82.4733656043669 35.60603322182457, -82.47265860421162 35.6062802218021, -82.47243860416147 35.606369221797586, -82.47228760412472 35.60644522179741, -82.47218060409521 35.6065212218019, -82.47209460406683 35.606613221811756, -82.47200560403552 35.60672022182441, -82.47183060397094 35.60695122185336, -82.47173860393991 35.6070532218646, -82.47164260391165 35.607133221870995, -82.47149160387148 35.60723122187539, -82.47136660384167 35.60729022187452, -82.47126460381865 35.607330221872196, -82.47112660379086 35.60736222186453, -82.47105460377786 35.607369221858505, -82.47101160377024 35.607372221854725, -82.47086060374582 35.60736822183833, -82.47036660367165 35.60731822177739, -82.46974460358048 35.607241221697784, -82.46906760348111 35.60715822161119, -82.46867560342058 35.60712922156498, -82.46843660337885 35.60714322154324, -82.46828860335009 35.60717022153346, -82.46820660333421 35.60718522152809, -82.46812460331712 35.6072082215244, -82.46793260327685 35.607263221515765, -82.46764060321463 35.607352221503895, -82.46756660319872 35.6073762215011, -82.46747960318055 35.60740022149702, -82.46742260316881 35.60741522149424, -82.46725360313376 35.60746122148624, -82.46719760312202 35.60747722148368, -82.46711660310521 35.60749922147982, -82.4670256030861 35.60752522147577, -82.46687460305569 35.60756022146733, -82.46679360303919 35.607580221463074, -82.46676760304933 35.607486221441256, -82.46669160307997 35.60720622137651, -82.46668660308222 35.607186221371926, -82.46665660308807 35.607116221354566, -82.466958603153 35.607019221365974, -82.4675746032883 35.606804221385595, -82.46790460335605 35.60671922140228, -82.46817860340622 35.60668822142416, -82.46832660342866 35.60670222144219, -82.46841760344235 35.60671122145346, -82.46864160346988 35.60677322148907, -82.46909160351659 35.606954221572174, -82.46928160353983 35.60700722160248, -82.46953860357982 35.607024221632436, -82.46978060362267 35.60700622165362, -82.46989160364807 35.6069612216559, -82.47012660370397 35.606851221657706, -82.4703476037443 35.60682722167559, -82.47070360380036 35.606846221716026, -82.47101160385195 35.60684222174693, -82.4712726039044 35.606783221761816, -82.47141960394461 35.60668022175598, -82.47152860398131 35.606559221742515, -82.47160560403339 35.6063042216986, -82.47162160406259 35.606132221665284, -82.47161760411927 35.60576022158923, -82.47152760414247 35.605513221529776, -82.4714126041396 35.6054082214966, -82.4712536041293 35.605304221459015, -82.47103860410141 35.605254221426804, -82.47085860407711 35.60521822140096, -82.47080760407025 35.60520822139369, -82.47039660400183 35.60521022135179, -82.46996460392835 35.605222221309795, -82.46965660388042 35.605202221274006, -82.46926860382334 35.60515522122456, -82.46913460380733 35.605115221202624, -82.46890160377934 35.605046221164685, -82.46858160376381 35.60480322108234, -82.4685206037939 35.60454222102298, -82.46850460386752 35.604048220920866, -82.46840460389502 35.60376222085243, -82.46838560392119 35.60357222081187, -82.46842160396588 35.60332122076452, -82.4684086039854 35.603180220734565, -82.46835960400983 35.60296922068655, -82.46832960404154 35.60273122063512, -82.46828060406584 35.60252122058734, -82.4681556040882 35.60224222051776, -82.46804060409886 35.60204922046671, -82.4679386040988 35.60194022043407, -82.46790160409866 35.601901220422306, -82.46772460408273 35.601814220386345, -82.46749560405637 35.60173922034767, -82.467206604018 35.6016772203053, -82.46678160396847 35.6015422202341, -82.46651860393968 35.60144622018752, -82.46576460386997 35.60108822003721, -82.46561560385472 35.60102722000949, -82.46546160383366 35.60099821998767, -82.46519260379381 35.60096721995373, -82.4651046037896 35.600900219931, -82.46490760379552 35.60065021985998, -82.464755603786 35.600548219823594, -82.46444760376187 35.60037421975652, -82.4643216037626 35.60023421971515, -82.46423660378767 35.59998021965475, -82.46418160384141 35.59957221956609, -82.46415160387687 35.59931021950975, -82.46409360390048 35.59909521946009, -82.46398960392247 35.59884021939753, -82.4637656039238 35.598591219323836, -82.46344860391 35.598340219240264, -82.4630496038748 35.5981392191583, -82.46255360382087 35.59795621907009, -82.46223060379063 35.59780521900613, -82.4617986037611 35.59753321890644, -82.46145560374781 35.59725021881362, -82.46130060374041 35.597132218773645, -82.46112260374314 35.596923218712845, -82.46098760375108 35.596726218658894, -82.46088460377088 35.59648721859971, -82.46086560380381 35.59625321855019, -82.46094160384776 35.596050218516794, -82.46097660386482 35.59597721850549, -82.46101960388543 35.595889218491976, -82.46113260392394 35.5957612184776, -82.46129860397143 35.59563121846829, -82.46157060403347 35.59552121847385, -82.46167760405334 35.59550721848201, -82.46214260413937 35.59544921851807, -82.4625456042197 35.595361218541655, -82.4629996043064 35.595286218573094, -82.46376260445862 35.595119218617576, -82.46425860455251 35.59504321865317, -82.46462960461592 35.595030218688734, -82.46486060464741 35.59507421872139, -82.46505960466536 35.59517221876175, -82.46521660467327 35.59528921880168, -82.4655176046888 35.59551221887805, -82.46617260472259 35.59599721904399, -82.46645260474766 35.59613521910084, -82.46666960476712 35.59624221914489, -82.4667946047804 35.596290219167535, -82.46745660485107 35.5965432192871, -82.46806560491412 35.59678921939971, -82.46839060496131 35.5968322194419, -82.46867460501299 35.59680221946505, -82.4689376050729 35.59669621947049, -82.46911560512292 35.596563219461764, -82.46923860516627 35.59641421944413, -82.46925960519255 35.596266219416115, -82.46925660523745 35.59597221935603, -82.46923660525657 35.595826219324366, -82.46921560527792 35.59566521928942, -82.46916660531373 35.59538021922652, -82.4690546053665 35.59491721912083, -82.46889460541709 35.59441721900267, -82.46875160544614 35.59407521891845, -82.4686686054668 35.593852218864576, -82.46857760547917 35.59367421881897, -82.46844260547945 35.59352721877527, -82.46822460546323 35.59339821872657, -82.4676906054094 35.59317321862596, -82.46652660528281 35.59274321841875, -82.4662996052625 35.592631218372645, -82.4659716052407 35.59242021829605, -82.46570660521064 35.59233021825053, -82.4655236052017 35.592191218203375, -82.465411605216 35.59197821814857, -82.46532960523544 35.59176421809663, -82.46531660527785 35.59147521803654, -82.46539760531928 35.59129321800786, -82.46558760537744 35.591120217992206, -82.46586860545575 35.59091421797924, -82.46626560555497 35.59069721797588, -82.46642360560365 35.59055121796249, -82.46651260564677 35.59036721793419, -82.46655460570877 35.59001021786604, -82.46649360574574 35.589704217797454, -82.46639260577854 35.58938321772185, -82.46627960585305 35.588778217587205, -82.46626960586049 35.58871921757415, -82.46616360593923 35.58809421743626, -82.46607060602881 35.58741321728815, -82.46586160611002 35.586661217113765, -82.46581760620384 35.58600521697588, -82.46577860627553 35.58549821686884, -82.46575360632066 35.585178216801154, -82.46574660633578 35.585072216778826, -82.4657096063858 35.58470821670105, -82.46566360640179 35.584555216665244, -82.46561260641909 35.58438821662604, -82.4655496064304 35.5842462165907, -82.46541960645393 35.583954216517924, -82.46537760646113 35.583862216494936, -82.46532160647145 35.583735216463324, -82.46537860648155 35.58373121646843, -82.46576160654855 35.58370821650313, -82.4658906065707 35.58370321651536, -82.4661516066154 35.583693216540155, -82.46627860663679 35.58369121655281, -82.46640860665842 35.583690216565984, -82.46654260668095 35.583688216579375, -82.46688960673794 35.58369121661561, -82.46717660678429 35.58369921664677, -82.4671886067862 35.58370021664819, -82.4678246068847 35.58374421672254, -82.46815560693413 35.583779216763695, -82.46860160699859 35.58384021682197, -82.46895360704846 35.58389521686927, -82.46922560708619 35.583943216907, -82.46946260711805 35.583991216941165, -82.46984660716952 35.58407021699673, -82.47021360721654 35.584159217052544, -82.4702456072208 35.584166217057216, -82.47034160723294 35.58419021707204, -82.47037460723726 35.584198217077045, -82.47046160724851 35.584218217090076, -82.4704646072489 35.58421921709052, -82.47072060727996 35.584293217131915, -82.47080760729044 35.584318217145906, -82.47108660732422 35.58439921719113, -82.47110760732664 35.58440621719471, -82.47166660739059 35.58459221728992, -82.47195360742174 35.584698217341085, -82.47199660742625 35.58471521734888, -82.47221060744867 35.58480021738815, -82.47228760745635 35.5848332174028, -82.47230160745772 35.58483921740551, -82.47234560746227 35.58485721741364, -82.47236060746366 35.58486421741667, -82.47245860747347 35.58490621743525, -82.47264960749261 35.58498721747136, -82.47275360750228 35.585036217492, -82.47285160751144 35.58508221751146, -82.4730446075295 35.585172217549584, -82.47306960753185 35.58518421755458, -82.47361760757998 35.58546121766731, -82.47380860759667 35.585558217706634, -82.47390960760549 35.585609217727345, -82.47421260763215 35.585762217789615, -82.47431360764088 35.58581421781061, -82.47438860764747 35.58585221782599, -82.47445860765424 35.58588321783954, -82.47461060766881 35.58595221786919, -82.47480260768846 35.586031217904974)))",6524,37,021,003001,370210030014,1588,1588,134,1544,1419,34,3,14,0,74,44,1347,78,1269,1325,1252,25,3,10,0,35,22,914,817,97
census_2010_blockgroups_view.fid--2dc29038_13ec899ba8f_-2618,"MULTIPOLYGON (((-82.58254062517908 35.588521229480854, -82.58284362523942 35.58845622949864, -82.58309962529044 35.5884012295138, -82.5832596253221 35.58836822952346, -82.58371862541607 35.588252229547, -82.58374962542257 35.58824422954847, -82.58405262548378 35.58817322956523, -82.58459162559329 35.588043229594085, -82.58621062592232 35.58765322968087, -82.58640562596175 35.58760722969151, -82.58675262603127 35.58753022971147, -82.58720762612427 35.58741722973514, -82.58784162625354 35.58726122976851, -82.58857662640237 35.58708722980852, -82.58860962640897 35.58708022981045, -82.58903762649298 35.58699622983724, -82.58924462653368 35.58695522985016, -82.5892756265396 35.58695022985234, -82.58977662663483 35.586872229887966, -82.58999862667568 35.58684622990542, -82.59024062672022 35.58681822992459, -82.59059262678352 35.58678722995435, -82.59075962681341 35.586773229968664, -82.59111462687561 35.586752230000826, -82.59165062696741 35.58673423005216, -82.59168662697357 35.586733230055685, -82.59200462702607 35.5867352300887, -82.59201862700571 35.586882230120054, -82.59202062700412 35.586895230122984, -82.59207762697318 35.587158230182375, -82.59212462696277 35.587276230211216, -82.59216362695692 35.58735623023155, -82.59217362695566 35.58737523023635, -82.59224062695066 35.58748023026466, -82.59224962695016 35.58749323026821, -82.59231062694707 35.587579230292015, -82.59243062694655 35.58771223033145, -82.59258662694324 35.587902230386135, -82.59280162693153 35.5882102304709, -82.59283762692968 35.58826123048497, -82.59301262691814 35.58852523055672, -82.59315362690575 35.58875823061866, -82.59318562690055 35.58882623063574, -82.59323762687858 35.589025230681635, -82.59326462684899 35.58924723072959, -82.59329462678807 35.589675230819864, -82.5932956267336 35.590030230892204, -82.59328362669409 35.59027423094065, -82.59322062660162 35.59080723104274, -82.59321962659916 35.59082223104569, -82.59316862654559 35.59111523110016, -82.59308462649301 35.591366231142686, -82.59298262644172 35.59158923117759, -82.59295162642437 35.59166823119052, -82.59293262641414 35.59171423119787, -82.59290362639327 35.591819231216284, -82.592883626378 35.59189623122997, -82.59285162634195 35.59209623126736, -82.59283562631855 35.592231231293226, -82.5928296263081 35.592292231304995, -82.59282562630112 35.59233323131299, -82.59281562628135 35.592451231335964, -82.59281362627856 35.59246723133898, -82.5928086262702 35.59251623134852, -82.5928076262674 35.592533231351865, -82.59278862624097 35.59268423138062, -82.5927456261848 35.59300323144118, -82.59272762616126 35.59313623146644, -82.59269262613255 35.59328523149318, -82.59265262610077 35.59344823152226, -82.59265062609954 35.59345423152333, -82.59260862607087 35.59359523154772, -82.59247762598108 35.59403723162428, -82.59243462595119 35.59418523164991, -82.5923856259201 35.5943342316753, -82.59235362589962 35.59443323169215, -82.59229762586698 35.59458423171717, -82.59222362583093 35.5947392317411, -82.59220662582341 35.59476923174546, -82.59215162579878 35.59487023176039, -82.59212962578933 35.59490723176571, -82.59206262576195 35.59501323178041, -82.5920396257521 35.595052231786, -82.59183862567805 35.59531623181904, -82.59179662566234 35.59537323182637, -82.59176762565033 35.59542023183298, -82.59173562563693 35.59547223184038, -82.59169462561972 35.59554023184993, -82.59166362560435 35.59560623186018, -82.59165462559817 35.59563723186555, -82.59163962558634 35.59569723187623, -82.5916216255712 35.595776231890476, -82.59161562556467 35.59581223189715, -82.59156062550187 35.59616123196265, -82.59154362548098 35.59627823198472, -82.59153362547093 35.59633323199482, -82.59150362544061 35.59649723202521, -82.59149462543051 35.59655323203563, -82.59148262541949 35.59661223204644, -82.59144962538674 35.596789232079125, -82.59143962537581 35.596849232090285, -82.59140962534774 35.59699923211779, -82.59137262531175 35.59719323215347, -82.59131462526257 35.59745023219986, -82.59128662523868 35.5975752322224, -82.59128062523381 35.59760023222692, -82.5912516252084 35.59773423225123, -82.59120362516504 35.597964232293094, -82.59117462513308 35.59814023232598, -82.59116662512453 35.59818723233475, -82.59115662511181 35.59825923234838, -82.59115462510883 35.598276232351616, -82.59113362507354 35.598483232391665, -82.59113262507088 35.59849923239475, -82.59112762505245 35.59861323241753, -82.59114562498971 35.59904023250628, -82.59114062497521 35.59912923252386, -82.59113362496778 35.59917023253151, -82.59112662495868 35.59922123254122, -82.59109462493751 35.5993242325589, -82.59107662492488 35.59938723256986, -82.59106662491793 35.59942123257577, -82.59102662489789 35.599508232589386, -82.5909736248759 35.599594232601476, -82.59092762485925 35.59965223260857, -82.59086162483524 35.59973723261902, -82.59052562472509 35.600090232656456, -82.5904606247023 35.60016823266566, -82.59039762467842 35.600255232676865, -82.59034562465564 35.60034723269026, -82.590342624654 35.60035423269143, -82.59031562463599 35.600442232706534, -82.59029562461377 35.60056523272956, -82.59029462459976 35.60065523274781, -82.59029662458813 35.60073223276368, -82.59029962457686 35.60080923277962, -82.59029962457625 35.60081323278045, -82.59032762453394 35.60111823284544, -82.59034662451103 35.60128723288187, -82.59036562448993 35.60144523291593, -82.59036762448822 35.601458232918766, -82.59037362448288 35.601499232927715, -82.59037562448107 35.60151323293077, -82.59038462447394 35.60156923294312, -82.59042062445161 35.60175323298434, -82.59045562443438 35.60190323301851, -82.5904706244276 35.60196323303221, -82.59048762441905 35.602037233049046, -82.59053762439558 35.60224323309615, -82.59055662438256 35.602348233119436, -82.59056462437243 35.60242323313557, -82.59055862434735 35.602579233166686, -82.59053662433203 35.602655233179945, -82.59050362431522 35.60272823319135, -82.59045262429329 35.6028162332041, -82.59039162426974 35.60290323321547, -82.59025362422186 35.60306523323431, -82.59018262419825 35.60314223324274, -82.5900926241641 35.60326623325874, -82.59005062414808 35.603325233266425, -82.58999462412521 35.603413233278644, -82.58997462411588 35.60345223328452, -82.58993162409567 35.60353723329734, -82.58988162407027 35.60364823331484, -82.5898416240461 35.603762233333946, -82.5897956240087 35.60395523336851, -82.58977662399364 35.604032233382206, -82.58977462399257 35.60403723338307, -82.58972662394598 35.60428823342925, -82.58971162393053 35.604372233444806, -82.58967162389101 35.604585233484066, -82.58959362381187 35.60501523356366, -82.58959162380572 35.60505323357119, -82.58958862379812 35.605099233580226, -82.5895816237842 35.60518223359641, -82.58958062377664 35.60523023360611, -82.58958062377408 35.60524723360959, -82.58959162375587 35.605377233637114, -82.5896056237475 35.60544623365265, -82.58974062375736 35.60552823368322, -82.58997862377748 35.60565423373332, -82.59013462379062 35.60573723376626, -82.59057162382922 35.60595823385616, -82.59067662383822 35.60601323387816, -82.59084162385008 35.60611423391566, -82.59091962385409 35.60617223393547, -82.59099462385609 35.60624023395702, -82.5910676238559 35.60632023398076, -82.59112862385588 35.60638623400047, -82.59134362385124 35.606648234075955, -82.59122362382303 35.606702234074596, -82.59094562375617 35.60683623407335, -82.5908246237268 35.60689623407316, -82.59066762368843 35.60697623407328, -82.59043262362692 35.60712223407892, -82.59009462353256 35.60737023409466, -82.59001262351035 35.607425234097455, -82.58992862348877 35.60747523409904, -82.58986362347349 35.60750423409824, -82.58978862345687 35.607531234096, -82.58971762344261 35.607547234091975, -82.58956862341589 35.60756023407935, -82.58938762338698 35.60755223405915, -82.58928562337168 35.60754123404639, -82.58871362328573 35.60748223397569, -82.58871062322753 35.60785723405175, -82.58871062322666 35.60786323405296, -82.58868362306167 35.60890523426233, -82.58867962304896 35.60898323427783, -82.58866462299291 35.60933123434717, -82.58867262299017 35.609357234353226, -82.58865762297813 35.60941923436431, -82.58864462296926 35.60946323437204, -82.58863762296295 35.60949623437796, -82.58861862294405 35.60959823439675, -82.58859262290765 35.60980723443669, -82.58858262288794 35.60992423445946, -82.58857162286391 35.61006823448766, -82.58855962282131 35.61033223454019, -82.58855862279145 35.6105242345792, -82.58853362273791 35.61084523464199, -82.58853162273246 35.6108782346485, -82.58851862267224 35.61125523472394, -82.58851962264131 35.61145723476518, -82.58855262257237 35.61194023486694, -82.58857062251762 35.61231523494515, -82.5885686225011 35.61242023496634, -82.58855562248789 35.61249223497963, -82.58852662247345 35.61255423498935, -82.5884426224524 35.61260023499009, -82.58835562243604 35.612613234983755, -82.58823462241696 35.612606234969924, -82.5880986223984 35.61258023495064, -82.58793262237926 35.612525234922366, -82.58781962236611 35.612488234903246, -82.58748462232816 35.61237323484542, -82.58736662231432 35.61233623482578, -82.58728762230625 35.61230323481091, -82.58724662230303 35.61228023480204, -82.58721962230467 35.61224023479107, -82.58711762229136 35.612216234775694, -82.58697962227185 35.612194234757055, -82.5867536222375 35.612173234729575, -82.58671162223104 35.61217023472466, -82.58656862220818 35.61216423470871, -82.58628562216565 35.61213523467379, -82.58587862210878 35.612065234617724, -82.58577962209654 35.61203823460209, -82.58567962208684 35.61199323458263, -82.58561362208413 35.611939234564844, -82.58553562208878 35.61182523453363, -82.58549162209442 35.61174123451202, -82.58545362209928 35.61166823449323, -82.58534462211203 35.6114682344413, -82.58532662211408 35.611435234432705, -82.58527062212158 35.6113262344048, -82.58522662212755 35.611240234382784, -82.5852236221278 35.61123523438144, -82.58513962214617 35.611025234330064, -82.5851226221554 35.610947234312384, -82.58511562215944 35.61091323430473, -82.58509362216546 35.61085023428963, -82.58514462218032 35.610809234286556, -82.58528962222681 35.61066323427172, -82.58536962225209 35.610586234264275, -82.58578362238093 35.610196234227395, -82.586188622512 35.6097822341847, -82.58645662259858 35.6095092341566, -82.58665962266357 35.6093062341361, -82.58680862271402 35.60913923411743, -82.58694062275833 35.60899423410145, -82.58708662281228 35.60880123407715, -82.58714362283528 35.608713234065064, -82.5871966228603 35.608608234049136, -82.58723962288718 35.60848023402745, -82.58729062292545 35.60828623399324, -82.58729862293558 35.608229233982456, -82.5873026229514 35.60813123396289, -82.58729862295932 35.60807523395108, -82.587264622972 35.60795623392339, -82.58718762298784 35.60777023387751, -82.58709162300809 35.60753523381992, -82.58701662301885 35.60738423378143, -82.58696862302217 35.607311233761564, -82.58693562302406 35.607263233748405, -82.58685462302512 35.60716923372099, -82.5868056230239 35.607124233706784, -82.58667562301848 35.60701923367214, -82.5865406230108 35.606923233638604, -82.58636862299886 35.606815233598965, -82.58611962298153 35.606659233541606, -82.58605362297796 35.60661123352504, -82.58600362297683 35.60656423351038, -82.5859666229779 35.606517233497044, -82.5859326229809 35.606461233482136, -82.58591062298501 35.606411233469686, -82.58589462299065 35.60635723345705, -82.58588262300466 35.60625323343465, -82.58589362302862 35.60610923340645, -82.58591462304648 35.60601623338963, -82.5859396230632 35.605934233375486, -82.58600762310148 35.60575923334683, -82.5861576231882 35.6053582332806, -82.58629262327636 35.60493123320752, -82.58634762331148 35.604762233178796, -82.5863736233278 35.60468423316555, -82.58656862344489 35.60413423307361, -82.58658162345607 35.604076233063054, -82.58658562346565 35.604018233051704, -82.5865766234821 35.603901233027024, -82.58654662349537 35.603783232999845, -82.58653062350251 35.60371923298512, -82.58641262353743 35.60336523290099, -82.58631162356018 35.60310823283825, -82.58622462357994 35.60288623278413, -82.58616262359212 35.60274023274803, -82.58605062361416 35.60247623268275, -82.58597462362776 35.60230623264033, -82.58591162363936 35.60216223260453, -82.5858546236483 35.602043232574516, -82.58580662365573 35.6019432325491, -82.58568362367056 35.60171423248995, -82.5856706236713 35.60169523248474, -82.58562262367421 35.601624232465326, -82.58559362367464 35.60159023245539, -82.58556862367493 35.60156123244694, -82.58543262367151 35.60143623240752, -82.58540662367055 35.601415232400534, -82.58530462366622 35.601333232373364, -82.58483762363974 35.60100123225784, -82.5847836236363 35.60096523224496, -82.58457062362277 35.600823232194145, -82.58455962362204 35.60081623219162, -82.5844906236186 35.600764232173894, -82.58397062358655 35.60041123204866, -82.58395362358557 35.600399232044445, -82.583532623559 35.60011723194381, -82.58346062355538 35.60006323192539, -82.58340162355344 35.60001223190897, -82.58334262355308 35.59995123189047, -82.58328962355579 35.599876231869786, -82.58318762356535 35.599704231824255, -82.58307562358047 35.59948523176823, -82.58298362359515 35.59929023171902, -82.58295462360253 35.59921123169999, -82.58291362361632 35.59907723166846, -82.58283062367505 35.59860623156407, -82.58282362367815 35.59857823155763, -82.5828026236886 35.59848823153716, -82.58277362369684 35.59840323151684, -82.58274362370096 35.59834423150176, -82.58245662371617 35.597935231389016, -82.58234762369548 35.597952231381214, -82.58222262367254 35.59796623137127, -82.58212362365533 35.59797123136213, -82.58196162362692 35.59798123134752, -82.58164862357476 35.59798223131562, -82.58125462351032 35.59797523127374, -82.58111962348929 35.59796623125804, -82.58083462344473 35.59794823122509, -82.58078662343819 35.59793923121832, -82.58069362342528 35.59792223120531, -82.58066562342144 35.59791723120145, -82.58045162339556 35.59785423116658, -82.5804236233926 35.59784323116149, -82.58033562338296 35.59781123114592, -82.57935062327844 35.597427230966616, -82.57910662325092 35.597342230924205, -82.57867162319842 35.59721423085352, -82.57847362317654 35.59714323081869, -82.57828062316024 35.597040230777885, -82.57814462315234 35.59694523074459, -82.57796962314748 35.59678723069443, -82.5778496231463 35.59666623065749, -82.57753162314766 35.596314230553155, -82.57739462314517 35.596182230512206, -82.57729162314084 35.5960992304848, -82.5772286231364 35.59606023047034, -82.57714662313084 35.59600823045139, -82.57701462311951 35.59593923042373, -82.57685362310136 35.59588323039576, -82.57664862307507 35.59583223036437, -82.57643062304568 35.59578823033298, -82.57620762301678 35.59573523029927, -82.57604462299453 35.59570423027623, -82.57573962295854 35.59560923022563, -82.57562962294513 35.59557723020779, -82.57556562292834 35.59561723020938, -82.5755156229154 35.595647230210325, -82.5755036229121 35.59565623021098, -82.57539962287632 35.59577623022464, -82.57536262286327 35.59582123023003, -82.57529262283826 35.59590823024062, -82.57508162276288 35.59617023027227, -82.57501262273783 35.59625823028307, -82.57488162274316 35.596082230233776, -82.5747506227485 35.59590623018447, -82.57454262275697 35.59562723010636, -82.57449062275909 35.59555723008671, -82.57348362274041 35.59459222978686, -82.57345362274212 35.59454822977485, -82.57325662275487 35.59425322969451, -82.57312262280188 35.59380322958916, -82.57309662281114 35.59371522956857, -82.57305862284825 35.593433229507234, -82.57303062287477 35.5932302294631, -82.5730026229014 35.593027229418844, -82.57293262296852 35.592515229307395, -82.57288162301771 35.592141229225994, -82.57276462309768 35.59149522908256, -82.57258162314118 35.59101522896595, -82.57248162316505 35.59075222890222, -82.57246562316882 35.590710228891965, -82.5723756231794 35.590544228849005, -82.57247562319927 35.59052322885496, -82.57277562325852 35.59046222887335, -82.57287662327836 35.59044222887962, -82.57291162328535 35.59043422888157, -82.57301962330672 35.59041222888821, -82.5730556233136 35.59040622889069, -82.57321062334424 35.59037422890005, -82.57367562343609 35.59027922892847, -82.57383162346675 35.59024822893817, -82.57394362348889 35.59022522894504, -82.5742806235557 35.59015522896537, -82.57439362357785 35.59013322897247, -82.57473762364582 35.590062228993354, -82.57538662377394 35.589930229033094, -82.57577262384898 35.58985922905831, -82.576118623916 35.58979722908127, -82.57631462395415 35.589761229094066, -82.57680062404837 35.589673229125985, -82.57690562406829 35.58965722913352, -82.57710462410564 35.58962922914822, -82.57754162418796 35.5895662291803, -82.57828562432778 35.58946022923508, -82.57884862443997 35.589339229268326, -82.57911962449373 35.58928222928452, -82.57928162452617 35.589246229293764, -82.57939462454893 35.5892202293001, -82.5795366245773 35.58918922930841, -82.57973362461681 35.589145229319655, -82.5798476246396 35.5891202293263, -82.57998062466615 35.58909122933403, -82.58014062469863 35.58905322934275, -82.58017062470445 35.58904722934459, -82.58062262479592 35.588941229369404, -82.58078362482824 35.58890422937837, -82.58110262489232 35.588832229396495, -82.58160262499268 35.58872022942503, -82.5818796250476 35.58866222944165, -82.58191262505413 35.588655229443596, -82.58254062517908 35.588521229480854)))",6217,37,021,001400,370210014001,1502,1502,495,1452,1046,144,9,6,0,247,50,1097,302,795,1075,821,90,4,5,0,155,22,634,596,38
census_2010_blockgroups_view.fid--2dc29038_13ec899ba8f_-2617,"MULTIPOLYGON (((-82.54377060808245 35.65764023956764, -82.54391860810131 35.65767723959046, -82.54424460814299 35.65775823964041, -82.54431160813783 35.65786323966871, -82.54439460813154 35.65799323970374, -82.54445760812675 35.65809223973037, -82.54446960812601 35.65811023973528, -82.54478160815938 35.658229239791616, -82.54488760817068 35.65827023981085, -82.54489260817188 35.65826823981097, -82.54496560818706 35.6582482398144, -82.54518460823226 35.65819123982531, -82.54525660824696 35.65817323982908, -82.54525860824711 35.65817423982951, -82.5454126082554 35.65828623986811, -82.54549760825978 35.65834923988967, -82.54588560836493 35.65808623987608, -82.54604360840749 35.6579802398707, -82.54604360840762 35.65797923987051, -82.54608160842002 35.657940239866534, -82.54619760845686 35.65782623985526, -82.54623660846921 35.65778823985147, -82.54627460847469 35.65779323985646, -82.54638860849107 35.65781023987163, -82.54642760849664 35.65781623987692, -82.54676760854527 35.65786723992224, -82.5473086086226 35.657948239994425, -82.54764560862422 35.658300240100694, -82.54787460862234 35.658558240176845, -82.54799960861648 35.6587312402249, -82.54807160859515 35.658946240276045, -82.54825360854029 35.659497240406935, -82.5484716085272 35.659816240494365, -82.54891760855543 35.66011324060071, -82.5491886085726 35.660293240665226, -82.54980860864632 35.66048324076768, -82.55024760880482 35.65992924070002, -82.5503706088407 35.65982924069238, -82.55169160915804 35.65919524069918, -82.55254560933169 35.658990240745325, -82.55326960946134 35.65892924080747, -82.55412360954979 35.6592752409657, -82.55471560961107 35.65951524107549, -82.55533460967732 35.65975224118745, -82.5559756097914 35.65970324124341, -82.55637360986199 35.65967424127841, -82.55687460997406 35.659488241292166, -82.5571516100506 35.659290241280296, -82.55740361012012 35.65911124126975, -82.5590916105646 35.65804924122726, -82.56012661081134 35.65756524123511, -82.56046261089362 35.65739424123488, -82.56069861095118 35.65727524123492, -82.56104361097412 35.65749824131579, -82.56149761104234 35.657545241372155, -82.56163961106358 35.65756024138979, -82.56169561106528 35.657609241405524, -82.5617406110689 35.65763424141521, -82.561792611078 35.657631241419956, -82.56190861110518 35.65758024142151, -82.56202961113685 35.65750524141867, -82.56204761114135 35.657495241418594, -82.5621726111759 35.65740624141323, -82.56229561120229 35.65736824141813, -82.56239161121631 35.65738024143046, -82.5625446112388 35.65739924145008, -82.56276061126115 35.65748724149019, -82.56287561127407 35.65752724151027, -82.5629326112835 35.6575272415161, -82.56301061129632 35.657528241524275, -82.56326261134687 35.65747224153883, -82.56329861135453 35.657461241540275, -82.56344361138463 35.65742224154727, -82.5636096114232 35.65735124154983, -82.56365761143428 35.657331241550715, -82.56371461144815 35.657302241550674, -82.56387461148682 35.65722424155128, -82.56403961152338 35.65716524155624, -82.56431061157771 35.65710524157186, -82.56457161163259 35.65703024158349, -82.56485761169795 35.656915241589495, -82.56498861172754 35.656864241592565, -82.56545461182598 35.65672824161279, -82.56559761186048 35.6566592416135, -82.5656876118831 35.65660924161261, -82.56579661190973 35.65655424161254, -82.56586961192423 35.65653924161701, -82.565881611926 35.65654024161846, -82.5659386119348 35.65654424162512, -82.56610861195675 35.656585241651, -82.56638761198647 35.656693241701625, -82.56695761204138 35.65695124181276, -82.56707861205359 35.6570022418356, -82.56717661206355 35.65704324185408, -82.5672836120735 35.65709424187549, -82.56766161211604 35.65722524194101, -82.56796461214853 35.65734124199586, -82.56823261217852 35.657435242042524, -82.56824661218018 35.65743924204474, -82.56854261221439 35.65753624209498, -82.56878661224677 35.657589242130925, -82.56943461234695 35.65763824220749, -82.5695866123705 35.65764924222537, -82.56992561242265 35.657676242265715, -82.5700426124406 35.65768624227978, -82.57019561246368 35.65770124229861, -82.5703346124849 35.65771324231536, -82.57075361254849 35.6577522423664, -82.57089361257025 35.65776224238278, -82.57142261265173 35.6578042424458, -82.57147961266041 35.65780924245268, -82.5716486126859 35.65782624247349, -82.57183361271366 35.657845242496435, -82.57222761277409 35.65787824254362, -82.57286361287363 35.65791824261725, -82.57323461293159 35.657942242660326, -82.57323961293241 35.657942242660745, -82.5737116130053 35.65797824271662, -82.57382661302253 35.65799024273097, -82.57400461304874 35.6580122427537, -82.57411961306498 35.65803124276939, -82.57437861309901 35.658089242807854, -82.57440861310293 35.65809624281237, -82.574603613127 35.65815024284343, -82.5746646131345 35.658167242853196, -82.57512461319004 35.65830324292816, -82.57527961320976 35.65834224295206, -82.57552461324322 35.65838924298684, -82.57576161327783 35.658420243017524, -82.57596561330875 35.6584392430424, -82.57602061331764 35.65844124304839, -82.57616061333995 35.658447243064046, -82.57634361337198 35.658437243080854, -82.57657961341705 35.658399243097364, -82.57670361344205 35.6583702431042, -82.57707561351675 35.658287243125606, -82.57720061354186 35.65825924313274, -82.57729561356089 35.65823824313824, -82.5773466135714 35.65822524314086, -82.57753761361062 35.65817724315066, -82.57777561366325 35.65809224315785, -82.57791761369442 35.658043243162496, -82.57798761371042 35.65801524316396, -82.57819961375846 35.65793224316892, -82.57827061377441 35.657905243170674, -82.5785296138334 35.65780224317635, -82.57880261389464 35.657699243183416, -82.57901261393917 35.65763724319242, -82.57923861398272 35.65759824320773, -82.57969261407167 35.657511243236684, -82.57978661408947 35.65749724324353, -82.57979261408043 35.65756224325742, -82.57981061406669 35.6576702432812, -82.57984061405362 35.657787243308114, -82.57987161404336 35.65788724333174, -82.57991661403322 35.6580012433595, -82.57997261402473 35.65811624338869, -82.58048261396365 35.65906124363357, -82.58050361396116 35.65910024364369, -82.58056661395355 35.65921724367398, -82.58058761395083 35.659257243684344, -82.58077561392803 35.659607243774936, -82.58134161385982 35.660658244047234, -82.58153061383705 35.661009244138135, -82.58158961382983 35.66111924416662, -82.58176961380835 35.66145224425296, -82.58182961380122 35.66156324428176, -82.58184561379925 35.6615932442895, -82.58189461379318 35.6616852443133, -82.58191161379125 35.661716244321305, -82.58196961380429 35.66169424432278, -82.58214661384325 35.661632244328324, -82.58220661385648 35.66161124433025, -82.58227061385475 35.661691244353186, -82.5824606138945 35.66163824436185, -82.58255861391497 35.661611244366505, -82.58310261402515 35.66148324439631, -82.58333561407275 35.661426244408666, -82.58362761413228 35.661355244424264, -82.58365461413827 35.66134524442498, -82.58366661414061 35.66134324442582, -82.58378961416368 35.66132624443499, -82.58383161417142 35.66132124443835, -82.58396361412807 35.66174424453804, -82.58436161399797 35.66301524483781, -82.58449461395463 35.66343924493788, -82.58459261392206 35.663755245012304, -82.58465261390273 35.66394524505719, -82.5848886138244 35.66470624523643, -82.58498761379175 35.665024245311386, -82.58507261376351 35.66529824537593, -82.58509761375893 35.66535524539012, -82.5852686137027 35.66590324551941, -82.58531861368434 35.666076245559736, -82.58538961365922 35.66631524561568, -82.5854766136245 35.666633245689425, -82.58552161359759 35.66685624573948, -82.58554961358443 35.66697124576574, -82.58557961354948 35.667230245821635, -82.58559561354316 35.667288245835024, -82.58561661349793 35.667603245901354, -82.58561461342477 35.66807524599732, -82.58560161339264 35.66826924603552, -82.58556261333618 35.66859224609725, -82.58552361329376 35.66882524614075, -82.58548761326202 35.668992246170994, -82.5854526132309 35.669155246200596, -82.58539861319453 35.66933324623134, -82.58536661317265 35.66944024624983, -82.58525961310876 35.6697382462995, -82.58511261301975 35.67015624636947, -82.58505061298597 35.67030824639408, -82.5850216129716 35.67037024640376, -82.58479361282743 35.67105824652041, -82.5845576126795 35.671761246639335, -82.5842706124902 35.672677246796326, -82.58418961243616 35.67294024684161, -82.5841136123734 35.67326424689975, -82.5840836123563 35.67334324691276, -82.58408261235549 35.67334724691353, -82.58400261230524 35.673586246953924, -82.5839766122884 35.67366724696781, -82.58392361228793 35.673613246951284, -82.58385161228696 35.673542246929415, -82.58360861228344 35.67330324685579, -82.58347561228139 35.67317324681556, -82.58335061227963 35.67305024677766, -82.58321261227772 35.67291424673576, -82.5829606122741 35.67266624665932, -82.58280061227191 35.67250824661066, -82.58273361227103 35.672442246590336, -82.58266461227018 35.67237324656917, -82.58260061226937 35.67230924654964, -82.58259761226941 35.67230624654867, -82.5824086122648 35.67213224649375, -82.58238861226415 35.6721152464883, -82.5823166122613 35.67205624646882, -82.5822456122362 35.67214224647909, -82.58217761221175 35.672227246489356, -82.58206761217136 35.67237024650716, -82.58204761216416 35.67239524651025, -82.58204161216162 35.67240524651163, -82.58197561213689 35.672494246522945, -82.58186061209524 35.67264024654087, -82.58178161206617 35.67274324655377, -82.58150961196993 35.67307324659296, -82.58139261192828 35.673217246610285, -82.58120061186463 35.67342224663226, -82.58106561182399 35.673540246642375, -82.58096161179232 35.67363324665066, -82.58070961172146 35.673820246662814, -82.58063861170231 35.673868246665286, -82.58018261157699 35.67418824668352, -82.57995061151328 35.67435124669291, -82.57957461140975 35.67461624670818, -82.57935561134975 35.67476924671681, -82.57869761116919 35.675229246742745, -82.57847961110922 35.67538324675161, -82.57832161106586 35.67549324675781, -82.5780306109858 35.675698246769656, -82.57785061093664 35.6758232467766, -82.57769461089354 35.67593424678316, -82.5773726108055 35.67615724679538, -82.5766226106001 35.67667924682455, -82.57640761054151 35.67682724683256, -82.57608561045352 35.67705024684488, -82.57582561042258 35.676970246801844, -82.57559861039556 35.67690124676439, -82.57537861035912 35.67690024674154, -82.57529161034542 35.67689524673156, -82.57506561030984 35.67688224670571, -82.57502261030352 35.67687724670027, -82.57475361026296 35.67685024666707, -82.57454161023026 35.67683324664176, -82.57427361018895 35.676812246609906, -82.57390661013149 35.67678924656749, -82.57389361012935 35.67678924656615, -82.57369461009705 35.67678424654462, -82.57363561008736 35.6767832465384, -82.5734146100428 35.676834246526, -82.57305260996432 35.67695224651278, -82.57297360994828 35.67697124650847, -82.57271860989565 35.67703724649572, -82.57258860987082 35.677058246486666, -82.57250960985567 35.677071246481134, -82.57230560981851 35.67709224646444, -82.57217860979665 35.67709724645242, -82.57195960975642 35.67712224643497, -82.57191660974799 35.67713024643215, -82.57177960972061 35.67715924642393, -82.57147060965303 35.67726524641373, -82.57094760953221 35.67748424640451, -82.57081960950202 35.67754124640296, -82.5707646094891 35.67756624640238, -82.57045960941859 35.677694246397095, -82.56995260930155 35.67790624638802, -82.56970160924571 35.67799724638078, -82.56965760923654 35.678009246378686, -82.56948960920107 35.678058246371386, -82.56926660916015 35.6780832463535, -82.5691166091341 35.67809024633948, -82.56881860908858 35.67806424630351, -82.56866960906925 35.67802924628107, -82.56854860905604 35.67798424625944, -82.56839860904228 35.67791224622931, -82.56826960903336 35.67783124619958, -82.56825560903305 35.67781824619553, -82.56816960903095 35.677739246170525, -82.56808960903126 35.67765124614437, -82.56799560903832 35.67750424610479, -82.56792560905316 35.67733324606276, -82.56777660909283 35.676916245962495, -82.56773660909666 35.67684824594455, -82.56765160910528 35.67670124590591, -82.56750760910899 35.67652224585463, -82.56740960910834 35.67642124582396, -82.56739760910807 35.67641024582046, -82.56728560910562 35.676305245787596, -82.56717960910467 35.67619724575471, -82.56711960910418 35.67613624573609, -82.56681560909747 35.675852245646944, -82.56675260909692 35.675788245627395, -82.5667116090966 35.675746245614654, -82.56661160909371 35.67565724558623, -82.5665266090892 35.67559524556489, -82.56643660908325 35.67553724554378, -82.56635260907551 35.6754962455268, -82.56614660904854 35.675449245496054, -82.56580460899924 35.67540124545105, -82.56557360896541 35.6753712454212, -82.56528560892424 35.675328245382794, -82.56509360889505 35.675310245359334, -82.56450560880555 35.675257245288044, -82.56426560876933 35.675233245258475, -82.5638066086998 35.675189245202255, -82.56368960868113 35.67518424518927, -82.56354660865729 35.6751852451747, -82.56340460863346 35.67518624516031, -82.56330660861622 35.67519224515143, -82.5630756085749 35.67521124513155, -82.56273260851343 35.67524024510221, -82.56238560845064 35.675273245073114, -82.56215660840907 35.67529624505424, -82.562111608401 35.67530024505046, -82.56210860840025 35.67530124505033, -82.56197760837718 35.67531024503875, -82.56193360836916 35.675314245034976, -82.56189060836162 35.675317245031195, -82.56187060835823 35.6753172450291, -82.56174060833655 35.675318245015895, -82.56168160832732 35.675314245009055, -82.56161960831751 35.67531124500209, -82.56134560827454 35.67529424497043, -82.56130560826819 35.67529224496587, -82.56104760822703 35.675281244937096, -82.56061660815708 35.67527024489049, -82.56052460814306 35.67526224487939, -82.56025260810141 35.6752392448467, -82.56015860808705 35.675231244835395, -82.56002860806814 35.6752132448184, -82.55974860802752 35.67517524478182, -82.55953560799851 35.67513424475156, -82.55946060798838 35.67511924474079, -82.55936460797467 35.67510424472793, -82.55914260794292 35.675071244698245, -82.55888060790555 35.67503124466315, -82.5587366078849 35.67501024464411, -82.55854960785665 35.67499124462094, -82.55836860782632 35.67499324460275, -82.55821660779937 35.67500424458935, -82.55809360777552 35.675026244581176, -82.55805560776798 35.67503424457885, -82.55788360773303 35.67507524456949, -82.55783860772297 35.67509224456834, -82.55775760770462 35.675123244566336, -82.55760860766944 35.67519124456482, -82.55743660762711 35.67528024456525, -82.55739060761557 35.675305244565614, -82.55727660758673 35.67536924456688, -82.55709160754316 35.67545224456474, -82.55684260748815 35.67554024455705, -82.55637760739123 35.675667244535035, -82.55616060734512 35.675732244525996, -82.55598760730723 35.67579124452016, -82.55595760730063 35.675802244519275, -82.55578560726072 35.675875244516504, -82.55560960721643 35.67597224451816, -82.5555476071993 35.67601624452065, -82.55549860719847 35.67596924450604, -82.55546460719789 35.67593624449587, -82.55519660718612 35.67572424442509, -82.5551076071822 35.67565424440171, -82.55494260717485 35.67552424435823, -82.55456960715587 35.67524624426324, -82.5544066071452 35.67514024422488, -82.55415160711995 35.67502924417607, -82.5539116070924 35.67494924413507, -82.55369460706513 35.67489224410113, -82.55345660703239 35.674848244067654, -82.55334260701474 35.67484024405428, -82.55323560699829 35.67483124404148, -82.5531016069758 35.67483324402804, -82.55306660696985 35.674834244024645, -82.5528246069275 35.674847244002365, -82.55279460692226 35.67484924399978, -82.55275060691469 35.67485124399559, -82.5524766068665 35.67486824397088, -82.55227160683427 35.67485624394733, -82.55210660681246 35.67482024392297, -82.5519826067983 35.67477824390169, -82.55194160679453 35.674758243893436, -82.5518096067824 35.674695243866964, -82.55161560676623 35.674591243825844, -82.55121060673511 35.67435724373654, -82.55093460671554 35.674187243673536, -82.55056660669439 35.67392824358289, -82.55007360667076 35.673551243455364, -82.54985260666008 35.67338324339846, -82.54969360664941 35.673281243361316, -82.54963460664527 35.673244243347725, -82.5493546066181 35.67311924329341, -82.54904060658009 35.67302724324238, -82.54884960655369 35.67299324321577, -82.54875360654037 35.672976243202484, -82.54851360650314 35.672959243174354, -82.54828760646257 35.67297824315486, -82.5481746064409 35.67299724314715, -82.54807360642135 35.67301524314039, -82.5477586063555 35.67310224312566, -82.54657760610007 35.673485243082105, -82.54623060602418 35.67360324307038, -82.54616360600939 35.673627243068424, -82.54596760596313 35.67371524306617, -82.54583660592849 35.67379924306978, -82.54571260589312 35.67389424307631, -82.54564960587484 35.67394524308026, -82.54558360585565 35.67399824308422, -82.54552660583877 35.67404624308813, -82.54538660579868 35.674155243095896, -82.54532060577965 35.674207243099744, -82.54526660578244 35.674131243078676, -82.54493760578771 35.67374324296582, -82.54472960578534 35.67353524290205, -82.54448060577866 35.67331124283084, -82.54432260577349 35.6731742427867, -82.54425660577127 35.67311824276849, -82.54410760576334 35.67300924273098, -82.54396260575363 35.672916242697106, -82.54382360574331 35.67283324266592, -82.5437056057369 35.67274824263649, -82.54358760573247 35.6726502426044, -82.54342260573051 35.672485242553826, -82.54328160573428 35.67230924250342, -82.54315560574503 35.67210424244875, -82.54313060574866 35.672054242436, -82.54308260575503 35.671961242412124, -82.54302260576891 35.67180724237457, -82.542968605784 35.67165124233732, -82.54292360579235 35.671549242311926, -82.54285060580155 35.671411242276235, -82.54269960581404 35.67116824221129, -82.54259860583157 35.6709462421557, -82.5425386058505 35.67075924211141, -82.54247060588355 35.67047224204601, -82.54238960591387 35.67018924198008, -82.54231660593753 35.66995724192533, -82.54226060594654 35.66983924189559, -82.54213960594959 35.66968924185256, -82.54208060594661 35.66964524183753, -82.54194960594012 35.669546241803864, -82.54151260590012 35.669335241715956, -82.54124560587393 35.66921824166466, -82.54096060584291 35.66911224161375, -82.54077360581977 35.66906124158411, -82.54063160580223 35.669022241561535, -82.54026260575509 35.66893024150487, -82.54014560574014 35.66890124148694, -82.54000560572157 35.668871241466334, -82.53981360569445 35.668840241440286, -82.53963860566783 35.668824241419046, -82.53934560561804 35.66883124139032, -82.53869960550799 35.66884924132751, -82.53869260550695 35.66884824132657, -82.53845060546787 35.668841241300235, -82.53823160543448 35.66882224127388, -82.53816860542618 35.6688082412645, -82.53801960540639 35.66877624124263, -82.5374846053387 35.66863924115972, -82.53718060530052 35.66855924111211, -82.53696860527397 35.66850324107889, -82.53639260520521 35.66832924098417, -82.5358626051349 35.66821424090616, -82.53556360509295 35.6681642408652, -82.53520260504415 35.668092240813515, -82.53488960500334 35.66802024076654, -82.53448760494923 35.66793824070851, -82.53420560491216 35.6678752406667, -82.53418760490979 35.66787124066403, -82.5335246048276 35.66769024055892, -82.53322160478854 35.66761724051283, -82.53299560475747 35.667575240481035, -82.53299360475734 35.66757424048063, -82.53280160472885 35.66755224045638, -82.532303604651 35.66752024039862, -82.5322476046423 35.6675172403922, -82.53215760463088 35.66749424037826, -82.53211460462714 35.667472240369335, -82.5320886046261 35.66745124036244, -82.53208560462599 35.6674482403615, -82.5320736046273 35.66742724035598, -82.53207160462742 35.667424240355196, -82.53206660462799 35.66741524035284, -82.53205460463074 35.66738424034534, -82.53205560463421 35.66736324034117, -82.53205560463662 35.66734724033789, -82.53205560463694 35.667345240337504, -82.5320576046412 35.66732024033254, -82.53205860464256 35.667312240331086, -82.53207760465101 35.6672782403261, -82.53211360466409 35.66723224032044, -82.53222460469307 35.66716324031781, -82.53224960469886 35.6671532403184, -82.53230660471131 35.667134240320344, -82.53239760472906 35.66711724032622, -82.53263060477067 35.667098240346384, -82.53282660480862 35.66706324035946, -82.53292360483123 35.66702124036084, -82.53300460485254 35.66697024035879, -82.53300760485354 35.6669672403585, -82.53310460488007 35.6668992403547, -82.53321060491197 35.66680724034688, -82.53321460491308 35.66680424034667, -82.53327460492928 35.666764240344676, -82.53335860494782 35.66673424034721, -82.53338860495343 35.66673024034955, -82.53342760496115 35.66672224035193, -82.53348060496992 35.66672224035738, -82.53357960498408 35.6667372403706, -82.53382360501813 35.66677924040422, -82.53392360503469 35.6667792404145, -82.5340066050502 35.66676824042081, -82.53407560506352 35.666756240425464, -82.534167605084 35.666722240428015, -82.53428960511374 35.66666124042816, -82.53443460515378 35.66655824042218, -82.53450260517441 35.66649724041672, -82.53455660519343 35.666432240409115, -82.53459460520791 35.666379240402165, -82.5346176052212 35.66631824039217, -82.53463260524384 35.66618824036723, -82.53460260527487 35.66595524031672, -82.53457960528922 35.665837240290315, -82.53458660531095 35.66570424026396, -82.53460260532307 35.66564324025324, -82.53464760534061 35.66557824024458, -82.53470860535906 35.66552424023988, -82.5347856053771 35.66549024024093, -82.53486160539327 35.66546724024403, -82.5349606054127 35.66544824025045, -82.53511360543743 35.66545224026692, -82.53522760545533 35.66545924028002, -82.53533660547298 35.6654622402919, -82.53542660548881 35.66545624029994, -82.53549460550305 35.665437240303085, -82.53556360551927 35.66540624030387, -82.53562460553526 35.665368240302364, -82.53568560555313 35.66531824029857, -82.53573860557013 35.66526524029316, -82.53579260559142 35.66518524028247, -82.53585360562698 35.66502124025536, -82.53591460565949 35.66487624023209, -82.53600560569932 35.66471624020888, -82.53605960571774 35.66465524020204, -82.53610560573377 35.66460124019583, -82.53621960576565 35.66451724019044, -82.53631160578678 35.66447924019215, -82.53641060580381 35.66447524020151, -82.53656260582848 35.664479240218014, -82.5367616058645 35.66446024023464, -82.5368906058901 35.66443324024241, -82.53708160593001 35.66438024025131, -82.53724960597151 35.66429224025061, -82.53764660608226 35.66400224023248, -82.53770360609927 35.66395324022833, -82.53780660612996 35.663865240221014, -82.53789760616394 35.66374324020562, -82.53797460620211 35.66357924018013, -82.53798160623568 35.663369240138074, -82.53792860626821 35.663102240078295, -82.53787560629242 35.66288824002929, -82.53782960630478 35.66275923999831, -82.53782960633846 35.6625412399539, -82.53787560636913 35.66239223992832, -82.5379896064056 35.66227823991682, -82.53812660644662 35.6621602399069, -82.53824160647162 35.66212223991101, -82.53837060649546 35.66210623992106, -82.53848560652514 35.662038239919035, -82.5385386065458 35.6619612399088, -82.53870660661899 35.66166823986646, -82.53883660666237 35.66152723985111, -82.53896660669109 35.66148123985516, -82.53914960672442 35.66146223987016, -82.53933260676018 35.661427239881846, -82.53946960679112 35.66137423988511, -82.5396376068321 35.66129023988535, -82.53973660686029 35.661214239880096, -82.53981260688295 35.661149239874696, -82.53986660691427 35.66100423985071, -82.53986660693246 35.660886239826674, -82.53990460696018 35.6607482398025, -82.53995060698074 35.660664239790094, -82.5400796070215 35.66053923977795, -82.54022460706045 35.66044323977336, -82.54042360710157 35.66039023978304, -82.54069760714366 35.66041323981592, -82.54085060717196 35.660394239827774, -82.54107160722232 35.6603062398326, -82.54123260726075 35.660230239833716, -82.54133860728905 35.66016123983066, -82.54142260732115 35.6600432398152, -82.54143860736346 35.65978723976477, -82.54152160740604 35.65960023973522, -82.54156760743376 35.65947023971348, -82.54159060745461 35.659360239693456, -82.54162160747275 35.65927623967955, -82.54166660748906 35.65921923967253, -82.54181160753484 35.659078239658804, -82.54224660765085 35.65879523964597, -82.54246060770045 35.6587042396495, -82.54264360774025 35.65864323965583, -82.54284160778262 35.658582239663836, -82.54294860780229 35.65857023967238, -82.54308560781725 35.65862023969668, -82.5431546078134 35.6587192397239, -82.54317760779485 35.65886423975586, -82.54318560776791 35.65904723979385, -82.54323860774028 35.659283239847404, -82.54326960773294 35.65936423986699, -82.54345960775149 35.65944823990369, -82.5436276077706 35.65950523993264, -82.5437876077931 35.65953123995437, -82.54386460780638 35.65952823996172, -82.54394860781682 35.65955123997496, -82.54402460782896 35.659554239983386, -82.5440776078401 35.65953923998585, -82.54413160785366 35.65950923998522, -82.54416960786713 35.659463239979765, -82.54418460787501 35.65942823997424, -82.544192607881 35.659398239968944, -82.54414660787808 35.65936723995786, -82.5440626078671 35.65934823994544, -82.54390960784109 35.65935223993048, -82.54377260782418 35.65931423990865, -82.5436886078184 35.65926123988914, -82.54362060781659 35.659200239869726, -82.5435816078237 35.6591122398478, -82.54356660784418 35.65896323981595, -82.54365860791602 35.658597239750925, -82.5437036079494 35.65842923972133, -82.54372260797982 35.658253239687475, -82.54373460801342 35.658048239647016, -82.54372660803867 35.65787623961115, -82.54369060806103 35.657693239570186, -82.54366660806902 35.657615239551795, -82.54368660807162 35.65762023955491, -82.54374960807971 35.6576352395645, -82.54377060808245 35.65764023956764)))",6467,37,021,001600,370210016004,1407,1407,83,1385,1280,39,4,33,1,28,22,1186,56,1130,1175,1090,28,4,30,1,22,11,795,701,94
census_2010_blockgroups_view.fid--2dc29038_13ec899ba8f_-2616,"MULTIPOLYGON (((-82.659706632632 35.62346624452164, -82.66004063266863 35.623589244581, -82.66062463273258 35.623805244685016, -82.66119663279517 35.62401724478696, -82.66148563282633 35.624127244838995, -82.66205363288887 35.624335244939736, -82.66217663290247 35.62438024496153, -82.66254863294326 35.62451724502764, -82.66267263295684 35.62456324504975, -82.66288063297972 35.624639245086584, -82.66301763299472 35.62469024511104, -82.66364863306309 35.62492824522436, -82.66401563310122 35.62507724529238, -82.66404863310434 35.625093245298984, -82.66433063313035 35.62522924535566, -82.66437963313417 35.62525724536645, -82.66452163314565 35.62533624539711, -82.66468463315863 35.62542824543258, -82.66493963317566 35.62559324549244, -82.66496563317737 35.62561024549854, -82.6650706331824 35.62569124552578, -82.66510863318435 35.625719245535464, -82.6652246331907 35.62580324556448, -82.66526363319277 35.625832245574344, -82.66529363319444 35.625854245581905, -82.66537363319632 35.62592824560522, -82.66566663320307 35.626201245690915, -82.66569063320217 35.62623324569999, -82.66578163319933 35.62634924573289, -82.66580063319877 35.62637424574001, -82.66585963319703 35.626449245761286, -82.66587963319654 35.626474245768485, -82.66596763319393 35.62658624580039, -82.66612563318898 35.62678924585788, -82.6662126331805 35.62693824589721, -82.66628563317354 35.627062245930006, -82.66635763316013 35.627227245971035, -82.66646163314111 35.62746324602986, -82.66653563311134 35.62773624609312, -82.66658363309263 35.62791024613343, -82.66664363306911 35.62812724618385, -82.66664663306517 35.62815624619003, -82.66669763299639 35.628658246297626, -82.66670863295818 35.62891824635178, -82.66672063292084 35.62917324640495, -82.66672463290934 35.62925224642149, -82.66675263287523 35.629504246475754, -82.66681363280338 35.630036246590414, -82.66686963274147 35.630499246690555, -82.6668846327258 35.63061724671619, -82.66694963270508 35.63082224676465, -82.66694463270412 35.63082324676438, -82.6668316326896 35.630795246747006, -82.66666363266802 35.63075324672125, -82.66601163259291 35.63053624661005, -82.66581863257016 35.63047524657782, -82.66566763255028 35.63044124655538, -82.66554563253145 35.63043124654081, -82.66543663251176 35.63044124653168, -82.66532563248849 35.63047224652661, -82.665170632452 35.63054224652496, -82.66516563245067 35.630545246524974, -82.66489863237784 35.630729246535104, -82.6645176322682 35.63102924655716, -82.66338363193691 35.631954246629284, -82.6630056318277 35.63225424665164, -82.66283263178 35.632377246659, -82.66269663174471 35.63245924666166, -82.66255963171328 35.63251524665909, -82.66243163168708 35.632547246652415, -82.6622866316612 35.63255824663979, -82.66214863163917 35.63255224662439, -82.66195063161253 35.63251124659569, -82.6617236315866 35.63243424655674, -82.66145563155955 35.632320246505955, -82.66124263154025 35.63221524646267, -82.66102663152243 35.63209724641646, -82.6608256315107 35.631956246367096, -82.66065163150697 35.63179224631577, -82.66054263150887 35.63166224627809, -82.6604916315098 35.631601246260416, -82.66010663152858 35.63106324611121, -82.65989763153122 35.630820246040265, -82.6597026315221 35.63066824598921, -82.65945163149851 35.63055024593946, -82.65920563147401 35.63044324589235, -82.65900663145433 35.63035624585422, -82.65878863143064 35.63027424581508, -82.65875163142663 35.630260245808465, -82.65857763140257 35.630228245784075, -82.65842063137322 35.63024924577223, -82.65819863132569 35.63031824576352, -82.65798763127685 35.630407245759905, -82.65782163123515 35.630498245761494, -82.6577116312053 35.63057324576541, -82.65760763117132 35.630681245776856, -82.65758663116263 35.630715245781616, -82.65750763112831 35.63085224580139, -82.65737663106644 35.63111224584092, -82.65720963099291 35.63140924588428, -82.65706863093558 35.631629245914745, -82.65677263081517 35.63209124597848, -82.65666763077206 35.632257246001515, -82.65647563068245 35.632631246058054, -82.65625363056407 35.63316024614305, -82.65610763049278 35.63346524619027, -82.65592863041023 35.633807246241574, -82.65559263026174 35.63440824632959, -82.65545163020222 35.63464224636277, -82.65527063012367 35.634956246408194, -82.65516863007788 35.63514324643582, -82.655035630018 35.63538824647209, -82.6547596298888 35.63592824655387, -82.65465462984132 35.63612324658277, -82.65463662983215 35.636163246589085, -82.65461262982157 35.63620624659541, -82.65455362979242 35.636331246614844, -82.65446462975552 35.636474246634826, -82.65440262973402 35.63654724664342, -82.65434862971955 35.63658324664512, -82.65427562970285 35.6366122466436, -82.65426262970028 35.63661524664284, -82.65420262968776 35.63663124663991, -82.65410862967124 35.63663724663153, -82.65395162964722 35.63662324661252, -82.65385062963392 35.63660024659745, -82.65373362961991 35.63656524657829, -82.65348962959622 35.63645524653086, -82.65313562956565 35.63627124645697, -82.65298562955128 35.63620224642761, -82.65278662952824 35.63613724639382, -82.65254562949136 35.63611624636482, -82.65250462948495 35.63611324636003, -82.65234962945848 35.63611724634492, -82.65216762942116 35.63616324633556, -82.65201362938765 35.636214246330105, -82.6519636293739 35.6362492463322, -82.65190062935669 35.63629324633465, -82.6518266293328 35.63636824634231, -82.65175362930293 35.636483246358296, -82.65169062927282 35.63661024637775, -82.65168162926824 35.63663024638083, -82.65164162924015 35.63676924640503, -82.65163262921139 35.636946246440225, -82.65165762919524 35.63707824646967, -82.6516686291744 35.63722524650074, -82.65165962915087 35.63736824652897, -82.65162562911961 35.637534246559376, -82.65158362908981 35.637682246585165, -82.65148862903196 35.63795524663115, -82.65135862895173 35.63833524669518, -82.65134562894063 35.6383932467057, -82.65131862893621 35.63839324670295, -82.65123762892266 35.6383932466946, -82.6512106289182 35.63839324669179, -82.65118362891364 35.63839324668902, -82.6509566288791 35.63837224666144, -82.65059662882595 35.63832824661548, -82.65031262877996 35.6383202465847, -82.65010562874379 35.63833124656567, -82.65009462874183 35.63833224656475, -82.64986562869734 35.63837324654957, -82.64962162864624 35.638441246538406, -82.64941862859706 35.6385412465379, -82.64936462858128 35.63858524654135, -82.64930162856255 35.63863824654568, -82.64923862853438 35.6387532465627, -82.64921862851494 35.638858246581975, -82.64922162849864 35.638967246604494, -82.64929462846725 35.63924924666953, -82.64929062845106 35.63935024668967, -82.64922762841755 35.63949924671357, -82.64904462834427 35.63977724675141, -82.64894162831145 35.639879246761616, -82.64884862828832 35.639928246762004, -82.64872262826252 35.63996024675567, -82.64845962821421 35.63998924673456, -82.64802462813941 35.64000524669318, -82.6478896281166 35.64000724667962, -82.64748162804742 35.640015246639365, -82.6467816279331 35.64000124656467, -82.64669162791917 35.63999424655399, -82.64657262790077 35.639985246539915, -82.64642662788103 35.6399552465188, -82.64641362787921 35.639953246517024, -82.64633962786962 35.63993524650584, -82.64614762784493 35.63988824647648, -82.64591462781786 35.639812246437096, -82.64567262779555 35.639696246388624, -82.64544562777985 35.63955224633592, -82.64543962777954 35.63954824633452, -82.64528362776697 35.6394612463007, -82.64492162772991 35.63931024623277, -82.64477262771969 35.639216246198266, -82.64463562771569 35.639094246159395, -82.64445862771703 35.63889424610044, -82.64423262771675 35.63865224602791, -82.64398462770887 35.63843524595823, -82.64348062768049 35.63807524583307, -82.64312162765722 35.637838245747886, -82.6430746276533 35.63781324573801, -82.64287662763626 35.63771024569665, -82.64265262760782 35.6376522456618, -82.64241462756979 35.63764224563532, -82.64212162752042 35.63764624560612, -82.64206962751165 35.637647245600924, -82.64169162744787 35.637652245563096, -82.641562627426 35.63765524555053, -82.64140262740084 35.63764524553207, -82.64125562738289 35.63760324550837, -82.64112662737281 35.637529245480096, -82.6410066273705 35.637415245444515, -82.64067362736729 35.63707624534116, -82.64062862736488 35.63704324532988, -82.64049262735716 35.63694624529612, -82.64040562734915 35.636904245278664, -82.64034262734333 35.636874245266064, -82.64025162733247 35.63684624525095, -82.64024162733129 35.63684324524937, -82.64021162732762 35.636834245244394, -82.64020162732649 35.6368312452428, -82.6400506273046 35.63681024522299, -82.63989262728029 35.63679724520411, -82.63977262726308 35.63677924518811, -82.63975862726139 35.63677524518585, -82.6396566272489 35.6367462451695, -82.6395296272393 35.63667124514112, -82.63940162723223 35.63657924510927, -82.63924362722598 35.63644924506651, -82.63895862722168 35.63616924498022, -82.6388126272112 35.63607924494686, -82.63866662719361 35.6360362449231, -82.63848362717137 35.63598224489333, -82.63823462713873 35.635925244856146, -82.63804162711422 35.63587624482633, -82.63775262707414 35.635824244785994, -82.63763662705918 35.63579624476842, -82.63756862705017 35.63578124475837, -82.6373076270197 35.635697244714414, -82.63714862700428 35.6356252446834, -82.63696162698842 35.635526244644005, -82.63673362697193 35.635387244592366, -82.63642462695198 35.635183244519034, -82.63612362693345 35.63497824444631, -82.63603862692818 35.63492024442579, -82.63595862692316 35.63486624440652, -82.63560962689893 35.634647244326075, -82.63551462688892 35.63460924430854, -82.63547162688442 35.634592244300684, -82.63536462687141 35.6345612442834, -82.63512962683953 35.6345142442497, -82.63497662681662 35.63449724423049, -82.63484762679496 35.634499244217615, -82.63475562677831 35.63450724420982, -82.63459862674611 35.63454724420182, -82.63450762672389 35.63459324420187, -82.63444162670609 35.63463724420406, -82.63437362668519 35.63469924420972, -82.63426162664771 35.634821244223076, -82.63399862655704 35.6351262442582, -82.63385762650952 35.6352822442755, -82.63376262647537 35.63540124428997, -82.63370862645198 35.63549424430337, -82.63359362639672 35.63572924433945, -82.63354662638083 35.63578124434522, -82.63348462636299 35.635830244348845, -82.63342562634995 35.63585124434708, -82.63340862634601 35.63585824434677, -82.633332626331 35.635873244342015, -82.63325362631747 35.63587624433448, -82.6327556262467 35.63579724426723, -82.63272362625148 35.6357322442507, -82.63271362626627 35.63562524422791, -82.63269362627436 35.635551244210816, -82.632654626283 35.635453244186735, -82.63264962628433 35.63543924418341, -82.6324576263276 35.6349512440643, -82.63240862633882 35.634825244033586, -82.63240362634004 35.63481224403038, -82.6322636263738 35.63444124394043, -82.63223362639096 35.63429824390819, -82.63222562640658 35.63418824388494, -82.63223462643121 35.63403824385531, -82.63248462673944 35.6323082435285, -82.63261362689819 35.631417243360154, -82.63266762697182 35.63099724328018, -82.6327026270099 35.6307882432411, -82.63275662706064 35.63051724319144, -82.63279862708929 35.630376243167056, -82.63282262710547 35.63029724315343, -82.63291162715623 35.63006424311507, -82.63306662724146 35.629678243052346, -82.63316262729785 35.62941624300885, -82.63319962732845 35.6292572429802, -82.63323662740457 35.62880324289154, -82.63326862743948 35.62861124285569, -82.6333096274671 35.628476242832406, -82.63336562749414 35.628361242814734, -82.63347062753324 35.628221242796926, -82.63372662762276 35.62791624276111, -82.63385762767062 35.627747242740064, -82.63395262771182 35.627582242716294, -82.63398762773004 35.62750224270353, -82.63402662774942 35.62741824269045, -82.63408162778016 35.627278242667565, -82.63418162783972 35.62699924262101, -82.63427662790014 35.62671024257184, -82.63435262794361 35.626510242538835, -82.63439362796625 35.6264072425221, -82.63451862803439 35.62610024247242, -82.63456162805718 35.625998242456035, -82.63461062808432 35.625875242435974, -82.63463162809549 35.62582524242796, -82.63468462813069 35.625654242398575, -82.6347046281565 35.62550824237082, -82.63470162815854 35.62549124236712, -82.63469462816731 35.62542724235338, -82.63467362817363 35.62536324233817, -82.63472662819247 35.62529824233036, -82.63480962823128 35.62513624230584, -82.634834628257 35.62499624227989, -82.63489062834842 35.624463242177, -82.63491662837463 35.624321242150764, -82.6349446283861 35.62427724214472, -82.63496162839255 35.62425324214153, -82.63502262840998 35.624206242138165, -82.63507062842254 35.624176242137, -82.6351886284453 35.624156242145034, -82.63549562849914 35.62413824217298, -82.6358586285594 35.62413924221044, -82.63620062860855 35.624189242255724, -82.63642062863289 35.624269242294616, -82.63664362865366 35.62437524233914, -82.63698562867984 35.62457424241475, -82.63729062870073 35.62476824248559, -82.6374356287127 35.624847242516594, -82.63758762872554 35.624928242548705, -82.63787762875602 35.62504324260191, -82.63810162878389 35.62510424263734, -82.6381636287916 35.62512124264717, -82.63851062884429 35.62515424268955, -82.63923862896497 35.62515724276489, -82.6396156290282 35.62515424280306, -82.63983562906664 35.625142242823124, -82.64008662911027 35.625130242846474, -82.64026962914669 35.62509124285731, -82.64047262919144 35.6250202428637, -82.64074162925769 35.62488024286276, -82.64146362944331 35.6244552428503, -82.64156862947019 35.62439424284871, -82.64167562949773 35.624331242846786, -82.64183262954283 35.62420824283788, -82.64191362956994 35.62411924282805, -82.64193162957707 35.62409224282442, -82.64200062960428 35.62399024281072, -82.64203262961891 35.623930242801755, -82.64207062964338 35.62381224278166, -82.64212662969862 35.62351424272666, -82.6421576297404 35.62327624268127, -82.64215962974261 35.62326424267911, -82.64221562978423 35.623054242642006, -82.64229262982528 35.62287124261269, -82.64247362989587 35.62260824257763, -82.64268862997245 35.622343242545746, -82.64294263005509 35.622081242518426, -82.64311663011306 35.62189224249775, -82.64325763016171 35.62172924247904, -82.64336363020568 35.62155824245505, -82.64350763027419 35.621269242410925, -82.6435566302997 35.621156242392914, -82.64362963033682 35.620994242367445, -82.64374963039502 35.620746242329155, -82.64400563048574 35.6204332422917, -82.64405963050208 35.6203852422874, -82.64414563052642 35.62032024228303, -82.64440863059544 35.62015624227658, -82.64458863064188 35.62004924227337, -82.64480363069478 35.61993824227272, -82.64506763075585 35.6198272422772, -82.6451536307752 35.619794242279376, -82.64541663083048 35.61971924229106, -82.64558763086542 35.61967724230004, -82.64561063087 35.61967224230145, -82.64632763101046 35.61953524234704, -82.64672363108475 35.619480242376504, -82.64691263111769 35.619471242394134, -82.6473496311865 35.61949624244404, -82.64764863123146 35.61952724248108, -82.64813363130578 35.619569242539455, -82.64863263138096 35.619620242600995, -82.64908963144549 35.619695242663234, -82.64960963151312 35.61981724274149, -82.64969563152552 35.619830242753, -82.6497536315349 35.61983224275931, -82.64981963154803 35.61981824276323, -82.64988063156201 35.619793242764395, -82.64992363157715 35.61974124275827, -82.64995063159215 35.61967324274712, -82.64995863160419 35.619603242733675, -82.64996163162013 35.61950324271364, -82.64995563165839 35.61924824266106, -82.64995863168804 35.619059242622846, -82.64996563170043 35.61898624260866, -82.65000663173275 35.61882024257899, -82.65002363174459 35.61876224256903, -82.6500316317494 35.61873924256509, -82.65007463177103 35.61864524255036, -82.6501326317963 35.6185442425357, -82.65033763187859 35.61823124249293, -82.65050463194257 35.61799624246225, -82.6506596320028 35.61777224243245, -82.65087163208779 35.617449242388396, -82.65092863210775 35.61738124238045, -82.65102963213941 35.6172852423712, -82.65109663214176 35.61734224238975, -82.65117663214355 35.61741724241317, -82.65117863214375 35.61741824241359, -82.65126963214588 35.6175022424401, -82.65143363214683 35.617673242491755, -82.65144863214677 35.61769024249674, -82.65158863214637 35.6178442425425, -82.65158963214634 35.617845242542785, -82.65171663214394 35.61799824258702, -82.65174163214334 35.61802924259595, -82.65190263214444 35.61819624264648, -82.65214163214353 35.61846024272487, -82.6521966321421 35.61852924274455, -82.65221363214164 35.61855024275054, -82.65255763213214 35.61898424287436, -82.6526586321292 35.619112242910774, -82.65286163212083 35.6193862429875, -82.6529186321175 35.619469243010236, -82.65299763211296 35.61958424304177, -82.65315263211028 35.61976924309541, -82.6533406321108 35.619969243155474, -82.65350363211341 35.62012824320456, -82.6535656321154 35.62018224322192, -82.65380963212367 35.62039224328977, -82.65391263212302 35.62050824332402, -82.65409363212856 35.62066724337503, -82.65419263213415 35.62073824339962, -82.6542606321369 35.62079424341798, -82.6545696321558 35.62100524349274, -82.65491163216993 35.62128324358455, -82.6549386321715 35.62130224359115, -82.6552576321903 35.62152524366935, -82.65548863220288 35.62169324372733, -82.65588163222972 35.621943243818606, -82.65651263228541 35.62226424394879, -82.65675063230947 35.62236524399379, -82.65700963233665 35.62246824404144, -82.6575206323922 35.62266024413298, -82.65774963241746 35.62274324417347, -82.65847463249739 35.623008244301886, -82.65874363252668 35.62310824434983, -82.65893563254784 35.62317924438403, -82.65951363261091 35.623394244487145, -82.659706632632 35.62346624452164)))",6357,37,021,002606,370210026063,889,889,50,881,827,7,14,12,0,21,8,680,26,654,676,642,3,9,9,0,13,4,386,356,30
census_2010_blockgroups_view.fid--2dc29038_13ec899ba8f_-2615,"MULTIPOLYGON (((-82.3442376010386 35.48892518475878, -82.34448060113658 35.488548184707284, -82.34466360119337 35.48837518469093, -82.3448746012589 35.48817518467199, -82.34527860133045 35.48814318470709, -82.34832060168051 35.48913218522029, -82.35029260188658 35.489909185580636, -82.35038260189607 35.48994418559697, -82.35166760206175 35.4902461857903, -82.35437760241116 35.49088318619802, -82.3563616026224 35.49164018655555, -82.35836860307099 35.490876186606684, -82.35885260333559 35.48967318641213, -82.3590386034388 35.48920118633551, -82.35916260345621 35.48922118635223, -82.3593946034911 35.489243186380605, -82.35950460350743 35.48925518639428, -82.35976460354593 35.489284186426936, -82.35989160356564 35.489292186441574, -82.36004360358803 35.489310186460855, -82.36032160362916 35.48934018649551, -82.36058060366638 35.489377186529545, -82.36086860370207 35.48945418657486, -82.360896603704 35.48947118658112, -82.36108760372285 35.489554186617575, -82.36130560374284 35.48965818666109, -82.3614146037518 35.4897171866843, -82.36158560376722 35.48980018671873, -82.36179260378958 35.48987718675559, -82.36191160380493 35.48990518677351, -82.36204760382648 35.48991118678865, -82.36221460385445 35.48990818680525, -82.36236360387942 35.489906186820185, -82.36250660390205 35.4899121868361, -82.36259960391249 35.48994418685207, -82.36267260391843 35.48998418686771, -82.36279960392228 35.49009518690326, -82.36285560392297 35.49015118692043, -82.3629336039268 35.49021018694037, -82.36301260393289 35.49025518695769, -82.36307860394 35.490280186969535, -82.36315860394964 35.49030318698242, -82.36325160396196 35.490323186995965, -82.36334460397515 35.49033718700842, -82.36343860398756 35.49035718702213, -82.36352760399797 35.490385187036956, -82.36360960400606 35.49042118705269, -82.3636586040081 35.49046018706568, -82.36371860400722 35.490530187085994, -82.36372960400112 35.49058218709762, -82.36373360399371 35.49063418710864, -82.36371460398138 35.49069418711885, -82.36368560396988 35.490738187124805, -82.36365060395896 35.490771187127976, -82.36360660394683 35.49080318712995, -82.36354960393348 35.4908291871293, -82.36346960391842 35.49084118712354, -82.36337760390478 35.49083118711205, -82.3633046038954 35.49081318710091, -82.36307760387291 35.49071618705796, -82.36284460385303 35.49059518700938, -82.36265260383414 35.49051118697266, -82.36245660381078 35.49045318694072, -82.36228560378574 35.49043218691888, -82.36219360377079 35.49043118690928, -82.36199760373604 35.49044618689214, -82.36189060371603 35.490461186884204, -82.3615336036467 35.49052918686134, -82.36138760361898 35.49055318685119, -82.36120460358055 35.49060618684316, -82.36114060356424 35.49064418684431, -82.36108660354577 35.49070618685135, -82.36104960352974 35.490770186860544, -82.36104660352012 35.490830186872415, -82.36105060351267 35.49088318688354, -82.3610616035063 35.49093618689552, -82.36110460350466 35.49099318691142, -82.36116160350774 35.49103418692558, -82.36122560351428 35.49106018693748, -82.3613356035289 35.491083186953475, -82.3614536035483 35.49108418696578, -82.36169860359686 35.491031186980145, -82.36187960363534 35.4909751869874, -82.36218160369805 35.49089118700141, -82.36230660372165 35.49087218701041, -82.36243660374292 35.490873187023965, -82.36253660375836 35.4908801870356, -82.36263460377069 35.49090518705077, -82.36272960378116 35.49093918706748, -82.36294160380281 35.491026187106804, -82.36304360381412 35.491062187124626, -82.36329460384032 35.4911611871705, -82.36358760386659 35.49130518722985, -82.36368860387759 35.49134218724773, -82.36378660388624 35.49139118726778, -82.36388860389296 35.491457187291644, -82.36395360389461 35.49151618731031, -82.36399060389024 35.49158418732789, -82.36399660388096 35.491651187342086, -82.36397460386769 35.49171418735266, -82.36391560384733 35.49178318736058, -82.3638166038206 35.49185018736408, -82.36371060380094 35.491865187356225, -82.36361960378757 35.4918541873446, -82.36354760378092 35.49182018733027, -82.36348260377632 35.491780187315484, -82.36342560377398 35.49173418730037, -82.36338060377456 35.491682187285136, -82.36325960377376 35.49155718724729, -82.36318860377112 35.4914971872278, -82.36312960376812 35.49145418721302, -82.36306260376352 35.491412187197646, -82.3629986037568 35.49138718718597, -82.36293460374807 35.49137518717699, -82.36286360373622 35.49137618716993, -82.36276560371743 35.49139318716329, -82.36268060370024 35.49141318715866, -82.36242460364502 35.49149818714959, -82.36233860362483 35.491536187148455, -82.36227260361035 35.49156018714656, -82.36220860359484 35.49159218714647, -82.3621516035792 35.49163318714896, -82.36208960355941 35.49169518715512, -82.36205660354672 35.491742187161314, -82.36204760353552 35.49180518717317, -82.3620626035291 35.49186318718654, -82.36210260352627 35.4919251872032, -82.36214760352814 35.49196118721507, -82.36220760353355 35.49199018722715, -82.36228160354199 35.49201518723979, -82.36237260355728 35.49201318724876, -82.3624766035786 35.49198618725396, -82.36257860360269 35.49193918725495, -82.36271560363281 35.49189018725905, -82.36277060364476 35.49187118726083, -82.36288060366294 35.49187118727213, -82.3629656036742 35.491889187284535, -82.3630356036792 35.491932187300414, -82.3631066036831 35.49198318731811, -82.36338760369087 35.49223418739786, -82.36351360369108 35.49236818743806, -82.3636856036974 35.49251218748496, -82.36380760369987 35.49262718752083, -82.36387560370262 35.49268218753899, -82.36393260370616 35.492720187552514, -82.36400260371427 35.49274318756438, -82.36410060372933 35.49275018757587, -82.36419160374594 35.49274018758323, -82.36426060376084 35.492717187585605, -82.3643236037771 35.49267918758442, -82.3643836037951 35.49262618757984, -82.3644566038218 35.492531187568055, -82.3645676038662 35.49236118754491, -82.36461860388302 35.49230618753897, -82.36467260389948 35.49225718753459, -82.36473960391639 35.49221918753377, -82.3647916039287 35.49219518753425, -82.36496860395954 35.49218418755023, -82.36514060398736 35.49218818756867, -82.36526860400554 35.49220718758568, -82.3653296040108 35.492239187598415, -82.36538060401398 35.49227318761056, -82.3654126040126 35.49231618762256, -82.36543860400936 35.49236518763523, -82.36544660400446 35.492406187644384, -82.36545360399312 35.492487187661524, -82.36542860398127 35.4925371876691, -82.36538660396648 35.492588187675146, -82.36534660395519 35.492619187677334, -82.36529660394321 35.4926431876771, -82.36521860392726 35.49266318767314, -82.36515960391522 35.49267818767011, -82.36497460388114 35.49270118765568, -82.36479660384676 35.49273418764419, -82.36471560382752 35.49277218764355, -82.36463660380683 35.492822187645544, -82.3645776037898 35.49286918764903, -82.36447960375723 35.4929761876607, -82.36447760375661 35.49297818766094, -82.36443560373898 35.49304718767061, -82.36440860372541 35.49310718768, -82.36433160369047 35.49325118770132, -82.36417660362606 35.49350418773678, -82.36413860361338 35.49354618774144, -82.36409460360136 35.49357718774319, -82.3640276035849 35.49361218774339, -82.36394760356956 35.49362618773803, -82.3638626035563 35.49362118772826, -82.36379460354674 35.493610187719035, -82.36366760353408 35.49355618769503, -82.36354560352264 35.493499187670906, -82.36338360350287 35.49345418764513, -82.36331060349033 35.49345718763826, -82.36324660347735 35.49347318763499, -82.36319960346708 35.493489187633394, -82.36315860345545 35.4935211876357, -82.36311660344178 35.49356518764025, -82.36308860342992 35.49361218764695, -82.3630726034202 35.493658187654596, -82.36306860341348 35.493697187662114, -82.36308260340888 35.493742187672716, -82.36314960340191 35.49386018770356, -82.36319660339959 35.49392518772155, -82.36327060339892 35.49400918774617, -82.36342060340023 35.494162187792696, -82.36347960340076 35.49422218781095, -82.36358060340449 35.49430618783833, -82.36366860341032 35.494363187858994, -82.36375360341827 35.4944021878756, -82.36382160342664 35.49442118788645, -82.3638416034286 35.494430187890295, -82.36392160343853 35.494451187902776, -82.36400160345156 35.494452187911264, -82.36408960346837 35.49443718791727, -82.36416060348456 35.49440818791859, -82.36427560351314 35.49434618791787, -82.36441660355202 35.49424418791166, -82.3645026035728 35.49420118791171, -82.36458360359116 35.49416918791363, -82.36463360360095 35.49415918791665, -82.36465860360563 35.49415518791844, -82.36472160361545 35.494159187925725, -82.36482660362921 35.494182187941206, -82.36484960363224 35.49418718794453, -82.36490860363743 35.49421718795671, -82.36496160363922 35.49426218797129, -82.36500360363779 35.49431718798679, -82.36509860362683 35.494490188031634, -82.36550560355585 35.49539018825624, -82.3655076035552 35.49539618825757, -82.36563060353005 35.495692188330324, -82.36565760351928 35.4957911883532, -82.36566560351305 35.495840188363964, -82.36565860350159 35.49590718837682, -82.36565260349126 35.495968188388645, -82.36563760347968 35.496027188399076, -82.36561360346542 35.496094188410204, -82.36554160342968 35.496250188434445, -82.36547160339144 35.49642318846236, -82.36543160337278 35.49650218847428, -82.36528260329467 35.496850188529606, -82.36523660326249 35.49701018855739, -82.36523160325352 35.49706318856766, -82.36523260324677 35.49710818857697, -82.36524060323961 35.497163188588836, -82.36530960321507 35.49739718864349, -82.36542760318348 35.497730188723224, -82.36551160316763 35.49792318877101, -82.36551260316747 35.49792518877149, -82.36553760316454 35.49797118878341, -82.3655776031634 35.49802218879788, -82.3656366031666 35.498064188812485, -82.36569360317131 35.49809518882463, -82.36574660317712 35.498114188833945, -82.36580560318471 35.4981281888428, -82.36597060320977 35.49814218886264, -82.36604460322198 35.49814218887023, -82.36614860323813 35.49814918888237, -82.36624960325253 35.498164188895764, -82.36629660325913 35.498171188902, -82.36636460326696 35.49819318891347, -82.3664876032776 35.498256188938846, -82.36653460328014 35.498290188950605, -82.36657960328054 35.49833618896463, -82.3666276032822 35.49837718897783, -82.36671660328328 35.498465189004826, -82.36688160328389 35.49863918905711, -82.36706060328807 35.49880418910901, -82.36707060328727 35.49882018911325, -82.36713160329144 35.49885818912723, -82.36719860329715 35.49889318914126, -82.3673046033082 35.498935189160655, -82.3673896033196 35.49895218917282, -82.36745760333002 35.498957189180835, -82.36752460334112 35.498957189187706, -82.36759760335417 35.498951189194, -82.36779160339353 35.49890318920424, -82.36789060341269 35.498885189210704, -82.36805160343984 35.49888118922644, -82.36815960345265 35.498914189244275, -82.36819560345444 35.498941189253436, -82.36824860345335 35.499005189271855, -82.36827460345089 35.499049189283504, -82.36828360343848 35.49913918930265, -82.36826360342765 35.49918818931052, -82.3682056034055 35.49927018932125, -82.36816060339272 35.49930518932377, -82.36808760337559 35.49933818932296, -82.36801260336091 35.49935318931831, -82.36791760334462 35.499357189309336, -82.36774960331715 35.49935518929164, -82.36757560329124 35.49933718927011, -82.36742360327023 35.499310189248995, -82.36734760326144 35.49928618923642, -82.36715360323981 35.49921818920258, -82.36705760323053 35.49917518918402, -82.36677460320057 35.49906618913278, -82.36669060319042 35.49904218911931, -82.36663760318332 35.499031189111626, -82.366583603175 35.49902718910533, -82.36653560316618 35.49903318910157, -82.36644460314803 35.499053189096294, -82.36640960313933 35.49907218909656, -82.36635060312268 35.49911718909959, -82.3663236031127 35.49915318910415, -82.36630460310279 35.49919718911115, -82.36630060309464 35.49924618912068, -82.36631760308424 35.49933218913985, -82.36634560308148 35.49938018915245, -82.36637960308141 35.49941718916355, -82.36642760308457 35.499448189174736, -82.3665246030939 35.49949218919359, -82.36658560310097 35.49951118920372, -82.3668126031311 35.49955918923679, -82.36696760315014 35.49960218926145, -82.36703560315593 35.49963718927553, -82.36705560315744 35.49964918928006, -82.36710060316071 35.49967618929019, -82.36715560316067 35.49973518930783, -82.36719260315837 35.49979018932279, -82.36722360315176 35.499866189341354, -82.36724360314444 35.49993518935739, -82.36729860312637 35.500112189399, -82.36732860312331 35.50016418941258, -82.3673746031223 35.500220189428724, -82.3674676031257 35.500298189454156, -82.36775160314801 35.50045818951581, -82.36808160317617 35.50062918958445, -82.3686586032223 35.50094918970868, -82.36881860323491 35.50103918974341, -82.36923160326442 35.50129118983701, -82.37010660332663 35.501826190035494, -82.37073660336941 35.502225190181214, -82.37093460338356 35.502346190226135, -82.37150460342387 35.50269619035573, -82.37157860342916 35.50274119037255, -82.37180060344475 35.50287819042314, -82.37187560345014 35.50292419044019, -82.37197260345705 35.502983190462096, -82.37226460347756 35.50316319052869, -82.37236260348456 35.503223190550884, -82.3726616035058 35.503406190618804, -82.37355860356934 35.50395719082287, -82.37385860359062 35.50414119089103, -82.37412660360947 35.504306190952015, -82.37493260366622 35.504803191135714, -82.37520160368514 35.50496919119714, -82.37537460369735 35.50507519123642, -82.37589360373414 35.50539419135447, -82.37606660374622 35.50550119139398, -82.37646160377471 35.50574019148309, -82.37699360381309 35.5060621916032, -82.37764460385893 35.50646419175161, -82.37803860388644 35.50670819184169, -82.37852460392088 35.50700619195209, -82.37924560397214 35.50744819211599, -82.37998560402454 35.50790219228419, -82.38047260405894 35.508202192395174, -82.38054860406429 35.50824919241248, -82.38077760408035 35.50839019246466, -82.38085460408585 35.50843719248213, -82.38135560412177 35.50874219259547, -82.38195060416426 35.509105192730345, -82.38217760418505 35.50921419277574, -82.38236860420822 35.50926819280635, -82.38245960421932 35.509294192820974, -82.38268560425095 35.50933119285169, -82.38291560428787 35.50933819287681, -82.38297860429891 35.509334192882484, -82.38307660431587 35.50932919289159, -82.38331160435901 35.509301192909966, -82.38356260440605 35.509264192928235, -82.383672604427 35.509246192935926, -82.38400460448996 35.50919319295925, -82.384115604511 35.50917619296718, -82.38513960470425 35.50901919304056, -82.38522160471973 35.50900719304653, -82.38678660501408 35.50877419315995, -82.38799860524345 35.50858419324594, -82.38821460528376 35.50855419326205, -82.38838460531541 35.508531193274784, -82.38872260537661 35.508496193302456, -82.38900660542454 35.50848919333015, -82.38924760546301 35.50849819335682, -82.38939360548514 35.50851119337446, -82.38945860549482 35.508518193382514, -82.38972760553278 35.5085601934187, -82.38982960554645 35.50858119343344, -82.3899736055655 35.50861219345456, -82.39015260558692 35.50866519348371, -82.39031360560254 35.50873619351465, -82.39049760561669 35.508842193555054, -82.39054760562053 35.508871193566094, -82.3907496056259 35.5090531936238, -82.39129260560756 35.50975619382231, -82.39159460559482 35.51016419393621, -82.39187760558286 35.5105461940429, -82.39193760558052 35.51062619406533, -82.39211860557319 35.51086819413306, -82.39225760556754 35.51105419418509, -82.39265560554972 35.51159819433647, -82.39283460554171 35.51184319440465, -82.3929396055369 35.51198719444464, -82.39304060553347 35.51211819448164, -82.39346260552398 35.51263319462957, -82.39383260555104 35.51285519471272, -82.39387860555526 35.512877194721895, -82.39417960558656 35.512997194777114, -82.39427960559709 35.51303619479539, -82.39465260563357 35.51320019486696, -82.39521560567809 35.51351519498876, -82.39589760572875 35.51391919514095, -82.39593060573121 35.513938195148164, -82.3960296057389 35.5139951951699, -82.39606260574145 35.51401419517716, -82.3962566057559 35.5141281952202, -82.39645860577093 35.514248195265345, -82.39683960579927 35.514473195350206, -82.39703460581381 35.51458819539364, -82.39708960581777 35.51462119540593, -82.39725660583025 35.51472019544321, -82.39731260583437 35.51475319545564, -82.39773760586672 35.51500019554955, -82.39816260589915 35.51524619564317, -82.39901160596229 35.51574819583234, -82.39943560599372 35.51599919592686, -82.39972760601576 35.51617019599163, -82.3999126060295 35.51627919603271, -82.40060460608122 35.516687196186744, -82.40089760610306 35.51686019625201, -82.40099460611029 35.516917196273496, -82.40128760613214 35.51709019633877, -82.40138560613941 35.51714819636059, -82.40151360614905 35.517223196389004, -82.40189760617781 35.51744919647434, -82.40202660618745 35.51752519650304, -82.40207260619086 35.51755219651321, -82.40212260619452 35.517582196524515, -82.40241060621534 35.51775619658942, -82.40250760622249 35.51781419661114, -82.40259860622876 35.517871196632086, -82.40272560623637 35.517958196662754, -82.40290760624572 35.51809319670896, -82.40306460625227 35.51821919675065, -82.40307460625272 35.5182271967533, -82.4032386062566 35.518378196800796, -82.40340660625837 35.5185471968524, -82.40356760625677 35.51873119690631, -82.40375060625074 35.51896719697303, -82.40389660624005 35.51919319703391, -82.40403060622474 35.51943719709726, -82.40409960621423 35.51958019713339, -82.40417960619753 35.519774197181015, -82.40422360618486 35.519904197211915, -82.40425560617572 35.519998197234315, -82.40430460615477 35.52018719727774, -82.40435160612857 35.52040819732751, -82.40438060610768 35.52057519736434, -82.404421606078 35.52081219741667, -82.40454460598862 35.52152619757441, -82.40458560595879 35.52176419762698, -82.40463460592433 35.52204119768822, -82.40463660592289 35.52205219769067, -82.40468960590017 35.52225719773773, -82.40476060588391 35.52243919778201, -82.4048616058717 35.522627197830616, -82.40497860586719 35.52278219787407, -82.40502160586715 35.522829197888065, -82.40510060586692 35.52291519791369, -82.40523560587162 35.52303019795089, -82.40543860588404 35.523167197999555, -82.4054626058862 35.523179198004506, -82.4055806058959 35.52324319802956, -82.40575860591349 35.52332019806354, -82.40595260593601 35.52338219809606, -82.40616060596298 35.52343019812718, -82.40623160597323 35.52344019813653, -82.40650160601187 35.523479198172176, -82.40635160598276 35.52350719816241, -82.40629560597321 35.52350919815709, -82.40618260595336 35.52351619814693, -82.40593260591321 35.5235091981198, -82.40579660588877 35.52352119810827, -82.4056756058647 35.52354819810131, -82.40566260586202 35.52355119810063, -82.40559560584309 35.52360219810408, -82.40551560581824 35.52367819811133, -82.40548560580561 35.523728198118384, -82.40538760576858 35.52386319813568, -82.40535460575595 35.523910198141856, -82.40522160570771 35.52408119816293, -82.40506660565428 35.524262198183756, -82.40495060561754 35.52437619819499, -82.40482960558174 35.5244791982035, -82.40477760556695 35.52451919820628, -82.4047266055527 35.524557198208825, -82.40457660551004 35.52467319821689, -82.40452660549566 35.52471319821991, -82.4044286054669 35.52479419822625, -82.40438360545353 35.52483319822961, -82.4042586054132 35.5249611982427, -82.40417460538185 35.525074198257094, -82.4041566053749 35.525100198260525, -82.40411160535456 35.52518419827294, -82.40406960533548 35.525263198284655, -82.40398960529353 35.525450198314445, -82.4039426052613 35.525609198341854, -82.40392060523826 35.52573519836519, -82.4039166052164 35.5258731983928, -82.40392660519345 35.52603319842632, -82.40397660514954 35.52637219850041, -82.40398560514447 35.526415198510016, -82.40401560512753 35.526557198541944, -82.40405160511307 35.52669019857267, -82.40409660510514 35.52679019859756, -82.404154605098 35.52689919862568, -82.40425760509335 35.52704019866492, -82.4044096050925 35.527209198714885, -82.40476660509287 35.52759019882894, -82.40493360509127 35.527780198884685, -82.40540360507629 35.52838319905553, -82.40565560506425 35.52873219915227, -82.405777605055 35.52892319920362, -82.40588160504396 35.52910719925171, -82.4059986050274 35.52934019931102, -82.40607060501766 35.52948119934707, -82.40610460501362 35.52954419936337, -82.40616360500641 35.52965419939175, -82.40645660497904 35.53014719952202, -82.40654560496885 35.53030919956407, -82.40659960495593 35.53045119959843, -82.40663160494215 35.53057519962691, -82.40664960492846 35.53068319965077, -82.40665760490666 35.530834199682204, -82.40665660490616 35.53083619968255, -82.40665460487044 35.53106619972904, -82.40666860483736 35.53129619977723, -82.40667860481533 35.53145019980953, -82.40667960481248 35.53147019981365, -82.4067016047858 35.531667199855946, -82.40672460477218 35.53178019988126, -82.40674160476718 35.531831199893375, -82.40675860476195 35.531883199905714, -82.40680560475566 35.53197519992923, -82.40687060475256 35.53206519995415, -82.40696560475114 35.53217619998646, -82.40714260475426 35.532346200039285, -82.40715560475473 35.53235720004279, -82.40745560476299 35.532626200128256, -82.40758960476434 35.53276120016946, -82.40769660476052 35.53290120020891, -82.40778560475583 35.53302720024359, -82.4078666047475 35.533168200280606, -82.4079946047347 35.53338920033865, -82.40810860472881 35.53355020038304, -82.40823260472884 35.53368320042285, -82.40837160473347 35.53380220046126, -82.40846860473786 35.533878200486676, -82.40867760475074 35.53401920053687, -82.40888360476205 35.534167200588016, -82.40898260476114 35.534279200620965, -82.40908360475669 35.53441720065943, -82.40918760474152 35.53462720071272, -82.4092226047315 35.53473020073727, -82.40931160470589 35.53499220079963, -82.40950060464273 35.53560620094379, -82.40953460462626 35.53574920097634, -82.40956660461266 35.5358722010046, -82.40961460459228 35.53605620104697, -82.40965760458218 35.5361682010741, -82.40969060457752 35.53623420109085, -82.40970460457544 35.53626220109803, -82.40976160457272 35.536341201119974, -82.40980760457239 35.53639320113525, -82.40981960457233 35.53640620113907, -82.40990560457477 35.536483201163556, -82.40996960457875 35.53652620117888, -82.41000760458098 35.536552201188044, -82.41002860458225 35.53656620119305, -82.41035460460418 35.53677420126882, -82.41041560460738 35.5368192012842, -82.41058160461591 35.536942201326276, -82.41078660462317 35.53711520138249, -82.41096460462727 35.53728020143434, -82.41115860462995 35.5374712014931, -82.41141160463013 35.53774220157415, -82.41142960462984 35.5377632015802, -82.41157160462703 35.53793420162961, -82.41164260462322 35.538035201657415, -82.41166860462054 35.53808020166919, -82.41169260461518 35.538141201684105, -82.41165860460849 35.538148201682056, -82.4114906045702 35.538216201678544, -82.41148060456761 35.53822220167876, -82.41134060453051 35.53831320168284, -82.41122360449327 35.53842920169438, -82.41112960445597 35.53857120171359, -82.41105560441909 35.53873120173845, -82.41105360441811 35.53873520173906, -82.41099660438694 35.53887620176186, -82.41096160437093 35.53894320177185, -82.41092660435491 35.53900920178163, -82.41092060435206 35.53902120178347, -82.4108416043212 35.539137201798894, -82.41081860431335 35.53916320180184, -82.41079360430514 35.53919020180473, -82.4107446042883 35.539246201811075, -82.41064760425976 35.53932820181778, -82.4104826042146 35.53944420182436, -82.41020360413813 35.539641201835714, -82.41008060410155 35.539747201844655, -82.40998060406743 35.53986120185748, -82.40989660403453 35.539985201874096, -82.4098066039956 35.54014120189649, -82.40975660397356 35.540230201909445, -82.40963360392789 35.54039520193029, -82.40961760392327 35.540408201931335, -82.40950760389124 35.54049820193829, -82.40941960386539 35.54057120194406, -82.40938960385658 35.54059620194609, -82.40923460381961 35.5406702019452, -82.40913560379958 35.54069420193993, -82.40907260378663 35.54071020193663, -82.40899660377255 35.54072020193083, -82.40891160375669 35.540732201924605, -82.40887060375009 35.540731201920174, -82.4086556037145 35.540731201898105, -82.40849260368825 35.540726201880304, -82.40836660366791 35.540723201866676, -82.4079496035999 35.54071720182262, -82.40775360357074 35.54069620179825, -82.40769760356218 35.54069120179144, -82.40750960353712 35.54065220176422, -82.407310603513 35.5405952017322, -82.40708960348827 35.54051820169385, -82.40685560346472 35.54042020164989, -82.40659160344063 35.54029320159692, -82.40641760342339 35.540218201563775, -82.40626560340733 35.54015920153617, -82.40612560339099 35.540115201512855, -82.40602160337744 35.54009120149731, -82.40594960336783 35.54007620148682, -82.40552260330956 35.53999620142673, -82.40541960329615 35.539972201411224, -82.40529860328067 35.5399432013929, -82.40493660323418 35.539856201338026, -82.40481660321868 35.53982820132, -82.40486060323583 35.53976420131152, -82.40494160325599 35.539720201310935, -82.40512060328643 35.53971420132808, -82.40548660334856 35.53970420136365, -82.40609860345648 35.5396602014177, -82.4061536034717 35.53962020141516, -82.40623960349504 35.53956120141206, -82.40632060354396 35.539330201373495, -82.40564760345792 35.539166201270916, -82.405378603433 35.53903920121749, -82.40519060341886 35.53892920117581, -82.40488860340618 35.53868720109561, -82.40483460341406 35.538577201067774, -82.40436360340475 35.53813220092894, -82.40398060338883 35.537824200826975, -82.40363660335991 35.53764220075467, -82.40360460335705 35.53762620074808, -82.4033216033246 35.53753320070013, -82.40299960327646 35.53750020066037, -82.40282460324583 35.53751120064465, -82.40246160317152 35.53760420062615, -82.40215160311014 35.537670200607735, -82.40200460308576 35.53767020059262, -82.40188360306917 35.53764820057564, -82.40176260306272 35.53756020054537, -82.4016686030624 35.53746120051559, -82.40156060304959 35.53742820049783, -82.401439603033 35.53740620048093, -82.40048460287942 35.53737820037705, -82.40036360285684 35.53739520036807, -82.40021560281045 35.53753720038168, -82.40004060276634 35.537636200383794, -82.39981260272529 35.537658200364824, -82.39944960267712 35.537581200311884, -82.39928760265106 35.537576200294225, -82.39907260260708 35.53763120028333, -82.39872960252345 35.537806200283555, -82.39862260250067 35.53783920027925, -82.39844760246832 35.537861200265745, -82.39827260244193 35.537845200244476, -82.39795660242187 35.537636200169544, -82.39784960240921 35.5376032001519, -82.39748560235417 35.537570200107744, -82.39720360230505 35.53758620008202, -82.39712960228778 35.53761920008117, -82.3968066022022 35.53782820009033, -82.39660560215714 35.53790520008535, -82.39640360212027 35.53792720006903, -82.39629560210759 35.537894200051255, -82.39620160209205 35.53789420004159, -82.39612060207614 35.537910200036485, -82.39597260203651 35.53800920004135, -82.39591960201587 35.53808620005156, -82.39586560197814 35.538273200083964, -82.39578460195126 35.53836120009352, -82.39571760193355 35.538404200095364, -82.39560960191066 35.53843720009096, -82.39542160187611 35.53845920007613, -82.3953136018617 35.53843720006056, -82.39524660185734 35.53839320004473, -82.39513960184476 35.538360200027064, -82.39485660178691 35.538432200012615, -82.39478960177577 35.538432200005666, -82.39465960176925 35.53833519997256, -82.39464160176831 35.538322199968185, -82.39457460177077 35.538234199943346, -82.39448060178913 35.538014199889076, -82.39442660178865 35.53795919987228, -82.39434560179727 35.53781619983491, -82.39377460180008 35.53718419964785, -82.39335160179449 35.53676619951948, -82.39294860180473 35.536266199376506, -82.3927676018409 35.53583719927075, -82.39271360184043 35.53578219925411, -82.39271960184311 35.53577119925242, -82.39267260185234 35.53566119922525, -82.39245760186589 35.53534219913836, -82.39238660186444 35.53527519911749, -82.39217560185985 35.53507819905575, -82.39191360184265 35.53490819899427, -82.39145660180617 35.53465519889592, -82.39118760177178 35.53458919885485, -82.39095960173657 35.53457319882818, -82.39075660171224 35.5345131987951, -82.39073060170901 35.534506198791064, -82.39019660165792 35.53426519868719, -82.38989060162848 35.53412719862767, -82.38954060159611 35.533962198558186, -82.38924560158112 35.533742198483196, -82.38897660155943 35.53359419842555, -82.38864060153783 35.53337419834629, -82.38843860151795 35.53328619830763, -82.3883136015153 35.533169198271, -82.38829760151498 35.533154198266345, -82.38809560152215 35.53289019819196, -82.38805860153025 35.532798198169516, -82.38802860153739 35.53271919815031, -82.38795560159122 35.532291198055894, -82.3879016016077 35.53212619801684, -82.38779360161517 35.53196119797224, -82.3876996016098 35.531895197949204, -82.38743160157736 35.53181819790601, -82.38713560155728 35.53163119783754, -82.38698060157056 35.531378197770294, -82.38694060157825 35.531285197747266, -82.38690060157674 35.5312521977365, -82.38681960158868 35.53108719769461, -82.38672560158842 35.530988197664854, -82.38645660155412 35.53092219762379, -82.38601360149028 35.53086119756584, -82.38586560149463 35.5306741975127, -82.38576460151684 35.530421197450956, -82.38587260154812 35.53033419744441, -82.3859666015687 35.530301197447315, -82.3860876015997 35.53022919744513, -82.38610060161037 35.53017419743533, -82.38588560160603 35.529971197371985, -82.38564360158978 35.52981719731579, -82.38550260158505 35.52969619727678, -82.38539560158932 35.52955319723667, -82.38530160161271 35.52930019717567, -82.38516660162595 35.52906919711488, -82.38495860163304 35.52880019703885, -82.38478760162518 35.52866719699429, -82.38467660162027 35.528580196965216, -82.3841526015777 35.528294196853295, -82.38366860153056 35.52808019676005, -82.3828146014276 35.52783219662192, -82.38278260142317 35.52782719661765, -82.38223660134737 35.52773319654234, -82.38202160130672 35.527766196527, -82.38179360125817 35.52783719651794, -82.38166660122862 35.52789319651623, -82.3811546011088 35.52812219651018, -82.38080460104659 35.52815019647993, -82.38042860098284 35.52816119644352, -82.37983660089535 35.52809419636899, -82.37898960074276 35.528176196298574, -82.37874760070866 35.52813819626602, -82.37873060070723 35.5281291962624, -82.378666600702 35.528094196248716, -82.37857260068986 35.5280721962346, -82.378324600669 35.527941196182496, -82.37817660065657 35.52786319615142, -82.37782660061903 35.527731196088645, -82.37745760057176 35.52764219603263, -82.37723360054093 35.52760219600148, -82.37681860048397 35.52752719594357, -82.37668460047456 35.527444195912956, -82.37655160046934 35.527335195877235, -82.37645560046545 35.52725719585146, -82.37636160045842 35.52720219583062, -82.37614660043477 35.527125195792856, -82.37567660036896 35.527048195728966, -82.37519160031007 35.52691019565107, -82.37482460025655 35.52686419560401, -82.37472360024321 35.52684219558914, -82.37438760018998 35.526827195551554, -82.3739776001249 35.52681019550597, -82.37380960010049 35.526788195484215, -82.37364060007579 35.526767195462575, -82.37344660004729 35.52674419543798, -82.37330260003138 35.526693195412776, -82.37313060001203 35.52663419538313, -82.37268659996991 35.526431195296276, -82.37252559995089 35.52638219526974, -82.37232459992366 35.52634319524122, -82.37232359992353 35.52634319524112, -82.37197759986546 35.526349195206734, -82.37150159978557 35.52635719515943, -82.37136259976216 35.52636019514573, -82.37077059967869 35.52626719506602, -82.37010859959943 35.52607119495818, -82.36993659957888 35.526020194930155, -82.36964659954023 35.52596019488808, -82.36948659951888 35.52592719486492, -82.3692985994886 35.52592219484458, -82.3689415994102 35.52604819483351, -82.3689315994083 35.526050194832884, -82.3686395993502 35.52611419481584, -82.36833659930166 35.526104194782654, -82.36790659926112 35.52590619469828, -82.36748959921336 35.52576919462756, -82.36711959915218 35.52576919458954, -82.36694559911673 35.52581319458057, -82.3668035990839 35.52587419457841, -82.36666959905251 35.525934194576784, -82.3664205990105 35.52594019455241, -82.36626659899001 35.52590719452988, -82.36609159897085 35.52584419449911, -82.36596559895722 35.52579819447683, -82.3657955989384 35.52573719444692, -82.36571459893017 35.525704194431924, -82.36559959892138 35.52563819440667, -82.36548459891249 35.52557219438146, -82.36546659891121 35.52556119437736, -82.36527759890707 35.5253851943222, -82.36501559892113 35.52501219421953, -82.36474659890987 35.524797194148206, -82.36449759891762 35.52447919405809, -82.36439659891366 35.52439619403084, -82.3643295989026 35.524396194023915, -82.3642515988957 35.52435719400801, -82.36406659887939 35.52426519397032, -82.36388559887405 35.52410519391921, -82.3637645988819 35.52392419387002, -82.36368959890582 35.52368819381439, -82.3636295989138 35.52357219378469, -82.36356159890937 35.52352819376872, -82.36340759888296 35.52353419375421, -82.36313859882335 35.523633193746626, -82.3629915987947 35.523661193737205, -82.36264159873619 35.523666193702184, -82.36248059871298 35.52364419368114, -82.3620225986567 35.52351819360846, -82.36159959861729 35.523320193524796, -82.36089359852352 35.523172193422205, -82.3605705984844 35.5230791933701, -82.36038859847208 35.52296419332806, -82.36011359846223 35.52273319325288, -82.35984359844129 35.522579193193884, -82.35966259841992 35.522524193164124, -82.35928659835598 35.52253619312788, -82.35901759831489 35.5225141930957, -82.35827059822452 35.52230019297547, -82.35792859817454 35.52225819293182, -82.35777359815177 35.52223919291202, -82.35724959807524 35.52217419284495, -82.35700059804698 35.52209119280249, -82.3567315980354 35.521877192731395, -82.35664459802524 35.52185019271693, -82.35660559801913 35.52184819271256, -82.35652959800714 35.521844192703966, -82.35615359792632 35.52196619269003, -82.35593159788212 35.52201519267714, -82.3554135977949 35.522026192626136, -82.35511859775131 35.52199319258912, -82.35407659760534 35.521823192447414, -82.35392159758564 35.52178519242383, -82.35375959757405 35.521686192387016, -82.35360559756974 35.52154919234343, -82.35337659755317 35.52141119229182, -82.35304759751989 35.52127419223016, -82.35285259750708 35.521148192184555, -82.35281159750973 35.521087192168025, -82.35274059752739 35.52089619212191, -82.35267059754557 35.52070319207552, -82.35261659754433 35.52065319205987, -82.35230059751223 35.52052219200076, -82.35183059744409 35.52046119194007, -82.35150759738642 35.52048919191251, -82.3514265973731 35.52048919190418, -82.35125459735085 35.520449191878356, -82.35113759733548 35.520423191861106, -82.35086259729593 35.52038519182507, -82.35057959726109 35.52030819178037, -82.35050859725524 35.52027019176538, -82.35042559724843 35.520225191747684, -82.3503135972479 35.52010819171243, -82.35022359724732 35.52001519168429, -82.35017659724696 35.51996719166972, -82.34994059722331 35.51986819162537, -82.34987959721444 35.519860191617454, -82.34975259719562 35.51984619160153, -82.3495715971607 35.519879191589595, -82.34948259714083 35.51991219158719, -82.34918159707328 35.52002819157974, -82.34867159698099 35.52008119153813, -82.34839459693065 35.52011119151567, -82.3483255969182 35.52011819151, -82.34824059690278 35.52012719150309, -82.34813259687898 35.520166191499996, -82.34812759687816 35.52016619149945, -82.34806059686495 35.52018019149543, -82.34793159683996 35.52020419148698, -82.34776959681997 35.52016019146141, -82.34763559681214 35.520067191428716, -82.34743359683202 35.519721191337794, -82.34725159681986 35.51960519129542, -82.3470435967941 35.51954919126268, -82.3468085967651 35.51948519122555, -82.34655259672968 35.5194411911903, -82.34631459670254 35.51936219114981, -82.34609559667744 35.519290191112674, -82.34581959664594 35.519199191065816, -82.34546159661396 35.51902219099309, -82.3454095966094 35.51899619098249, -82.34527259660267 35.51889319094748, -82.34506659659253 35.518738190894844, -82.3449325965797 35.518677190868694, -82.3449265965791 35.518675190867626, -82.34471759655356 35.51861719083439, -82.34434059649537 35.518590190790135, -82.34413959646905 35.51854619076054, -82.34395059645225 35.51845219072205, -82.34374359643041 35.51837219068452, -82.34356759641183 35.51830419065264, -82.34334859638115 35.518269190622995, -82.3430565963401 35.518222190583465, -82.342751596293 35.51820119054785, -82.3422505962155 35.51816719048942, -82.34177259614682 35.518101190426826, -82.34131559610934 35.517854190329714, -82.34103059607651 35.517762190281715, -82.34102659607595 35.517761190281156, -82.34060359600787 35.5177501902354, -82.34052259599713 35.51773319022363, -82.34044459599114 35.51768819020646, -82.34029359597949 35.51760219017351, -82.33998659595122 35.51745619011226, -82.33978259593235 35.5173601900718, -82.33948659589284 35.517299190029014, -82.33858059581227 35.51685118984487, -82.33849959580505 35.516811189828466, -82.33819659577112 35.51670618977599, -82.33810459576236 35.51666518975826, -82.33779359573255 35.51652518969779, -82.3377045957218 35.516499189683366, -82.33760459570982 35.51647018966725, -82.3367845956395 35.51604718949704, -82.33665659562419 35.51600918947622, -82.33652159560684 35.51597718945584, -82.33618659556355 35.51589918940555, -82.3361235955627 35.51583718938645, -82.33597159556098 35.51568518933998, -82.33570859552779 35.51561918929954, -82.33558959550972 35.51560918928528, -82.33535959547449 35.515591189258, -82.33494959541531 35.51553618920466, -82.33465359538076 35.51544318915536, -82.33439859533695 35.51545418913142, -82.33406859528326 35.51544918909641, -82.33392759526515 35.51541618907525, -82.33380759525235 35.515370189053584, -82.33355159522506 35.51527318900755, -82.33322159516995 35.515277188974416, -82.33308059514646 35.515279188960314, -82.33293159512463 35.51526118894133, -82.33279859510498 35.51524618892464, -82.33258959508066 35.515180188889765, -82.33211859503645 35.51496218879707, -82.3318555950118 35.514840188745254, -82.33185059501005 35.514846188745956, -82.3317925949863 35.51493818875869, -82.3317385949631 35.515031188772014, -82.33172059494802 35.515110188786146, -82.33171759493658 35.515181188800256, -82.33173059492839 35.51524818881521, -82.3317675949259 35.51530418883041, -82.3318015949251 35.51534618884244, -82.33186259492987 35.515380188855595, -82.33192659493581 35.51541018886826, -82.33197759494128 35.515429188877405, -82.33202359494673 35.51544318888492, -82.332117594957 35.515477188901436, -82.33234659498714 35.51552718893516, -82.3324535950008 35.51555318895144, -82.33278159504597 35.51561118899699, -82.33296459506512 35.515683189030455, -82.33307159507339 35.5157441890538, -82.33310959507492 35.515775189063966, -82.3331635950773 35.51581718907805, -82.33324759507244 35.51593918911141, -82.33333159505996 35.516110189154745, -82.33337059505338 35.51619518917602, -82.33339259505158 35.516230189185436, -82.33340459505055 35.516250189190735, -82.3329195949703 35.51625118914102, -82.33133259467539 35.51646618902145, -82.33070559455778 35.516558188975694, -82.3289695942308 35.51682118885052, -82.3269695938149 35.51738018875829, -82.32512159341141 35.51802018869806, -82.32398959321237 35.51810018859788, -82.32234659296238 35.51796318840106, -82.32226859295302 35.51794018838838, -82.32131859283834 35.5176671882353, -82.32091659278967 35.5175521881706, -82.31968359270586 35.51677518788612, -82.31882759266827 35.51610118766133, -82.31875459266512 35.51604418764226, -82.3182155926862 35.515329187441715, -82.31784159270123 35.51483018730206, -82.31706459275111 35.51367318698736, -82.31666959282026 35.51280018676958, -82.31608759292996 35.51146318643848, -82.31560759304087 35.51022718613835, -82.31535559309268 35.50962018598931, -82.31488659312181 35.508928185800656, -82.31380259320261 35.507240185346674, -82.31377459323058 35.507028185300776, -82.31366459323752 35.50686518525646, -82.31357659327102 35.506553185184075, -82.31335959335348 35.505784185005695, -82.31343259343595 35.505326184920335, -82.3135595935161 35.50494118485525, -82.31401459365858 35.50450318481319, -82.31404159366689 35.5044781848109, -82.31476759384931 35.504070184802764, -82.3151795939176 35.50406818484476, -82.31528959393522 35.50407118485668, -82.31562759398936 35.50408218489363, -82.31614959407034 35.50411518495403, -82.3167275941634 35.504130185016464, -82.31697159421526 35.50405418502614, -82.31754859433259 35.50391018505635, -82.31778359437425 35.503891185076576, -82.31817859444172 35.503876185114166, -82.31944759464629 35.50390718525102, -82.32051559482983 35.50385918535097, -82.32136059499754 35.503675185400525, -82.32237059520405 35.503415185451615, -82.32319959538077 35.503155185484125, -82.323727595506 35.50290718548811, -82.32379959554434 35.50273518546059, -82.32391659563189 35.50229118538257, -82.32424359572119 35.50206118536953, -82.32467059579345 35.50204918541096, -82.32560259600761 35.50165618542704, -82.32582359607518 35.50145418540873, -82.32581159618098 35.5007531852653, -82.32572759635448 35.499534185009296, -82.32567359636501 35.49940818497812, -82.3255115963959 35.49903318488543, -82.32545859640639 35.49890818485464, -82.3254865964883 35.498405184755384, -82.32547159648828 35.498389184750614, -82.32487059648874 35.49774118455736, -82.3248145965218 35.497466184495835, -82.32498259657768 35.497283184475975, -82.32501059659646 35.49719118446019, -82.32506259661069 35.497154184458054, -82.32520659664978 35.49705418445249, -82.32537059672433 35.49674518440667, -82.32553359673925 35.496823184439236, -82.32602259678393 35.497057184537006, -82.32618659679883 35.4971361845699, -82.32657459683423 35.497322184647544, -82.32774059694043 35.49788318488116, -82.32812959697581 35.498070184959175, -82.32857359701626 35.49828318504797, -82.32990459713764 35.49892218531451, -82.33034959717818 35.49913618540365, -82.33079659722188 35.499331185489176, -82.33213859735298 35.49991918574647, -82.33258659739671 35.50011518583231, -82.33312459744066 35.50040718594685, -82.33699059818838 35.49969218619917, -82.33813459852685 35.49871818611906, -82.33895559892846 35.49698618585193, -82.33973959929065 35.495471185625036, -82.33931059944558 35.49400218528283, -82.33951559952403 35.493712185245066, -82.33971759960069 35.49343018520854, -82.33882059974306 35.49154018473283, -82.33897859983807 35.49109118465794, -82.33948060003856 35.49032518455413, -82.34051060032871 35.489543184501244, -82.34083460042687 35.489252184475504, -82.34116860049804 35.4891471844885, -82.34340960082241 35.48944318477882, -82.34386260090822 35.489371184810835, -82.34411760098989 35.48911318478461, -82.3442376010386 35.48892518475878)))",6392,37,021,003204,370210032042,1490,1490,55,1470,1420,14,6,3,0,27,20,1143,30,1113,1136,1103,10,4,3,0,16,7,674,596,78
census_2010_blockgroups_view.fid--2dc29038_13ec899ba8f_-2614,"MULTIPOLYGON (((-82.55070161984204 35.588847226277565, -82.55074661985448 35.58881522627564, -82.55088761989093 35.588730226272844, -82.55090861989629 35.58871822627256, -82.55117761996121 35.588586226273264, -82.551496620031 35.58847722628389, -82.5517056200765 35.58840722629113, -82.55170062005486 35.58854222631802, -82.55168462002756 35.58870222634902, -82.55167362000716 35.588823226372504, -82.55163861997518 35.58899322640348, -82.55151461989416 35.58938522647061, -82.55145361985778 35.589556226499056, -82.55135561979853 35.58983522654585, -82.55126261974294 35.59009622658942, -82.55103361960573 35.59074022669691, -82.55098261957595 35.59087922672002, -82.5508876195199 35.59114022676332, -82.55106661954582 35.59116522678678, -82.55108761954885 35.59116822678956, -82.55160961962979 35.59120522685079, -82.55179161965803 35.59121822687209, -82.55196261968469 35.59122922689184, -82.55198561968827 35.591231226894706, -82.55221661972588 35.59123522691919, -82.55232261974386 35.59123322692972, -82.55247661977185 35.59121722694226, -82.55253861978294 35.5912122269476, -82.55264661980421 35.59119022695422, -82.55273261982153 35.59117022695899, -82.55285961984661 35.59114422696669, -82.55315161990393 35.5910872269851, -82.55350061997294 35.591015227006295, -82.5536406200005 35.59098722701497, -82.55371562001483 35.59097522702026, -82.55376862002504 35.59096622702386, -82.55385662004066 35.59095922703149, -82.55397962006137 35.59095722704372, -82.5539856200624 35.59095722704433, -82.55416762008973 35.59097622706686, -82.554413620128 35.59099222709543, -82.55474562017827 35.59102422713601, -82.55477362018273 35.591025227139106, -82.5549476202097 35.59103722715939, -82.55503862022253 35.59105222717178, -82.55513762023638 35.591069227185535, -82.55515762023951 35.59107022718771, -82.55551962029475 35.59110222723142, -82.5556406203131 35.59111322724606, -82.55579862033737 35.59112622726496, -82.55627262040966 35.59116722732193, -82.55643062043384 35.59118122734109, -82.55651762044732 35.59118722735116, -82.55666662047257 35.5911842273659, -82.55737662059195 35.5911742274368, -82.5576136206316 35.59117222746076, -82.55788062067619 35.59117022748778, -82.55843662076911 35.591166227544065, -82.55868262081111 35.59115922756787, -82.55880962083258 35.59115622758029, -82.55894962085765 35.591144227592196, -82.55906462087788 35.591137227602665, -82.55924462090752 35.59113922762154, -82.559248620908 35.59114022762215, -82.55962262096756 35.59115622766383, -82.56012962104978 35.59116922771854, -82.56042562109758 35.59117722775061, -82.5604356210893 35.59124222776481, -82.56044762108333 35.591294227776665, -82.56045762107856 35.59133622778624, -82.56049462106824 35.59144322781178, -82.56051262105774 35.591530227831356, -82.56053962104724 35.591628227854095, -82.56054362104578 35.591641227857124, -82.56058262103477 35.591755227884335, -82.56038162099554 35.59179322787146, -82.56031662098218 35.5918102278682, -82.56025962096894 35.59183422786726, -82.56018062094908 35.5918782278681, -82.5599186208828 35.592026227871294, -82.55984762086378 35.59207322787355, -82.55983162085815 35.59209222787589, -82.55982862085403 35.59211622788037, -82.55983762084907 35.59215822788985, -82.5599026208253 35.59238222794215, -82.5599856207909 35.59269522801438, -82.56005262076725 35.59292122806731, -82.56005362076694 35.59292422806793, -82.56009862075044 35.59308022810436, -82.5601756207252 35.59332722816254, -82.5600736207052 35.593347228156176, -82.55992262067532 35.59337822814696, -82.55947362058637 35.59347122811971, -82.55932362055663 35.59350322811084, -82.55940762049805 35.593974228215366, -82.55959462036962 35.59501022844541, -82.55961162035963 35.59509322846406, -82.55964162035431 35.59516022848078, -82.55975062034193 35.595358228532376, -82.5599576203189 35.5957312286295, -82.55998962031758 35.595774228641545, -82.55983462027822 35.595862228643576, -82.55967862023847 35.595952228645785, -82.55936462016075 35.59611822864737, -82.55936062015958 35.59612122864759, -82.55921162012147 35.59620822865002, -82.55926762012108 35.59627122866856, -82.55936462012075 35.59637822870028, -82.5594366201196 35.59646322872495, -82.55949162011875 35.59652822874389, -82.55950862011852 35.59654822874966, -82.5595596201177 35.59660822876713, -82.55957662011748 35.59662822877293, -82.55925762004067 35.59678322877175, -82.55830361981035 35.59725022876883, -82.55798561973349 35.597406228767895, -82.55769061966235 35.5975502287669, -82.55680461944854 35.59798322876405, -82.55651061937743 35.59812822876335, -82.55642761935749 35.59816822876294, -82.55620861930451 35.598276228762394, -82.55618061929782 35.59828922876217, -82.55609861927776 35.598331228762376, -82.5558246192115 35.59846622876164, -82.55500361901268 35.598872228759944, -82.5547306189464 35.59900822875957, -82.55463661892385 35.59905322875909, -82.55435761885634 35.59919022875828, -82.55426461883388 35.59923622875813, -82.55418961881588 35.59927222875776, -82.5539676187622 35.59938122875709, -82.55389461874445 35.599418228757145, -82.55378361871772 35.59947222875675, -82.55345161863764 35.59963422875565, -82.55341261862807 35.599654228755696, -82.55333961861115 35.599685228754474, -82.55320961858109 35.59974022875229, -82.55292761851962 35.59983522874265, -82.55271661847632 35.599889228732025, -82.55254261844202 35.59992422872129, -82.55231761839958 35.59995722870484, -82.55217261837377 35.59996822869217, -82.55191561833013 35.59997522866722, -82.551638618285 35.59996922863753, -82.55162861828347 35.59996822863629, -82.55119161821465 35.599944228586516, -82.55111761820311 35.59993922857787, -82.55089661816864 35.59992522855232, -82.55082361815705 35.59992122854405, -82.55079061815206 35.59991822854001, -82.5506946181371 35.59991222852893, -82.55066261813194 35.59991122852548, -82.55055161811457 35.599904228512635, -82.55049361810536 35.599901228506056, -82.55022161806134 35.59989422847669, -82.55014961804949 35.599893228469135, -82.55011161804333 35.599892228464974, -82.55011661805034 35.599852228457394, -82.55013661808484 35.59965022841832, -82.55020661820254 35.59896122828523, -82.55021161820902 35.59892422827818, -82.55024461825171 35.59868322823254, -82.54999361821326 35.598662228202485, -82.54979161818451 35.598631228175485, -82.54940561812927 35.59857322812398, -82.54904761807708 35.598526228077645, -82.54877461803804 35.59848622804145, -82.54856961800797 35.59846022801504, -82.54843861798945 35.598439227997346, -82.54832761797375 35.598421227982314, -82.54817561795363 35.59838822795994, -82.54804861794051 35.59833622793632, -82.54800661793762 35.59831022792671, -82.54794661793315 35.59827422791317, -82.54784761793125 35.598180227883894, -82.54780661793272 35.59812622786869, -82.54776661793447 35.59807222785362, -82.54769161794523 35.597921227815135, -82.54754561797492 35.59757122772891, -82.54745361798805 35.597386227681795, -82.54733161800546 35.59714222761963, -82.54717761797107 35.59719922761542, -82.54707261794955 35.597226227610136, -82.54628461778604 35.59743822757232, -82.54625761778036 35.59744622757118, -82.5460266177301 35.59752322756311, -82.54586161775633 35.59717522747533, -82.54583261776185 35.59710822745871, -82.54581661776504 35.59707022744931, -82.54578161777647 35.59695822742291, -82.54575761779407 35.59681822739192, -82.54574561781406 35.59667522736163, -82.54574861783615 35.59653522733348, -82.54576761786183 35.59638922730569, -82.54584461790958 35.596162227267435, -82.5458626179207 35.59610922725846, -82.54597461797131 35.59590122722764, -82.54603761799503 35.595815227216654, -82.54610261801902 35.59572922720578, -82.54624061806534 35.59557722718904, -82.54635061809795 35.595484227181366, -82.54656561816202 35.595300227166035, -82.54662161817853 35.59525322716226, -82.54686261824898 35.59505522714667, -82.54707861831332 35.594870227131224, -82.5472746183698 35.59471522711986, -82.54741561841222 35.594591227109035, -82.54743861842012 35.59456522710613, -82.5474986184399 35.594501227099244, -82.5476106184813 35.59435322708064, -82.5476536184992 35.59428322707078, -82.5477006185192 35.59420422705953, -82.54784261858738 35.593914227015105, -82.54839161885033 35.5927982268444, -82.54849961890187 35.59258022681116, -82.54858161893853 35.59243022678901, -82.5486686189783 35.59226622676456, -82.54876461902134 35.59208922673844, -82.548937619098 35.591778226692874, -82.54902861913806 35.5916162266693, -82.54920661921687 35.59129622662242, -82.54924561923754 35.59120422660766, -82.54935461929459 35.59095122656741, -82.54951761939033 35.59050522649344, -82.54962661944518 35.590266226455924, -82.54974561950127 35.59003022642006, -82.5498046195268 35.58992822640539, -82.54987561955687 35.58980922638847, -82.5500496196283 35.58953322635023, -82.55016761967079 35.58938422633197, -82.55031961972522 35.589194226308955, -82.55050261978505 35.58900322628881, -82.55055061979915 35.588963226285614, -82.55062361982033 35.58890422628109, -82.55070161984204 35.588847226277565)))",6026,37,021,000100,370210001001,1398,1398,58,1377,1106,251,5,11,0,4,21,1359,54,1305,1342,1085,237,5,11,0,4,17,915,736,179
census_2010_blockgroups_view.fid--2dc29038_13ec899ba8f_-2613,"MULTIPOLYGON (((-82.51045361242068 35.59367522312456, -82.51050561242282 35.5937172231384, -82.51054861242378 35.59375722315097, -82.51062161242066 35.59385622317861, -82.51069561241754 35.59395622320655, -82.51102961240144 35.594420223335334, -82.51105961239999 35.59446222334689, -82.5112046123926 35.594666223403294, -82.51130861238319 35.594839223449185, -82.51136961237619 35.59495022347805, -82.51140661236848 35.5950402235002, -82.51142561236449 35.59508622351145, -82.51146261235075 35.5952152235415, -82.51150461231506 35.59549222360221, -82.51155361224858 35.595976223705705, -82.5115696122368 35.59607022372652, -82.5115976122294 35.59614822374522, -82.51164261222125 35.59624922377038, -82.51166261221907 35.59628522377972, -82.51187461219696 35.59665722387722, -82.51194661219083 35.596774223908454, -82.5120206121845 35.59689522394066, -82.51212961217331 35.59708522399051, -82.51215361216997 35.597132224002564, -82.51218861216542 35.597199224019796, -82.51221161216026 35.5972582240342, -82.51224961215205 35.597352224057154, -82.51228861213846 35.59748222408765, -82.51229461212267 35.59759122411044, -82.51229361210598 35.597698224132095, -82.5122706120583 35.597983224187715, -82.51226961205596 35.59799722419049, -82.51223961201518 35.59822922423462, -82.5121406119187 35.59874922433016, -82.51211161183664 35.59925022442915, -82.51212061180259 35.59948122447708, -82.51213161179513 35.59954122449042, -82.51215561178923 35.59960522450585, -82.51219361178627 35.599665224521964, -82.51225561178668 35.5997292245414, -82.51240361179097 35.59986122458348, -82.51256461179833 35.59998622462545, -82.51257961179947 35.599995224628834, -82.51266261180507 35.60004822464816, -82.51277561181553 35.60010222467074, -82.5128996118296 35.600144224692, -82.51306561185224 35.600176224715554, -82.51319861186751 35.600220224738244, -82.51326461187226 35.600260224753185, -82.51330661187536 35.600285224762544, -82.51337361187444 35.600363224785326, -82.51341761187084 35.60043422480426, -82.51344361185386 35.60057222483501, -82.51344661185034 35.600598224840624, -82.51348461181075 35.60089622490511, -82.51352761180226 35.60099722493013, -82.51359361179274 35.60113022496393, -82.51366361177494 35.601321225009976, -82.51370561174873 35.601536225058126, -82.51374861173001 35.60170422509668, -82.51376561172493 35.6017552251088, -82.5137716117233 35.601772225112875, -82.51381461171995 35.60184022513114, -82.51384061171987 35.60186922513967, -82.51387061171977 35.601902225149416, -82.51397861172389 35.60199122517872, -82.51404861172908 35.6020332251944, -82.51413361173512 35.60208522521373, -82.51421861174245 35.602129225231444, -82.5142676117468 35.602154225241556, -82.51435761175445 35.602201225260416, -82.51449961176027 35.60231622529837, -82.51458261175534 35.602437225331514, -82.51468161174449 35.60261422537768, -82.51471461173522 35.60271022540067, -82.51471761173296 35.602728225404626, -82.514732611722 35.602815225423875, -82.51475961170163 35.60297622545941, -82.51479661167441 35.60319322550733, -82.51480361165318 35.60333822553754, -82.51479661164005 35.60341622555273, -82.5147646116216 35.60350122556668, -82.5147176115984 35.60360122558222, -82.51468661158577 35.60364922558879, -82.51460261155128 35.60378322560744, -82.5144996115126 35.60392322562532, -82.51445661149016 35.60402222564103, -82.51443561147542 35.60409522565377, -82.5144336114634 35.60417122566902, -82.51444661145268 35.604255225687425, -82.51447561144398 35.60434222570814, -82.51451361143569 35.60443722573135, -82.51458461142606 35.604576225766905, -82.51463961142095 35.60466822579124, -82.51468361141943 35.60472522580746, -82.51472861141926 35.6047752258222, -82.51477661142059 35.604818225835885, -82.51483361142586 35.60484522584728, -82.51491861143707 35.60486422585981, -82.5150306114562 35.60486022587052, -82.51521561149262 35.60482322588201, -82.51545561154406 35.60474822589148, -82.51551961155634 35.60473722589581, -82.51569261158927 35.60470922590785, -82.51605461166083 35.604635225930096, -82.5161326116757 35.60462222593538, -82.5161796116837 35.60462122594003, -82.51620161168397 35.60464322594682, -82.51635861171472 35.60461222595656, -82.51659461176088 35.604567225971756, -82.51663261176826 35.60456022597418, -82.51680061181025 35.604468225972745, -82.51680661181285 35.60445822597133, -82.51691661185774 35.6042852259474, -82.51699461191046 35.60402722590295, -82.51716461194822 35.60396522590779, -82.5173356119667 35.604029225938426, -82.51745461198216 35.60405722595634, -82.5175656119965 35.604083225973106, -82.51773861202292 35.604098225993866, -82.51785161203995 35.604109226007765, -82.51794161203799 35.604219226039426, -82.51796861203854 35.60424422604734, -82.51811661204253 35.60437822608971, -82.51825761203952 35.60454922613898, -82.51830261203017 35.604658226165796, -82.51831761202739 35.604692226174265, -82.51945961183125 35.6071942268007, -82.51915661169419 35.6077572268841, -82.51655061109129 35.608863226841244, -82.5157636107506 35.6102262270377, -82.5155876106266 35.61084122714471, -82.51514761032048 35.61235322740712, -82.51477661002203 35.61388922768141, -82.51473760994251 35.614363227773865, -82.51473360994028 35.614373227775474, -82.51460460985501 35.61478722784645, -82.51452560979972 35.615061227894124, -82.5143576097254 35.615362227938064, -82.51432660966857 35.615697228003015, -82.51433760966098 35.615758228016595, -82.5143856096292 35.61601622807398, -82.51442160960094 35.61623822812295, -82.51451060953039 35.61679122824455, -82.51458760947858 35.617210228337676, -82.51458960947711 35.61722122834015, -82.51454360936255 35.617915228476576, -82.51444860931025 35.61815222851512, -82.51418260918865 35.61865422858984, -82.51412160912682 35.6189892286517, -82.51409060906816 35.61933622871913, -82.51399360902104 35.619537228750076, -82.51403560901413 35.61962722877276, -82.51400560900557 35.6196502287743, -82.51396760899095 35.619704228781345, -82.51394860897925 35.61976022879084, -82.51394360896822 35.619826228803696, -82.51396060895435 35.619934228827425, -82.51398260894585 35.62001322884576, -82.51403660892561 35.620202228889845, -82.5140386089144 35.620277228905294, -82.51401960890166 35.62033922891599, -82.51397760888511 35.62040122892424, -82.51373460880303 35.6206722289544, -82.5136776087812 35.62075222896478, -82.51363360875773 35.620857228981606, -82.51356560873086 35.6209582289952, -82.51355760872734 35.62097222899726, -82.51333260864851 35.621241229028826, -82.51325460862112 35.621335229039865, -82.51319460860067 35.62140322904758, -82.51316760859106 35.621436229051454, -82.51306760855473 35.621564229067246, -82.51303860854081 35.62162322907633, -82.51303660853976 35.62162822907709, -82.5130216085261 35.62170022909024, -82.5130226085245 35.62171222909278, -82.5130326085145 35.62178722910907, -82.51317160848919 35.622101229187216, -82.51347260843481 35.62277722935571, -82.51361560839545 35.62318622945362, -82.51363360838513 35.623272229472974, -82.51370560834683 35.62359822954678, -82.51373660833947 35.62367922956635, -82.5136196083348 35.62358322953478, -82.51356260833607 35.6235142295149, -82.5135146083413 35.62342822949252, -82.51348160834806 35.62334922947297, -82.5134206083573 35.62322322944111, -82.5133616083618 35.6231312294163, -82.51329660836329 35.62305122939335, -82.5132186083612 35.62298122937105, -82.51314560835776 35.622925229352205, -82.51307360835102 35.622891229337924, -82.51300960834351 35.62287122932719, -82.51291760832943 35.62286322931616, -82.51286460831977 35.62286922931185, -82.51278660830305 35.62289322930878, -82.51260360825977 35.62297722930704, -82.51248560823097 35.623037229307116, -82.51246160822542 35.62304722930673, -82.5123586082009 35.62309522930588, -82.51225260817684 35.62313722930353, -82.51216060815692 35.623167229300144, -82.51203760813209 35.62319622929336, -82.51194260811381 35.62321222928684, -82.51184360809634 35.623219229278085, -82.51137160801608 35.62323122923199, -82.51124160799334 35.62323922922027, -82.51113260797223 35.62325922921309, -82.51106360795687 35.6232842292111, -82.51101960794563 35.62331022921186, -82.51098960793658 35.62333622921404, -82.51095460792179 35.623394229222285, -82.51094960791576 35.62342822922866, -82.51097460790882 35.62350022924591, -82.510994607907 35.623533229254676, -82.51105260790678 35.623597229273635, -82.51114960790284 35.62372722931012, -82.51117060790092 35.623762229319375, -82.51119460789313 35.623838229337316, -82.51121060787871 35.6239492293615, -82.51119560785345 35.62409622938992, -82.51101660769804 35.624911229537275, -82.51098260766389 35.62509622957147, -82.51091060760642 35.62539122962409, -82.51081860754202 35.625709229679266, -82.51073560748667 35.62597922972569, -82.5107066074633 35.62609922974707, -82.51069060744493 35.62620122976619, -82.51068560742758 35.62630822978749, -82.51069660738878 35.626571229842114, -82.51070160735628 35.626787229886546, -82.5107116072942 35.627200229971656, -82.51069560727277 35.62732222999483, -82.51065460725158 35.627415230009525, -82.5106116072343 35.62748123001851, -82.51054760721378 35.62754523002496, -82.51051560720526 35.62756623002592, -82.51047560719446 35.627593230027294, -82.51036660716896 35.627641230025866, -82.51027160714976 35.627663230020545, -82.51016460713124 35.62766823001058, -82.51005860711572 35.62765522999707, -82.50996860710396 35.627634229983535, -82.50985460709127 35.627594229963684, -82.50974360708034 35.627545229942285, -82.50969960707681 35.627521229932796, -82.50950760706034 35.62742122989272, -82.50933460704412 35.62734022985849, -82.50914660702405 35.62726822982446, -82.50906160701385 35.627243229810624, -82.50892660699469 35.62722222979245, -82.50886560698444 35.62722322978642, -82.50880760697366 35.62723022978192, -82.50879760697177 35.6272322297813, -82.50872960695766 35.62725022977793, -82.50860960693188 35.627288229773356, -82.50715960659629 35.62790422974946, -82.50696660654867 35.628005229750165, -82.50684960651384 35.62810522975847, -82.50676060648206 35.628215229771726, -82.50669060644888 35.62835522979299, -82.50665960642768 35.62845922981098, -82.50665560641234 35.62855422982988, -82.50666760640337 35.628625229845575, -82.50670960639293 35.62873822987291, -82.50673660639069 35.62878122988444, -82.50679160638687 35.628865229907156, -82.5069776063835 35.629087229971496, -82.50704160637603 35.62920423000183, -82.50705460636422 35.629295230021626, -82.50702160634516 35.62938323003617, -82.5069416063164 35.62948323004832, -82.50683860628804 35.62955623005253, -82.50681760628228 35.62957123005346, -82.5067796062733 35.629588230052974, -82.50673160626198 35.62961023005255, -82.50658560623344 35.62963823004323, -82.50657160623068 35.62964123004238, -82.50651960622157 35.62964423003763, -82.5060666061418 35.62967422999718, -82.50425760582529 35.62978022983262, -82.50398260577562 35.629806229809596, -82.50380460574041 35.62984322979878, -82.50365260570335 35.629920229798834, -82.50341360563097 35.630132229817335, -82.50327960559252 35.63023722982502, -82.50311160555154 35.630322229824955, -82.5029556055185 35.63036822981827, -82.50220760537267 35.63050922977003, -82.50191760531447 35.63057422975343, -82.501810605288 35.630631229753945, -82.50173460526409 35.630704229761015, -82.50168860524177 35.63079922977559, -82.50168160522124 35.630925229800546, -82.50168860518527 35.63116522985003, -82.50168160516219 35.63130722987827, -82.50163560513529 35.63143222989896, -82.50155960510322 35.63155822991676, -82.50141460505972 35.631684229927494, -82.50119260500605 35.63179322992677, -82.50119560500907 35.63177722992379, -82.50118560500991 35.631761229919555, -82.50116060500821 35.631745229913726, -82.50111460500256 35.63173222990643, -82.50089260496966 35.631707229878415, -82.50052460491617 35.63165822983063, -82.50042560490107 35.63164922981854, -82.5003816048953 35.63163922981202, -82.50032860488813 35.6316292298045, -82.50030760488704 35.63161322979912, -82.50024460487522 35.6316222297945, -82.50017460486094 35.63163922979076, -82.49994560480287 35.631769229793605, -82.49982560477018 35.63185222979816, -82.49967860474105 35.63188322978936, -82.4995876047255 35.63188622978062, -82.49943660470215 35.631875229762784, -82.4993266046879 35.63184922974621, -82.49915660467177 35.631771229712875, -82.49890860465482 35.631614229655334, -82.49879760465036 35.631524229625626, -82.49862660464531 35.631373229577314, -82.49845760463161 35.63128022954101, -82.49830260461468 35.63122322951352, -82.4981626045956 35.63119622949357, -82.49800360457127 35.63118322947456, -82.49790960455567 35.63118322946488, -82.49783060454524 35.6311662294533, -82.49780560454396 35.63114722944691, -82.49776360454442 35.631099229432785, -82.49775660454767 35.631070229426165, -82.49775460455496 35.63102122941599, -82.49778260456766 35.63096922940829, -82.49779860457274 35.63095322940666, -82.49787860459045 35.630924229409004, -82.49794760460316 35.630916229414495, -82.4981046046297 35.63091322943, -82.49825760465414 35.63091922944701, -82.49846160468563 35.63093422947107, -82.49863760470991 35.630966229495684, -82.4987436047233 35.63099322951206, -82.49898360474764 35.631093229557116, -82.4991846047618 35.63121822960322, -82.49935860477163 35.63134122964612, -82.49946560478062 35.631398229668704, -82.4995536047949 35.63140022967814, -82.49962560481036 35.6313772296809, -82.4997076048335 35.63131522967675, -82.4997756048582 35.63122822966611, -82.49987760489275 35.63111422965335, -82.49998260492659 35.631008229642624, -82.50008260495717 35.63091722963433, -82.50018060498218 35.630860229632844, -82.50029760500753 35.63082222963715, -82.50044260503604 35.630793229646166, -82.50050160504911 35.63077222964808, -82.50055760506628 35.63072122964335, -82.50059460508335 35.63065022963271, -82.500588605093 35.63058122961809, -82.50056660510771 35.630462229591686, -82.50056260512484 35.6303472295678, -82.50067860518135 35.630105229530486, -82.50072960520971 35.6299762295095, -82.50075860523623 35.629836229484, -82.50076960526197 35.6296812294536, -82.50078760528974 35.62952022942275, -82.50085060532133 35.629383229401284, -82.50090760535507 35.62922622937524, -82.50094560538327 35.629084229350234, -82.50099060540698 35.62897922933353, -82.50103560542246 35.62892722932755, -82.50107060543105 35.6289092293275, -82.5011056054378 35.628903229329936, -82.50118360544953 35.62891122933953, -82.50130960546363 35.628955229361466, -82.50145060548125 35.62899222938353, -82.50171460552194 35.629012229414705, -82.5019676055635 35.6290152294414, -82.50203960557998 35.628985229442705, -82.50207860559249 35.62894622943881, -82.5020986056012 35.62891122943369, -82.50213060562479 35.62879322941301, -82.50212560565144 35.62861522937624, -82.50212960567198 35.62848622935046, -82.50218360570103 35.62835622932952, -82.50247160581947 35.62789822926604, -82.50255260584476 35.62782122925865, -82.50265760587068 35.62776622925823, -82.50298060594034 35.62766222927034, -82.50314060597555 35.62760622927536, -82.5033426060175 35.62755122928495, -82.50351060604665 35.62754322930068, -82.50365860607364 35.627527229312605, -82.50416160614668 35.62759422937799, -82.50438460618246 35.62760222940252, -82.50453360620871 35.62759222941587, -82.50454660621169 35.62758722941618, -82.50464960623466 35.627549229419074, -82.50478260627028 35.62746122941481, -82.50492960631398 35.627336229404484, -82.5050106063419 35.62724222939375, -82.50511560640282 35.62696022934717, -82.50514560641466 35.62691622934124, -82.5052236064388 35.62684322933452, -82.50535560647265 35.62676622933234, -82.50551760650703 35.62671722933916, -82.50568160653846 35.62669022935044, -82.5060276066109 35.62659222936609, -82.50649060669991 35.62651322939765, -82.50681860675975 35.626478229424315, -82.50699460678602 35.62649722944626, -82.50706660680017 35.62648322945085, -82.50714760681957 35.626444229451245, -82.50722360684085 35.626388229447656, -82.50726360685177 35.62636022944607, -82.50778460698531 35.62605522943762, -82.50813360707025 35.625880229437925, -82.50812660707305 35.625854229431845, -82.5081456070838 35.62580522942387, -82.50845360719057 35.6254442293821, -82.50862960724629 35.625272229365194, -82.50868260726665 35.625197229355386, -82.5087376072983 35.62505122933139, -82.50874560737596 35.62455722923166, -82.50873360738876 35.624461229210844, -82.50870260740025 35.62435322918576, -82.50869960741765 35.62423722916181, -82.50871960744365 35.624090229133955, -82.50882560752046 35.62370622906678, -82.50880360757542 35.62332622898718, -82.5087336075586 35.62336022898693, -82.50870760755103 35.62338122898856, -82.5086696075331 35.62345622899981, -82.50858560748145 35.62370122904107, -82.50853160745561 35.62381022905765, -82.50847660743146 35.62390822907194, -82.50839460739793 35.62403722908976, -82.50823160733367 35.624278229122034, -82.50819560731652 35.62435022913295, -82.50813160726695 35.624603229177865, -82.50809960722333 35.62485122922502, -82.50808360721254 35.62490422923418, -82.50803960719422 35.62497522924408, -82.50791560715645 35.62508722925415, -82.50757560706579 35.62530922926429, -82.50743960702604 35.625420229272976, -82.5071816069393 35.62570522930433, -82.50708160690073 35.6258472293229, -82.50699360687518 35.625918229328335, -82.50690560685295 35.62596822932945, -82.50680760683159 35.62600122932607, -82.5067616068238 35.62600222932164, -82.5065416068027 35.62590222927859, -82.50647660679577 35.62587722926686, -82.50641860678728 35.62587022925942, -82.50614460672864 35.625955229248554, -82.50609560672008 35.625958229244155, -82.50601160670816 35.625945229232876, -82.5058506066901 35.62588922920492, -82.50577160667616 35.62589422919774, -82.50552260661416 35.6260282291994, -82.50544360659599 35.626061229197965, -82.50527460656477 35.62608222918484, -82.50516560654152 35.6261152291804, -82.50507460651701 35.62617622918341, -82.50495660647012 35.62635322920734, -82.50490060645359 35.626400229211114, -82.50489360645132 35.62640722921184, -82.50465960639772 35.626503229207295, -82.50456660637295 35.62656422921012, -82.50452560635729 35.62662122921749, -82.50450660634583 35.62667522922655, -82.50450660632809 35.626790229249934, -82.50447360630568 35.626900229268884, -82.50444360629358 35.626946229275184, -82.50433560626452 35.62701822927875, -82.5042936062566 35.6270242292756, -82.50410460625847 35.626809229212434, -82.50397360626852 35.62660322915704, -82.50387660629143 35.62635022909555, -82.5038606063295 35.62608622904023, -82.50391260637893 35.62582222899188, -82.50397860641918 35.62563222896003, -82.50405560646408 35.62542422892566, -82.50410860651671 35.62514022887327, -82.50413960660062 35.62462922877252, -82.50424460668566 35.62419122869418, -82.5041746067023 35.62400822864981, -82.50416360670586 35.623973228641525, -82.50437760684692 35.62328922852441, -82.5044216068499 35.62331722853459, -82.50447960689765 35.62307022849029, -82.50448560690283 35.623043228485436, -82.50447860695553 35.622694228413735, -82.50444760696513 35.62259822839107, -82.50441560697206 35.62251922837162, -82.50441660697425 35.622506228369126, -82.50421560698405 35.62222622829151, -82.5040006070047 35.62186122819514, -82.50389360701146 35.62170222815182, -82.50361360698929 35.62154522809104, -82.50317060694994 35.62132422800051, -82.50273960690807 35.62113222791711, -82.502193606844 35.62096022782595, -82.50174260677709 35.62090922776917, -82.50151160673833 35.620912227746025, -82.5014206067144 35.62096922774825, -82.50129460668163 35.621046227750995, -82.50120060666802 35.621033227738664, -82.5010166066451 35.6209842277098, -82.50113160666871 35.620954227715465, -82.5012566067072 35.62083922770491, -82.50135060673273 35.620775227701586, -82.50140460676114 35.620649227681476, -82.50139560676367 35.62062322767528, -82.50137060677154 35.62054522765682, -82.50112860676359 35.62033622758947, -82.50107160676465 35.620268227569795, -82.50102160676546 35.620209227552564, -82.50096660676657 35.62014322753354, -82.50094760676697 35.62012022752692, -82.500893606768 35.6200552275081, -82.50087860676935 35.62003022750144, -82.50085260677129 35.61998922749049, -82.5008526067765 35.61995622748377, -82.50084860678272 35.619911227474184, -82.50084160680149 35.61978222744727, -82.50076360679788 35.619722227427005, -82.50068060679386 35.619658227405445, -82.50063160679152 35.619621227392884, -82.50058360679706 35.61953322737002, -82.5005776068131 35.61942322734706, -82.5005366068241 35.61930822731944, -82.50051760683711 35.619203227296126, -82.50045660684901 35.61906022726071, -82.50040260685367 35.618972227237315, -82.5003756068601 35.618901227220086, -82.50036260686821 35.6188352272053, -82.50036260688083 35.61875322718856, -82.50039660690096 35.61865922717302, -82.50047760693971 35.61849522714794, -82.50054960696409 35.61841422713892, -82.5005886069772 35.61837122713415, -82.50069960701474 35.61824722712036, -82.5008136070361 35.61823122712883, -82.50086760705454 35.61817022712196, -82.50088660706278 35.618137227117245, -82.50094160708623 35.61804422710398, -82.50097960710436 35.61796722709219, -82.50101560712133 35.617896227081445, -82.50106960714898 35.61777522706238, -82.50115060718194 35.61764822704488, -82.50117160719377 35.6175942270361, -82.50117760720076 35.617555227028824, -82.50117760721606 35.61745622700861, -82.50117960721998 35.61743322700414, -82.50118460722814 35.617385226994955, -82.50119160723365 35.61735722698988, -82.50119160724383 35.61729122697653, -82.50120460725346 35.617243226968064, -82.501211607259 35.617214226962844, -82.50135960731318 35.61702222693906, -82.50139560733075 35.61694722692746, -82.50149460737804 35.61674722689697, -82.501508607392 35.61667122688294, -82.50153460742855 35.61646222684314, -82.50157560745666 35.616324226819316, -82.50158860747396 35.616226226800684, -82.5015556074974 35.61603922675922, -82.50154660751436 35.61591922673389, -82.5015356075391 35.61574722669776, -82.50155560756947 35.615571226664024, -82.50155660757041 35.61556622666309, -82.50158260760021 35.61540122663223, -82.50161660762863 35.61525322660564, -82.50163160764706 35.615150226586195, -82.50163660765233 35.6151212265808, -82.5016236076764 35.614951226544925, -82.50162360771812 35.61468122648998, -82.50163060774376 35.61452222645837, -82.50167160778697 35.61428622641458, -82.50170860785467 35.6138872263372, -82.5017116078588 35.613863226332604, -82.50167160786582 35.613775226310565, -82.50164460786807 35.61373122629889, -82.50159760788404 35.613577226262684, -82.50160360789347 35.61352222625211, -82.50160160789838 35.61348822624498, -82.50159960790198 35.613463226239745, -82.50159760791288 35.61339022622465, -82.50159760791315 35.61338822622424, -82.5015986079172 35.61336322621933, -82.50159960792355 35.61332322621128, -82.50160460793701 35.61324122619509, -82.5016006079417 35.61320622618755, -82.50159760794732 35.61316722617927, -82.50158460796584 35.613033226150684, -82.50152460798562 35.6128402261053, -82.50145660798869 35.61274722607937, -82.50143660799012 35.612716226071015, -82.50139660799326 35.6126532260541, -82.50136960800143 35.612571226034646, -82.50134960801087 35.61248822601565, -82.50130860801508 35.61241722599705, -82.50127560802392 35.61232422597471, -82.50118760803059 35.61218622593757, -82.50119460804437 35.61210422592166, -82.50119460805291 35.61204922591038, -82.5012286080687 35.6119832259005, -82.50129560809505 35.61188422588726, -82.50133660810947 35.61183522588155, -82.50132960812694 35.61171422585617, -82.50136360817419 35.61144422580476, -82.50137160818892 35.611357225787856, -82.50137660819746 35.61130722577816, -82.50141060823105 35.61112622574484, -82.50141760825595 35.6109722257143, -82.50139960826812 35.61087422569256, -82.50146060827733 35.61088022570002, -82.50164660830536 35.61089822572278, -82.50170860831464 35.61090422573036, -82.5019996083599 35.61092422576436, -82.50217360838748 35.61093222578387, -82.50277660848275 35.61096322585221, -82.50356860860498 35.61102222594567, -82.50380660864172 35.61104022597373, -82.50392460866138 35.611039225985685, -82.50398860867404 35.611026225989654, -82.50400860868356 35.610986225983595, -82.50400960868936 35.610949225976135, -82.50399460869868 35.610873225959175, -82.50396360873015 35.610635225907515, -82.50396360873077 35.61063122590672, -82.50395460874799 35.6105102258812, -82.5039646087804 35.61031022584147, -82.50404360886276 35.60986122575832, -82.5040546088891 35.60970222572715, -82.50405560890793 35.609581225702584, -82.5040566089109 35.60956322569904, -82.50405160892765 35.60944922567535, -82.5040306089453 35.60931222564526, -82.50401260895485 35.609231225626935, -82.5038306090369 35.608503225460176, -82.50381560904731 35.608419225441516, -82.50376460909604 35.608048225360804, -82.5037416091593 35.60761322526995, -82.50375660921183 35.607289225205605, -82.50377960924381 35.607106225170746, -82.50382560934375 35.60650722505362, -82.5038556093763 35.60632822502029, -82.50386360939066 35.60624422500398, -82.5038866094245 35.60604922496671, -82.50391660947359 35.605763224911556, -82.5039546095221 35.60548922485976, -82.50399260954727 35.60536722483885, -82.50405760957375 35.605265224824805, -82.50412260959563 35.60519322481688, -82.50417760961241 35.605143224812345, -82.50424560963056 35.60509922481029, -82.5044496096785 35.6050072248126, -82.50462560971808 35.60494022481708, -82.50475360975008 35.60487022481603, -82.50486060978218 35.60477722480806, -82.50491460980163 35.60470922479977, -82.50493960981343 35.604659224792144, -82.504955609825 35.60460122478203, -82.50496360984098 35.60450622476356, -82.50496260984917 35.60445222475242, -82.50494860985984 35.604368224733925, -82.50486860988207 35.604137224678716, -82.50480060989398 35.60398722464121, -82.50475360990225 35.60388322461519, -82.50472160991475 35.603767224588346, -82.50470660993194 35.603640224560905, -82.50470860995233 35.60351022453468, -82.50471460996529 35.60343222451945, -82.50470460998164 35.60331522449458, -82.50469160999239 35.60323122447618, -82.5046076100155 35.60299122441876, -82.50452261003178 35.60279422436992, -82.5043866100534 35.602507224297554, -82.50435261005998 35.602428224277965, -82.50413761010188 35.60192522415354, -82.50407861011351 35.60178622411926, -82.50401861012573 35.60164222408376, -82.50390861013938 35.60143522403034, -82.5038906101455 35.60137622401648, -82.50387461015168 35.60131922400324, -82.50386661016051 35.60125322398894, -82.50386761016439 35.60122922398418, -82.50386961017301 35.6011752239735, -82.50389561020012 35.601027223946, -82.5039156102195 35.60092322392686, -82.50392961023844 35.60081522390635, -82.50400061031065 35.60042322383395, -82.50403761034772 35.600222223796884, -82.50405561036405 35.60013622378119, -82.50407261038467 35.60002022375934, -82.50407661038848 35.60000022375573, -82.50409261040254 35.5999262237423, -82.50413061042308 35.599834223727505, -82.50415861044088 35.5997482237129, -82.50423261048186 35.59956222368264, -82.50429261051889 35.59938622365299, -82.50429961052379 35.59936222364881, -82.50435461055862 35.59919522362057, -82.50436561056787 35.59914722361192, -82.50437261057424 35.59911322360567, -82.50439261060454 35.59893822357213, -82.50438961061421 35.59887222355845, -82.50436261063656 35.598698223520216, -82.5043556106423 35.5986532235104, -82.50434261065374 35.59856522349116, -82.50432961067057 35.59844222346479, -82.50432561070777 35.59819622341432, -82.50433661072518 35.59809522339494, -82.50436261074525 35.59799322337686, -82.50440561076925 35.59788322335884, -82.50445461079407 35.59777522334196, -82.50451461081661 35.59769322333143, -82.50459961084415 35.59760622332245, -82.50469961087232 35.59753122331747, -82.50484261090968 35.59744222331411, -82.50491261092566 35.59741422331562, -82.50498361094161 35.597387223317384, -82.50526061099836 35.59731722333166, -82.50539661102329 35.597301223342335, -82.50570761107612 35.59729322337275, -82.50576561108528 35.59729622337931, -82.50601861112617 35.59730322340675, -82.50622961115957 35.59731322343044, -82.5065126112036 35.597332223463376, -82.50718761131246 35.59735222353679, -82.50734261133893 35.59734722355174, -82.50743561135619 35.597335223558915, -82.5075516113789 35.59731322356636, -82.50773761141724 35.59726422357547, -82.50798161146824 35.59719622358675, -82.50818161151076 35.59713522359485, -82.50861761160311 35.59700522361325, -82.5087516116325 35.59695822361744, -82.5087786116389 35.59694622361781, -82.50889761166664 35.5968942236195, -82.50896661168402 35.59685522361858, -82.50917161173658 35.59673522361529, -82.5094246118044 35.59656722360713, -82.50955561184499 35.596445223595694, -82.50960161186188 35.59638522358823, -82.50967161189054 35.59627422357287, -82.50971561191325 35.59617422355706, -82.50972561191739 35.596158223554845, -82.50985461199953 35.59576422348796, -82.5098766120125 35.59570322347773, -82.5099256120395 35.595581223458005, -82.50994561205239 35.59551922344746, -82.5099606120621 35.59547222343946, -82.50999061208364 35.59536422342052, -82.51001261210322 35.59526122340183, -82.51005061213567 35.595091223371185, -82.51008661215913 35.594978223351866, -82.51015661219257 35.59483622333017, -82.51030161224853 35.594629223303016, -82.5103416122685 35.59454222328936, -82.5103556122752 35.59451422328513, -82.51038661230204 35.59437322325965, -82.51039461231743 35.59428222324192, -82.51040661233823 35.59416022321835, -82.51044561240069 35.59379622314837, -82.51045061240804 35.593754223140266, -82.51045361242068 35.59367522312456)))",6249,37,021,001802,370210018021,1302,1302,38,1281,1202,54,0,18,0,7,21,1029,25,1004,1021,967,39,0,12,0,3,8,591,547,44
census_2010_blockgroups_view.fid--2dc29038_13ec899ba8f_-2612,"MULTIPOLYGON (((-82.62936962941083 35.61160023898923, -82.62984062942844 35.611994239117834, -82.6299376294331 35.61206923914316, -82.63004462943829 35.612151239170785, -82.63025462944965 35.612304239223576, -82.63046662946323 35.61244523927406, -82.63078862948674 35.612640239346824, -82.63092762949753 35.6127202393774, -82.6313846295362 35.61296323947385, -82.63163662956036 35.61307823952315, -82.63185162958332 35.613161239562096, -82.63191162958962 35.61318523957314, -82.63226462962547 35.613334239639734, -82.63254262965891 35.61341723968516, -82.63252262962015 35.613647239730064, -82.63251662959931 35.61377623975569, -82.63251262958444 35.61386823977404, -82.63249862955868 35.61402023980353, -82.63249762953483 35.61417423983481, -82.63251562951828 35.61430123986255, -82.6325616295 35.61446923990149, -82.63269262946703 35.61482523998748, -82.63273762945576 35.614947240017, -82.63281862943595 35.61516324006927, -82.63283462943231 35.61520424007928, -82.63285562942629 35.61526624009408, -82.63287762942049 35.61532724010876, -82.63294662940125 35.61552724015661, -82.63296062939527 35.61558124016903, -82.63298862938343 35.615688240193705, -82.63300562937391 35.61576824021182, -82.63300762935715 35.615879240234634, -82.63299262933452 35.616010240259754, -82.63298562932935 35.61603624026435, -82.63296562931214 35.61612624028061, -82.63293462929192 35.616224240297434, -82.63287962926454 35.61634224031579, -82.63280862923305 35.616470240334614, -82.63266962917822 35.61667624036227, -82.63248162910568 35.61694424039759, -82.6324766291037 35.61695124039855, -82.63241662907946 35.617044240411325, -82.63238062906086 35.61712624042429, -82.63235262904278 35.61721324043918, -82.63233862903135 35.617272240449715, -82.63233062902505 35.61730424045543, -82.6323236290133 35.61737324046879, -82.63232762900077 35.6174592404867, -82.63235462898811 35.617570240512116, -82.63244462897481 35.617754240558845, -82.63250462897076 35.6178452405835, -82.63256762896378 35.61795824061303, -82.63262262895803 35.61805524063842, -82.63268562895064 35.618171240668524, -82.63272062894248 35.61826224069072, -82.63275962892783 35.618399240722624, -82.63276762892482 35.61842724072912, -82.63278862890907 35.61855224075679, -82.63280262886566 35.618849240818676, -82.63282362868007 35.620077241071066, -82.63283462860402 35.620583241175325, -82.63287862837983 35.62208624148608, -82.63288762833773 35.62236924154467, -82.63303162830405 35.62274324163566, -82.63335462828985 35.62318424175867, -82.63341462828757 35.62326424178112, -82.63349462828114 35.62339224181552, -82.63355862827612 35.623494241842764, -82.63372062825773 35.62378824191935, -82.63382662824472 35.62398724197078, -82.63386462824099 35.62405224198796, -82.63399162822856 35.62427024204536, -82.6340996282194 35.62444624209228, -82.63412762821744 35.62448924210398, -82.634307628205 35.624764242178536, -82.63447862819511 35.62501324224681, -82.63455662818963 35.62513324227923, -82.63458962818727 35.62518424229305, -82.63464262818133 35.62528024231806, -82.63467362817363 35.62536324233817, -82.63469462816731 35.62542724235338, -82.63470162815854 35.62549124236712, -82.6347046281565 35.62550824237082, -82.63468462813069 35.625654242398575, -82.63463162809549 35.62582524242796, -82.63461062808432 35.625875242435974, -82.63456162805718 35.625998242456035, -82.63451862803439 35.62610024247242, -82.63439362796625 35.6264072425221, -82.63435262794361 35.626510242538835, -82.63427662790014 35.62671024257184, -82.63418162783972 35.62699924262101, -82.63408162778016 35.627278242667565, -82.63402662774942 35.62741824269045, -82.63398762773004 35.62750224270353, -82.63395262771182 35.627582242716294, -82.63385762767062 35.627747242740064, -82.63372662762276 35.62791624276111, -82.63347062753324 35.628221242796926, -82.63336562749414 35.628361242814734, -82.6333096274671 35.628476242832406, -82.63326862743948 35.62861124285569, -82.63323662740457 35.62880324289154, -82.63319962732845 35.6292572429802, -82.63316262729785 35.62941624300885, -82.63306662724146 35.629678243052346, -82.63291162715623 35.63006424311507, -82.63282262710547 35.63029724315343, -82.63279862708929 35.630376243167056, -82.63275662706064 35.63051724319144, -82.6327026270099 35.6307882432411, -82.63266762697182 35.63099724328018, -82.63261362689819 35.631417243360154, -82.63248462673944 35.6323082435285, -82.63223462643121 35.63403824385531, -82.63222562640658 35.63418824388494, -82.63223362639096 35.63429824390819, -82.6322636263738 35.63444124394043, -82.63240362634004 35.63481224403038, -82.63240862633882 35.634825244033586, -82.6324576263276 35.6349512440643, -82.63264962628433 35.63543924418341, -82.632654626283 35.635453244186735, -82.63269362627436 35.635551244210816, -82.63271362626627 35.63562524422791, -82.63272362625148 35.6357322442507, -82.6327556262467 35.63579724426723, -82.63250962621309 35.635750244232405, -82.63181662611778 35.63562024413469, -82.63177162611203 35.63560924412789, -82.6316116260912 35.635571244103645, -82.63153062608177 35.63554524409005, -82.63146662607424 35.63552524407947, -82.6313476260623 35.63547424405684, -82.63094662602795 35.63526424397283, -82.6304056259815 35.63498124385956, -82.63018162596128 35.63487024381399, -82.62995162593622 35.63478524377299, -82.62976162591325 35.63472924374209, -82.62958262588836 35.634697243717234, -82.62943762586687 35.634680243698874, -82.62933462585015 35.6346772436876, -82.62927062583985 35.63467524368068, -82.62912462581481 35.63468024366667, -82.62911862581363 35.63468124366626, -82.62893162577943 35.634701243651165, -82.62873362574119 35.634735243637685, -82.62848962569065 35.63480024362589, -82.62821162563223 35.63487924361345, -82.62737762545665 35.635118243576464, -82.62725062542978 35.63515524357095, -82.62709762539895 35.63519024356238, -82.62696662537404 35.635210243553026, -82.62685862535328 35.635228243545576, -82.62656962530448 35.63523324351687, -82.62643762528202 35.63523624350392, -82.62641962527898 35.63523624350208, -82.62636462526973 35.63523724349668, -82.62634762526676 35.63523824349508, -82.62595562520066 35.6352442434561, -82.62581462517694 35.63524524344183, -82.62478362500394 35.63525524333793, -82.62429662492151 35.63526424328968, -82.62421762490854 35.63526324328139, -82.62412562489338 35.635262243271725, -82.62399262487406 35.635244243254434, -82.62385162485657 35.635205243231994, -82.62373762484476 35.63515924321087, -82.62370562484205 35.63514224320415, -82.62361662483474 35.63509324318503, -82.62355362483106 35.63504924316957, -82.62352062482906 35.63502624316146, -82.62328162482268 35.634810243092986, -82.62315962482103 35.63468924305572, -82.62303362481931 35.63456424301739, -82.62298062481867 35.63451124300113, -82.62282162481628 35.63435524295297, -82.62276962481546 35.63430424293721, -82.62257662481 35.63413124288219, -82.62243162480347 35.63401724284408, -82.62233562479905 35.633942242818925, -82.62211062478461 35.63379324276545, -82.62186662476545 35.63365424271201, -82.62126662470683 35.633387242596044, -82.62086262466714 35.63320824251807, -82.62082662466827 35.63316224250503, -82.62078562468135 35.633033242474454, -82.62077362468517 35.63299524246552, -82.6206206247242 35.63257724236461, -82.62058862473287 35.632486242342814, -82.62052662475072 35.63230324229918, -82.620434624778 35.632027242233434, -82.6204086247912 35.63191324220757, -82.62038562480426 35.63180424218303, -82.62036062483509 35.631577242134135, -82.62035562487063 35.631341242085604, -82.62038462491878 35.631060242031346, -82.6204366249828 35.63070024196331, -82.62043762498381 35.630695241962385, -82.62048062505262 35.630295241885335, -82.62052062511538 35.629931241815314, -82.62056662516888 35.62963324175928, -82.62057962517692 35.629595241752874, -82.62065062521785 35.62940624172166, -82.62077062527085 35.62919224169042, -82.6209176253266 35.62898924166415, -82.62109962539103 35.62876724163764, -82.62129762545892 35.62854024161169, -82.62176562562122 35.627992241548135, -82.62183962564737 35.62790224153737, -82.62229162580647 35.62735824147299, -82.62250062588231 35.62709124144002, -82.62266062593672 35.626911241419855, -82.62273262595855 35.62684724141416, -82.62282162598513 35.62677024140762, -82.62297562602544 35.62667524140402, -82.62311562605738 35.62661924140708, -82.62328062609005 35.62658524141701, -82.62344262611693 35.62658524143367, -82.62355862613211 35.626612241451134, -82.6236586261429 35.62665024146906, -82.62389262615977 35.62679324152229, -82.62397662616657 35.626840241540485, -82.62406462617675 35.62686924155544, -82.62416262618973 35.62689024156977, -82.62425062620382 35.626894241579656, -82.62435662622238 35.626888241589356, -82.6244756262451 35.626869241597696, -82.62460662627261 35.626831241603405, -82.62461162627406 35.62682824160328, -82.62469162629257 35.626794241604564, -82.62485362633308 35.6267062416033, -82.62497762636711 35.62661924159831, -82.62505862639354 35.62653524158953, -82.62512962641907 35.626446241578606, -82.62513862642383 35.626425241575284, -82.62517662644241 35.626345241562916, -82.625197626457 35.62627324155042, -82.62520062645898 35.62626324154868, -82.62522162648226 35.626135241524736, -82.62523062653769 35.62578524145439, -82.62523562656358 35.62562224142164, -82.62524662664515 35.62510524131744, -82.62525262668585 35.62484724126552, -82.62527862679755 35.624150241126145, -82.62528562684938 35.62382124105988, -82.62529662689178 35.62355824100742, -82.62529662689208 35.62355624100698, -82.62530862697353 35.6230402409031, -82.62529962700918 35.622799240853055, -82.62528162702223 35.62269524083004, -82.6252716270298 35.62263524081677, -82.62521062704253 35.62248624078017, -82.6251156270511 35.6223282407382, -82.62506862705426 35.62225724071893, -82.62499562705909 35.622147240689024, -82.62487562706448 35.62198224064308, -82.62478162707197 35.62183224060285, -82.62476762707405 35.62180324059555, -82.62463762709496 35.62152724052591, -82.62461962709757 35.621491240516775, -82.62461162709874 35.62147524051264, -82.62458762710204 35.621427240500424, -82.62457962710306 35.62141224049653, -82.62454262710816 35.62133924047784, -82.62453462710896 35.621325240474185, -82.62445062711812 35.621175240435036, -82.62438462712267 35.62107424040763, -82.62433762712617 35.62100124038799, -82.62433162712634 35.62099324038573, -82.6242216271296 35.620853240345916, -82.6241006271298 35.62072124030658, -82.62398162712601 35.620617240273134, -82.62395462712489 35.62059524026589, -82.62368962711473 35.62037524019388, -82.62344262710685 35.620160240124676, -82.62334462710497 35.62006624009546, -82.62326262710657 35.61996724006683, -82.62318862711001 35.61986524003855, -82.62310362712108 35.61970123999639, -82.62302162713722 35.619508239948615, -82.62298462715889 35.619327239907975, -82.62298362715951 35.619322239906886, -82.62296262718564 35.619130239865555, -82.62296262720963 35.61897423983384, -82.62299462723945 35.61881523980468, -82.62301162724731 35.61878223979971, -82.6230456272636 35.61871323978909, -82.62306762727545 35.61866023978058, -82.62319562734527 35.6183452397296, -82.62325662737685 35.61820623970753, -82.6233826274412 35.61792423966299, -82.62378862764182 35.61706023952864, -82.62387162768087 35.61689623950377, -82.62396462772047 35.61673923948132, -82.6240556277568 35.61660223946279, -82.62410462777521 35.616535239454144, -82.62417162780038 35.616444239442544, -82.62436462786694 35.6162202394167, -82.62450162791158 35.61607823940176, -82.62451662791614 35.61606523940067, -82.62462862795046 35.61596323939138, -82.62464562795549 35.61594923939031, -82.62479062799761 35.615832239381376, -82.62491362803216 35.61574023937522, -82.62498962805286 35.61568823937244, -82.62507962807702 35.615628239369435, -82.62511562808663 35.61560523936848, -82.62523762811853 35.61552923936552, -82.62545662817364 35.615408239363326, -82.62564262821876 35.61531623936367, -82.62568162822797 35.61529823936404, -82.625825628262 35.61523323936559, -82.62614962833418 35.61511423937464, -82.6263176283693 35.615067239382256, -82.6265186284106 35.61501623939255, -82.62744262859714 35.614803239444015, -82.62753762861739 35.61477423944781, -82.62766762864493 35.61473623945345, -82.62777662866992 35.614691239455446, -82.62787462869335 35.614645239456145, -82.62802762873237 35.61455723945399, -82.6281156287562 35.61449723945076, -82.62819762877832 35.61444223944794, -82.62820762878172 35.614431239446766, -82.62830462881162 35.61434123943839, -82.6283716288379 35.61424323942527, -82.62841562885725 35.61416523941396, -82.6284196288588 35.61415923941308, -82.62846462888105 35.614063239398135, -82.62828262885695 35.61402323937132, -82.62819862884591 35.614004239358806, -82.62797462881667 35.61395223932527, -82.62779162879258 35.61391123929808, -82.62750162875646 35.613832239252254, -82.62733562873719 35.61377823922421, -82.62720662872344 35.613728239200775, -82.62709162871337 35.61366923917692, -82.6270026287069 35.613615239156736, -82.62691062870284 35.613542239132514, -82.62678062870361 35.61339623908934, -82.62671162870838 35.61329123906086, -82.62669562871002 35.613263239053595, -82.62662862871693 35.61314623902282, -82.62655562872781 35.6129962389848, -82.62651862873741 35.612894238960166, -82.62649462874697 35.61280623893981, -82.62648162875175 35.61276123892934, -82.62645562879433 35.612456238864475, -82.62645662883114 35.61221823881612, -82.62645862886426 35.61200523877289, -82.6264706289012 35.61177823872791, -82.626488628939 35.611552238683714, -82.62657362905557 35.61088723855689, -82.62660962912837 35.610453238472246, -82.62665962922715 35.60986523835757, -82.62668262928334 35.60952523829068, -82.62668662929167 35.609475238280865, -82.62668062931672 35.6093062382458, -82.6266576293348 35.60916423821454, -82.62659362935874 35.60893923816212, -82.62658262936583 35.608881238149166, -82.62655462937317 35.60880323813043, -82.626536629381 35.60873323811429, -82.62652762938998 35.608665238099505, -82.62654562940294 35.60860023808813, -82.62657762941566 35.60855223808162, -82.62658762941885 35.60854223808066, -82.62663962943428 35.60849823807696, -82.6267076294521 35.60845623807541, -82.6267796294693 35.608422238075875, -82.62688462949279 35.608383238078744, -82.62704562947147 35.608695238158816, -82.62722062945335 35.60900223823931, -82.62727962944835 35.60909823826495, -82.62737162944073 35.60924723830476, -82.6275466294266 35.60952823837993, -82.62792362940897 35.61005023852504, -82.62810762940337 35.61028523859179, -82.62856962939819 35.61081823874779, -82.62875462939893 35.61101323880654, -82.62877762939928 35.611035238813365, -82.62911862940432 35.61137123891682, -82.62936962941083 35.61160023898923)))",5962,37,021,002607,370210026073,1108,1108,195,1067,860,47,2,22,0,136,41,805,111,694,793,657,39,2,16,0,79,12,432,398,34
census_2010_blockgroups_view.fid--2dc29038_13ec899ba8f_-2611,"MULTIPOLYGON (((-82.52945358933182 35.76332925960882, -82.52964458937991 35.76322425960709, -82.52992558945158 35.76306325960335, -82.53016058951383 35.76291425959727, -82.53023558953454 35.762861259594246, -82.53036358956959 35.762772259589326, -82.5305585896269 35.76261225957687, -82.53077458969297 35.76241825955962, -82.5309455897478 35.76224825954261, -82.53112758980986 35.7620432595197, -82.53134858988902 35.76177025948689, -82.53156658996986 35.761483259450955, -82.53174059003248 35.76126625942474, -82.53195659010703 35.761017259396304, -82.53205659013828 35.76092325938755, -82.53210559015372 35.76087625938298, -82.53228259020882 35.76071125936763, -82.53246359025992 35.760576259358864, -82.53257659028964 35.76050525935607, -82.53268759031897 35.76043525935321, -82.53284859035809 35.76035625935376, -82.5329225903761 35.76031925935392, -82.53311259042194 35.760227259354714, -82.53314759042998 35.76021325935552, -82.53322559044742 35.76018425935759, -82.53336259047812 35.760133259361375, -82.53340059048631 35.76012125936287, -82.53360359052988 35.760058259370936, -82.53385859058298 35.75998925938326, -82.53393959059912 35.75997225938811, -82.53412259063538 35.7599342593993, -82.53468959074895 35.7598102594325, -82.534754590762 35.75979625943635, -82.53530259087043 35.75968425947007, -82.53567459094552 35.75959925949119, -82.53607659102569 35.75951325951513, -82.53643059109565 35.75944225953715, -82.53665359114015 35.75939425955042, -82.53728659126598 35.75926125958862, -82.53767459134295 35.759181259612355, -82.53804459141527 35.75911225963647, -82.5383245914699 35.75906025965477, -82.53863359152858 35.75901325967714, -82.53929759165142 35.758933259729325, -82.53936759166413 35.75892625973506, -82.53956659170034 35.75890625975151, -82.53986459175235 35.75889025977902, -82.54023259181653 35.758871259813105, -82.54034859183658 35.75886625982404, -82.54040059184543 35.75886525982923, -82.54112159196967 35.75883725989787, -82.54140359201766 35.758830259925574, -82.54153659204006 35.75882825993884, -82.54184059209295 35.75881325996718, -82.54221159215592 35.758805260003776, -82.54225259216295 35.75880326000765, -82.54253559221159 35.758793260034814, -82.54261459222526 35.758790260042325, -82.54285259226616 35.75878126006506, -82.54293259227981 35.75877926007284, -82.5429505922829 35.758778260074486, -82.54300659229268 35.75877526007968, -82.54302559229589 35.75877526008162, -82.54305859230172 35.75877326008463, -82.54315959231909 35.75876926009423, -82.54319359232477 35.75876926009776, -82.54332959234836 35.75876326011058, -82.54341059236206 35.75876126011859, -82.54374059241908 35.75874826014994, -82.54387759244244 35.75874426016316, -82.54391359244876 35.75874226016655, -82.54402459246786 35.7587382601772, -82.54406159247411 35.758737260180794, -82.5442785925115 35.75872926020154, -82.54493159262312 35.75870926026484, -82.54514959266051 35.75870226028586, -82.5452365926754 35.75869926029423, -82.54550759272179 35.75869126032053, -82.54573759276205 35.758678260341604, -82.54583159277817 35.75867526035072, -82.54594059279664 35.758672260361394, -82.54625059284876 35.75866926039273, -82.54652659289343 35.75867726042278, -82.54666759291456 35.75869226044043, -82.5468355929386 35.7587172604628, -82.54698359295885 35.758745260483764, -82.54714459298009 35.758781260507746, -82.54741259301345 35.75885326055002, -82.54756859303104 35.75890726057714, -82.54758959303324 35.75891526058095, -82.54771259304576 35.758966260604005, -82.54787959306177 35.75904226063673, -82.54804359307644 35.759123260670066, -82.54812759308267 35.75917326068893, -82.54820859308875 35.75922126070706, -82.54821759308923 35.75922726070924, -82.54848059310596 35.75940126077181, -82.54856859311161 35.759459260792724, -82.5486405931157 35.75951026081044, -82.548785593124 35.759612260846204, -82.54886059312867 35.75966226086413, -82.54893459313324 35.75971226088201, -82.5490255931383 35.75977726090457, -82.54928559315718 35.75993426096341, -82.54929959315812 35.75994326096667, -82.54942059316828 35.760007260992154, -82.54954959318086 35.76006426101706, -82.54974559320175 35.76014026105271, -82.54985759321595 35.760168261069964, -82.55014759325572 35.76022326111109, -82.55047759330324 35.76027026115476, -82.55056759331625 35.76028326116667, -82.5507425933407 35.76031326119083, -82.55087459336094 35.7603242612067, -82.55089059336328 35.760326261208704, -82.55092059336768 35.76033026121261, -82.5510115933805 35.760345261225055, -82.55104259338482 35.760350261229284, -82.55123659341277 35.76037826125501, -82.55144259344392 35.76039826128034, -82.55163059347227 35.76041726130363, -82.55196759352557 35.760435261342025, -82.55265059363903 35.76043626141265, -82.55276959365858 35.760437261425174, -82.55305359370456 35.76044526145604, -82.55322059373276 35.76044326147293, -82.55365559379938 35.76048026152528, -82.55398659384791 35.76052226156798, -82.55415759387287 35.760544261590105, -82.55439259390825 35.760568261619255, -82.55452659392914 35.760577261634836, -82.55460359394148 35.76058026164341, -82.55474059396417 35.76058126165774, -82.5549085939943 35.760567261672236, -82.55670559431206 35.760446261832904, -82.55679159432724 35.76044026184052, -82.55742259443893 35.76039726189687, -82.55772759448814 35.7604072619304, -82.5578775945115 35.7604172619479, -82.55791459451723 35.760420261952326, -82.55828259456982 35.760475262001464, -82.55832359457547 35.76048326200732, -82.5584115945872 35.760502262020225, -82.55846959459399 35.76052026202991, -82.55869659462118 35.76058826206718, -82.55869859462135 35.7605892620676, -82.55910459466847 35.76072126213636, -82.55928059469076 35.76076626216365, -82.55938159470571 35.76077826217648, -82.55944859471549 35.760787262185296, -82.55950459472419 35.76079126219189, -82.55958859473826 35.76079026220027, -82.55961859474392 35.760786262202565, -82.55971259476124 35.76077526221004, -82.55982159478233 35.76075626221741, -82.55984359478711 35.76074926221828, -82.55994459480803 35.760722262223155, -82.56007759483812 35.76067126222652, -82.56014559485473 35.760637262226595, -82.5602595948847 35.76056626222389, -82.56032459490307 35.760517262220624, -82.560415594933 35.7604222622106, -82.56042559493666 35.76040926220899, -82.56046859495174 35.760358262203056, -82.56052959497524 35.76027226219183, -82.56055859498771 35.76022326218484, -82.56064259502416 35.760078262163965, -82.56071859505948 35.759932262142094, -82.56083259512083 35.75965926209827, -82.560844595127 35.75963226209397, -82.56089759515957 35.75947926206825, -82.56102659524421 35.75907226199863, -82.5610695952675 35.75896826198196, -82.56111959528855 35.758886261970396, -82.561171595306 35.75882926196412, -82.56123359532428 35.75877826196012, -82.56130159534105 35.758743261960035, -82.56138659535954 35.75871526196315, -82.56157459539622 35.75868026197538, -82.56180559543917 35.75865126199325, -82.56211259549461 35.75862326201924, -82.56211559549509 35.75862326201953, -82.56224059551612 35.7586222620322, -82.56230559552627 35.75862626203973, -82.56239059553795 35.758642262051744, -82.56252959555492 35.75868126207402, -82.56270959557007 35.75877726211216, -82.56291059558673 35.75888526215497, -82.56309659560488 35.75896726219074, -82.563107595606 35.75897226219295, -82.5632375956214 35.759012262214505, -82.56334159563556 35.75903226222928, -82.56353359566566 35.759044262251564, -82.56395059573613 35.75903726229308, -82.56406359575543 35.75903426230412, -82.56417759577624 35.759022262313465, -82.56429059579825 35.75900126232077, -82.5643775958162 35.758979262325326, -82.56443259582718 35.75896726232855, -82.56450459584296 35.75894326233104, -82.56462859587165 35.75889126233329, -82.56477659590794 35.75881626233326, -82.56513059591549 35.75914726243716, -82.5654265959242 35.75940826252087, -82.56559859592925 35.75956026256955, -82.56583759593357 35.75978826264066, -82.56590859593332 35.75986626266388, -82.56603359593146 35.76001226270643, -82.56606759592945 35.76006126271997, -82.5661615959181 35.76023526276507, -82.56619559591063 35.760320262785946, -82.56621659590293 35.76039226280269, -82.56625259588161 35.760568262842284, -82.56626859586656 35.760682262867185, -82.56630359579852 35.761158262967726, -82.5663305957542 35.76147226303448, -82.56634759574311 35.76156226305461, -82.56637059573315 35.761651263075045, -82.5664055957265 35.76173126309495, -82.56644359572242 35.761798263112524, -82.56649459572087 35.76186326313104, -82.56654159572149 35.761909263145306, -82.5666065957249 35.76195726316172, -82.56675759574001 35.76202126319031, -82.56684259575158 35.76203826320262, -82.56702959578148 35.76204626322344, -82.56716459580502 35.76203926323601, -82.56717759580727 35.76203826323714, -82.56769459589938 35.761999263282476, -82.56777359591301 35.76199626329004, -82.56786159592812 35.761993263298486, -82.56804959595861 35.76199826331889, -82.56821359598143 35.7620272633417, -82.56838159600196 35.76207526336882, -82.56847959601257 35.76211126338624, -82.56876659604022 35.76224126344238, -82.56886359604799 35.76229526346338, -82.56896059605448 35.76235726348595, -82.56910759606063 35.76247526352517, -82.56935359606032 35.76274126360468, -82.56936559606015 35.76275526360884, -82.5695155960575 35.76293326366047, -82.56969559605652 35.76313226371964, -82.56977459605774 35.76320926374347, -82.57001259607185 35.76337326380141, -82.57004559607378 35.76339626380949, -82.5702805960901 35.763543263863674, -82.57036659609291 35.76361726388764, -82.57044859609385 35.76369826391261, -82.5706125960917 35.7638882639682, -82.57065859609055 35.76394526398457, -82.57076359608776 35.76407626402205, -82.57083559608435 35.764175264049655, -82.57085159608337 35.764198264056034, -82.57089259608124 35.76425626407204, -82.5709015960809 35.76426826407537, -82.57091959608029 35.76429126408195, -82.5710285960759 35.764436264122665, -82.57103559607552 35.764446264125475, -82.57116259606886 35.76462526417506, -82.57123859606365 35.764740264206274, -82.57130659605697 35.76485626423695, -82.57134359605055 35.76493726425726, -82.57135459604854 35.76496226426349, -82.57139459603657 35.765082264292026, -82.57140259603167 35.765122264300985, -82.57141959602099 35.765209264320504, -82.57142859600219 35.765340264348104, -82.5714205959786 35.76548326437647, -82.57141859597735 35.765489264377436, -82.57137159592575 35.76577126443003, -82.57131759587405 35.76604626448046, -82.57129459584684 35.766197264508904, -82.57128159581971 35.76635826454037, -82.571287595803 35.76647226456417, -82.5713065957884 35.76658626458934, -82.57130859578754 35.76659426459128, -82.57133159578093 35.76666126460719, -82.57136559577523 35.76673426462561, -82.57139859577215 35.76678926464018, -82.57147159576881 35.76688926466813, -82.57148659576865 35.76690626467307, -82.57157259576779 35.76700426470191, -82.57162259576803 35.76705626471766, -82.57193159576939 35.76737926481533, -82.57199259576589 35.76746626483939, -82.57202059576271 35.76751726485262, -82.5720705957569 35.76760826487634, -82.57210759574858 35.767701264899095, -82.5721975957283 35.76792826495463, -82.5722715957091 35.76813126500358, -82.57231659569774 35.76825326503308, -82.57245159565235 35.768690265136065, -82.57249359563505 35.76884626517216, -82.57251959561344 35.76901326520884, -82.57255159557253 35.769311265272854, -82.57256559554926 35.769476265307915, -82.5725875955123 35.769737265363325, -82.57260859549459 35.76987426539341, -82.57262159548748 35.76993426540703, -82.57263059548231 35.769977265416664, -82.57265559547275 35.77006526543719, -82.57266059547173 35.77007726544012, -82.57269259546526 35.77015326545893, -82.5727375954608 35.77023026547926, -82.57278359545893 35.77029126549643, -82.57283059545856 35.770344265512065, -82.57290659545971 35.77041826553499, -82.57292359546064 35.770430265539176, -82.57304559546768 35.770516265569306, -82.57309059547036 35.77054726558023, -82.57317559547732 35.77059326559834, -82.57344459549888 35.77074226565646, -82.5735705955076 35.770821265685576, -82.57364459551265 35.770868265702816, -82.57368959551286 35.77091526571699, -82.57375059551174 35.77098826573814, -82.57380459550433 35.771093265765124, -82.57386259546493 35.77140926583545, -82.57399459537727 35.772115265992895, -82.57415959532926 35.772601266108964, -82.57433059530608 35.77293426619437, -82.574406595296 35.77308026623196, -82.57457259529488 35.77326526628675, -82.57467759530262 35.77332826631044, -82.57476559531062 35.7733712663283, -82.57484359531999 35.77339426634101, -82.57490559532815 35.77340826635024, -82.57494259533289 35.77341726635588, -82.57510759535961 35.77342226637394, -82.5753765954093 35.77339026639519, -82.57563059545791 35.77334926641303, -82.57587159550397 35.77331126643018, -82.57634059559184 35.77324826646565, -82.57669359565946 35.773191266490485, -82.57679359567999 35.77316626649565, -82.57687359569607 35.77314826650024, -82.57701759572957 35.77308726650271, -82.57716459576679 35.77300526650111, -82.5773075958073 35.7728972664939, -82.57748959586095 35.77274726648209, -82.57771659592584 35.77257226646988, -82.57800059600095 35.77239326646266, -82.57834559609013 35.77218926645667, -82.57866159617022 35.77201226645325, -82.57885259622232 35.77188126644626, -82.5790115962631 35.77178926644389, -82.57910459628467 35.77175026644557, -82.57918159630084 35.77172826644903, -82.57926259631788 35.77170526645268, -82.57944159635066 35.77168626646725, -82.57960659637939 35.77167826648267, -82.57976359640777 35.77166326649578, -82.58003659645935 35.77162426651596, -82.58010759647233 35.771616266521704, -82.58045159653574 35.77157726654919, -82.58089259661386 35.77154726658862, -82.58098459662962 35.7715442665975, -82.58092459659784 35.771684266619786, -82.58086159655929 35.771865266650174, -82.58083159653577 35.771984266671296, -82.58081259649997 35.772194266712134, -82.58080159645634 35.77246326676582, -82.5808855964235 35.77276526683597, -82.5808525964096 35.77281926684362, -82.5808165963945 35.772878266851905, -82.5808185963908 35.77290426685744, -82.58081559638532 35.77293626686363, -82.58080659636825 35.77303626688307, -82.58078059634518 35.77315726690503, -82.58075259632513 35.77325626692233, -82.5806775962909 35.77339626694316, -82.58061459626705 35.77348226695408, -82.58053459623972 35.773572266964166, -82.5804305962016 35.77370626698081, -82.58042959620111 35.77370826698114, -82.58036759616971 35.773844267002396, -82.58030959612276 35.7740842670453, -82.58028059610828 35.77414626705495, -82.58024359609314 35.77420426706299, -82.580198596079 35.77424726706712, -82.58012859605914 35.774300267070664, -82.5800475960344 35.774372267076984, -82.58000259601715 35.774435267085174, -82.57999359601348 35.774449267087086, -82.5799525959919 35.77454426710223, -82.57991659596003 35.77471126713259, -82.57988859593543 35.77483926715574, -82.5798485959092 35.77496526717725, -82.57821959553029 35.77565926715066, -82.57568659495124 35.776672267095755, -82.574241594621 35.777249267064285, -82.57299659434058 35.77772026703179, -82.57261659425419 35.77786926702294, -82.57238159419994 35.77796626701849, -82.56881559338257 35.779407266944155, -82.5684395932953 35.779566266937735, -82.56835759327616 35.7796012669364, -82.56731359303387 35.78004226691858, -82.56700859296295 35.78017226691356, -82.56698959295855 35.780180266913234, -82.56693859294651 35.780203266912736, -82.56683059292088 35.78025226691146, -82.5665245928487 35.780389266907875, -82.56528459255577 35.7809462668934, -82.56500959249048 35.78107126689051, -82.56498159248407 35.78108326688998, -82.56487059245816 35.78113026688817, -82.56478859243943 35.78116326688641, -82.56437359234339 35.78133726687906, -82.56288259199776 35.781964266852924, -82.56268759195244 35.78204726684968, -82.56238659188251 35.78217426684448, -82.5621715918328 35.78226426684077, -82.56152759168363 35.78253426682922, -82.56142259165917 35.78257926682754, -82.56139559165274 35.78259126682718, -82.5613135916339 35.782625266825676, -82.56046459143928 35.782968266807956, -82.5573255907158 35.78426226674763, -82.5559335903946 35.78483826672127, -82.55513959021145 35.78516626670614, -82.55168558941541 35.78659026663977, -82.55164358940574 35.78660726663886, -82.55110458928117 35.786831266628845, -82.55108058927563 35.78684126662834, -82.55102758926378 35.786861266627064, -82.55038058911725 35.78711126661114, -82.54100858699452 35.79073426638167, -82.53986158668408 35.791503266419824, -82.53974258665207 35.79158226642359, -82.53968658663686 35.791620266425596, -82.53962858662123 35.791658266427376, -82.53955858660221 35.79170626642986, -82.53930458653315 35.79187826643865, -82.53876458645415 35.791808266368704, -82.53849258641083 35.79179626633819, -82.53853158642372 35.791755266333816, -82.53860958644906 35.79167526632562, -82.53866958646998 35.791605266317575, -82.53868058647353 35.79159426631645, -82.53884458652769 35.791421266298194, -82.53889258654348 35.791371266292934, -82.53894158655955 35.791320266287606, -82.53897358657012 35.791286266284, -82.53904358659592 35.79119526627263, -82.53908658661379 35.791126266263014, -82.53913058663733 35.79102226624644, -82.53915058665638 35.79092126622788, -82.53914858667234 35.790816266206306, -82.5391135866845 35.79070026617908, -82.5390255866921 35.79055726614086, -82.53899758669283 35.790523266131025, -82.53877058669788 35.790247266051416, -82.5386935867033 35.790130266019624, -82.53866058671386 35.79002726599528, -82.53864658672431 35.78994526597714, -82.53864958674427 35.78982026595194, -82.53872458679494 35.78957426590961, -82.5387865868315 35.789405265881584, -82.53890558690877 35.78903626581877, -82.53894658694436 35.78885126578536, -82.538976586977 35.78867326575212, -82.53899658701515 35.7884492657086, -82.53902858712378 35.787784265576484, -82.53906158723177 35.787125265445695, -82.53911758728793 35.78682426539022, -82.53925558742735 35.786075265251874, -82.53929058746196 35.78589026521784, -82.53932158754633 35.78538026511718, -82.539276587588 35.78506426504821, -82.53912158764784 35.784513264919944, -82.53880158768999 35.78390026476213, -82.53866458770811 35.78363726469442, -82.5386325877231 35.78350626466448, -82.53870158778446 35.78318526460616, -82.53861358777326 35.78316326459264, -82.53835558774863 35.78304526454202, -82.53801458771619 35.782889264474996, -82.53764058768871 35.782666264391, -82.53747858768057 35.78254526434963, -82.53739658767763 35.78247626432711, -82.53722158767118 35.782330264279324, -82.53711458766864 35.78223226424835, -82.53706558766748 35.782187264234075, -82.53691358766599 35.78203426418731, -82.53679258766999 35.781879264143186, -82.53672558767666 35.78176426411289, -82.53670358768356 35.78169626409678, -82.5366765876923 35.78161126407671, -82.53666258771558 35.78144626404159, -82.53668658775631 35.781210263996044, -82.53668458778085 35.78105026396328, -82.5366685877997 35.78091226393353, -82.53661858781132 35.78078326390205, -82.53648858781885 35.78059626385057, -82.53634658781789 35.78045026380619, -82.53616158780994 35.78030326375714, -82.5360425877998 35.780241263732265, -82.53593558778854 35.78019926371267, -82.53580258777174 35.780165263692, -82.53573758776277 35.780153263682905, -82.53533258770682 35.78007926362603, -82.5351335876784 35.78004926359943, -82.53506358766683 35.780049263592105, -82.53504658767206 35.77999726357978, -82.53504358767299 35.77998826357764, -82.5349815876845 35.77984826354272, -82.53495958768842 35.77979926353045, -82.5349475876907 35.77977126352351, -82.53484858770561 35.779569263472226, -82.53483758770774 35.77954426346596, -82.53471758773313 35.77925226339412, -82.53466558775973 35.779025263342525, -82.53461558779733 35.77873026327731, -82.53460158780834 35.778644263258336, -82.53453158781191 35.77854626323119, -82.53447158780865 35.77850326321617, -82.53444358780713 35.778483263209296, -82.53434358779873 35.77843026318816, -82.53420458778133 35.77839326316631, -82.53397958774441 35.77839026314248, -82.5336785876938 35.778393263112, -82.53344958765675 35.778387263087126, -82.53337358764591 35.77837526307683, -82.53322058762438 35.77835026305599, -82.53285358757005 35.77830726300935, -82.53261158753608 35.778266262976, -82.5324925875223 35.77822826295593, -82.53238958751227 35.77818226293603, -82.53178058748138 35.77772926278093, -82.5314905874591 35.777562262717, -82.5312575874382 35.77744726266953, -82.53107358742511 35.77733526262771, -82.53089758741862 35.777188262579585, -82.53074058741707 35.777030262531255, -82.53073058741747 35.7770172625275, -82.53029958743235 35.77646026236964, -82.53003258743783 35.77613926227668, -82.5297875874409 35.77585726219409, -82.5293755874317 35.77547526207375, -82.52902458741593 35.77520126198171, -82.52850658735724 35.775025261892424, -82.52799558730483 35.774815261796924, -82.52770258727118 35.774718261746884, -82.52759058725646 35.77469326173025, -82.52733858722051 35.77465526169656, -82.5271405871889 35.77464626167424, -82.52710858718397 35.774644261670566, -82.52694458716185 35.77461126164692, -82.52684858714898 35.77459126163292, -82.5267965871418 35.77458126162557, -82.52670158713399 35.774530261605335, -82.52658658712446 35.774468261580886, -82.52657258712328 35.77446126157808, -82.52650658711957 35.774414261561645, -82.52645158711644 35.77437526154797, -82.52638658711284 35.77432926153186, -82.52629758711107 35.77424526150565, -82.52624858710993 35.77420026149136, -82.5262345871096 35.77418726148725, -82.52621458710928 35.77416826148137, -82.52619458710844 35.77415226147602, -82.52618058710783 35.774141261472394, -82.52616858710715 35.77413226146931, -82.52613558710563 35.77410726146076, -82.52612458710499 35.774099261458, -82.52607558710288 35.77406026144505, -82.52606258710232 35.77405026144168, -82.52596258709607 35.773983261417726, -82.52592258709298 35.77396026140886, -82.52586958708886 35.77393026139732, -82.52584758708707 35.77391826139262, -82.52568158707193 35.77383826135917, -82.52557358706035 35.77379726133971, -82.52550158705063 35.77378226132927, -82.52541858703754 35.77377826131984, -82.52533558702135 35.773793261314296, -82.52528158701082 35.773803261310746, -82.52469658689478 35.77392426127505, -82.52429558681453 35.77401126125139, -82.52372158669475 35.77416826122408, -82.52368358668704 35.77417726122203, -82.52351458665206 35.7742212612135, -82.52331258661142 35.774266261201795, -82.52312958657895 35.77428026118576, -82.5231125865759 35.774281261184235, -82.52290958654272 35.774277261162496, -82.52283058653038 35.774272261153264, -82.52254158648502 35.774255261120025, -82.52222458643702 35.77422526108122, -82.52208858641764 35.77420426106286, -82.5219455863986 35.77417326104181, -82.52193958639799 35.77417126104085, -82.52172158637042 35.774115261006905, -82.52164858635949 35.77410726099766, -82.52157058636224 35.774006260969145, -82.5213925863633 35.773809260910575, -82.52128558636203 35.773703260878, -82.52113458636013 35.77355326083188, -82.52073158634602 35.77321326072104, -82.52026258632932 35.77281926059244, -82.52015358632764 35.77271326055962, -82.52007858633087 35.772612260531254, -82.52007758633077 35.772611260530994, -82.5200345863372 35.77252426050884, -82.51992058636408 35.77222926043704, -82.51986258637223 35.77211526040781, -82.51982758637729 35.772045260389945, -82.51972658638644 35.77187826034555, -82.51971158638774 35.77185326033889, -82.51959758639339 35.771695260294955, -82.51942658639325 35.77151326024027, -82.51919458638841 35.77129626017212, -82.5191725863877 35.77127726016597, -82.51903358638357 35.77115526012677, -82.5189675863816 35.7710972601082, -82.51890858637998 35.77104426009133, -82.51871358637293 35.77088126003797, -82.5186095863674 35.77080526001174, -82.51854958636426 35.77076125999665, -82.51835858635182 35.77063725995169, -82.5181905863379 35.770547259916036, -82.51813558633323 35.77051825990442, -82.51808858632926 35.77049325989452, -82.51796958631773 35.77044025987145, -82.51791458631236 35.77041625986084, -82.51794658631827 35.770412259863356, -82.51802558633281 35.770403259869646, -82.5180435863364 35.770399259870686, -82.51807658634269 35.77039425987315, -82.51825558637726 35.77036325988527, -82.5184045864078 35.770326259893125, -82.5184965864264 35.770305259898294, -82.51875558648243 35.77022125990797, -82.51902058654237 35.77011925991454, -82.51922458659192 35.77001825991505, -82.51933758662067 35.76995425991371, -82.51941858664098 35.769910259913075, -82.51962158669576 35.769775259906524, -82.5196245866966 35.76977325990647, -82.5198205867528 35.76962125989572, -82.51998558680414 35.76946725988145, -82.52000158680897 35.76945325988022, -82.52006658683001 35.769387259873525, -82.52017158686408 35.76928025986257, -82.5202655868959 35.76917625985109, -82.52040458694304 35.76902125983388, -82.52043858695505 35.76898025982904, -82.52064558702779 35.76873425980026, -82.52093958712882 35.768398259762265, -82.52120358721916 35.7680992597286, -82.52125858723716 35.76804225972268, -82.52134158726444 35.76795525971354, -82.5215145873192 35.76778825969747, -82.5215545873313 35.76775325969437, -82.52171358737868 35.76761825968335, -82.52191458743557 35.76746725967335, -82.52218058750682 35.767293259665365, -82.5225835876094 35.767064259660366, -82.52258858761056 35.76706225966041, -82.52294758770068 35.76686625965753, -82.52307358773253 35.76679625965638, -82.52345158782732 35.76659025965342, -82.52357858785903 35.76652225965264, -82.52366158788 35.766476259651874, -82.52391158794256 35.76634125965024, -82.52399558796344 35.76629625964971, -82.52403658797381 35.766273259649196, -82.52415958800478 35.76620625964829, -82.52420158801512 35.76618425964811, -82.52468258813563 35.76592325964463, -82.52526858828226 35.76560625964059, -82.52612658849765 35.765138259633844, -82.5266075886183 35.76487625963009, -82.52673858865133 35.76480425962894, -82.52713358875039 35.76458925962602, -82.52726558878334 35.76451825962511, -82.52738658881405 35.76445025962374, -82.52745958883217 35.764411259623344, -82.52775358890592 35.7642512596211, -82.52787658893662 35.76418525962032, -82.5279845889638 35.76412625961948, -82.5283105890452 35.763951259617485, -82.5284195890723 35.763893259616964, -82.52930158929371 35.763412259609986, -82.52945358933182 35.76332925960882)))",6329,37,021,002804,370210028041,1136,1136,17,1118,1098,4,3,4,0,9,18,885,9,876,878,860,4,3,4,0,7,7,498,448,50
census_2010_blockgroups_view.fid--2dc29038_13ec899ba8f_-2610,"MULTIPOLYGON (((-82.5644906253034 35.56822722349635, -82.56520762547396 35.56789122350153, -82.56572462556835 35.56783622354346, -82.56636262568436 35.56777022359544, -82.56776462596754 35.567442223672614, -82.57042062655242 35.56650622375469, -82.57147562678428 35.56613722378779, -82.57154262679907 35.56611322378989, -82.57339762715839 35.565779223912195, -82.57347162714439 35.5659502239546, -82.57349262714041 35.565999223966735, -82.57362762708765 35.56648822408011, -82.57367862706846 35.56666822412201, -82.57361762705675 35.5666782241178, -82.57361662705658 35.56667822411765, -82.57365062705023 35.566756224137016, -82.57366762704628 35.56680022414777, -82.57381162701314 35.56717122423808, -82.57385962700205 35.56729522426822, -82.57389562699235 35.56739722429266, -82.5740036269631 35.567704224366274, -82.57403962695328 35.567807224390926, -82.5740766269423 35.56791822441733, -82.57413662692524 35.56809422445929, -82.57417862691618 35.568198224484846, -82.57420462691334 35.56824522449697, -82.57426362690738 35.56834722452384, -82.5742686269069 35.56835622452619, -82.57432962690497 35.5684342245483, -82.57442862690515 35.5685402245801, -82.5745596269086 35.568659224617754, -82.57532262692862 35.56935322483731, -82.57550862693007 35.569544224895296, -82.57581062693241 35.56985522498961, -82.57585462694176 35.56984222499146, -82.57597162694289 35.56996122502769, -82.57598362692657 35.570080225053175, -82.5759546268476 35.57056222514833, -82.57592862679812 35.57085622520554, -82.57592262678622 35.57092722521934, -82.57589762670617 35.571421225317344, -82.57589662670212 35.57144622532236, -82.57583962663354 35.57183022539466, -82.57583262660508 35.57200822543024, -82.57581162656756 35.57222922547303, -82.575775626501 35.5726232255496, -82.57573962641281 35.57315822565475, -82.57570262634793 35.57354022572879, -82.57569662633601 35.57361122574255, -82.57562862619784 35.57443622590362, -82.57559462613564 35.57480322597476, -82.5755726260933 35.57505522602384, -82.57550662595165 35.575905226190066, -82.57547862589043 35.5762732262621, -82.57544762584008 35.5765662263186, -82.57542262579912 35.57680622636488, -82.57536862569113 35.577450226490505, -82.57535362565973 35.57763822652724, -82.57533262564004 35.57774322654647, -82.57520362561989 35.577735226531544, -82.57481862555949 35.57771222648738, -82.57479062555498 35.5777112264843, -82.57469462553469 35.5777392264801, -82.57469562553723 35.57772422647717, -82.57470462555467 35.5776202264569, -82.5746286255454 35.57759822644464, -82.57445662552246 35.57756222641961, -82.57370862542217 35.577406226311105, -82.57345962538888 35.57735422627492, -82.57332562537094 35.577326226255494, -82.57327162536365 35.57731522624774, -82.57292662531756 35.57724222619742, -82.57279462529984 35.57721522617841, -82.57269762528696 35.577194226164146, -82.57258762527195 35.577173226148574, -82.5719666251868 35.577056226060996, -82.57176062515859 35.577017226031955, -82.57175062515721 35.57701522603048, -82.57168462514827 35.57700222602107, -82.57148962512113 35.57696822599418, -82.57090662503997 35.576866225913555, -82.57071262501304 35.57683222588672, -82.57071562502429 35.57676222587278, -82.57069862504083 35.57663622584535, -82.57065962506209 35.57645622580466, -82.57060062509458 35.57618122574271, -82.57051962513191 35.575851225667115, -82.5704526251681 35.57554322559758, -82.57043062518831 35.57538822556376, -82.57043062519595 35.57533822555366, -82.57043062520425 35.57528422554265, -82.5704466252219 35.57518722552449, -82.57050462526536 35.57496722548568, -82.57043462526175 35.57491522546791, -82.57024462526758 35.57467222539892, -82.56994662527632 35.574293225291164, -82.56951462528986 35.573739225134084, -82.56947762529101 35.57369122512051, -82.569444625293 35.57364322510732, -82.56942862529858 35.57358922509465, -82.56944062530572 35.573556225089256, -82.5694696253154 35.57352422508566, -82.56959062534246 35.57347922508898, -82.56960162534476 35.57347622508944, -82.56969362536327 35.573455225094634, -82.5698646253921 35.57345222511157, -82.5701746254443 35.5734472251424, -82.5705286255021 35.57345322517993, -82.57066262552348 35.57345922519489, -82.57086262555532 35.573468225217326, -82.57092862556514 35.57347522522546, -82.57098262560505 35.57327422519015, -82.5710126256269 35.57316422517075, -82.57106662565927 35.573012225145376, -82.5711086256887 35.57286622512004, -82.57112862571107 35.57274222509683, -82.57112962572238 35.57267022508224, -82.57113362574768 35.572510225050095, -82.57113062575436 35.57246322504021, -82.57111962577845 35.572294225004654, -82.57111562578099 35.57227422500017, -82.57109662579418 35.57216722497644, -82.57106462580433 35.572067224952775, -82.57101162581444 35.571944224922305, -82.57092062582515 35.57177622487881, -82.570903625826 35.57175222487216, -82.57083662583007 35.57165322484512, -82.5707886258298 35.57160322483003, -82.57063462582978 35.571437224780404, -82.57062762582986 35.571429224778036, -82.57056962583147 35.57135622475721, -82.57041262583276 35.57117822470492, -82.57019662583676 35.57091922462998, -82.57015462583755 35.570868224615296, -82.57008262583213 35.57082622459936, -82.57001262582494 35.57079722458632, -82.56994462581699 35.57077522457487, -82.5699306258153 35.570771224572596, -82.56983062580159 35.57075222455846, -82.56973562578736 35.570742224546684, -82.56966562577688 35.57073522453805, -82.5695096257526 35.57072422451981, -82.5694356257384 35.570737224514865, -82.56937262572454 35.5707592245129, -82.56931662570994 35.57079322451405, -82.56927262569745 35.570827224516464, -82.56927262569728 35.57082822451663, -82.56922962568109 35.57088722452427, -82.56920062566674 35.57094922453386, -82.5691806256499 35.571037224549734, -82.56914162562947 35.57112822456429, -82.56907862560941 35.57119022457046, -82.56901862559434 35.57122322457097, -82.5689386255784 35.57124122456641, -82.5688686255659 35.5712462245603, -82.56878062555325 35.571234224548824, -82.5684256255104 35.57112922449099, -82.568273625491 35.57109122446764, -82.56805662546336 35.57103722443445, -82.56794662544718 35.571023224420216, -82.56786262543372 35.57102022441104, -82.56774762541447 35.5710212243994, -82.56767762540186 35.57102722439347, -82.56763462539392 35.57103222439004, -82.56750962536971 35.57105522438191, -82.56719562530431 35.57114122436715, -82.56713662529347 35.571148224362545, -82.56710262528708 35.57115322436001, -82.56699262526892 35.57115222434858, -82.56695262526345 35.57114422434279, -82.56688862525495 35.57113122433359, -82.56680762524638 35.57109922431879, -82.5667526252433 35.571060224305214, -82.56672962524316 35.57103622429791, -82.56668162524295 35.57098522428262, -82.5665016252456 35.57077422422126, -82.56642062525071 35.570653224188256, -82.56638862525607 35.57058422417098, -82.5663736252643 35.570514224155175, -82.56637162527427 35.57044722414126, -82.56637762528247 35.570400224132385, -82.56639662530414 35.57028022410984, -82.56639962531287 35.57022622409923, -82.56638962532274 35.57015122408293, -82.56637962533047 35.57009022406948, -82.56634362533434 35.57002622405274, -82.56631162533566 35.569983224040676, -82.56625062533507 35.56992122402186, -82.56611862532932 35.56981622398689, -82.56599262532374 35.56971622395364, -82.56574862531423 35.569515223887656, -82.56526862529257 35.569137223761444, -82.5650826252858 35.56898022371037, -82.56507562528569 35.56897422370846, -82.56501162528606 35.568902223687175, -82.56486262529104 35.56870922363268, -82.56479862529089 35.56864122361222, -82.56470462526988 35.56867622360976, -82.56454062523574 35.56872122360206, -82.5643866252052 35.568753223592715, -82.5642346251775 35.56876922358039, -82.56411562515748 35.56877122356853, -82.56401462514046 35.56877322355861, -82.56381162510844 35.568762223535536, -82.56387262514558 35.56858622350595, -82.56389062515177 35.56856522350351, -82.56406962520292 35.5684262234936, -82.5644906253034 35.56822722349635)))",5250,37,021,001000,370210010003,806,806,72,790,733,37,1,7,1,11,16,642,48,594,634,590,25,1,6,1,11,8,380,348,32
census_2010_blockgroups_view.fid--2dc29038_13ec899ba8f_-260f,"MULTIPOLYGON (((-82.67363963766493 35.605835242357536, -82.67380663769646 35.605811242369796, -82.6739296377214 35.60578224237652, -82.6741266377611 35.60573724238758, -82.67426463779049 35.60569524239313, -82.67438663781333 35.60567924240242, -82.67450063783383 35.60566924241211, -82.6747226378709 35.605668242434646, -82.6748016378816 35.605684242446074, -82.67496763790372 35.605720242470426, -82.67509063792008 35.605747242488505, -82.67523963793988 35.605779242510295, -82.6754586379709 35.60581524254016, -82.67561463799464 35.605829242559004, -82.67582963802738 35.60584924258507, -82.67654163813916 35.60589324266715, -82.67675863817256 35.60591124269307, -82.67708063822359 35.60592824272958, -82.67720563824268 35.60593924274459, -82.67773563832323 35.60598924280915, -82.67804163836894 35.60602324284748, -82.67809263837651 35.60602924285394, -82.67834463841201 35.60607124288835, -82.67858163844241 35.6061302429247, -82.67877863846536 35.60619424295799, -82.67893263848097 35.606259242987, -82.67921663850967 35.60638024304078, -82.67918463848665 35.606495243060934, -82.67917163847666 35.60654624307004, -82.67911863842916 35.60679724311578, -82.67910963842006 35.60684724312502, -82.67908863839838 35.606965243146945, -82.67908363839372 35.6069902431515, -82.67905763837126 35.60710824317293, -82.67903863835389 35.60720024318974, -82.67895563828856 35.607535243249544, -82.67892163826087 35.60767824327516, -82.67890963825107 35.60772924328437, -82.67885563818622 35.608092243352765, -82.67881963815805 35.60823624337845, -82.67876563812892 35.60836724339968, -82.67872963811233 35.608436243410004, -82.67865463808401 35.608539243423316, -82.6784886380274 35.608727243444605, -82.678118637907 35.60910924348458, -82.6780116378725 35.609218243495725, -82.67792063784269 35.60931324350583, -82.67780263780332 35.609441243519804, -82.67772363777571 35.60953524353079, -82.67764063774453 35.60964824354532, -82.67758763772098 35.60974424355952, -82.6774916376657 35.60999924360163, -82.67743963762862 35.61018424363404, -82.67731763753372 35.61066924372036, -82.67728763751226 35.61077624373911, -82.67720763746478 35.61099824377613, -82.67708263740013 35.611283243821404, -82.67702763737711 35.611373243834144, -82.67699663736606 35.6114112438387, -82.67697463735983 35.61142824383988, -82.67690763734315 35.61146424384035, -82.67686563733433 35.611476243838524, -82.676816637325 35.61148324383488, -82.67645063724756 35.61159024381914, -82.67563363710222 35.611651243747765, -82.67480063697398 35.611583243648404, -82.6747036369429 35.611680243658306, -82.6746506369256 35.61173524366401, -82.67439163684324 35.61199024368946, -82.67427063680356 35.612117243702976, -82.67425263679745 35.61213724370519, -82.67417663677111 35.61222624371547, -82.6741416367584 35.61227124372105, -82.67410963674618 35.612316243726944, -82.67406663672836 35.6123852437366, -82.67394563667024 35.61263224377457, -82.67368663656643 35.613026243828294, -82.67338663647136 35.61331924385727, -82.67306063639188 35.61348324385722, -82.67301363638026 35.613508243857545, -82.6726786362965 35.61369024386023, -82.6719236361009 35.61414424387534, -82.67150363599383 35.61438524388138, -82.67129063593845 35.61451424388575, -82.67093163584482 35.614735243893996, -82.67071063578443 35.614888243902534, -82.67048963572303 35.61504824391243, -82.6703216356744 35.61518224392258, -82.67015363562477 35.615323243934085, -82.67013063561868 35.615338243934794, -82.67001663558084 35.61546024394791, -82.66992463554719 35.6155792439627, -82.66983363551165 35.61571224398053, -82.66974963547473 35.615861244002225, -82.6696806354398 35.61601324402613, -82.66962763540806 35.61616224405104, -82.6695816353762 35.61631924407842, -82.6694596352891 35.616753244154324, -82.6692226351051 35.61769224432137, -82.66917663507348 35.617848244348515, -82.66906263497688 35.618352244439535, -82.66898663490731 35.618722244507126, -82.66895263487743 35.618879244535655, -82.66890163483264 35.61911524457856, -82.66877163473833 35.61958724466142, -82.66853263462252 35.62008124473763, -82.66822463449654 35.62056624480487, -82.66790763437878 35.6209882448583, -82.66807763440356 35.621011244880435, -82.66808463440456 35.621012244881456, -82.66827763442978 35.621057244910354, -82.6685716344624 35.621163244962176, -82.66873463448049 35.62122224499091, -82.66949863456361 35.6215082451276, -82.67019163463888 35.62176924525197, -82.67131663475985 35.622200245455325, -82.6717886348112 35.62237724553979, -82.6719566348295 35.62244024556985, -82.67255363489454 35.62266324567657, -82.67293463493642 35.62280324574429, -82.67311863495604 35.62287524577787, -82.6732896349743 35.62294124580881, -82.67332663497821 35.62295624581571, -82.67373663501701 35.62314724589668, -82.67396363503222 35.623294245949936, -82.67419663504268 35.623478246011366, -82.6744196350412 35.62372924608547, -82.67465163503176 35.624041246172915, -82.67481063502989 35.624225246226715, -82.67499363503578 35.62438524627807, -82.67506863504005 35.62443824629661, -82.67512463504323 35.62447824631049, -82.67526763505462 35.624559246341654, -82.67545363507284 35.62464224637773, -82.67559763508942 35.624690246402224, -82.67579163511445 35.62473724643175, -82.67611563515963 35.624794246476604, -82.67676863525577 35.62487624656038, -82.67763263538275 35.62498624667143, -82.67970863568723 35.6252542469392, -82.67980463570125 35.62526724695173, -82.68028163577114 35.62532924701323, -82.68069063583307 35.62536924706341, -82.6806686358223 35.62541524707047, -82.68060063579932 35.625491247079005, -82.6805806357923 35.62551524708187, -82.68049563576858 35.62557724708575, -82.68040863574682 35.62562424708641, -82.68020263569923 35.62571024708281, -82.68014363568565 35.62573524708183, -82.68006063566699 35.62576624707971, -82.67998363564972 35.62579524707763, -82.67975363559819 35.625881247071604, -82.67967763558092 35.6259112470699, -82.67923963548314 35.626072247057834, -82.67909663545109 35.62612624705415, -82.67884763539375 35.626229247049594, -82.67861063533765 35.62633724704724, -82.67842163529058 35.626438247048426, -82.67824663524358 35.626554247054116, -82.67810763520166 35.626676247064786, -82.67807463519185 35.62670424706707, -82.67803663517738 35.62675724707396, -82.67793563513824 35.62690224709317, -82.67780163507634 35.627159247131836, -82.67775663505417 35.62725424714657, -82.67766463500791 35.62745524717812, -82.67762163498753 35.62754124719124, -82.67757463496501 35.627636247205736, -82.67749463492697 35.62779724723035, -82.67739963488124 35.62799124726017, -82.67708963473142 35.628629247358454, -82.67701563469977 35.62875424737629, -82.67692763466978 35.6288542473877, -82.67679863462959 35.62897524739912, -82.67677963462434 35.628989247400014, -82.67657963456594 35.62915224741269, -82.67646363453501 35.629227247416104, -82.67632763449896 35.629314247419835, -82.67623863447632 35.629365247421156, -82.67609263443873 35.62945124742371, -82.67591563439727 35.62952924742144, -82.67571663435393 35.62959524741448, -82.67550063431227 35.629632247399876, -82.67549663431147 35.62963324739962, -82.67523863426386 35.62966324737928, -82.67512763424399 35.629672247369655, -82.67503563422726 35.629681247362086, -82.67485763419593 35.62969224734605, -82.67479463418503 35.62969524734016, -82.67468463416559 35.62970224733035, -82.67438363411459 35.6297082473007, -82.67420963408694 35.62969924728097, -82.67399463405252 35.62969024725709, -82.6735856339904 35.629651247207114, -82.67319963393352 35.62960324715773, -82.6727926338746 35.62954624710432, -82.67242163382069 35.62949524705588, -82.6723226338057 35.62948524704366, -82.67215563378062 35.62946724702283, -82.67199163375412 35.62946224700496, -82.67186763373219 35.629470246993925, -82.67172863370618 35.62948924698345, -82.67168963369829 35.6294982469813, -82.67155063366975 35.629533246974205, -82.67129763361456 35.629618246965535, -82.67080163350353 35.62980224695212, -82.670279633388 35.6299882469365, -82.66988663330142 35.63012524692406, -82.66928663316905 35.63033624690549, -82.66885263307333 35.63048824689192, -82.66883163306889 35.630494246890954, -82.66852063300094 35.63059924688047, -82.66824463294161 35.63068624686985, -82.66800463289115 35.63075424685912, -82.66782063285522 35.63078924684732, -82.66754163280487 35.63081424682378, -82.66743063278572 35.630818246813185, -82.6670896327266 35.63083324678128, -82.66700363271315 35.63082824677144, -82.66694963270508 35.63082224676465, -82.6668846327258 35.63061724671619, -82.66686963274147 35.630499246690555, -82.66681363280338 35.630036246590414, -82.66675263287523 35.629504246475754, -82.66672463290934 35.62925224642149, -82.66672063292084 35.62917324640495, -82.66670863295818 35.62891824635178, -82.66669763299639 35.628658246297626, -82.66664663306517 35.62815624619003, -82.66664363306911 35.62812724618385, -82.66658363309263 35.62791024613343, -82.66653563311134 35.62773624609312, -82.66646163314111 35.62746324602986, -82.66635763316013 35.627227245971035, -82.66628563317354 35.627062245930006, -82.6662126331805 35.62693824589721, -82.66612563318898 35.62678924585788, -82.66596763319393 35.62658624580039, -82.66587963319654 35.626474245768485, -82.66585963319703 35.626449245761286, -82.66580063319877 35.62637424574001, -82.66578163319933 35.62634924573289, -82.66569063320217 35.62623324569999, -82.66566663320307 35.626201245690915, -82.66537363319632 35.62592824560522, -82.66529363319444 35.625854245581905, -82.66526363319277 35.625832245574344, -82.6652246331907 35.62580324556448, -82.66510863318435 35.625719245535464, -82.6650706331824 35.62569124552578, -82.66496563317737 35.62561024549854, -82.66493963317566 35.62559324549244, -82.66468463315863 35.62542824543258, -82.66452163314565 35.62533624539711, -82.66437963313417 35.62525724536645, -82.66433063313035 35.62522924535566, -82.66404863310434 35.625093245298984, -82.66401563310122 35.62507724529238, -82.66364863306309 35.62492824522436, -82.66301763299472 35.62469024511104, -82.66288063297972 35.624639245086584, -82.66267263295684 35.62456324504975, -82.66254863294326 35.62451724502764, -82.66217663290247 35.62438024496153, -82.66205363288887 35.624335244939736, -82.66148563282633 35.624127244838995, -82.66119663279517 35.62401724478696, -82.66062463273258 35.623805244685016, -82.66004063266863 35.623589244581, -82.659706632632 35.62346624452164, -82.65951363261091 35.623394244487145, -82.65893563254784 35.62317924438403, -82.65874363252668 35.62310824434983, -82.65847463249739 35.623008244301886, -82.65774963241746 35.62274324417347, -82.6575206323922 35.62266024413298, -82.65700963233665 35.62246824404144, -82.65675063230947 35.62236524399379, -82.65651263228541 35.62226424394879, -82.65588163222972 35.621943243818606, -82.65548863220288 35.62169324372733, -82.6552576321903 35.62152524366935, -82.6549386321715 35.62130224359115, -82.65491163216993 35.62128324358455, -82.6545696321558 35.62100524349274, -82.6542606321369 35.62079424341798, -82.65419263213415 35.62073824339962, -82.65409363212856 35.62066724337503, -82.65413663214 35.62063924337373, -82.65419263215526 35.62060124337175, -82.65420563215886 35.62059224337123, -82.65430863218505 35.620533243369806, -82.6544136322059 35.62051124337604, -82.6544596322126 35.62051724338198, -82.65459163223186 35.62053524339921, -82.65460463223374 35.62053724340097, -82.65472363224934 35.62056424341866, -82.65473863225982 35.62051224340966, -82.65480863233256 35.62011524333594, -82.65481463233839 35.6200842433302, -82.65487063241311 35.61965924324935, -82.65488563242828 35.61957724323415, -82.65489663243805 35.61952524322469, -82.65495163248376 35.61928824318204, -82.6549836325054 35.61918224316372, -82.65501763252503 35.6190912431486, -82.65506763255047 35.61898024313114, -82.65515463258956 35.61882024310746, -82.65516463259368 35.6188042431052, -82.65521163261187 35.61873724309641, -82.65527563263527 35.61865424308606, -82.65537363266834 35.61854524307389, -82.6554656326965 35.61846224306648, -82.6556206327431 35.618327243054836, -82.65579763279592 35.618175243041975, -82.65598663285552 35.61799224302414, -82.65606663288305 35.617900243013594, -82.65620263292939 35.61774624299618, -82.6565356330468 35.61734324294823, -82.65660963307285 35.617254242937676, -82.65711063324743 35.616662242868415, -82.65741763335608 35.61628824282367, -82.65756663341507 35.616066242793714, -82.65765463345333 35.615912242771415, -82.65773963349275 35.61574824274671, -82.65775063349832 35.61572424274295, -82.65787963356085 35.61545724270176, -82.65798463361847 35.61519624265931, -82.65800063363005 35.61513824264917, -82.65802963365036 35.61503824263177, -82.65804163366106 35.61498124262131, -82.65806963368438 35.61486024259955, -82.65809963372112 35.61465424256064, -82.65811463374726 35.61450024253083, -82.6581186337527 35.614469242524855, -82.65811863377284 35.61433824249817, -82.6581116337888 35.614227242474826, -82.65810763380122 35.614142242457135, -82.6580826338337 35.613904242406065, -82.6580806338344 35.61389724240443, -82.65806363384837 35.61378824238046, -82.65805363385671 35.613723242366184, -82.65802863387076 35.61360524233959, -82.65800963388186 35.61351224231863, -82.65796963389874 35.61335924228336, -82.65793363391042 35.613244242256194, -82.65786863392627 35.613071242214346, -82.65783563393445 35.61298224219282, -82.65781063394368 35.612895242172456, -82.6577996339485 35.61285224216257, -82.65779463395168 35.61282624215675, -82.65778463396052 35.61275824214185, -82.65778663397445 35.61266924212396, -82.65780163398499 35.612617242114894, -82.65780963399015 35.61259224211066, -82.65783163399968 35.61255424210511, -82.65785663401034 35.61251224209916, -82.65793763403492 35.61244024209278, -82.65804463406326 35.612371242089736, -82.65815963408996 35.6123222420915, -82.65828963411748 35.612284242097125, -82.65845563415097 35.61224624210641, -82.65862863418434 35.61221624211798, -82.65876463420994 35.61219724212807, -82.65891763423743 35.61218424214118, -82.65908063426527 35.61217924215688, -82.6591866342825 35.61218224216838, -82.65930963430063 35.612197242184074, -82.65942663431623 35.61222224220109, -82.66010963440196 35.612404242308344, -82.66023863441784 35.61244024232894, -82.66146563457556 35.61274224251634, -82.66185363462753 35.61282424257295, -82.66221463467723 35.612892242623815, -82.66297163478431 35.613015242726576, -82.66335063483906 35.613069242776476, -82.66394163492546 35.61314724285299, -82.66402063493707 35.613157242863146, -82.66420163496352 35.61318124288667, -82.66425863497179 35.61318924289413, -82.66433863498322 35.61320124290482, -82.66486263505875 35.61327724297403, -82.66496063507273 35.613292242987136, -82.66563663517009 35.61339124307669, -82.66579563519528 35.61339924309466, -82.66601363523178 35.61339824311679, -82.66619163526335 35.61338524313242, -82.66639663530182 35.61335724314779, -82.66644263531147 35.61334424314982, -82.66660063534414 35.61330324315769, -82.66695263541885 35.61319824317235, -82.6673416355016 35.61308124318846, -82.66773063558419 35.61296524320474, -82.66808463566012 35.61285524321861, -82.66841363573069 35.61275224323139, -82.66868063578984 35.61265724323943, -82.66881163582171 35.61259124323945, -82.668923635851 35.61252224323684, -82.66901263587641 35.61245324323193, -82.66908063589872 35.6123822432244, -82.6691486359234 35.61229524321367, -82.66920563594964 35.612186243197314, -82.66922363596164 35.61212824318731, -82.66925363598165 35.6120302431704, -82.66925963598976 35.61198424316168, -82.66927263600608 35.61189224314418, -82.66928463602838 35.61176024311855, -82.66928763604837 35.61163324309302, -82.66927763606368 35.61152324306953, -82.66925863607497 35.611429243048455, -82.66921563609093 35.61127824301329, -82.6691116361174 35.610994242944706, -82.6690396361402 35.610768242891204, -82.66900763616752 35.61055624284473, -82.66899863618751 35.610416242815276, -82.66900363621812 35.61022324277645, -82.66903663625403 35.61002524273944, -82.66906163627355 35.60992524272164, -82.66909763629512 35.60982424270477, -82.66918863634353 35.6096082426701, -82.66933863641081 35.6093332426294, -82.66948063646947 35.609105242597494, -82.66970763656371 35.60873824254596, -82.66976063658852 35.60863424253025, -82.66980663661208 35.608531242513884, -82.66985163663925 35.608403242492464, -82.66988863666585 35.60827024246914, -82.66999363676655 35.60772924236965, -82.67002863679684 35.60757024234082, -82.67015363690335 35.607013242240114, -82.67039463709098 35.60605424206933, -82.67047563715141 35.60574924201548, -82.67051263717579 35.60563124199527, -82.67054163719041 35.60556724198517, -82.6705726372037 35.60551424197753, -82.67061363721872 35.60546124197091, -82.67062163722144 35.6054522419699, -82.67065663723243 35.605418241966554, -82.67070363724503 35.60538724196509, -82.67075363725675 35.60536524196569, -82.67080763726801 35.605350241968225, -82.67086363727874 35.60534124197214, -82.67091363728828 35.605333241975565, -82.67097663729834 35.60533624198266, -82.67109263731291 35.605367242000874, -82.671225637326 35.605426242026574, -82.6714156373434 35.605518242064804, -82.67157363735944 35.60558524209469, -82.67204663740922 35.605773242181534, -82.67220463742726 35.605827242208775, -82.67234963744616 35.60586124223055, -82.67243563745869 35.605873242241834, -82.67249163746662 35.60588224224938, -82.67260163748365 35.60589024226231, -82.67291563753503 35.60589624229572, -82.67308463756437 35.60588824231149, -82.6731956375843 35.605879242320995, -82.67344263762816 35.60586124234266, -82.67352863764431 35.605849242349066, -82.67363963766493 35.605835242357536)))",6344,37,021,002605,370210026053,794,794,54,776,750,8,1,1,0,16,18,609,29,580,605,583,6,1,1,0,14,4,354,322,32
census_2010_blockgroups_view.fid--2dc29038_13ec899ba8f_-260e,"MULTIPOLYGON (((-82.60721660384459 35.753197265563244, -82.60740960387271 35.7532232655884, -82.60759960390011 35.75325026561356, -82.6077966039296 35.753272265638266, -82.60799260395977 35.75328726566151, -82.60803660396658 35.753291265666846, -82.60818860399083 35.75329826568397, -82.60821460399504 35.75329926568684, -82.60864460406597 35.75330326573199, -82.60885060410163 35.75329426575133, -82.60897960412385 35.75329026576388, -82.60924160417039 35.75327126578698, -82.6095146042199 35.7532452658098, -82.60988960429158 35.75318526583622, -82.61010160433297 35.753146265850084, -82.61053860442257 35.75303826587312, -82.61080360447842 35.75296226588495, -82.61103860452786 35.75289626589575, -82.61143860461385 35.752771265911434, -82.61172760467598 35.75268126592287, -82.61259660486182 35.7524152659582, -82.61288660492404 35.75232626596999, -82.6132316049981 35.752219265983754, -82.61351760505916 35.75213226599545, -82.61408360518014 35.7519602660187, -82.61426760521951 35.75190426602625, -82.61449060526702 35.75183726603554, -82.61461360529343 35.7517992660405, -82.6153156054437 35.75158426606901, -82.61577060554082 35.75144626608771, -82.61604460560064 35.7513552660974, -82.616378605677 35.751221266104565, -82.61654160571871 35.75112726610215, -82.61671760576709 35.751004266095244, -82.61751760599917 35.75036726604784, -82.61802260614513 35.749968266018584, -82.61824960620757 35.74980926600957, -82.61840960625011 35.749707266005245, -82.61861460630215 35.74959126600269, -82.61880360634618 35.749510266005665, -82.61918360643158 35.749368266015864, -82.61925560644792 35.74934026601756, -82.61937160647386 35.74929726602076, -82.61941360648315 35.749282266021986, -82.61947260649654 35.74925926602342, -82.61954560651286 35.749232266025395, -82.61963560652968 35.74922126603243, -82.61979560655892 35.74920426604543, -82.6199086065802 35.74918826605384, -82.6199996065972 35.749176266060815, -82.62021960663866 35.74914526607717, -82.6204496066795 35.74912926609753, -82.62051060669029 35.74912526610304, -82.62078160673512 35.749127266131346, -82.6210956067844 35.749146266167564, -82.62138960682793 35.74918226620527, -82.62170160687047 35.749242266249595, -82.62179860688265 35.749268266264885, -82.6220006069078 35.74932326629691, -82.62223360693501 35.74939826633619, -82.62225860693792 35.74940626634038, -82.62244360695682 35.749483266375115, -82.62247160695962 35.749495266380436, -82.62298360700781 35.74973426648188, -82.62306160701512 35.749771266497476, -82.62326760703439 35.74986826653854, -82.62335460704254 35.74990926655586, -82.62361560706648 35.75003526660842, -82.6237026070743 35.750078266626105, -82.62388360709083 35.750166266662696, -82.62436160713428 35.75039926675944, -82.62442660714001 35.750432266772805, -82.62460660715564 35.75052526681035, -82.62441760709125 35.750737266834115, -82.6241466070013 35.75102626686509, -82.623873606913 35.7513022668932, -82.62372860686598 35.751450266908414, -82.62331160672764 35.75189426695594, -82.62302560663058 35.752213266991554, -82.62240360641559 35.7529312670738, -82.62216860632664 35.75325226711505, -82.62184860619226 35.75377526718869, -82.62184060618861 35.753790267190865, -82.62169660612324 35.75405726723042, -82.62154660604998 35.75436826727841, -82.62136060596369 35.754725267332006, -82.62135060595901 35.754744267334864, -82.62122560590343 35.75496826736761, -82.62122260590205 35.75497426736858, -82.62109060585276 35.755150267390775, -82.62094660578659 35.755422267431356, -82.62086760574533 35.755603267460145, -82.62083160572435 35.75570026747624, -82.62080160570628 35.75578426749027, -82.62074360566871 35.75596426752096, -82.620720605654 35.7560342675329, -82.62066760561974 35.75619826756084, -82.620645605609 35.75624426756793, -82.6206146055933 35.75631226757864, -82.62060960559086 35.75632226758013, -82.6205946055837 35.75635226758466, -82.62059060558131 35.75636326758656, -82.62043960551554 35.75662526762438, -82.62042660550959 35.756650267628096, -82.62014260539175 35.75710426769139, -82.62002960534227 35.757302267720135, -82.61998560531838 35.75740926773739, -82.61992860528618 35.75755526776128, -82.61985760525447 35.75768326778002, -82.61983360524381 35.75772626778637, -82.61981060515971 35.75824426788951, -82.61918960501636 35.75850126787791, -82.61802960474746 35.75898926785783, -82.61677760445664 35.7595192678369, -82.61652060439694 35.75962826783266, -82.61626660433753 35.759738267828894, -82.61581360423196 35.75993226782166, -82.61548660415569 35.7600732678168, -82.61471760397777 35.76039426780298, -82.61430460388215 35.76056726779566, -82.61323460363438 35.76101526777668, -82.60847360253376 35.76299726768993, -82.60764960234393 35.76333626767408, -82.60749760230895 35.76339826767102, -82.59754760000835 35.767545267490455, -82.59626759971047 35.76809026746954, -82.59331159902442 35.76933926741929, -82.59306259896755 35.769438267413825, -82.5903235983354 35.770572267362475, -82.58876659797369 35.77123226733633, -82.58851159791509 35.77133626733128, -82.58491859708263 35.772844267268084, -82.5845635970009 35.77299026726118, -82.58307659665783 35.773605267233116, -82.58117059621657 35.77440326719912, -82.58077859612511 35.77457226719312, -82.58074759611816 35.77458326719218, -82.5798485959092 35.77496526717725, -82.57988859593543 35.77483926715574, -82.57991659596003 35.77471126713259, -82.5799525959919 35.77454426710223, -82.57999359601348 35.774449267087086, -82.58000259601715 35.774435267085174, -82.5800475960344 35.774372267076984, -82.58012859605914 35.774300267070664, -82.580198596079 35.77424726706712, -82.58024359609314 35.77420426706299, -82.58028059610828 35.77414626705495, -82.58030959612276 35.7740842670453, -82.58036759616971 35.773844267002396, -82.58042959620111 35.77370826698114, -82.5804305962016 35.77370626698081, -82.58053459623972 35.773572266964166, -82.58061459626705 35.77348226695408, -82.5806775962909 35.77339626694316, -82.58075259632513 35.77325626692233, -82.58078059634518 35.77315726690503, -82.58080659636825 35.77303626688307, -82.58081559638532 35.77293626686363, -82.5808185963908 35.77290426685744, -82.5808165963945 35.772878266851905, -82.5808525964096 35.77281926684362, -82.5808855964235 35.77276526683597, -82.58080159645634 35.77246326676582, -82.58081259649997 35.772194266712134, -82.58083159653577 35.771984266671296, -82.58086159655929 35.771865266650174, -82.58092459659784 35.771684266619786, -82.58098459662962 35.7715442665975, -82.58116759669844 35.771297266566016, -82.58136659676256 35.77109726654578, -82.58144159678878 35.77100926653559, -82.58151559681762 35.77090226652145, -82.58170259689759 35.770588266476715, -82.58184159694896 35.77040626645398, -82.5819135969724 35.770332266446324, -82.58197459699014 35.77028326644269, -82.58204159700867 35.770236266439916, -82.58231959707932 35.77007926643664, -82.58242659710567 35.77002426643646, -82.58261259715607 35.76989926643024, -82.5827675972016 35.76977226642033, -82.58283859722344 35.76970726641439, -82.58290459724502 35.76963926640733, -82.58300459728012 35.76952026639344, -82.58309059731866 35.769364266370474, -82.58313059734226 35.76925526635238, -82.5831565973627 35.76915126633391, -82.58318059737765 35.76908126632213, -82.58323059739878 35.768998266310334, -82.58327759741486 35.768945266304414, -82.58333459743243 35.76889326629971, -82.58338859744627 35.76886226629896, -82.5834665974642 35.7688302663005, -82.58370059751356 35.76876326631094, -82.58378059753166 35.76873226631286, -82.58401659758707 35.768628266315986, -82.58409959760492 35.76860226631928, -82.58420759762689 35.768577266325345, -82.58430959764596 35.76856326633299, -82.58439859766092 35.76856226634199, -82.58443759766695 35.768565266346606, -82.58448059767386 35.76856726635143, -82.58449059767523 35.76856926635286, -82.58453959768164 35.768580266360175, -82.58454659768265 35.76858126636109, -82.58461459769057 35.76860326637261, -82.58470259769824 35.76864826639085, -82.58474559770053 35.76867926640159, -82.58477759770233 35.76870226640959, -82.58498259770589 35.768899266470804, -82.58505659770853 35.76896126649109, -82.5851255977121 35.769012266508625, -82.5852825977246 35.76910026654273, -82.58528759772517 35.769102266543705, -82.58545159774236 35.769167266573845, -82.58550359774848 35.769183266582445, -82.5855445977533 35.76919626658929, -82.58559559776015 35.769207266596794, -82.5857135977758 35.76923326661428, -82.58587859780081 35.76924826663433, -82.58595159781196 35.7692552666433, -82.58597459781573 35.76925526664567, -82.58601459782238 35.76925526664981, -82.5861345978419 35.76925826666274, -82.58617459784844 35.76925926666709, -82.58647959789845 35.769264266699594, -82.58666459793106 35.76925226671624, -82.58673259794467 35.769237266720154, -82.58679059795784 35.76921526672167, -82.58684459797168 35.769184266720934, -82.58688959798664 35.76913526671561, -82.58693059800288 35.76907526670761, -82.58697059802181 35.768996266695616, -82.58700359804047 35.76891126668164, -82.58706759808629 35.768685266642294, -82.58714859813819 35.7684372666001, -82.58729059821964 35.76806526653892, -82.58737159826556 35.7678562665047, -82.58763459840604 35.7672332664049, -82.58767659843133 35.767115266385126, -82.58771359845767 35.766985266362525, -82.58777959850067 35.76677926632735, -82.58783959853068 35.76665026630722, -82.58807559862878 35.76627126625431, -82.58813559865682 35.7661552662369, -82.58824959871382 35.76591026619871, -82.5883505987728 35.76563826615371, -82.58839259880266 35.765491266128066, -82.5884235988277 35.76536326610524, -82.58847159887308 35.76512226606104, -82.58850959891882 35.764868266013195, -82.5885415989723 35.76455826595336, -82.58856059901996 35.76427126589688, -82.58855959907493 35.7639162658244, -82.58854759909462 35.76377626579467, -82.58854359911521 35.76363926576628, -82.58855459914295 35.7634722657334, -82.58858259917774 35.76327826569678, -82.58867159923349 35.76301426565217, -82.58874059926879 35.76286126562814, -82.58884359931326 35.76268526560289, -82.5888475993147 35.762680265602285, -82.58897259936153 35.76251226558093, -82.58911059940941 35.76235226556254, -82.5894385995194 35.7619952655236, -82.5899845997055 35.76138126545484, -82.59005059972631 35.76131826544879, -82.59009359974237 35.76126126544164, -82.59000259974957 35.76111726540287, -82.58999659975018 35.76110626540003, -82.58989159975667 35.76095226535782, -82.58980759975844 35.76085026532834, -82.58971159975648 35.76076026530013, -82.58967359975438 35.76073326529072, -82.58960859975033 35.760689265275076, -82.58952959974401 35.76064526525789, -82.58948559974044 35.760621265248545, -82.58936759972786 35.76057526522702, -82.58924459971273 35.760541265207365, -82.58914859969984 35.760521265193404, -82.58890059966359 35.76048826516108, -82.58871659963663 35.76046526513744, -82.58849359960477 35.76043126510751, -82.58801059953724 35.76034826504086, -82.58765659949103 35.76026626498763, -82.58724259943926 35.76015526492236, -82.58698959940878 35.76008026488098, -82.58693159940182 35.76006326487159, -82.58636859933634 35.75988126477642, -82.58599459929316 35.759758264712765, -82.58580859927163 35.75969726468127, -82.58540859922729 35.75955426461077, -82.58521359920722 35.75947426457446, -82.58501159918782 35.75938226453489, -82.58489759917784 35.75932426451127, -82.58467659915824 35.75921326446591, -82.58455259914933 35.759137264437655, -82.58448159914435 35.75909326442136, -82.58444759914241 35.759070264413175, -82.58437359913782 35.759020264395346, -82.58421759912686 35.758923264359524, -82.58413659912206 35.75886726433974, -82.5840355991161 35.75879726431505, -82.58377859910641 35.75858426424514, -82.58300759907675 35.757948264036116, -82.58296859907539 35.7579152640254, -82.58285259906896 35.757832263996505, -82.58273659906145 35.75775626396907, -82.58279259909399 35.75760626394435, -82.58280459910259 35.757564263937006, -82.58297659922192 35.75697926383549, -82.58298659922873 35.756946263829825, -82.58302259926019 35.75678226380012, -82.58303759927729 35.75668826378248, -82.58304159929325 35.756589263762756, -82.583034599309 35.75648026373982, -82.58297959932932 35.756290263695504, -82.58292859933715 35.756185263668854, -82.5828725993443 35.756079263641446, -82.58264159937376 35.75564126352836, -82.58256559938764 35.755470263485655, -82.5825225993977 35.75535926345865, -82.58248659941329 35.75522026342665, -82.58246759943121 35.75508426339698, -82.58245659946215 35.754873263352856, -82.58246759950397 35.75461526330146, -82.58249659952868 35.754487263278286, -82.58254159955142 35.754389263263036, -82.58259759957289 35.75431026325267, -82.5826775995992 35.754227263243976, -82.58276659962624 35.75414826323716, -82.58283759964692 35.75409126323277, -82.58290659966653 35.754038263229155, -82.58308559971886 35.753893263218, -82.58315259973963 35.753831263212305, -82.58323859976946 35.7537312632008, -82.5832895997896 35.7536562631908, -82.58332459980674 35.75358326317955, -82.58333259981178 35.75355926317548, -82.58338859984934 35.753377263144195, -82.58340359986737 35.753277263125305, -82.58354159999773 35.75258526299856, -82.58357660002974 35.752416262967756, -82.58368560012653 35.751909262875735, -82.58373660016153 35.751738262846104, -82.58378460018986 35.751607262824386, -82.58385160022057 35.751481262805626, -82.58390660024165 35.751404262795646, -82.58396360026076 35.751342262788825, -82.58403360027997 35.75129326278611, -82.58410560029807 35.75125426278557, -82.58419760031894 35.75121826278767, -82.58427660033533 35.75119726279158, -82.58440260035954 35.751176262800264, -82.58453360038222 35.75117126281278, -82.5848316004311 35.75117526284428, -82.58528160050173 35.75120326289633, -82.58540560052231 35.75120326290917, -82.58554460054661 35.7511962629221, -82.5855846005542 35.75119026292496, -82.58571260057789 35.75117426293486, -82.58585360060528 35.75114926294429, -82.5859926006337 35.75111526295176, -82.58655460075103 35.75096226297844, -82.5868616008139 35.75088626299461, -82.58700760084287 35.75085626300362, -82.58722160088251 35.75083026302031, -82.58723060088413 35.75082926302101, -82.58739760091395 35.75081626303559, -82.58760960095097 35.750805263055256, -82.58797860101468 35.75079026309025, -82.58815960104468 35.75079126310904, -82.58852760110251 35.75081326315146, -82.58866160112422 35.75081726316608, -82.58876560114257 35.75081026317539, -82.58886360116193 35.75079126318162, -82.58896360118382 35.75075726318497, -82.58906860120844 35.75071126318646, -82.58916560123426 35.75064826318364, -82.58921660124875 35.75061026318107, -82.58925660125986 35.75058126317929, -82.58973260140354 35.75016526314371, -82.5898306014331 35.750080263136425, -82.58986660144397 35.750049263133825, -82.59027360156429 35.749710263106685, -82.5902976015712 35.74969126310528, -82.59041260160431 35.749601263098796, -82.59049560162819 35.74953626309415, -82.59087160174165 35.74920826306607, -82.59099160178198 35.749077263051696, -82.59105260180829 35.74897326303683, -82.59105560180939 35.74896926303628, -82.59107660182492 35.7488912630226, -82.59107460183691 35.748812263006315, -82.59105160184608 35.74872826298677, -82.59102260185065 35.7486672629714, -82.590884601862 35.74844626291212, -82.59085360186985 35.74836226289182, -82.59084860188237 35.748276262873816, -82.59086160189801 35.74818926285737, -82.59088460191049 35.74813326284839, -82.59092160192533 35.748077262840745, -82.59100860195629 35.747971262828116, -82.59111160198907 35.747870262818154, -82.59119260201346 35.74780026281228, -82.59132560205725 35.74766026279748, -82.59162460215106 35.74737626277041, -82.59183060221444 35.74718926275348, -82.59200260226316 35.74705926274473, -82.59212260229607 35.74697626274018, -82.59220960231828 35.74692626273901, -82.59244560237819 35.746793262736176, -82.59246460238293 35.746783262736095, -82.59250160239243 35.746761262735475, -82.59265160243199 35.74666726273176, -82.59278360246795 35.746577262727065, -82.59291860250977 35.74645226271549, -82.59295060252043 35.74641826271184, -82.5930356025488 35.746326262701864, -82.59321260261831 35.74606826266756, -82.59335060267227 35.74586826264099, -82.5934776027254 35.7456622626121, -82.59352360274639 35.74557626259929, -82.59358960278045 35.74542726257581, -82.59361560279937 35.74533326255935, -82.59365060284112 35.74510126251566, -82.59365460287839 35.744865262467926, -82.59365860291352 35.74464326242312, -82.59365060292988 35.74452826239887, -82.59363460294264 35.74442926237708, -82.59362660294865 35.744382262366685, -82.59358560295716 35.74428326234226, -82.5935186029629 35.74417426231315, -82.59344960296177 35.744107262292445, -82.5933036029594 35.743966262248634, -82.59309460295242 35.74378626219045, -82.59281060294158 35.74355126211329, -82.59259460293532 35.74336026205215, -82.59258760293504 35.74335426205013, -82.59248960293644 35.74324026201687, -82.59242760293868 35.74315926199399, -82.59238060294447 35.74307126197121, -82.59237560294608 35.743055261967434, -82.59235560295174 35.74299726195349, -82.59235460295201 35.742994261952795, -82.59234160296462 35.742899261932095, -82.59234560297837 35.74281526191552, -82.59234860298814 35.7427552619035, -82.59236560305237 35.74235926182453, -82.59236760305613 35.74233726182029, -82.59241160313351 35.741885261732705, -82.59244260315879 35.74175526170941, -82.5924766031766 35.741677261697035, -82.59251760319202 35.74162126168988, -82.59258560321189 35.74156626168565, -82.5926866032377 35.74150826168431, -82.59289660328254 35.74144426169284, -82.59327560336351 35.741329261708515, -82.59335660338093 35.7413042617117, -82.59336460338253 35.74130226171213, -82.59355760342629 35.74122726171676, -82.59359360343534 35.74120726171638, -82.59366960345405 35.74116826171625, -82.59371160346448 35.741146261716075, -82.5938976035148 35.74102126170979, -82.5939236035228 35.740997261707584, -82.59407160356758 35.74086726169633, -82.59447660369369 35.740489261661054, -82.5946066037325 35.74037826165182, -82.59471260376375 35.74029026164488, -82.59485960380147 35.74020526164269, -82.59491760381621 35.740172261641945, -82.59506360385092 35.74010526164331, -82.59517160387402 35.74007226164772, -82.59527660389351 35.74005926165587, -82.59538460390975 35.74007026166921, -82.59546860391998 35.74009426168277, -82.59549660392345 35.74010226168734, -82.59564160393839 35.74016126171428, -82.59583660395379 35.74027126175682, -82.59627460399003 35.74050826185018, -82.5964706040081 35.74060226188958, -82.59660960402219 35.74066026191563, -82.59682660404638 35.740737261953704, -82.59714560408739 35.74081526200245, -82.59723560409945 35.740834262015596, -82.59755260414182 35.74090126206194, -82.59786560418449 35.74096226210661, -82.59802660420654 35.74099326212947, -82.5985116042727 35.74108726219863, -82.59867360429475 35.741119262221844, -82.59891760432802 35.74116626225662, -82.59931460438115 35.74125026231456, -82.59966560442886 35.74131926236477, -82.59972660443795 35.74132626237248, -82.59977960444485 35.741338262380424, -82.60007760448686 35.74138726242111, -82.60038260453285 35.741418262458815, -82.60085560460637 35.74145226251446, -82.60092560461707 35.741458262522926, -82.60109660464373 35.74147026254299, -82.60112960464875 35.74147326254704, -82.60133760468214 35.741481262570126, -82.60149560471014 35.741470262584066, -82.60158060472675 35.741454262589585, -82.60160860473296 35.74144426259043, -82.60167160474641 35.741425262593076, -82.60176760476945 35.74137926259355, -82.60177860477215 35.74137426259372, -82.6019076048046 35.74130326259253, -82.60206060484867 35.74118326258385, -82.60206560485027 35.74117826258328, -82.60224560490518 35.74101726256904, -82.60239060495337 35.74086226255243, -82.60251260499723 35.740710262534, -82.60257060502107 35.740619262521484, -82.60265660506211 35.740446262495034, -82.60269860508856 35.74032126247389, -82.6028156051608 35.7399802624165, -82.60288560520392 35.73977726238233, -82.60297660525771 35.73952826234094, -82.60302960528857 35.73938626231749, -82.60345960552786 35.738304262141284, -82.60350260555296 35.73818826212209, -82.60365360564069 35.73778426205532, -82.60367160565069 35.73773926204805, -82.60374860569404 35.73754226201584, -82.60376260570135 35.73751026201078, -82.6038526057465 35.737315261980314, -82.60392160577894 35.73718026195987, -82.60408260584498 35.736927261924926, -82.6041246058611 35.73686826191725, -82.60420760589257 35.73675426190255, -82.60427660591627 35.73667526189355, -82.60436660594723 35.73657226188185, -82.60438060595185 35.73655726188026, -82.60467860604689 35.73626426185121, -82.60471360605891 35.736224261846694, -82.60479160608509 35.73613926183739, -82.6048176060944 35.73610726183356, -82.60490360612529 35.73600026182058, -82.60495260613051 35.73601926182949, -82.60524860615239 35.736196261896005, -82.6052876061568 35.73620926190278, -82.60567460620094 35.73634026196926, -82.60584060621491 35.736428262004274, -82.60598260621816 35.73656026204584, -82.60599960621771 35.73658126205182, -82.60612960621506 35.736738262097205, -82.60624360620277 35.73694026215018, -82.60633660618784 35.73713626219964, -82.60638360616467 35.737336262245286, -82.60646760610454 35.73781426235129, -82.60651760607634 35.738050262404585, -82.60658660606725 35.73818326243882, -82.60674760605905 35.73840926250142, -82.6069116060482 35.73865526256847, -82.60699060604182 35.73878126260226, -82.60705460603687 35.73888226262938, -82.60712860601384 35.7391102626835, -82.6071566059825 35.739342262733636, -82.60716260594852 35.7395682627803, -82.60716360593784 35.73963826279469, -82.60715660592625 35.73970526280763, -82.6071286058726 35.74002126286913, -82.60710960585511 35.7401142628861, -82.60708460582981 35.740250262911275, -82.60707660582217 35.74029126291882, -82.60706560581136 35.74034926292947, -82.60703960579737 35.740411262939496, -82.60702460578862 35.740451262946046, -82.60693960574197 35.74066126298013, -82.60673260563975 35.741098263047824, -82.60671760563235 35.74113026305279, -82.60664760558053 35.74138926309832, -82.60658460549797 35.74185426318664, -82.60656260546854 35.742020263218215, -82.60654160545765 35.742068263225825, -82.60641260539124 35.74235826327161, -82.6061766052972 35.74271126331924, -82.60595060520915 35.743036263362185, -82.60573060512323 35.74335426340434, -82.60554760505141 35.74362126343988, -82.60550760503594 35.74367826344736, -82.60538960498931 35.743852263470664, -82.60535160497389 35.74391026347858, -82.60531760496052 35.743960263485256, -82.60522460492527 35.74408726350155, -82.60497260482956 35.74443426354626, -82.60483760477942 35.744613263568894, -82.60470660473058 35.744787263590815, -82.60466260471415 35.74484626359833, -82.60458260468451 35.74495126361148, -82.60444660463364 35.74513326363454, -82.60422060455436 35.74540226366604, -82.604197604546 35.7454312636696, -82.60407260449995 35.745594263689924, -82.60403860448761 35.74563726369525, -82.6039376044503 35.74576926371172, -82.60390460443801 35.745813263717295, -82.60360260433052 35.74618226376132, -82.60307260414133 35.74683326383941, -82.60288460407286 35.747072263868745, -82.60281860404365 35.747190263885955, -82.6027606040122 35.74733126390872, -82.60275760401026 35.74734026391023, -82.6027356039929 35.74742826392594, -82.6027206039813 35.74748726393641, -82.6026686039243 35.74779926399456, -82.60265860391297 35.747861264006275, -82.60264160389082 35.74798626402996, -82.60261460385416 35.7481932640693, -82.6026056038257 35.74836726410388, -82.60261160379767 35.74855426414256, -82.60261260379728 35.74855826414345, -82.60262960377142 35.74874326418297, -82.60265460374704 35.748927264223035, -82.60276860367513 35.74951326435414, -82.60281460364685 35.74974526440614, -82.60283860362338 35.7499222644447, -82.60284260361395 35.74998726445834, -82.60283860360232 35.750058264472464, -82.60282460359062 35.750118264483234, -82.60279860357367 35.750200264497245, -82.60275260355299 35.75028426450966, -82.60269460352983 35.75037126452141, -82.60243360343472 35.75070426456237, -82.6021026033121 35.75113926461685, -82.60192960324233 35.75140326465282, -82.60188260322121 35.75148926466552, -82.6018546032071 35.751550264675096, -82.6018336031963 35.751597264682516, -82.60180060317573 35.75169426469886, -82.60178460315788 35.75179226471719, -82.60178060314261 35.751886264735894, -82.60178560313389 35.751948264749046, -82.60180160312494 35.752023264766, -82.6018386031146 35.75212926479141, -82.60191360310084 35.75229826483354, -82.60206660307645 35.75262026491493, -82.6020856030734 35.752660264925055, -82.60216560305817 35.75284426497077, -82.60223360304053 35.75303126501589, -82.60229360301798 35.75324126506488, -82.602389602972 35.75364026515609, -82.60241960295765 35.75376526518467, -82.60244060294303 35.75388226521069, -82.60246560293042 35.753990265235316, -82.60255060294678 35.75397626524116, -82.602716602977 35.75395926525477, -82.60274160298097 35.75396026525755, -82.60290660300697 35.75397026527663, -82.6030196030213 35.753999265294226, -82.60318960303921 35.7540662653254, -82.60351660306712 35.75423726539387, -82.60353660306892 35.75424726539799, -82.60376660308953 35.7543612654449, -82.60381760309411 35.7543862654553, -82.60394260310723 35.75443626547829, -82.60407660312411 35.75447126549928, -82.60408360312493 35.754473265500394, -82.6041566031365 35.75447726550875, -82.60430760316116 35.754480265524954, -82.60442260318325 35.75446126553294, -82.60454160320758 35.75443226553927, -82.6046566032351 35.75437826554013, -82.60476060326346 35.754307265536305, -82.6048796033009 35.75419326552548, -82.60494560332452 35.75411226551572, -82.605155603399 35.75385726548535, -82.60527060344003 35.75371626546842, -82.60531260345566 35.75366026546139, -82.6054096034915 35.753533265445455, -82.60554460353931 35.75337026542614, -82.60567060357988 35.75324426541348, -82.60576260360612 35.75317326540846, -82.60583960362631 35.75312626540688, -82.6058706036341 35.7531092654066, -82.60603360366943 35.753056265412674, -82.60607860367803 35.75304926541578, -82.60611760368543 35.753043265418654, -82.60620760370124 35.75303826542686, -82.60630760371667 35.75304626543881, -82.60642560373473 35.75305626545303, -82.60698960381302 35.75315726553174, -82.607178603839 35.753192265558305, -82.60721660384459 35.753197265563244)))",6315,37,021,002803,370210028032,1105,1105,50,1094,1066,5,5,3,1,14,11,822,25,797,816,796,5,5,3,1,6,6,462,420,42
census_2010_blockgroups_view.fid--2dc29038_13ec899ba8f_-260d,"MULTIPOLYGON (((-82.6248646331962 35.582126232522235, -82.62491063320051 35.58214723253126, -82.62496363320707 35.58216223253971, -82.62500363321185 35.582174232546315, -82.62510163322371 35.58220323256226, -82.62522863324108 35.582227232580145, -82.62527163324752 35.582232232585625, -82.6253776332633 35.58224423259891, -82.62539063326525 35.582245232600386, -82.62543063327129 35.58224923260535, -82.62544463327337 35.58225123260723, -82.62546263327602 35.58225323260943, -82.62554463328877 35.58225923261904, -82.62581563333072 35.58227923265093, -82.62583763333404 35.58228123265369, -82.62607363336991 35.582303232682385, -82.62628963340272 35.58232323270861, -82.6266426334547 35.58236723275374, -82.62687263348792 35.58240023278406, -82.6269266334955 35.58240923279143, -82.62729363354616 35.582476232842765, -82.62756063358185 35.58253323288177, -82.62836463368879 35.582707232999645, -82.62840463369399 35.58271623300561, -82.62863163372343 35.58277023303987, -82.62856163370478 35.58281623304209, -82.62849663368459 35.58287723304789, -82.62841763366133 35.58294223305296, -82.62821963360295 35.58310823306651, -82.62809663356474 35.583224233077566, -82.62780863347517 35.58349523310315, -82.62778163346651 35.58352223310594, -82.62773963345217 35.58357023311136, -82.62771963344359 35.58360423311623, -82.62768863343044 35.583656233123676, -82.62766963341946 35.58370723313211, -82.6276666334162 35.58372523313542, -82.62764463339418 35.58384423315748, -82.62763563337778 35.583941233176255, -82.62763263336846 35.58399923318779, -82.62760563327967 35.58454723329664, -82.62760563323599 35.584831233354514, -82.62760563319327 35.585109233411096, -82.6276056331899 35.58513123341562, -82.6276076331829 35.58517823342542, -82.62760763317968 35.58519923342969, -82.62760963317653 35.585222233434564, -82.62760963316944 35.5852682334439, -82.6276086331689 35.58527023344421, -82.6276086331522 35.58537923346649, -82.627608633139 35.585465233483944, -82.62760763310297 35.58569823353137, -82.627605633012 35.58628823365135, -82.62759263299317 35.586396233671955, -82.6275876329853 35.58644223368086, -82.62756463296489 35.58655023370049, -82.6275566329517 35.586627233715376, -82.62745063293161 35.58664323370771, -82.62712763286952 35.5866972336856, -82.62709463286319 35.58670323368346, -82.6267506327983 35.586753233658335, -82.62631663271519 35.58682423362823, -82.62624463270093 35.58683923362392, -82.62606863266578 35.58687723361363, -82.62589763263065 35.58692123360504, -82.62584863262055 35.58693423360269, -82.62577863260596 35.58695323359935, -82.62543163253268 35.58705423358437, -82.62528963250297 35.58709423357788, -82.62522363248885 35.58711423357523, -82.62496963243534 35.587187233564045, -82.62486463241369 35.587215233558965, -82.62472363238422 35.58725423355243, -82.62466263237157 35.587270233549425, -82.62450063233833 35.58731123354115, -82.62407563225109 35.587419233519554, -82.6238346321997 35.587493233509875, -82.62380963219427 35.58750123350892, -82.62373163217659 35.58753223350729, -82.62365363215726 35.587573233507584, -82.62362663215016 35.58759023350836, -82.62359163214109 35.587611233508966, -82.6235826321387 35.587617233509306, -82.62351763212017 35.587667233512825, -82.62346663210332 35.587722233518726, -82.62345963210088 35.58773023351973, -82.62343363209165 35.58776223352349, -82.62340763208225 35.58779523352758, -82.62335763206067 35.58788123353997, -82.62332763204722 35.587936233548135, -82.62319763198612 35.588193233587134, -82.62316163197015 35.588258233596726, -82.62312663195426 35.58832323360632, -82.62308063193902 35.58837323361183, -82.62308163193146 35.588423233622095, -82.62309563192576 35.58847523363408, -82.62311363192237 35.588517233644474, -82.62311963192182 35.5885272336472, -82.62326863190988 35.5887652337109, -82.62338063190192 35.58893823375767, -82.6234696318957 35.58907523379474, -82.6235066318957 35.58911523380664, -82.62359563189345 35.589226233838396, -82.62371063188678 35.58939323388426, -82.62392563187355 35.589712233971255, -82.62404163186638 35.589884234018186, -82.62410663185881 35.590003234049156, -82.62413263185339 35.59006723406479, -82.6241496318473 35.59012523407839, -82.62415863183843 35.59019223409298, -82.62416363181478 35.59035123412587, -82.62415163178626 35.590524234159865, -82.62416163177586 35.59060223417679, -82.62417863176607 35.590684234195244, -82.62420663176125 35.59074623421075, -82.6242436317605 35.59079123422369, -82.62430663176312 35.59084223424054, -82.6243856317693 35.590887234257806, -82.62445663177787 35.59090823426939, -82.62455763179294 35.590919234282005, -82.6246626318129 35.5909032342895, -82.6248606318527 35.59085823430064, -82.62501363188265 35.590829234310426, -82.6253826319591 35.59073123432832, -82.62562463200892 35.59066823434038, -82.62581163204452 35.59063923435361, -82.62588263205606 35.590641234361364, -82.62601063207396 35.59066323437894, -82.62608763207894 35.590714234397254, -82.62612363207903 35.59075223440866, -82.62613063207912 35.59075923441078, -82.626213632074 35.59088223444436, -82.62634963206541 35.591085234499694, -82.62647063206123 35.591243234544315, -82.62649363206137 35.59126723455153, -82.62660263206169 35.591383234586424, -82.62652263203945 35.591441234589986, -82.62643263201427 35.591507234594175, -82.62627463197343 35.591602234597346, -82.62621363195765 35.59163923459862, -82.62618963195156 35.591652234598754, -82.6261166319338 35.59168923459884, -82.62602263190999 35.59174223460005, -82.62596663189579 35.59177423460076, -82.6257336318355 35.59191423460538, -82.62558863179494 35.592021234612275, -82.62555163178338 35.59205623461559, -82.62549063176364 35.592118234621964, -82.6254276317407 35.59219923463199, -82.62537563172143 35.59226823464081, -82.62536263171629 35.59228823464355, -82.62532663170052 35.59235123465267, -82.62530063168592 35.59241823466365, -82.62526263166428 35.59251823468007, -82.62525363165939 35.592540234683604, -82.62522963163534 35.59267023470767, -82.62521363161677 35.59277323472704, -82.6251976315922 35.59291623475448, -82.62519563158902 35.59293523475812, -82.62518963156916 35.59305723478238, -82.62519063151426 35.59341523485545, -82.62519163149568 35.593537234880394, -82.62519763146399 35.59375023492438, -82.625191631443 35.593880234950284, -82.62516263140861 35.594072234986434, -82.62514663139373 35.594151235000865, -82.62508163135261 35.594348235034325, -82.6249766312932 35.59462123507917, -82.62488563124067 35.59486423511928, -82.62481363119828 35.595062235152284, -82.624764631162 35.59524523518453, -82.62474563114364 35.59534323520255, -82.6247426311357 35.59539223521218, -82.62473963112069 35.59548623523105, -82.62474063111273 35.59553923524202, -82.62474263110533 35.59558923525234, -82.6247516310947 35.59566823526934, -82.6247936310717 35.5958632353134, -82.62484663105624 35.59602123535101, -82.62491263103702 35.596217235397766, -82.62499663100516 35.59651523546707, -82.62505863096023 35.59687423554656, -82.62507963091079 35.59721823561875, -82.62507263089226 35.59733123564107, -82.62506763087619 35.597430235660774, -82.62504863085765 35.59753023567915, -82.62501763083736 35.59762823569599, -82.6249826308214 35.5976942357058, -82.62493363080607 35.59774123571037, -82.62488263079325 35.59776923571086, -82.62484363078458 35.5977832357097, -82.62481063077804 35.597790235707755, -82.62469363075786 35.59779523569671, -82.62462763074642 35.59779823569062, -82.62432063069616 35.597793235657996, -82.62415363067097 35.59777623563748, -82.62394563064089 35.59774723561018, -82.62369763060471 35.59771423557799, -82.62360163059083 35.59770023556533, -82.6235616305852 35.59769423555996, -82.6234086305626 35.5976752355404, -82.62316563052627 35.59764923551017, -82.62315263052419 35.597648235508665, -82.62309163051468 35.59764423550155, -82.62305263050652 35.59765523549984, -82.62302363049861 35.597675235500894, -82.62288763050095 35.59751323545391, -82.62286963050127 35.59749123544753, -82.62247963051111 35.597006235308804, -82.62241663051154 35.596935235287795, -82.62225763051251 35.59675723523521, -82.62221663051292 35.59671023522145, -82.62220063051271 35.59669423521653, -82.62212063051204 35.59661223519167, -82.62201963050968 35.59651823516214, -82.6219586305083 35.596461235144254, -82.6216786304987 35.596221235066665, -82.6213916304842 35.596005234993186, -82.62132463048023 35.595958234976735, -82.62107263046573 35.595780234914606, -82.62050263043095 35.59539023477665, -82.62046163042868 35.59536123476655, -82.62041663042524 35.595334234756436, -82.62033363041971 35.59528123473715, -82.6200606304033 35.59509223467061, -82.61958563037777 35.59474523455112, -82.61933163036247 35.59457023448941, -82.61931963036163 35.594562234486524, -82.61899363034425 35.5943232344044, -82.61868463032948 35.594085234324226, -82.61861963032624 35.594036234307566, -82.61846663031909 35.59391723426762, -82.61837163031473 35.59384323424279, -82.618255630312 35.59373523420888, -82.61814663031107 35.59362323417489, -82.61788663031255 35.59333323408915, -82.6178336303128 35.59327423407171, -82.6177956303121 35.59323723406022, -82.61769063030944 35.59314123402996, -82.61763363030798 35.59308923401347, -82.61756563030502 35.59303523399549, -82.61750763030244 35.592989233980155, -82.61740763029677 35.592918233955494, -82.6172966302888 35.59284923392998, -82.61715263027739 35.592768233898695, -82.61701063026607 35.59268823386784, -82.61643363021777 35.59237923374571, -82.6162236301988 35.592275233702985, -82.616170630194 35.592249233692215, -82.6159356301663 35.592175233653, -82.61569763013154 35.5921442336223, -82.61505363002857 35.5921172335507, -82.61474962998192 35.59209223351442, -82.61415062990048 35.59197423342888, -82.61392862987348 35.59191023339303, -82.61371462985292 35.591812233351085, -82.61362962984438 35.591776233335075, -82.61349662983095 35.59171923330987, -82.61324762979363 35.59169323327892, -82.61306962975861 35.5917282332678, -82.61290962972325 35.591785233263, -82.61278362969259 35.59184823326288, -82.61195362948932 35.592273233264315, -82.61177962944481 35.59237423326698, -82.61173762943098 35.592419233271904, -82.6117156294213 35.592458233277576, -82.61169262939146 35.59262723330964, -82.61168562938305 35.592674233318434, -82.61168962938233 35.592683233320685, -82.61123062928556 35.592816233300674, -82.6110876292577 35.59284323329149, -82.61077062919605 35.59290123327084, -82.61073762919065 35.59290023326719, -82.61015462909427 35.592897233206656, -82.60967662902429 35.59283523314509, -82.60932462897276 35.592790233099734, -82.60881362889795 35.59272423303382, -82.6087846288939 35.5927192330298, -82.60717062866145 35.59248623281674, -82.60663262858388 35.59240923274579, -82.60632762854 35.59236523270554, -82.60607062850546 35.59231223266834, -82.60584062847443 35.5922652326352, -82.60536462842177 35.59209323255132, -82.6049026283866 35.59182323244889, -82.60455862837063 35.59155523235899, -82.60419562835399 35.59127123226391, -82.60410762834923 35.59120723224182, -82.60394662830629 35.59131223224667, -82.60380262826331 35.591436232257195, -82.60378862825813 35.59145423225936, -82.60368962822112 35.591588232276514, -82.60361062818673 35.591726232296544, -82.60356062815633 35.591870232320694, -82.60353562812165 35.59206823235851, -82.60354362804036 35.59260523246867, -82.60354562803043 35.592672232482506, -82.60351562799099 35.592896232525035, -82.60345962796653 35.59299423253927, -82.60357062797843 35.59303723255942, -82.6037186279962 35.59308123258359, -82.60381062800832 35.593102232597275, -82.60388862801756 35.59312623261022, -82.60391062801885 35.59314123261549, -82.60393362802039 35.59315623262088, -82.60395362801816 35.593192232630294, -82.60396062801321 35.593232232639124, -82.60396062801146 35.59324323264148, -82.60395862799966 35.59331823265644, -82.60395662798729 35.593396232672156, -82.60397562796751 35.59354523270446, -82.60397662796697 35.593550232705574, -82.60398162795688 35.59362123272054, -82.60400162791508 35.59391423278227, -82.60400862790262 35.59400323280112, -82.60400762788436 35.59412023282482, -82.60397462786567 35.59420623283899, -82.60384562784802 35.594181232820645, -82.60358962782155 35.59407723277316, -82.60343762779885 35.59406023275407, -82.60341462779523 35.59405923275162, -82.6032826277737 35.594056232737415, -82.60321862776524 35.59404223272799, -82.60313562775882 35.5939942327097, -82.60311662775294 35.59401223271133, -82.60304362773785 35.59403123270773, -82.60285762770637 35.59403523268952, -82.60238762762641 35.59404723264364, -82.60208862757932 35.59403023260948, -82.60199862756465 35.59402823259984, -82.60171262751776 35.59402423256971, -82.60137862746402 35.594012232533, -82.60037862730294 35.59397923242359, -82.60004562724924 35.593968232387155, -82.60002762726934 35.59381823235477, -82.60002662727076 35.59380823235262, -82.60002062729497 35.59364423231854, -82.60001162730552 35.59356623230176, -82.59999862731333 35.59350123228721, -82.59995362732532 35.59337523225691, -82.59989062733575 35.593239232222736, -82.59993262734764 35.59320723222053, -82.60006262738352 35.593114232214944, -82.60010562739542 35.59308323221306, -82.600754627577 35.59260423218211, -82.60270262812142 35.59117023209004, -82.60335262830294 35.59069223205952, -82.60362162837973 35.59048423204468, -82.60442962860992 35.589860232000554, -82.60469962868667 35.58965323198606, -82.60495162875718 35.58946723197401, -82.60571062896894 35.588910231938556, -82.60596362903948 35.58872523192682, -82.60672062925435 35.588146231886626, -82.60732162942466 35.58768823185498, -82.60776462954942 35.58735623183286, -82.60813862966663 35.58699823179824, -82.60842862975677 35.586725231772455, -82.60884562989393 35.58628423172547, -82.60886362990044 35.5862612317226, -82.60925563003774 35.58579223166728, -82.60945963011393 35.58551723163226, -82.60985563026975 35.58493223155376, -82.60989863028638 35.58487023154553, -82.61008463036656 35.584550231499385, -82.61027063045248 35.584192231445655, -82.61060563061697 35.58348523133597, -82.61076663071476 35.583023231258395, -82.61080963074025 35.58290323123837, -82.61098663085441 35.58235223114431, -82.61101363088187 35.58220323111671, -82.61109863096475 35.58175623103439, -82.61112763099226 35.581608231007266, -82.61114863101778 35.581465230980264, -82.61121563109441 35.581039230900394, -82.61123863111996 35.58089823087404, -82.61133063113462 35.58090223088427, -82.61136063113962 35.580902230887325, -82.61172963120046 35.58090523092581, -82.61185263122064 35.58090723093883, -82.61237163130622 35.58091123099289, -82.61261663134654 35.5809142310187, -82.61337763147255 35.58091723109738, -82.61388063155502 35.5809242311504, -82.61392863156297 35.580924231155315, -82.6144486316487 35.58092923120967, -82.61471363169247 35.58093123123729, -82.61550863182347 35.580938231320246, -82.61568863185316 35.5809402313392, -82.6157736318671 35.58094123134807, -82.61596763189903 35.58094323136841, -82.61655063199474 35.580951231429864, -82.6167456320266 35.58095423145052, -82.61688763205055 35.58095223146467, -82.61711863209008 35.580945231486915, -82.61726263211462 35.58094123150087, -82.61767963218789 35.58091523153839, -82.61810263226378 35.58087923157441, -82.61823463228811 35.58086323158475, -82.61847963233299 35.580836231604366, -82.61860563235675 35.580818231613634, -82.61895063242173 35.58076823163885, -82.61902963243661 35.580757231644725, -82.61998163261573 35.58062123171463, -82.62030463267679 35.580573231738015, -82.62072963275712 35.58051023176882, -82.62098263280507 35.580472231787084, -82.62105963281958 35.58046123179271, -82.62127163285905 35.58043323180873, -82.62143863288932 35.58041723182262, -82.6215766329126 35.580415231836355, -82.62169463293083 35.58042423185028, -82.62174863293872 35.58043123185727, -82.62178463294379 35.58043723186216, -82.62190363295848 35.580470231881144, -82.62199563296886 35.5805022318971, -82.62218063298774 35.580579231931765, -82.62234263300395 35.580649231962646, -82.62268463303805 35.58079723202786, -82.62303363307157 35.58095623209604, -82.62318463308554 35.58102923212645, -82.62336463309938 35.58113323216604, -82.62341363310308 35.58116223217702, -82.62351563311017 35.5812262322005, -82.62368163312047 35.58133923224051, -82.62372163312278 35.581367232250315, -82.62384463313029 35.58145123228006, -82.62388563313273 35.58148023229021, -82.6239986331393 35.58155923231787, -82.6243406331593 35.58179923240184, -82.6244546331658 35.58188023243005, -82.62453363317061 35.581934232449214, -82.6246846331799 35.582037232485625, -82.62477663318764 35.582086232505056, -82.62478663318858 35.58209123250707, -82.6248646331962 35.582126232522235)))",6030,37,021,001300,370210013002,1931,1931,236,1842,1370,227,4,29,69,143,89,1393,137,1256,1362,1080,141,3,21,28,89,31,821,760,61
census_2010_blockgroups_view.fid--2dc29038_13ec899ba8f_-260c,"MULTIPOLYGON (((-82.49847062710994 35.48515919982408, -82.5057916286504 35.48301720013909, -82.5064566287771 35.48290920018532, -82.50730662893882 35.48277220024463, -82.50747462897283 35.4827322002537, -82.5079816290749 35.48261420028166, -82.50809462909758 35.48258820028796, -82.50815062910875 35.48257520029103, -82.50833762914654 35.48253120030126, -82.50890062925973 35.48240120033254, -82.50908862929741 35.48235820034308, -82.50913762930846 35.482339200344235, -82.50913862930878 35.48233820034418, -82.509291629343 35.482280200347994, -82.50934262935438 35.482261200349456, -82.50938162936244 35.48225020035116, -82.50950062938664 35.48222120035742, -82.50954062939466 35.482212200359726, -82.51050062958662 35.4819972004144, -82.51094662967591 35.481896200439564, -82.5111916297247 35.48184220045374, -82.51250962998806 35.48154820052902, -82.51301563008927 35.48143520055796, -82.51338463016292 35.481353200579036, -82.5143456303548 35.48113920063402, -82.51444163037354 35.48112120064018, -82.51476163043539 35.48106320066123, -82.51492463046702 35.48103320067181, -82.5156856306142 35.480895200721726, -82.5159866306725 35.480840200741426, -82.51666463080375 35.4807162007857, -82.5172446309159 35.4806112008238, -82.51736163092914 35.48065120084396, -82.51771563096901 35.48077420090521, -82.51783363098224 35.48081520092561, -82.51836963109136 35.480682200953574, -82.51998163141907 35.48028620103825, -82.52051863152826 35.48015420106642, -82.52069963156009 35.48014220108251, -82.52074863156876 35.480138201086774, -82.52143863168999 35.48009320114823, -82.52166963173039 35.48007920116915, -82.52168863170215 35.480284201212754, -82.52174863161792 35.48089920134403, -82.52176963158998 35.481104201387794, -82.52180363154552 35.48143120145778, -82.52180863153849 35.481482201468694, -82.52181763152788 35.48156120148569, -82.5219076314123 35.48241320166824, -82.52194263136786 35.482741201738534, -82.52195263135707 35.48282220175601, -82.52198463132501 35.483066201808846, -82.52199563131428 35.48314820182665, -82.52200463129923 35.48325620184958, -82.52202763126552 35.483501201901795, -82.52203963125501 35.48358220191946, -82.52205563124102 35.48369120194331, -82.52210763115679 35.48429720207188, -82.52212663113482 35.484461202107134, -82.52217563107926 35.484877202196856, -82.52220063099786 35.48543520231288, -82.5221956309699 35.48561220234832, -82.52219463095989 35.48567620236125, -82.52215563090178 35.48601320242584, -82.5220946308114 35.48653720252617, -82.52206263077 35.486773202570895, -82.52203463073175 35.4869922026125, -82.52196263063571 35.48754120271682, -82.52191963057538 35.48788820278303, -82.52179263039451 35.48893120298206, -82.5217516303344 35.489279203048625, -82.52151463000985 35.491141203403124, -82.52147262995109 35.49147920346758, -82.52143262989294 35.49181520353175, -82.52110462941474 35.49458020406056, -82.52102162933585 35.495005204138494, -82.5209466292736 35.495330204196875, -82.52081362918747 35.495748204268274, -82.52066462910089 35.49615220433521, -82.52052362902694 35.496482204387824, -82.52044362899021 35.49663520441073, -82.52027862891322 35.49695920445972, -82.52009162883496 35.4972672045032, -82.51987962874726 35.49761020455127, -82.51966262866058 35.4979412045963, -82.51947562858345 35.49824220463832, -82.51936662854015 35.498407204660694, -82.51904262841042 35.49890320472841, -82.51893462836706 35.499069204751095, -82.51888362836186 35.499048204741584, -82.51869362834292 35.4989662047054, -82.518675628341 35.49895920470213, -82.51814762828465 35.49875620460671, -82.51799262826759 35.49869920457926, -82.51795962826392 35.498688204573625, -82.5177116282349 35.49860920453209, -82.51732362820172 35.49840620445101, -82.51717862818946 35.49833020442068, -82.51634262810438 35.497981204264036, -82.51611962808217 35.49788520422163, -82.51571862804234 35.49771220414533, -82.51555362802613 35.49763920411357, -82.51505862797764 35.4974202040183, -82.5148946279616 35.497348203986775, -82.51469562794206 35.4972602039485, -82.51410162788405 35.496997203834134, -82.51390362786455 35.49691020379611, -82.51381962785635 35.49687320377998, -82.51356762783158 35.49676220373156, -82.51348462782349 35.496725203715485, -82.51279662775612 35.49642120358312, -82.51266362774321 35.496362203557496, -82.51253262773005 35.49630620353265, -82.51195862767256 35.496061203424006, -82.51178162765453 35.49598720339079, -82.51135562760977 35.49581920331301, -82.51122962759563 35.495775203291075, -82.51049562751804 35.49548820315747, -82.50988862745413 35.49524920304666, -82.50963462742682 35.495153203001074, -82.50958662742158 35.49513520299241, -82.50912962737112 35.49497020291205, -82.50865562731786 35.494805202829895, -82.50794762723827 35.49456020270748, -82.5058266269992 35.49382820234117, -82.50556262696941 35.49373720229557, -82.5051296269253 35.49355720221455, -82.50487062690372 35.49341820215974, -82.50480562689833 35.49338320214594, -82.50460462688497 35.493253202098934, -82.50423362686547 35.49297920200515, -82.50414862686141 35.492914201983226, -82.5039166268504 35.49273520192304, -82.50379162684442 35.4926392018907, -82.50341762682646 35.49235220179396, -82.50339562682541 35.49233520178823, -82.50329362682065 35.49225620176169, -82.50326062681918 35.49223020175301, -82.50316162681433 35.49215520172763, -82.50312962681281 35.49213020171928, -82.50300262680649 35.49203420168673, -82.50294262680362 35.49198820167123, -82.50262562678837 35.491745201589346, -82.50250062678242 35.49164920155704, -82.50224962677058 35.49145520149178, -82.50173062674621 35.4910532013569, -82.5014966267348 35.490875201296625, -82.50124562672248 35.49068420123208, -82.50115162671796 35.49061220120776, -82.50099162671017 35.49049020116662, -82.50055762668899 35.49015920105474, -82.50023462667463 35.4899042009698, -82.4999846266635 35.4897072009041, -82.49956362664327 35.48938420079528, -82.49894962661381 35.48891320063648, -82.49830962658523 35.48840820046822, -82.4982956265846 35.488397200464604, -82.49789062656536 35.48808520035962, -82.49770462655681 35.48794020031105, -82.49726362653685 35.48759420019545, -82.49714662653042 35.48750920016621, -82.49695662652002 35.48737220011888, -82.49679362651061 35.4872572000788, -82.49645162649094 35.487016199994706, -82.4963066264823 35.486916199959495, -82.49614362647247 35.486804199919995, -82.49604062646615 35.486734199895224, -82.49583962645384 35.486597199846734, -82.49566162644277 35.48647719980409, -82.49531262642012 35.48624819972175, -82.49572062652977 35.48597319970774, -82.49680862676026 35.48564519975256, -82.49847062710994 35.48515919982408)))",6110,37,021,002206,370210022062,2053,2053,68,1989,1766,159,6,31,0,27,64,1686,51,1635,1658,1490,120,4,24,0,20,28,1208,1047,161
census_2010_blockgroups_view.fid--2dc29038_13ec899ba8f_-260b,"MULTIPOLYGON (((-82.41377460966584 35.507525195678554, -82.41402660973483 35.507347195668274, -82.41423960979327 35.50719619565945, -82.41426860980116 35.50717619565842, -82.41435860982479 35.50711919565611, -82.41438860983264 35.50710019565528, -82.4145846098845 35.506973195649586, -82.41478860993132 35.50688819565328, -82.41488360995085 35.506863195658, -82.4150286099805 35.50682619566533, -82.41652961025676 35.5066431957823, -82.41685661031683 35.506604195807995, -82.41707961035782 35.50657719582537, -82.4171306103673 35.506570195829184, -82.41728661039588 35.50655219584158, -82.4173386104052 35.506547195845876, -82.41745861042743 35.50653219585517, -82.4176066104545 35.506515195866946, -82.41781961049439 35.50648419588249, -82.41794061051706 35.50646719589146, -82.41819861056555 35.50642919591019, -82.4184596106224 35.506340195919, -82.41849561063005 35.5063291959204, -82.41871161068609 35.50619619591559, -82.41896561076213 35.50597519589673, -82.41919061083354 35.505752195874564, -82.4194216109112 35.5054951958461, -82.41961361098218 35.505239195813786, -82.41961461098236 35.50523919581389, -82.41976661104263 35.50501019578297, -82.41989661109886 35.50478419575039, -82.41992861111449 35.504717195740135, -82.41993461111757 35.50470319573784, -82.42002761116295 35.50450819570784, -82.42004661117376 35.504458195699605, -82.42007961119194 35.50437519568618, -82.42014561122885 35.504206195658575, -82.42017161124448 35.504132195646186, -82.42036361135843 35.50359719555722, -82.42043561140058 35.50340019552462, -82.4205246114527 35.503156195484216, -82.42068261154596 35.50271919541164, -82.4207386115749 35.50259119539135, -82.42084961162557 35.50238019535987, -82.42103761170495 35.502066195315436, -82.42120661177258 35.50180719528022, -82.42153761190684 35.50128919520894, -82.4219806120859 35.50060019511443, -82.42209261213118 35.50042619509056, -82.42269861237534 35.49948819496227, -82.42295961247389 35.49912719491571, -82.42333061260344 35.49868319486362, -82.42342361263464 35.498580194852195, -82.42365161270878 35.498342194827295, -82.4237666127461 35.49822319481491, -82.42407661284162 35.49793519478827, -82.42438561293199 35.49767919476792, -82.42446061295375 35.497618194763284, -82.42464661300622 35.4974761947535, -82.42469161301922 35.4974401947508, -82.42482861305788 35.49733619474372, -82.42487461307084 35.49730119474131, -82.42488461305895 35.497389194760224, -82.42512161301636 35.49792219489282, -82.42517361300727 35.49803719492155, -82.4253356129986 35.49826819498512, -82.42550961300536 35.49841119503208, -82.42567161301439 35.49852719507222, -82.42573861302205 35.49854919508357, -82.42601361304234 35.49871319514521, -82.42610861304799 35.49877919516828, -82.4262826130531 35.49893319521747, -82.42629661303347 35.49907619524797, -82.42616161298238 35.49926319527204, -82.42615261297016 35.49933319528539, -82.42614861296333 35.499373195293124, -82.42616861294981 35.49948319531747, -82.42628961292928 35.499747195383556, -82.42644661292924 35.49991619543398, -82.42662861292929 35.50011219549248, -82.42674261292369 35.50027119553653, -82.4269716129346 35.500447195595754, -82.42713761293764 35.50060619564512, -82.42724661293948 35.50071119567764, -82.42799261298272 35.501233195860266, -82.42815361298909 35.50136519590361, -82.42831561298885 35.50154119595601, -82.4285776129377 35.50215619610788, -82.4286176129106 35.50237619615665, -82.42860461287967 35.5025631961933, -82.42865161284446 35.502843196255064, -82.42867861283852 35.50291119627163, -82.4288396128046 35.50330519636818, -82.4289806127452 35.50384419649222, -82.42902061272999 35.50398619652511, -82.42902261272461 35.50402319653285, -82.42903461270359 35.50417319656457, -82.4289876126519 35.50445919661781, -82.42898661264773 35.504485196622994, -82.42898661262636 35.50462419665124, -82.42901361261231 35.504745196678655, -82.42904061260833 35.50480019669254, -82.42914861261097 35.50489919672383, -82.42921561259836 35.505053196761914, -82.42920861253833 35.50543719683928, -82.42924961252649 35.50555819686805, -82.42931661252238 35.50565719689503, -82.42947761252528 35.50581119694281, -82.42954461251539 35.50594819697754, -82.42956461249166 35.50612419701536, -82.42955061246896 35.50625719704096, -82.42953761244497 35.506399197068454, -82.42957861243484 35.506509197095035, -82.42973961243106 35.506707197151805, -82.42978961241984 35.50683419718276, -82.42983361240955 35.5069481972104, -82.42986761238139 35.50716819725857, -82.4298676123492 35.50737819730126, -82.4298676123341 35.507476197321175, -82.42981361229306 35.507685197358114, -82.42982661227836 35.5077951973818, -82.4299686122613 35.50805919744998, -82.43025061225406 35.5084101975503, -82.43047161223572 35.5087671976455, -82.4304976122301 35.50883219766134, -82.43062061220463 35.50913019773455, -82.43064661218862 35.50926219776407, -82.43068161218038 35.50935419778634, -82.43071461217284 35.50943819780681, -82.43073961217043 35.509481197818126, -82.43095561215051 35.509843197913824, -82.43098961214743 35.5099001979289, -82.43101961214192 35.509968197945796, -82.43112461212249 35.510207198005126, -82.431136612113 35.510282198021564, -82.43117161208808 35.510482198065844, -82.43125161207766 35.51063619810533, -82.43142661208555 35.51077319815113, -82.4317866121139 35.510976198229315, -82.43185661211956 35.511015198244465, -82.43207161213309 35.51115819829561, -82.43283161216851 35.51174619849309, -82.43289461217287 35.51178519850752, -82.43300561218038 35.51185619853331, -82.43332861221351 35.511988198593365, -82.43371161224567 35.51219119867386, -82.4339266122711 35.512257198709406, -82.43406161227992 35.51234519874112, -82.43415561227691 35.51246619877535, -82.43419561226153 35.512609198808526, -82.43426261225403 35.51273019883995, -82.4345856122661 35.5129991989278, -82.43464561226416 35.513076198949584, -82.43468661225916 35.513153198969434, -82.43472661223534 35.51335119901384, -82.43487461221935 35.513615199082665, -82.43506961222589 35.513782199136614, -82.4351036122269 35.51381219914616, -82.43518361222489 35.513911199174565, -82.43523061221248 35.514043199206135, -82.43527061215991 35.514428199288524, -82.435338612145 35.514598199330024, -82.43542461213971 35.51472519936463, -82.43547961213629 35.51480719938703, -82.43550661211532 35.51497219942327, -82.43549261206239 35.51530219948889, -82.43556061204488 35.51548919953386, -82.43566761204079 35.51563119957374, -82.43571461201473 35.51585119962328, -82.43574861191392 35.516544199767566, -82.43581561188269 35.516819199830294, -82.43582861188074 35.516846199837104, -82.43590961188153 35.51692819986211, -82.43597661188751 35.516961199875745, -82.43609761190415 35.51698319989261, -82.43620561190589 35.51708819992501, -82.4362056118823 35.51724219995636, -82.43614461185112 35.51737919997792, -82.43615861183825 35.517478199999466, -82.43623861184224 35.51753820001982, -82.43634661185672 35.51756020003544, -82.43657461190458 35.517494200045455, -82.43664261191581 35.51749420005236, -82.43668261191736 35.517527200063235, -82.43670961191172 35.51759320007939, -82.436723611887 35.51776920011662, -82.43676361186827 35.51793420015428, -82.43683061186408 35.51803320018125, -82.43706561187254 35.51823120024563, -82.43720061189245 35.51824720026274, -82.43747561194635 35.51819220027975, -82.4377986120032 35.518170200308504, -82.43802661203917 35.51818120033415, -82.43830961209018 35.5181542003577, -82.43864561216431 35.5180332003676, -82.43882061220681 35.51794520036773, -82.43911661226764 35.51786820038249, -82.43917461227569 35.51787820039041, -82.43904461223941 35.51797420039658, -82.43892561220746 35.518054200400634, -82.43861061212255 35.51826720041158, -82.43843361207169 35.51840820042212, -82.43830661203047 35.51853920043564, -82.43823461200276 35.51864220044917, -82.438215611995 35.51867220045336, -82.43813561195493 35.518847200480685, -82.43811061193955 35.518920200492936, -82.4380016118736 35.51923220054511, -82.43794561184731 35.51934320056197, -82.43793161184026 35.51937420056679, -82.43786261181181 35.519484200582056, -82.4377656117757 35.519615200598764, -82.43764261173196 35.519767200617046, -82.4374856116836 35.51991320063054, -82.43734561164398 35.52002020063793, -82.43711761158582 35.520153200641545, -82.43694861154447 35.52024020064186, -82.43692461153857 35.52025320064196, -82.43687761152738 35.52027520064162, -82.43683161151577 35.520301200642194, -82.4366866114803 35.52037620064252, -82.4365526114449 35.52046220064625, -82.43641061140403 35.52057520065462, -82.4362806113646 35.520692200665096, -82.43613461131815 35.52083720067951, -82.43600261128107 35.52093620068611, -82.4358976112548 35.52099420068706, -82.43584761124224 35.52102220068763, -82.43565661119959 35.521094200682676, -82.43545161115753 35.52114720067242, -82.43528961112693 35.521172200660835, -82.4351046110941 35.52118620064468, -82.43494761106801 35.52118720062876, -82.4346686110248 35.52116820059624, -82.43388361091047 35.521067200495054, -82.43364361087384 35.52104720046636, -82.43346861084602 35.521040200447, -82.43339461083374 35.52104020043941, -82.43310961078612 35.521043200410716, -82.43254861068871 35.52107320035917, -82.43243061066732 35.52108520034945, -82.43228361063737 35.52112220034191, -82.43214761060716 35.52117220033815, -82.43202061057497 35.521245200339905, -82.43198261056408 35.52127520034209, -82.43168561047789 35.521516200360615, -82.43155761044277 35.521607200365864, -82.43141061040662 35.52168420036643, -82.43115661034768 35.52179420036271, -82.43079561026181 35.52196420036019, -82.43039661016421 35.522170200361025, -82.42985561003148 35.5224512003626, -82.42942060992442 35.52268020036444, -82.42902960982937 35.522877200364256, -82.42897160981538 35.5229062003642, -82.42890360979833 35.52294420036493, -82.4287936097798 35.52294620035408, -82.42875060977242 35.52294820035004, -82.4284646097276 35.5229322003174, -82.42842960972185 35.522931200313636, -82.42835560970934 35.522933200306426, -82.42831160970192 35.52293420030208, -82.42801460965363 35.522929200270575, -82.42773460960785 35.522925200241026, -82.42761560958978 35.522915200226784, -82.42748860956847 35.522917200214124, -82.42699160948331 35.52293620016691, -82.42688360946468 35.522941200156836, -82.4266516094258 35.52294420013366, -82.42652560940549 35.52294120012003, -82.42630760936859 35.522946200098666, -82.4260946093351 35.522935200074635, -82.42599660932119 35.52292020006147, -82.42566860928238 35.52282020000749, -82.42546560925997 35.522747199971754, -82.42533460924538 35.52270119994898, -82.42521660923032 35.52267219993092, -82.42509760921634 35.522635199911235, -82.42499060920464 35.52259619989226, -82.42486160918911 35.52255819987132, -82.42474560917194 35.522545199856786, -82.42464060915445 35.52254619984619, -82.42452360913367 35.52255519983604, -82.42442760911534 35.52257119982938, -82.42433060909606 35.522592199823656, -82.42415160905708 35.52265319981767, -82.42409160903888 35.522707199822506, -82.42404160901975 35.522778199831805, -82.42401760900297 35.52286119984619, -82.42401760899135 35.52293719986167, -82.4240236089841 35.52299019987303, -82.42403660897165 35.52308519989366, -82.42409260894547 35.52331619994634, -82.42416960892241 35.5235492000016, -82.42417360891415 35.523607200013764, -82.42412760889833 35.5236602000198, -82.42403660887801 35.52369420001735, -82.42387260884585 35.52372720000725, -82.42363060880002 35.52376519999015, -82.42350960877849 35.523775199979696, -82.42326760873772 35.52378019995589, -82.42295160868281 35.52379719992683, -82.4229476086822 35.5237971999264, -82.42269460863663 35.52382119990532, -82.42250260860061 35.5238491998913, -82.42229660856425 35.52386419987321, -82.4221436085414 35.52384819985418, -82.42174460848645 35.52377619979862, -82.42171260847499 35.52381619980345, -82.42161960844088 35.52393819981867, -82.4215886084294 35.52397919982382, -82.4212566084054 35.523778199748854, -82.42046660834829 35.52330019957062, -82.42027460833322 35.52319119952874, -82.42026060833203 35.52318419952588, -82.42011460831853 35.52311519949683, -82.41990560829692 35.52303119945829, -82.41973660827819 35.52297119942877, -82.41953560825398 35.52291219939613, -82.41951860825174 35.52290819939357, -82.41930460822341 35.522862199362216, -82.41905260818805 35.522821199327986, -82.41883560815572 35.522798199301086, -82.4186586081279 35.52278919928099, -82.41848560809926 35.52278919926328, -82.41838060808122 35.52279319925331, -82.41829360806629 35.522797199245154, -82.418103608032 35.52281619922954, -82.41799560801145 35.52283319922184, -82.41787460798867 35.522851199213115, -82.41768960795213 35.522890199201974, -82.41692060779961 35.523055199156495, -82.41677760777111 35.52308619914814, -82.41647460771078 35.523153199130654, -82.41620060765624 35.52321319911466, -82.41537860749267 35.52339319906675, -82.41510560743811 35.523454199051166, -82.4144556073087 35.52359719901337, -82.41386160719036 35.52372819897894, -82.4127056069599 35.523984198912224, -82.41268460695532 35.523991198911496, -82.41250760692081 35.52402519890016, -82.41239060689789 35.524048198892814, -82.41212260684773 35.52408619887309, -82.41184860679921 35.52410719884918, -82.41181260679339 35.52410619884522, -82.41170460677561 35.52410619883418, -82.41166860676965 35.524106198830495, -82.41157660675462 35.52410519882081, -82.4115696067536 35.524104198819906, -82.41127460670822 35.52408219878506, -82.4112646067065 35.52408219878405, -82.41117660669333 35.52407319877319, -82.4109216066554 35.52404619874153, -82.4109036066529 35.52404319873904, -82.41063160661291 35.52401019870439, -82.41008860653365 35.52394219863482, -82.40981760649406 35.523908198600004, -82.40975860648561 35.523900198592315, -82.40958460645997 35.52387919857024, -82.40952660645152 35.523872198562856, -82.40946360644233 35.52386419855475, -82.40938260643044 35.523854198544406, -82.40927760641523 35.523840198530756, -82.40921560640626 35.52383219852275, -82.40913560639473 35.523821198512294, -82.4088976063601 35.52379019848155, -82.4088186063486 35.52378019847145, -82.40870560633219 35.52376519845668, -82.4083676062832 35.523720198412846, -82.40825560626685 35.52370619839849, -82.40790460621596 35.52366019835307, -82.40685160606276 35.52352419821729, -82.40650160601187 35.523479198172176, -82.40623160597323 35.52344019813653, -82.40616060596298 35.52343019812718, -82.40595260593601 35.52338219809606, -82.40575860591349 35.52332019806354, -82.4055806058959 35.52324319802956, -82.4054626058862 35.523179198004506, -82.40543860588404 35.523167197999555, -82.40523560587162 35.52303019795089, -82.40510060586692 35.52291519791369, -82.40502160586715 35.522829197888065, -82.40497860586719 35.52278219787407, -82.4048616058717 35.522627197830616, -82.40476060588391 35.52243919778201, -82.40468960590017 35.52225719773773, -82.40463660592289 35.52205219769067, -82.40463460592433 35.52204119768822, -82.40458560595879 35.52176419762698, -82.40454460598862 35.52152619757441, -82.404421606078 35.52081219741667, -82.40438060610768 35.52057519736434, -82.40435160612857 35.52040819732751, -82.40430460615477 35.52018719727774, -82.40425560617572 35.519998197234315, -82.40422360618486 35.519904197211915, -82.40417960619753 35.519774197181015, -82.40409960621423 35.51958019713339, -82.40403060622474 35.51943719709726, -82.40389660624005 35.51919319703391, -82.40375060625074 35.51896719697303, -82.40356760625677 35.51873119690631, -82.40340660625837 35.5185471968524, -82.4032386062566 35.518378196800796, -82.40307460625272 35.5182271967533, -82.40306460625227 35.51821919675065, -82.40290760624572 35.51809319670896, -82.40272560623637 35.517958196662754, -82.40259860622876 35.517871196632086, -82.40250760622249 35.51781419661114, -82.40256060624372 35.51773319660013, -82.40263160627177 35.51762719658591, -82.4027126063065 35.51748819656599, -82.40276160632722 35.5174061965544, -82.40284260636197 35.51726719653443, -82.40306560645492 35.51690219648322, -82.40319860651019 35.51668519645282, -82.403313606558 35.51649819642662, -82.40357360666506 35.51608119636864, -82.4036776067021 35.5159521963532, -82.40377760673286 35.515859196344536, -82.40388660676209 35.51578619634091, -82.40400660679146 35.51572419634063, -82.40416760682555 35.51567519634719, -82.40432960685659 35.515648196358356, -82.40452660689067 35.51563819637657, -82.40461660690578 35.51563619638538, -82.4047666069309 35.51563419640045, -82.40502760697328 35.515639196428225, -82.40524460700922 35.51563919645059, -82.40608760714794 35.51564319653794, -82.40638060719434 35.51565619657073, -82.40643160720231 35.515659196576514, -82.40664760723557 35.51567519660198, -82.40677860725458 35.51569219661889, -82.40693060727665 35.515712196638525, -82.40717860731074 35.51575719667321, -82.40744860734611 35.515817196713094, -82.4074526073466 35.5158181967137, -82.40778760738925 35.51590119676498, -82.40810260742977 35.51597619681266, -82.4081996074421 35.51600019682746, -82.40839860747043 35.51603019685395, -82.40858960750012 35.51604219687606, -82.40882260754084 35.516028196897125, -82.40893660756274 35.516008196904764, -82.40901460757777 35.51599419690998, -82.409062607588 35.51597919691187, -82.40923460762441 35.51592719691897, -82.40936760765535 35.51586919692084, -82.4094066076644 35.5158521969214, -82.40954560769929 35.51577419691979, -82.40961660771939 35.51572019691617, -82.4097006077428 35.515658196912185, -82.40982960778351 35.51553219689987, -82.4099326078201 35.51540519688466, -82.41003160786391 35.5152261968584, -82.41009160789808 35.515068196832466, -82.41010060790761 35.51501619682284, -82.41012560793283 35.51487919679764, -82.41012660795617 35.51472819676698, -82.4101056079736 35.514592196737254, -82.4100956079833 35.51451819672116, -82.41008160799377 35.51443519670285, -82.41002160803527 35.51410019662872, -82.40996060806685 35.51382919656736, -82.40994660811668 35.513490196497116, -82.40995460816531 35.51318219643531, -82.40996360821944 35.51283919636652, -82.41001260836153 35.51196719619446, -82.410037608392 35.51179619616226, -82.41008860842281 35.51165019613783, -82.41015460845624 35.511504196115006, -82.41029060850835 35.51131119608975, -82.41035660853369 35.51121719607746, -82.41051460859224 35.51100619605084, -82.4115556089746 35.50963719587972, -82.41170760903077 35.50943519585421, -82.41213560918602 35.5088851957865, -82.41227960923611 35.50871419576655, -82.41250160930795 35.50848519574283, -82.4127916093946 35.50823319572142, -82.41311960948748 35.50798119570389, -82.41377460966584 35.507525195678554)))",6312,37,021,003203,370210032032,1278,1278,13,1251,1198,44,7,1,0,1,27,1017,9,1008,999,964,26,7,1,0,1,18,493,445,48
census_2010_blockgroups_view.fid--2dc29038_13ec899ba8f_-260a,"MULTIPOLYGON (((-82.60061163040417 35.574067228392344, -82.60077163045723 35.57389522837372, -82.60111063056726 35.57354622833743, -82.6011476305794 35.57350722833326, -82.6012616306174 35.573383228319756, -82.6014416306746 35.57320522830201, -82.60153763070612 35.57310422829128, -82.60167863075243 35.57295522827536, -82.60210463089163 35.572510228228445, -82.60224663093798 35.57236222821289, -82.60230163095613 35.57230322820651, -82.60232263096293 35.57228222820443, -82.60247163101036 35.57213422818952, -82.60252963102866 35.57207822818408, -82.60253363102991 35.572074228183716, -82.60255263103632 35.57205322818138, -82.60262163105949 35.571977228173, -82.60264563106709 35.57195322817052, -82.60288863110125 35.57199422820379, -82.60296163111256 35.5719992282123, -82.60305863112744 35.572007228223946, -82.60345463119006 35.572028228268806, -82.60392063126278 35.57205822832279, -82.60395363126781 35.57206122832671, -82.60424063131326 35.572076228359236, -82.60452663135804 35.57209422839223, -82.6050056314327 35.572126228447914, -82.60538463149261 35.572146228490865, -82.60567163153776 35.57216222852361, -82.6056826315396 35.57216222852471, -82.60573063154698 35.57216622853045, -82.60573563154782 35.57216622853092, -82.60571463150822 35.572401228576645, -82.6056746314291 35.572872228668494, -82.6056636313908 35.57311022871582, -82.60566363138905 35.57312122871809, -82.60563963135047 35.57334622876142, -82.60562963133454 35.57343922877934, -82.60560663129658 35.57366122882217, -82.60560163128653 35.57372122883391, -82.60559463127095 35.57381522885228, -82.60558963126057 35.57387722886445, -82.60558363123401 35.574043228897615, -82.60557663119303 35.57430222894967, -82.60554363113056 35.57467322902178, -82.60553963112145 35.574728229032566, -82.605531631096 35.574885229063746, -82.60552063108321 35.57495622907712, -82.6055056310664 35.5750492290945, -82.60548263101451 35.57536222915587, -82.60547063098495 35.57554122919112, -82.60546063094793 35.575771229236935, -82.6054206308801 35.576169229313905, -82.60540963083665 35.57644022936797, -82.60539863081277 35.576583229395936, -82.60539163079487 35.57669222941743, -82.60538763074817 35.5769922294781, -82.60521763071677 35.57701222946472, -82.60509863069471 35.57702722945558, -82.604882630651 35.57707822944384, -82.6047796306211 35.57716122945015, -82.60476263061287 35.5771962294555, -82.60471663058993 35.57729622947119, -82.60469463057748 35.577353229480536, -82.60466963056378 35.57741522949059, -82.6045946305221 35.577605229521545, -82.60458863051834 35.57762322952459, -82.60455963050752 35.57766222952957, -82.60469163051886 35.577731229557216, -82.60505963054997 35.57792622963471, -82.60508563055174 35.57794322964082, -82.60516063055681 35.57799122965826, -82.60517963055112 35.57804922967201, -82.60518363054985 35.578061229674894, -82.60514763049778 35.57836122973231, -82.60512463044222 35.57869722979834, -82.60511763040964 35.578902229839365, -82.60511563039523 35.57899322985772, -82.60507163028325 35.5796742299919, -82.605093630164 35.580473230156905, -82.60507463003124 35.581316230326635, -82.60506863000636 35.5814712303576, -82.60505562994125 35.58188123043973, -82.60504062992777 35.581952230452686, -82.60498462990883 35.58201523045976, -82.60484362986364 35.58215623047398, -82.60477362984298 35.582215230478866, -82.60460762983722 35.582073230432826, -82.60430862982676 35.58181823035022, -82.6041186298187 35.58166523029958, -82.60410362981774 35.581655230296015, -82.60392262980614 35.581535230253, -82.60390862980563 35.581523230249154, -82.60383162979929 35.58148123023266, -82.60380562979731 35.581466230226916, -82.60370562978957 35.581408230204815, -82.6036996297891 35.581405230203664, -82.60349962976873 35.58132123016605, -82.60338262975384 35.58129123014787, -82.60327162973961 35.581264230130934, -82.60308462971271 35.58123723010632, -82.60303662970566 35.58123123010018, -82.6025196296239 35.58120423004157, -82.60233162959403 35.58119523002051, -82.6021716295701 35.58117823000061, -82.60207062955479 35.5811682299882, -82.60176262951062 35.58112322994747, -82.60169562950131 35.58111122993816, -82.6015376294792 35.581084229916414, -82.60140362946107 35.58105722989718, -82.60116862942911 35.58101122986367, -82.60100262940593 35.5809822298407, -82.60086962938728 35.58096022982257, -82.60070662936297 35.58094222980216, -82.60056762934212 35.580927229784834, -82.60021562928648 35.58090922974505, -82.60005262926043 35.58090222972692, -82.59978562921773 35.580891229697286, -82.59958562918561 35.580884229675334, -82.59935362915088 35.58085922964639, -82.5989886290981 35.580808229598595, -82.59872462905999 35.58077122956394, -82.59845762902248 35.58072622952742, -82.59835962900866 35.58071022951405, -82.59813662897915 35.58066122948121, -82.59793762895681 35.58059122944654, -82.59769362893488 35.58047022939691, -82.59745162891305 35.580351229347805, -82.59734562890418 35.580294229325276, -82.597187628891 35.58020922929182, -82.59703062887903 35.58011722925691, -82.59692762887131 35.58005622923394, -82.59671862885658 35.579926229185986, -82.59663862885095 35.579876229167624, -82.59637362883522 35.57969222910297, -82.59611762882159 35.57950422903844, -82.5959206288112 35.579359228988665, -82.59570762879875 35.57921022893643, -82.59567862879653 35.579193228930045, -82.59546362878 35.5790682288825, -82.59490462873109 35.578782228766876, -82.59464462870835 35.57864922871307, -82.59457562870259 35.57861222869847, -82.59436862868478 35.57850422865523, -82.59429962867891 35.57846822864085, -82.59444262871158 35.578410228643754, -82.59461162874163 35.57839722865841, -82.59473662876337 35.578391228670014, -82.59486662878581 35.57838522868208, -82.59519462884187 35.57837522871374, -82.59551662889588 35.57837222874617, -82.5957386289342 35.57836222876694, -82.59595162897395 35.57833422878307, -82.59607962899995 35.578303228789935, -82.59617462901917 35.578281228795184, -82.59639462906728 35.578206228802514, -82.59650262909317 35.57815422880305, -82.59657662911087 35.57811922880347, -82.5967586291566 35.57801822880158, -82.59688362919091 35.57793022879644, -82.59689162919332 35.57792322879587, -82.59698762922065 35.57784922879064, -82.59709162925314 35.57775022878118, -82.59721062929262 35.57762222876732, -82.59731062932832 35.57749822875235, -82.5974176293609 35.577401228743526, -82.59757462940232 35.5773022287395, -82.59794862949698 35.57709022873471, -82.59834362959691 35.57686722872986, -82.59842462961775 35.576819228728375, -82.5986026296629 35.57671822872603, -82.59867162968007 35.57668122872565, -82.59875562970078 35.5766372287253, -82.59882862971868 35.57659922872502, -82.59901862976828 35.57648222872073, -82.5991846298169 35.5763452287098, -82.59922162983072 35.57629522870345, -82.59931862986603 35.576170228687964, -82.59942962991624 35.575964228657355, -82.59956762998388 35.57567322861225, -82.59961963000892 35.57556622859582, -82.5998796301278 35.57507422852224, -82.59999363018301 35.574838228485945, -82.60010863023145 35.5746472284589, -82.60022263027507 35.57448722843801, -82.60032963031347 35.5743532284217, -82.60039063033295 35.57429222841547, -82.60061163040417 35.574067228392344)))",5712,37,021,001200,370210012003,789,789,43,774,725,31,3,1,0,14,15,647,31,616,636,601,21,2,1,0,11,11,385,364,21
census_2010_blockgroups_view.fid--2dc29038_13ec899ba8f_-2609,"MULTIPOLYGON (((-82.72699366145034 35.50868322801509, -82.72701466144188 35.508761228033194, -82.72703366143476 35.508828228048785, -82.72707366142085 35.508963228080376, -82.72708866141399 35.50902422809434, -82.72712866140395 35.50913322812062, -82.7271356614022 35.50915222812528, -82.72715766139673 35.50921222813968, -82.72726266138632 35.5093942281876, -82.72736866138594 35.50951222822252, -82.7274786613885 35.50961522825474, -82.72749066138927 35.509623228257546, -82.7276546613991 35.509737228297666, -82.72767266140025 35.50974922830192, -82.72770766140306 35.50976922830955, -82.72773366140507 35.509784228315254, -82.72780266140924 35.50983222833214, -82.72786466141416 35.50986722834563, -82.72791866141827 35.50989922835771, -82.72801066142517 35.50995422837826, -82.72815866143821 35.510030228408915, -82.7284246614614 35.51016822846426, -82.72851566146821 35.510222228484594, -82.72858566147242 35.51027122850171, -82.72866266147696 35.51032522852061, -82.72870266147798 35.51036222853231, -82.72879866147682 35.51047422856496, -82.72881666147536 35.5105032285727, -82.72888566147056 35.51061022860152, -82.72892466146631 35.5106802286198, -82.72896166146387 35.51073622863498, -82.72900966146072 35.51080922865484, -82.72910866145419 35.51095922869557, -82.72916366145394 35.51102122871383, -82.72918966145379 35.51105022872239, -82.7292186614525 35.51109022873347, -82.72925266145113 35.51113622874632, -82.72928266145128 35.51116822875594, -82.72940066145145 35.511295228793905, -82.72950566145671 35.511375228820995, -82.72958266146051 35.51143422884088, -82.7295876614609 35.511437228842006, -82.72965366146516 35.51148122885775, -82.72975666147157 35.51155122888252, -82.72985266147731 35.51161822890601, -82.72990266148025 35.51165322891825, -82.72991866148112 35.51166522892232, -82.72992466148155 35.51166922892377, -82.72994466148252 35.51168422892886, -82.72995166148281 35.51169022893085, -82.72999766148477 35.51172722894309, -82.73002166148592 35.51174522894918, -82.73002466148607 35.51174822895009, -82.73018566149143 35.51188822899512, -82.73022666149352 35.51191922900564, -82.73027166149582 35.51195322901723, -82.73030066149792 35.51197122902381, -82.73032166149943 35.51198422902865, -82.73033666150039 35.51199422903219, -82.7303896615052 35.51202022904286, -82.73041266150722 35.51203222904772, -82.73043066150883 35.512041229051384, -82.73044566151015 35.51204922905457, -82.73048966151546 35.51206222906172, -82.73051066151785 35.51206922906522, -82.73055266152305 35.512081229071974, -82.73056066152395 35.512084229073395, -82.73068466154133 35.512105229090366, -82.73072966154764 35.512113229096606, -82.73082066156047 35.51212822910904, -82.73093366157482 35.51215722912645, -82.73095866157799 35.51216422913047, -82.73101166158432 35.51218022913915, -82.73105866158882 35.51220222914844, -82.73146466161279 35.51248722924812, -82.7315886616201 35.51257422927848, -82.73163366162191 35.51261122929068, -82.73167766162383 35.51264722930247, -82.7317566616259 35.51271922932522, -82.73180966162614 35.51277522934208, -82.73184766162288 35.51283822935883, -82.73187366161801 35.51289822937373, -82.73188766160229 35.513016229399206, -82.7318856615914 35.51308522941307, -82.7318766615802 35.513148229425, -82.73183266154784 35.513312229453994, -82.73179866152658 35.51341422947133, -82.73170266147176 35.51366822951329, -82.73166366144581 35.51379522953515, -82.73165066142975 35.513886229552405, -82.73164866141511 35.51397922957119, -82.73156766138788 35.514069229581246, -82.73151266136514 35.51415822959372, -82.73147066134956 35.51421422960086, -82.73141466133167 35.5142702296066, -82.73125766127862 35.514446229626394, -82.73117866125375 35.51452222963386, -82.73110866123358 35.51457822963809, -82.73109866123035 35.51458822963916, -82.73103866121197 35.51464322964422, -82.73103666121145 35.514644229644176, -82.73099466119963 35.51467622964647, -82.73091066117233 35.514763229655564, -82.73086966115534 35.51482922966483, -82.73084866114635 35.51486522967001, -82.73083166113776 35.514903229676, -82.73079866112089 35.51497722968778, -82.73073166108621 35.515131229712324, -82.73069866107024 35.51519922972279, -82.7306636610531 35.51527322973432, -82.73066266105249 35.51527622973487, -82.73061966103036 35.51537422975044, -82.73060466102191 35.5154132297568, -82.73058066100731 35.51548222976844, -82.73051966097833 35.515605229787255, -82.73042266092749 35.51583222982369, -82.73039366091193 35.51590222983497, -82.73036766089646 35.51597522984716, -82.73031566086604 35.516117229870865, -82.7302836608466 35.51620922988628, -82.73019866079973 35.51642322992125, -82.73016366077553 35.51654322994222, -82.73016266077526 35.51654422994226, -82.73011366075028 35.51665422995969, -82.73009666074327 35.51668122996348, -82.7300646607268 35.51675422997504, -82.7300286607075 35.51684122998909, -82.73004366069233 35.51695623001412, -82.73004766068858 35.516985230020396, -82.73005866067815 35.517065230037886, -82.72996266064705 35.51716423004825, -82.72970766054564 35.517549230100634, -82.72955066049724 35.51769523011435, -82.72947866047475 35.51776323012089, -82.72877366023779 35.518544230208015, -82.72852766014242 35.51890023025546, -82.72830366005539 35.519225230298844, -82.7281626600091 35.51937423031477, -82.72769865983079 35.520034230401976, -82.72630965929636 35.52201523066373, -82.725846659118 35.52267623075116, -82.7259756590965 35.52295723082174, -82.72616065906593 35.52335823092241, -82.72650865907089 35.523704231028525, -82.72661865907256 35.52381323106205, -82.72649365903739 35.5239062310682, -82.72503165862857 35.524987231139065, -82.72407365837223 35.525619231169934, -82.7236396582561 35.525906231184, -82.72356665869765 35.52294223057214, -82.72262065865635 35.522183230320614, -82.72129365825376 35.5233702304269, -82.72120965822346 35.523476230439925, -82.72043165814121 35.5231672302973, -82.72006665806796 35.52324923027665, -82.71963765798155 35.52334723025273, -82.71872565788739 35.522970230082585, -82.71824265780683 35.52297123003337, -82.71781965774649 35.522905229976644, -82.71740265771322 35.52266922988579, -82.71693265766957 35.522443229791676, -82.71645465761438 35.522284229710344, -82.71605965754189 35.5223282296789, -82.71595265753156 35.52227922965797, -82.71584565751974 35.52224022963902, -82.71573965750602 35.52221422962287, -82.71563965749229 35.52219522960879, -82.71553365747651 35.52218322959549, -82.71539565745417 35.52217922958059, -82.71533165744302 35.52218222957467, -82.7150986574028 35.52219122955265, -82.7146786573288 35.5222182295152, -82.7145106572998 35.52222522949932, -82.71441165728203 35.522233229490865, -82.7142596572557 35.522240229476715, -82.71412965723219 35.52225222946592, -82.71404565721656 35.52226322945956, -82.71396165719963 35.522282229454795, -82.71390065718532 35.52230922945405, -82.71367965713097 35.52242422945494, -82.71365865712637 35.52243122945422, -82.71353165710094 35.52245922944689, -82.71339465707719 35.52246522943414, -82.71341265707782 35.522481229439194, -82.71342865707535 35.5225142294476, -82.71345065707243 35.52255722945857, -82.71348065706631 35.5226302294766, -82.71350365705618 35.52272122949749, -82.71353465704209 35.52284722952634, -82.71354165702449 35.52296922955192, -82.71354965698666 35.523225229604925, -82.71354965696396 35.523373229635105, -82.71352665693675 35.52352622966393, -82.71350365689972 35.52374322970584, -82.71345765685992 35.523953229743995, -82.71345065683947 35.524079229768965, -82.71337465683611 35.524018229748705, -82.71332865683553 35.5239722297346, -82.71329765683967 35.52391122971903, -82.71321365685537 35.52371722967084, -82.71307665687118 35.523465229605485, -82.71297765687457 35.52333522956885, -82.71290165687299 35.52326322954635, -82.71284765686872 35.52323222953457, -82.71277865686123 35.52320622952213, -82.71273765685503 35.52320222951716, -82.71270165684905 35.52320222951346, -82.71264965683868 35.523213229510404, -82.71261165682992 35.523229229509745, -82.71256565681762 35.52325922951115, -82.71236665676174 35.52340822952117, -82.71215365669697 35.52359922953834, -82.71205465666365 35.523709229550605, -82.71174165655555 35.52407522959321, -82.71150465647686 35.52433122962116, -82.71110065634714 35.524739229663034, -82.71103165632694 35.524796229667565, -82.7109706563086 35.52485022967234, -82.7109026562902 35.52489622967476, -82.7107876562636 35.524945229672994, -82.71073265625196 35.52496122967063, -82.71062765622973 35.52499222966621, -82.71056865621634 35.52501522966481, -82.71053165620656 35.525039229665936, -82.71051765620278 35.525048229666325, -82.71050765619992 35.52505622966701, -82.71047465618987 35.525086229669704, -82.71045365618042 35.52512522967553, -82.71044465617477 35.52515222968011, -82.71043765617023 35.525174229683834, -82.71042365615259 35.525274229702795, -82.7104206561351 35.525385229725146, -82.71042465612378 35.525463229741426, -82.71042865611678 35.52551322975206, -82.71042565607434 35.52578722980758, -82.71041865606642 35.52583122981588, -82.71038365604585 35.52592722983186, -82.71035365603343 35.52597622983873, -82.71027765600863 35.52605522984706, -82.71022065599244 35.526099229850274, -82.71002565594071 35.52622522985603, -82.70997465592696 35.52625922985764, -82.70992765591264 35.526302229861656, -82.70989465589984 35.5263492298679, -82.70987165588731 35.526406229877104, -82.70986465587774 35.52646122988763, -82.70986565587572 35.52647522989054, -82.70986965586773 35.52653222990263, -82.70990365584959 35.52668722993771, -82.70991465584058 35.52675822995331, -82.70992065582797 35.526847229972034, -82.70991265581212 35.526942229990595, -82.7098836557884 35.527065230012695, -82.70984665576765 35.52716023002827, -82.70983565576124 35.52719023003328, -82.70979765574492 35.52725523004264, -82.70975565572866 35.52731623005078, -82.70970265571064 35.527376230057584, -82.70964965569463 35.52742323006179, -82.70958665567734 35.527467230064325, -82.7095286556633 35.52749623006422, -82.70941365563773 35.52753823006104, -82.7091956555947 35.527582230047685, -82.70907265556907 35.52761623004204, -82.70899965555212 35.52764723004086, -82.70892965553416 35.52768823004204, -82.70887265551782 35.52773323004539, -82.70882465550297 35.527778230049684, -82.70878065548779 35.52782923005556, -82.70871165545918 35.52794123007139, -82.70868465544581 35.52799923008042, -82.70853365536395 35.528369230140434, -82.7084776553357 35.528493230159924, -82.70845065532303 35.52854623016797, -82.70832865526518 35.5287912302055, -82.70830065524962 35.52886223021707, -82.70828665523888 35.528917230226824, -82.70827165522259 35.52900723024363, -82.70827465520401 35.52913223026944, -82.708290655195 35.529208230286585, -82.70831965518558 35.52930123030853, -82.70833565518082 35.529350230320205, -82.7084246551613 35.52957423037489, -82.70842865516056 35.52958323037721, -82.70846965515538 35.52966123039727, -82.70849165515236 35.52970523040848, -82.70851065515043 35.52973823041721, -82.7085426551472 35.52979423043188, -82.70860965514427 35.529886230457514, -82.70865165514233 35.52994423047355, -82.70866065514234 35.52995423047658, -82.70871965514225 35.53001923049582, -82.70885365514582 35.530141230534426, -82.70893065514917 35.53020323055496, -82.70897965515177 35.530239230567304, -82.70927265516683 35.53045923064218, -82.70938265517344 35.53053523066893, -82.70957765518068 35.53070023072251, -82.70966565518326 35.53077923074765, -82.70975665518421 35.530872230775934, -82.709770655184 35.53088823078058, -82.70983065518297 35.53096023080141, -82.70990065517927 35.531060230828956, -82.70996165517252 35.531171230857815, -82.71000265516558 35.53126123088039, -82.7100366551574 35.53135123090222, -82.71005365514891 35.53142523091907, -82.710062655138 35.53150623093652, -82.71006165512173 35.53161123095778, -82.71005265510601 35.53170423097584, -82.71003765507547 35.53188723101156, -82.71004065505717 35.532010231036956, -82.71005765503628 35.532165231070294, -82.71007965502324 35.53227423109481, -82.7101206550069 35.53242523112985, -82.71016365499145 35.532572231164146, -82.71021465497213 35.532754231206525, -82.71026465493668 35.533040231269936, -82.71028765492902 35.53311523128755, -82.7103086549272 35.533149231296676, -82.71034465492733 35.53318823130826, -82.7103896549297 35.53322123131969, -82.7104486549356 35.533247231330975, -82.71049565494013 35.533268231340074, -82.71058065495015 35.53329523135429, -82.71066565496132 35.533315231367034, -82.71075965497249 35.53334423138259, -82.71086665498478 35.53338023140086, -82.71088265498655 35.53338623140371, -82.71097165499586 35.533422231420175, -82.71099065499772 35.53343023142378, -82.71109565500775 35.53347923144445, -82.7112376550194 35.53355723147497, -82.71130465502478 35.53359523148955, -82.71142065503255 35.53367023151673, -82.71154165503968 35.53375523154646, -82.71157065504069 35.533780231554466, -82.71162265504252 35.533825231568976, -82.71169865504217 35.53391023159408, -82.71174465503887 35.53398123161332, -82.711788655033 35.534067231635326, -82.71183865502277 35.53418823166513, -82.71183965502263 35.53419023166562, -82.71186065500439 35.53433223169672, -82.71186665498185 35.534486231728756, -82.71186265497613 35.534519231735054, -82.71186165497285 35.534539231739075, -82.71184365495765 35.53461923175352, -82.71183665495138 35.5346522317595, -82.7112056548453 35.534659231696345, -82.71088065478905 35.53467323166588, -82.71036965469938 35.53470323161974, -82.71020165466955 35.53471523160498, -82.70997365462884 35.53473323158534, -82.70754765420043 35.534893231369615, -82.70530465380499 35.535037231169326, -82.70405665358491 35.535118231058114, -82.70397865357113 35.53512323105118, -82.7036726535176 35.53514023102329, -82.70357265349988 35.53514723101449, -82.70327465344661 35.5351712309889, -82.70317565342887 35.53517923098039, -82.70302665340284 35.53518723096678, -82.70258265332517 35.53521223092638, -82.70243465329911 35.53522123091306, -82.70184665319545 35.53525923086064, -82.70110765306491 35.53530823079495, -82.70081965301563 35.535317230767326, -82.70048865296273 35.5353022307304, -82.70008365290383 35.53524723067765, -82.69950065281877 35.5351692306021, -82.69915865276857 35.53512523055808, -82.69886565272479 35.53509223052141, -82.69858065267944 35.53507923048956, -82.69847465266157 35.53508023047889, -82.69831365263451 35.535082230462834, -82.69794065256902 35.535104230429184, -82.69758965250371 35.53514923040242, -82.69543265207467 35.535606230274695, -82.69442465187416 35.53582023021512, -82.69434165186512 35.5357892302003, -82.69430365186079 35.535776230193754, -82.69416265184402 35.53573223017037, -82.69403665182755 35.53570323015156, -82.6939286518108 35.5356952301389, -82.6939146518085 35.535695230137385, -82.69380165178751 35.535709230128724, -82.69385165180073 35.53567723012736, -82.69397165183206 35.535603230124515, -82.6940006518401 35.53558223012322, -82.69404965185333 35.53554923012148, -82.69407265185956 35.535533230120556, -82.69441465195786 35.53526323010054, -82.69449965198233 35.535196230095565, -82.69492165210181 35.53487423007319, -82.69502465213279 35.53478423006536, -82.69510465215947 35.53469723005587, -82.69517165218176 35.534624230047854, -82.69524565220922 35.534525230035214, -82.69530365223271 35.53443523002276, -82.69537765226805 35.53428522999983, -82.69542165228849 35.53419922998682, -82.69557665236528 35.53386622993474, -82.69575265245238 35.53348922987586, -82.69617765266156 35.53258522973513, -82.69628165271355 35.532359229699765, -82.69645765280039 35.53198322964109, -82.69646265280345 35.53196922963873, -82.69648165281292 35.531928229632285, -82.69648865281602 35.531915229630364, -82.69649065281725 35.53190922962935, -82.6964986528211 35.531893229627016, -82.69650165282236 35.53188822962625, -82.69650765282564 35.53187322962381, -82.69652265283285 35.53184222961897, -82.69652665283525 35.531831229617104, -82.6965336528384 35.531818229615276, -82.69681765291493 35.531627229605405, -82.69716565301007 35.53138422959149, -82.69778265317856 35.53095422956699, -82.6990446535263 35.53005522951286, -82.69907665353539 35.53003122951131, -82.69946265364136 35.5297582294951, -82.69962665368678 35.52964022948786, -82.69964765369241 35.52962622948717, -82.70010765383053 35.529224229452275, -82.70037265391005 35.52899322943229, -82.70068965400111 35.528743229413806, -82.70116565413765 35.52836922938631, -82.70129765418496 35.5282032293659, -82.70157865428584 35.52785022932274, -82.7022436544941 35.52721322926092, -82.70257165459316 35.52692322923542, -82.7029936547201 35.52655222920296, -82.70358965489712 35.52604422916036, -82.70423065511136 35.52534222908287, -82.70495865534207 35.52462722901159, -82.70540965548587 35.524178228966235, -82.70581665563134 35.52367022890436, -82.7063116558145 35.523012228820825, -82.70674165597917 35.522404228740854, -82.70717465613497 35.52185722867368, -82.70738465621625 35.52155522863359, -82.70742165623062 35.5215012286264, -82.70753265627357 35.52134122860508, -82.70757065628801 35.52128822859822, -82.70759565629777 35.52125122859325, -82.7076716563272 35.521142228578746, -82.70769765633699 35.52110622857407, -82.70786465640165 35.52086522854199, -82.70803965646911 35.52061522850897, -82.70832865659318 35.52011922843738, -82.70847765665651 35.51986722840132, -82.70851365667201 35.51980522839231, -82.70857565669982 35.51969122837544, -82.708633656726 35.51958322835938, -82.70865565673607 35.51954122835301, -82.7087236567667 35.51941522833429, -82.70874665677681 35.51937422832828, -82.70885465682548 35.5191732282984, -82.70895065687073 35.51898222826923, -82.70902565690585 35.51883422824673, -82.7091176569508 35.51864122821684, -82.70954565715122 35.51779722808855, -82.7097466572448 35.51740422802893, -82.70976265725267 35.51737022802374, -82.70981365727613 35.51727222800897, -82.70983065728397 35.51723922800396, -82.70991865732591 35.51706122797668, -82.71018665745214 35.51652822789539, -82.7102766574942 35.516351227868476, -82.71035965753339 35.516185227843174, -82.71061165765126 35.51568922776786, -82.71069565769045 35.515524227742766, -82.71083765775727 35.51524222769984, -82.71126765795822 35.51439722757151, -82.71141065802502 35.51411622752888, -82.7114626580497 35.5140112275128, -82.71162265812464 35.51369622746494, -82.71167665814946 35.51359222744931, -82.7117876582015 35.51337322741598, -82.711799658207 35.51335022741245, -82.71186265823424 35.51324022739658, -82.71199865828936 35.51302822736724, -82.71213765834024 35.512847227344565, -82.71220565836363 35.51276822733535, -82.71225565838076 35.51271022732867, -82.71237265841899 35.51258822731579, -82.71250365845988 35.51246322730362, -82.71260065848921 35.51237722729604, -82.71262665849689 35.51235522729429, -82.71287365856803 35.51215922727957, -82.71305465861722 35.51203422727262, -82.71328765867726 35.51189522726811, -82.71336965869786 35.51185022726729, -82.71348065872522 35.51179222726685, -82.7136496587653 35.51171422726825, -82.71385365881234 35.51162822727154, -82.71395265883464 35.511590227273935, -82.71441265893728 35.5114202272863, -82.71487665904036 35.51125122729937, -82.71518565910895 35.511139227308114, -82.71533665914257 35.51108322731217, -82.71578965924341 35.51091722732465, -82.71594165927709 35.51086222732896, -82.71623865934343 35.510752227336894, -82.71713165954186 35.51042622736177, -82.71742965960823 35.51031722737005, -82.71773865967705 35.51020322737844, -82.71866865988373 35.50986422740441, -82.71897865995265 35.50975122741308, -82.71902665996348 35.509732227414155, -82.71917065999558 35.509679227418026, -82.71921966000643 35.50966222741962, -82.7195166600726 35.509552227427555, -82.72040866027126 35.50922422745193, -82.72070666033764 35.50911522746019, -82.72105266041409 35.50899122747026, -82.72138266048717 35.50887322747997, -82.72150966051612 35.50882222748252, -82.72181266058729 35.50868622748582, -82.72189466060732 35.50864422748565, -82.72198166062995 35.50859122748377, -82.72205466064973 35.50854122748104, -82.72218566068501 35.508453227476465, -82.7223476607325 35.50831922746571, -82.7223786607416 35.508293227463604, -82.72251166078388 35.50816222745043, -82.7225806608067 35.50808822744241, -82.72261366081855 35.50804622743725, -82.72302666096506 35.50753822737594, -82.72308766098566 35.507470227368245, -82.7231446610037 35.50741422736267, -82.72320766102155 35.50736522735915, -82.72328166104028 35.507324227358346, -82.72335166105641 35.5072942273594, -82.72342666107258 35.50727022736214, -82.7234346610743 35.50726822736257, -82.7234736610818 35.50726122736516, -82.72349466108639 35.50725422736586, -82.72353566109396 35.50724922736905, -82.7236606611149 35.50724822738159, -82.72373466112619 35.50725522739065, -82.72380466113572 35.50726922740065, -82.72384766114129 35.507279227407025, -82.72394366115259 35.50731022742319, -82.72394766115306 35.50731122742376, -82.72435866119348 35.507494227503145, -82.72449566120689 35.5075562275298, -82.72495866125229 35.507763227619364, -82.72563766131859 35.50806822775102, -82.72587766134377 35.50816522779536, -82.72600766135879 35.50820822781744, -82.72626966139293 35.50827022785682, -82.72632566140088 35.50827922786444, -82.72638166140956 35.50828322787099, -82.72648966142624 35.508292227883864, -82.72679266147661 35.508292227914815, -82.7268896614934 35.508288227923906, -82.7269246614786 35.50842322795499, -82.72699366145034 35.50868322801509)))",6565,37,021,002401,370210024011,784,784,24,773,760,8,2,1,0,2,11,607,15,592,601,593,3,2,1,0,2,6,363,324,39
census_2010_blockgroups_view.fid--2dc29038_13ec899ba8f_-2608,"MULTIPOLYGON (((-82.56800662316897 35.58589822745442, -82.56825162324677 35.58565722743059, -82.5683176232675 35.58559322742437, -82.56845862326105 35.58578722747823, -82.56853662326054 35.585874227504, -82.56876662325955 35.586129227579534, -82.56911862327252 35.586425227675896, -82.5691916232755 35.58648422769542, -82.56978262329964 35.58696522785407, -82.57105962328876 35.58841422828013, -82.57127062328692 35.588653228350466, -82.57159262326623 35.58913522848172, -82.57163662326342 35.58920122849963, -82.57169662325974 35.58929022852394, -82.5717596232522 35.58940722855425, -82.57179862324772 35.58947822857267, -82.57191362323404 35.58969122862788, -82.57225962319316 35.59033022879349, -82.5723756231794 35.590544228849005, -82.57227762316023 35.590563228842754, -82.57198662310265 35.59062322882505, -82.5718896230835 35.59064322881918, -82.57173062305222 35.59067522880936, -82.57125362295815 35.5907712287799, -82.57109562292686 35.590804228770395, -82.5709816229045 35.59082622876325, -82.57064162283748 35.59089522874234, -82.57061162283142 35.59090222874069, -82.57052962281503 35.590920228735904, -82.57051362281187 35.590923228734916, -82.57046562280249 35.59093222873181, -82.57045062279946 35.59093622873107, -82.57033162277575 35.590961228723984, -82.5699746227047 35.59103822870294, -82.56985662268113 35.59106422869609, -82.56981362267261 35.59107322869353, -82.56968462264693 35.59110022868581, -82.56964262263845 35.591110228683455, -82.56959962263011 35.59111822868074, -82.56947362260505 35.59114522867324, -82.56943162259651 35.59115522867103, -82.56917462254842 35.591190228651755, -82.56867862245532 35.59126022861507, -82.56840462240751 35.59127522858995, -82.56814662236219 35.59129122856671, -82.56809662235351 35.59129322856204, -82.56794962232773 35.591302228548734, -82.56790062231913 35.59130522854434, -82.56767962227788 35.59133522852771, -82.5673026222145 35.59134022848997, -82.56713862218643 35.59134522847421, -82.56693262215116 35.59135222845452, -82.56662462209437 35.59138922843037, -82.56629262202901 35.59145522840971, -82.56602062197223 35.591531228397244, -82.56583762193138 35.591599228392276, -82.56556962186741 35.591725228390445, -82.56519862177132 35.5919492283979, -82.56501862172016 35.59208722840749, -82.56501562171927 35.592090228407876, -82.56486462167204 35.592234228421624, -82.56470962162028 35.59240322844015, -82.5646406215951 35.592492228451185, -82.56458562157499 35.59256322845996, -82.56452462154917 35.59266522847446, -82.56451162154414 35.59268422847698, -82.56448762153376 35.59272522848284, -82.56447562152891 35.592744228485486, -82.56446362152366 35.592765228488574, -82.56441762150418 35.59284222849947, -82.56439862149607 35.59287422850408, -82.5643366214683 35.59298822852087, -82.5642296214154 35.593216228556365, -82.56417662138874 35.593332228574496, -82.56403162132618 35.59358222861049, -82.56396462129703 35.5936992286274, -82.56382562124365 35.59389622865331, -82.56363762117849 35.594116228678764, -82.56349362113261 35.59425922869308, -82.56343962111521 35.59431422869865, -82.56328062106705 35.59445522871106, -82.56318562103834 35.59453922871841, -82.563142621026 35.594573228720954, -82.56291362095928 35.59475922873534, -82.56271262090375 35.5949032287439, -82.56256662086305 35.59501022875076, -82.56244662082892 35.59510222875713, -82.5624456208288 35.59510222875701, -82.56206462072662 35.595355228769385, -82.5620606207253 35.595359228769816, -82.56193462069288 35.595434228772106, -82.56182962066565 35.59549722877413, -82.56167762062756 35.595581228775586, -82.5616016206083 35.59562422877662, -82.56115562049851 35.59585622877798, -82.56088762043403 35.595986228776894, -82.56062262036995 35.59611622877617, -82.56041262031941 35.596218228775406, -82.559785620168 35.59652522877346, -82.55957662011748 35.59662822877293, -82.5595596201177 35.59660822876713, -82.55950862011852 35.59654822874966, -82.55949162011875 35.59652822874389, -82.5594366201196 35.59646322872495, -82.55936462012075 35.59637822870028, -82.55926762012108 35.59627122866856, -82.55921162012147 35.59620822865002, -82.55936062015958 35.59612122864759, -82.55936462016075 35.59611822864737, -82.55967862023847 35.595952228645785, -82.55983462027822 35.595862228643576, -82.55998962031758 35.595774228641545, -82.5599576203189 35.5957312286295, -82.55975062034193 35.595358228532376, -82.55964162035431 35.59516022848078, -82.55961162035963 35.59509322846406, -82.55959462036962 35.59501022844541, -82.55940762049805 35.593974228215366, -82.55932362055663 35.59350322811084, -82.55947362058637 35.59347122811971, -82.55992262067532 35.59337822814696, -82.5600736207052 35.593347228156176, -82.5601756207252 35.59332722816254, -82.56009862075044 35.59308022810436, -82.56005362076694 35.59292422806793, -82.56005262076725 35.59292122806731, -82.5599856207909 35.59269522801438, -82.5599026208253 35.59238222794215, -82.55983762084907 35.59215822788985, -82.55982862085403 35.59211622788037, -82.55983162085815 35.59209222787589, -82.55984762086378 35.59207322787355, -82.5599186208828 35.592026227871294, -82.56018062094908 35.5918782278681, -82.56025962096894 35.59183422786726, -82.56031662098218 35.5918102278682, -82.56038162099554 35.59179322787146, -82.56058262103477 35.591755227884335, -82.56054362104578 35.591641227857124, -82.56053962104724 35.591628227854095, -82.56051262105774 35.591530227831356, -82.56049462106824 35.59144322781178, -82.56045762107856 35.59133622778624, -82.56044762108333 35.591294227776665, -82.5604356210893 35.59124222776481, -82.56042562109758 35.59117722775061, -82.56012962104978 35.59116922771854, -82.55962262096756 35.59115622766383, -82.559248620908 35.59114022762215, -82.55924462090752 35.59113922762154, -82.55906462087788 35.591137227602665, -82.55894962085765 35.591144227592196, -82.55898362090801 35.5908542275367, -82.55907462103963 35.590097227391965, -82.55908562105833 35.58998722737073, -82.55911762110819 35.58969822731519, -82.55915762117256 35.58932322724298, -82.55922862128577 35.588664227116126, -82.5592626213629 35.588200227025126, -82.55929162142537 35.5878252269518, -82.55930362145122 35.58767022692145, -82.55933862152844 35.58720622683062, -82.55935162155431 35.587052226800544, -82.55935462156091 35.587012226792766, -82.55938362162782 35.58660922671372, -82.55948062184804 35.585283226453775, -82.55951362192151 35.58484122636721, -82.55951862193245 35.584775226354246, -82.55952862195154 35.584662226332306, -82.55953162196465 35.58458022631589, -82.55953562197531 35.584515226303054, -82.55953662197965 35.58448822629768, -82.55953962198679 35.584445226289276, -82.55954062199261 35.5844082262818, -82.55954262199698 35.58438222627674, -82.55954662200718 35.58432022626448, -82.55956462204634 35.58408522621856, -82.55956462204891 35.58406822621507, -82.55958062209483 35.583787226159565, -82.5596236222037 35.583126226029414, -82.5596386222409 35.582900225984886, -82.55964162225501 35.58281222596734, -82.55991162230549 35.5827752259875, -82.56068762245016 35.58267222604622, -82.56072262245657 35.582668226049016, -82.56099462250539 35.58264422607209, -82.56124762255092 35.582621226093316, -82.561333622568 35.5826032260985, -82.56137762257674 35.58259422610122, -82.56143562258896 35.582577226103695, -82.56170662265008 35.58247222611016, -82.5619836227104 35.582379226119656, -82.56203562272367 35.582349226118914, -82.56207662273675 35.58230822611473, -82.56211862275482 35.58223622610441, -82.56212962276392 35.582189226095934, -82.5621346227784 35.5821002260784, -82.56215762283459 35.58175922601134, -82.5622536228508 35.581758226021016, -82.56253462289588 35.581768226051885, -82.56255462289901 35.581769226054114, -82.56287962295275 35.58177122608791, -82.56295362296815 35.58175122609144, -82.56303862298742 35.581717226093254, -82.56321062302936 35.581630226093225, -82.56357962312403 35.58141322608696, -82.56370862315701 35.581338226084846, -82.5638206231848 35.58127822608418, -82.56391662320611 35.58124322608695, -82.5639996232228 35.58122422609155, -82.56400962322479 35.58122222609213, -82.56420362326001 35.58120222610803, -82.56429562327598 35.58119822611667, -82.56439162329228 35.58119522612588, -82.56447062320983 35.58181722626063, -82.5644926232011 35.581897226279175, -82.56450662319624 35.58194422629016, -82.56484862309574 35.58296622653339, -82.56490262307705 35.58314622657556, -82.56491862305133 35.58333022661462, -82.56495662296025 35.58396322674741, -82.56497562291577 35.58427322681245, -82.56498962287233 35.58457022687436, -82.56500062286293 35.58464322689038, -82.56501162286062 35.58467022689695, -82.56502962285681 35.58471422690772, -82.56508862281724 35.58503522697913, -82.56510562281342 35.585078226989644, -82.56512262280967 35.58512122700019, -82.56515862280388 35.58519722701931, -82.56522362280239 35.585277227042305, -82.56530462280234 35.585365227068486, -82.56540262280518 35.585452227096276, -82.56555062281281 35.585562227133906, -82.56578462282644 35.58572622719126, -82.56592662283352 35.58583322722762, -82.56596062283371 35.58586922723846, -82.5660016228295 35.58594022725714, -82.56621162280811 35.58630622735329, -82.56627062279954 35.586425227383515, -82.566447622774 35.586782227474366, -82.5665066227653 35.58690222750487, -82.56664562279954 35.586830227504464, -82.56700862288798 35.58664722750451, -82.56706562290232 35.58661522750383, -82.56720362293669 35.586541227502956, -82.56721162293876 35.58653622750269, -82.56723562294475 35.58652322750258, -82.56724462294682 35.5865192275026, -82.56729362295913 35.586492227502156, -82.56732062296686 35.58647122750065, -82.5675386230275 35.5863122274907, -82.56761162304763 35.586260227487585, -82.56769762307174 35.586196227483406, -82.56772062307805 35.58618022748252, -82.56792962314462 35.58597322746181, -82.56800662316897 35.58589822745442)))",6369,37,021,000900,370210009002,949,949,24,918,571,327,10,1,1,8,31,892,22,870,864,540,307,10,1,1,5,28,519,488,31
census_2010_blockgroups_view.fid--2dc29038_13ec899ba8f_-2607,"MULTIPOLYGON (((-82.58447563711024 35.51292921428969, -82.584569637136 35.51286321428594, -82.58466463716205 35.512796214282, -82.58610063756774 35.511704214206915, -82.58677363772604 35.511400214214, -82.58762563791997 35.511057214231485, -82.58882063819162 35.510579214256566, -82.5903836385741 35.50977621425322, -82.59071963865624 35.50960421425266, -82.59105463873834 35.50943121425178, -82.5914136388261 35.5092472142511, -82.59235863909005 35.508548214205646, -82.5924856391673 35.50818221414409, -82.5925126392738 35.50751621401139, -82.59237963944055 35.50628421374691, -82.59232663948468 35.50593821367103, -82.59224163955594 35.505381213548915, -82.5922646396667 35.50468321340913, -82.5923286398461 35.50358221319158, -82.59234563989257 35.5032972131353, -82.59231963997284 35.502745213020255, -82.59230564001841 35.50243221295511, -82.59229064006391 35.50211921288985, -82.59226964013035 35.501662212794635, -82.59213764018567 35.50115821267851, -82.59214664022058 35.500940212635065, -82.59216364028454 35.50054121255564, -82.59217964034845 35.50014121247585, -82.5922326403596 35.500126212478186, -82.59227664036852 35.50011521248047, -82.59239364039367 35.50007821248488, -82.59244764040511 35.50006221248721, -82.59254864042676 35.500030212490984, -82.59255264042753 35.50002921249121, -82.5927776404784 35.499941212496346, -82.59284264049408 35.499909212496505, -82.59289364050615 35.499885212496864, -82.59293664051724 35.49985921249594, -82.59293964051352 35.499887212501946, -82.59294864050214 35.49997121251999, -82.59295164049934 35.49999321252474, -82.59295264049848 35.49999921252607, -82.59297364048908 35.50008321254534, -82.59297564048823 35.50009121254718, -82.59302864047301 35.50024821258455, -82.59306464046666 35.50032821260452, -82.59310064046049 35.50040821262453, -82.59313464045432 35.50048521264367, -82.59313964045377 35.50049421264602, -82.59323464043518 35.50071821270139, -82.59326864042885 35.50079621272068, -82.5933626404106 35.50101721277534, -82.5936466403557 35.50168321294, -82.59374164033746 35.50190521299495, -82.59381464032323 35.50207721303741, -82.59391964030304 35.502323213098265, -82.59403564028042 35.50259621316576, -82.59410964026618 35.50276921320849, -82.59425664024252 35.50308321328754, -82.59435364023561 35.503233213328, -82.59435564023545 35.50323621332881, -82.59451464023536 35.50340921338031, -82.5949506402438 35.50382621350984, -82.59513464024084 35.504045213573306, -82.59525464023267 35.50422821362282, -82.59537564022283 35.50442421367518, -82.59565164019996 35.504872213794606, -82.5959936401716 35.50542821394282, -82.59607164016518 35.50555421397652, -82.59659864012498 35.50638721420004, -82.59674164011729 35.50659221425648, -82.5968986401115 35.50680021431487, -82.59705764010927 35.506987214369275, -82.59710764010974 35.50703821438474, -82.59722664011099 35.50715921442167, -82.59740564011507 35.50732621447396, -82.59758864012153 35.507482214524444, -82.5978726401318 35.507723214602606, -82.59810464013873 35.50792921466828, -82.59833164014388 35.50814121473472, -82.59856764014596 35.508383214808134, -82.59874364014335 35.50859121486851, -82.59893864013056 35.50888621494854, -82.59916164010922 35.509267215049, -82.59938364008185 35.5096862151571, -82.5994686400705 35.50985221519956, -82.59961464005181 35.51013221527154, -82.60002763999343 35.51096021548236, -82.60007463998747 35.511050215505534, -82.60012363998136 35.51114321552949, -82.60034463995719 35.511540215633, -82.60051663994182 35.51182721570903, -82.60052763994103 35.511844215713644, -82.60056063993824 35.51189821572802, -82.6005716399373 35.511916215732754, -82.60063163993271 35.5120112157583, -82.60067463992986 35.512076215775906, -82.60075463992482 35.5121962158086, -82.60099563991032 35.51255121590552, -82.60110363990388 35.51271021594897, -82.60112363990295 35.512738215956716, -82.60118363989972 35.5128242159804, -82.6012046398987 35.51285321598839, -82.60134763989313 35.51304521604219, -82.60147263989009 35.51320021608658, -82.60183663988124 35.513652216215846, -82.6023066398727 35.51421721637904, -82.60258763986751 35.51455521647667, -82.60262963986673 35.51460621649134, -82.6027566398643 35.514759216535516, -82.60279963986362 35.51481021655031, -82.60313363985837 35.51520621666514, -82.60386663984457 35.516090216920254, -82.60401963983959 35.516288216976236, -82.60406963983738 35.516357216995495, -82.60421263983109 35.51655321705004, -82.60463263980733 35.517163217217224, -82.60479263979644 35.51740721728334, -82.60502963977792 35.51778521738459, -82.60515863976543 35.51800621744271, -82.60529663974735 35.518273217511265, -82.60542863972874 35.518538217578744, -82.60553063971388 35.518745217631356, -82.6055816397066 35.51884821765762, -82.60572563968118 35.51917021773795, -82.60576663967382 35.51926221776083, -82.60598163963029 35.51977921788808, -82.60615063958839 35.52023521799825, -82.60623363956466 35.52048021805668, -82.60629463954703 35.520661218099754, -82.60635563952715 35.52085721814596, -82.6063586395261 35.52086721814828, -82.6063756395197 35.520927218162264, -82.6064056395076 35.521038218187904, -82.60647063948166 35.52127821824346, -82.606494639471 35.52137421826547, -82.60652263945826 35.52148721829133, -82.60655563944357 35.5216192183216, -82.60657763943385 35.52170621834155, -82.60663963939628 35.522018218411404, -82.60665063938954 35.52207421842403, -82.60666363937962 35.52215321844137, -82.60668263936465 35.522271218467424, -82.60673263932742 35.52256821853297, -82.60673863931906 35.52262921854604, -82.6067516393028 35.52274921857179, -82.60675863929367 35.52281621858615, -82.6067816392667 35.5230172186294, -82.60678963925777 35.52308421864392, -82.60679063925562 35.52309921864709, -82.60679463924943 35.523144218656654, -82.60679663924726 35.52316021866011, -82.60680163923104 35.523271218683234, -82.60681663918956 35.52355821874315, -82.60680563918038 35.523606218751816, -82.60680263917725 35.52362321875489, -82.60680063917007 35.52366821876396, -82.60679163916106 35.523717218773015, -82.60677563914231 35.52382221879271, -82.60677563914196 35.52382421879312, -82.60677863909237 35.524151218859984, -82.60677963907582 35.524260218882304, -82.6067816390346 35.5245312189377, -82.60678363901876 35.52463621895932, -82.6067756389678 35.52496021902443, -82.60675063890459 35.52534521910028, -82.60673463886027 35.52561721915402, -82.60673163885134 35.52567221916495, -82.6067216388341 35.52577321918449, -82.60669663878525 35.52606521924132, -82.6066876387566 35.5262422192765, -82.60668663874993 35.52628421928492, -82.60667963873117 35.52639921930761, -82.60685363876088 35.52639421932451, -82.60690863876859 35.526403219331925, -82.60695763877533 35.52641221933879, -82.60757563885235 35.52657921943613, -82.6077986388802 35.526639219471114, -82.60801963890772 35.52669921950607, -82.60868463899004 35.52688221961145, -82.60890663901758 35.52694321964667, -82.60914263904712 35.52700621968367, -82.60950263909187 35.52710421974051, -82.6098506391353 35.5271982197954, -82.61008663916466 35.527262219832515, -82.6102366391833 35.52730321985625, -82.61068963923965 35.52742621992766, -82.61084063925826 35.52746821995169, -82.6118726393866 35.52774922011472, -82.61342363957955 35.528171220359624, -82.6140806396613 35.52834922046319, -82.61447763970992 35.52846222052686, -82.61488863975947 35.52858422059391, -82.61496563976836 35.52861022060704, -82.61541563981899 35.528767220685104, -82.61591563987334 35.52895422077448, -82.61597163987894 35.52897822078509, -82.6161656398988 35.52905922082147, -82.61636163991784 35.52914722085942, -82.61644063992539 35.52918322087485, -82.61687963996603 35.529394220962814, -82.61709563998545 35.52950122100675, -82.61748364001788 35.5297102210891, -82.61750364001958 35.52972122109341, -82.61787664004959 35.52992922117395, -82.6182726400815 35.530150221259554, -82.61941964017406 35.53078922150725, -82.61946364017764 35.53081322151665, -82.61986264021023 35.53103322160231, -82.61989164021269 35.53104822160838, -82.61997564021966 35.5310942216263, -82.61998064022018 35.531096221627266, -82.62000964022221 35.531114221633864, -82.62025264024076 35.53125622168771, -82.6205606402642 35.53143722175607, -82.62087464028596 35.531635221828665, -82.62097364029218 35.53170222185242, -82.62120864030679 35.531861221908926, -82.62116064029246 35.531903221912515, -82.62088764020737 35.53216222193731, -82.62065564013479 35.5323842219588, -82.62041364005319 35.53265422198894, -82.62025464000143 35.53281922200629, -82.62016663997576 35.53289122201188, -82.62003363994015 35.53297922201616, -82.61991863991089 35.53304522201783, -82.61953863981378 35.53326722202411, -82.6194046397795 35.5333452220263, -82.61929863975205 35.53340922202844, -82.61906063968999 35.533556222033944, -82.61889963964576 35.53367022204074, -82.61879963961823 35.5337412220449, -82.61861363956456 35.533890222056165, -82.61840563950405 35.53405922206928, -82.61839563950146 35.53406522206952, -82.61831763948163 35.534110222070694, -82.61807063941788 35.53425822207547, -82.61779863936609 35.53430122205633, -82.61731663926719 35.53442422203204, -82.61722063924739 35.53444922202727, -82.61702163915861 35.534812222080845, -82.61694963908565 35.53521022215447, -82.61658763894096 35.535761222229624, -82.61620763878351 35.53637622231595, -82.61583463867606 35.536672222338, -82.61576663862826 35.536910222379454, -82.61537763852326 35.53717322239312, -82.61489163839009 35.53751522241298, -82.61462963829347 35.537861222456584, -82.61436463823902 35.53792922244324, -82.6143136382246 35.537968222446004, -82.61426863820714 35.53803322245464, -82.61420763817871 35.53815222247264, -82.6141386381417 35.53831922249951, -82.61407763810165 35.53851422253304, -82.61401663807155 35.5386442225532, -82.61392463803686 35.53877022256942, -82.61365063794752 35.539056222599605, -82.6136046379299 35.53912122260815, -82.6134976378853 35.539296222632785, -82.61339863784535 35.5394492226538, -82.61328463780373 35.53959722267231, -82.61303963772427 35.539849222698486, -82.61276563764245 35.54008622271866, -82.61252163757325 35.540273222731756, -82.61224663750235 35.54043722273696, -82.61181963739402 35.54068122274288, -82.61178863738606 35.54069922274336, -82.6117466373753 35.54072422274413, -82.61136563727854 35.540942222749486, -82.61122563724203 35.54102822275264, -82.6111076372086 35.54111822275886, -82.61101463717952 35.54120722276747, -82.61094963715527 35.54129522277873, -82.61088163712498 35.54141922279697, -82.61076263706465 35.541683222838515, -82.6106946370403 35.54176822284891, -82.6106186370211 35.54181122284984, -82.61053363700323 35.541835222846, -82.61044763698916 35.54183422283703, -82.61035663697787 35.54180922282255, -82.61013363695312 35.54172922278342, -82.60997663693165 35.541699222761245, -82.609862636913 35.54169722274911, -82.60970663688354 35.541720222737844, -82.60955963685403 35.541753222729525, -82.60923063678423 35.54185222271589, -82.6086626366581 35.54205922269987, -82.60851563662399 35.54212222269763, -82.60836963658713 35.54220422269929, -82.60828363655975 35.54229022270799, -82.60823763654 35.542369222719465, -82.60819663651381 35.542495222740904, -82.60818563649615 35.5425982227607, -82.60819863647927 35.54272222278729, -82.60822263646541 35.54283822281338, -82.60823163645165 35.542938222834636, -82.60821563643778 35.54301122284788, -82.60817863641972 35.543088222859815, -82.60804763637204 35.54325722288077, -82.60799663635179 35.54333422289119, -82.60777263625137 35.543746222952144, -82.60753463615626 35.54410822300144, -82.60743963612202 35.54422822301611, -82.60735063609559 35.5443042230225, -82.60724663606987 35.54435922302303, -82.60714963604899 35.54439022301941, -82.6070216360244 35.54441222301075, -82.6068766359988 35.54442222299796, -82.60651163593616 35.54443522296316, -82.60634663590692 35.54444722294867, -82.60616863587313 35.54447422293597, -82.60602963584503 35.544507222928424, -82.60592863582296 35.54454122292498, -82.60590563581793 35.54454922292424, -82.60571263576959 35.544655222926096, -82.60566363575627 35.54468922292791, -82.6056396357495 35.54470722292915, -82.60555463572459 35.54477822293489, -82.60536363566622 35.544951222950566, -82.60525263563413 35.54504022295725, -82.60512463559952 35.54512722296188, -82.60500063556833 35.54519622296316, -82.60493463555231 35.54522922296313, -82.60484963553147 35.54527322296338, -82.60482763552626 35.54528322296317, -82.60471663550032 35.54533222296177, -82.60465963548715 35.54535622296086, -82.60477963547817 35.54554422301147, -82.60487363547232 35.54568422304957, -82.60490763547048 35.54573322306299, -82.60511463546227 35.54601022314066, -82.60531863545664 35.5462682232141, -82.60559863545046 35.54661122331265, -82.60584663544488 35.546916223400146, -82.60648963543048 35.54770522362676, -82.60775663540274 35.54925722407281, -82.60805963539998 35.5496032241743, -82.60824663539657 35.54982722423909, -82.60843563539241 35.550059224305706, -82.60907863537776 35.55085022453278, -82.60908963537757 35.550863224536506, -82.60912263537666 35.55090522454848, -82.60912463537665 35.550907224549086, -82.6091376353774 35.55091622455226, -82.60929263536667 35.55115422461662, -82.60965863535804 35.55160622474618, -82.61028763534361 35.55238122496848, -82.61042463533893 35.552559225018825, -82.61078063532842 35.55301322514781, -82.61085663532786 35.55309922517305, -82.61100463532355 35.553287225226505, -82.61119163531144 35.553568225302975, -82.61124463530554 35.553664225327985, -82.61130563529883 35.55377422535661, -82.61136863529379 35.55387522538359, -82.61146263527085 35.55412622544437, -82.61151063526313 35.554228225470105, -82.61154563524683 35.554372225503016, -82.61156663524082 35.554434225517795, -82.61157563523837 35.55446022552398, -82.61154463523316 35.55446022552083, -82.61144163521642 35.554458225509805, -82.61141363521173 35.55445822550698, -82.61126763518763 35.55445722549184, -82.61119863517611 35.55445722548471, -82.61100363514358 35.5544582254649, -82.61080563511007 35.55446222544545, -82.61074163509917 35.55446422543928, -82.61021563500793 35.55448922539045, -82.60969363491448 35.55453322534591, -82.60963163490324 35.55453922534074, -82.60924263483169 35.554584225309995, -82.60913263481144 35.55459722530137, -82.60876663474205 35.55465322527525, -82.60863663471717 35.55467422526624, -82.60811463461575 35.55477022523221, -82.60760863451446 35.55488222520314, -82.60735463446278 35.554944225189644, -82.60688863436756 35.5550592251653, -82.60678063434575 35.55508522515954, -82.60673063433558 35.555097225156864, -82.60667263432379 35.55511122515375, -82.60545863407673 35.55540622508931, -82.60370263371873 35.55583822499728, -82.603318633641 35.55592922497642, -82.60292463356066 35.55602622495567, -82.60257763348989 35.556111224937474, -82.60206063338455 35.55623822491031, -82.601536633278 35.5563652248824, -82.60118963320726 35.55645022486411, -82.60104363317747 35.556486224856435, -82.60079263312625 35.55654822484342, -82.60064863309684 35.55658422483593, -82.59960063288375 35.55683822478014, -82.59955863287509 35.5568492247781, -82.59952863286897 35.55685622477639, -82.59932163282677 35.55690722476562, -82.59920463280292 35.55693622475948, -82.59914063278994 35.55695122475598, -82.59894963275102 35.55699822474596, -82.59888663273816 35.557014224742744, -82.59877463271535 35.55704122473681, -82.59844163264755 35.55712222471912, -82.59833063262491 35.557150224713375, -82.59793463254441 35.5572462246924, -82.59719663239376 35.55742822465374, -82.59694863234289 35.55749122464108, -82.5967496323016 35.5575452246317, -82.59670863229296 35.55755722462997, -82.59645463223892 35.55763422461959, -82.59636063221872 35.557664224616005, -82.5962376321915 35.55770822461235, -82.59601163214187 35.557787224605256, -82.59597963213469 35.557799224604416, -82.59590163211675 35.557831224603, -82.59586163210786 35.55784622460192, -82.59574363208104 35.55789322459934, -82.59570463207211 35.55790922459857, -82.59549163202249 35.558001224595465, -82.59530063197688 35.558092224594425, -82.59514863194026 35.55816622459391, -82.59482863186058 35.55833922459635, -82.59451063177863 35.55852822460213, -82.59429463172081 35.558671224609164, -82.59415663168328 35.55876622461437, -82.59409863166736 35.55880722461676, -82.5938036315837 35.55903322463244, -82.59370563155585 35.55910822463767, -82.59369363155248 35.55911722463828, -82.59337263145895 35.55937922465869, -82.59326663142782 35.559467224665745, -82.5931956314558 35.55920822460576, -82.59290563151156 35.55853222443837, -82.5927846315513 35.55814222434655, -82.59275763156039 35.55805422432586, -82.59262263157746 35.55779722425971, -82.59251463159097 35.5575922242069, -82.59207063167928 35.556537223946464, -82.59170763172945 35.55581822376282, -82.5912906317235 35.55540622363617, -82.59041863167823 35.55475822341483, -82.590395631677 35.55474122340899, -82.58976363165362 35.55421022323603, -82.5896896316509 35.554148223215854, -82.58949463164979 35.553944223154296, -82.58948763165706 35.553889223142384, -82.58961063167918 35.55387822315279, -82.58950763166965 35.553829223132205, -82.58945063166446 35.553801223120665, -82.58939363165908 35.553774223109286, -82.58905863160903 35.55373822306763, -82.58897963160531 35.55367722304708, -82.58890163160177 35.5536152230265, -82.58818063156932 35.55304722283684, -82.58764263154517 35.55262322269532, -82.58612363141117 35.55185322238274, -82.58571563137524 35.55164622229882, -82.58446663127197 35.550968222032665, -82.58376863121435 35.55058922188392, -82.58254963114469 35.54972422158277, -82.58180263111825 35.54908922137684, -82.58117263112005 35.548396221171096, -82.58056363110377 35.54784422099629, -82.58038663114237 35.547401220887956, -82.5800526311342 35.54709322079097, -82.57934563107587 35.546709220640246, -82.57812663092037 35.54640422045319, -82.576004630629 35.54600722015473, -82.57447163045978 35.54545221988447, -82.57339063033918 35.54506921969568, -82.57156963011329 35.544572219407634, -82.57132663008322 35.544505219369135, -82.57108363005301 35.54443921933074, -82.5707956300172 35.544361219285314, -82.5703356299723 35.544156219196445, -82.56972662991271 35.54388621907902, -82.56945862988654 35.54376721902734, -82.56925562987203 35.543642218981056, -82.5687236298339 35.543315218859874, -82.5681916297959 35.542988218738806, -82.56808362978806 35.542922218714246, -82.56771962977707 35.54260021861129, -82.5672576297632 35.542191218480774, -82.567069629758 35.54202221842708, -82.56655062974342 35.541556218278984, -82.56593362970077 35.54116721813647, -82.56591062969912 35.541153218131306, -82.56574462968761 35.541048218092925, -82.56566562968204 35.540999218074845, -82.5652136296318 35.54083821799569, -82.56519962963041 35.54083221799298, -82.56507662961654 35.54078921797161, -82.56501962961204 35.540757217959246, -82.56483162959714 35.5406512179184, -82.56474162959003 35.54060021789875, -82.56464462958215 35.54054621787793, -82.56442762956497 35.5404242178308, -82.56390162952108 35.5401412177192, -82.56362162949765 35.539991217660024, -82.5635776294894 35.53999721765665, -82.56346362948432 35.53990721762666, -82.56337262948033 35.53983521760272, -82.5633496294792 35.53981721759666, -82.56327362947589 35.53975721757667, -82.56317062946967 35.53968621755164, -82.56306562946341 35.539613217526025, -82.56287362946351 35.53940521746405, -82.56285162946386 35.53937921745639, -82.56272962946665 35.539229217413414, -82.56265462947259 35.539109217381274, -82.56264962947307 35.53910121737918, -82.56253762950111 35.538797217305756, -82.56226562948544 35.53860521723876, -82.56213762953058 35.53817321713778, -82.56204062953462 35.53804221710116, -82.56186562954196 35.53780521703498, -82.56180162956139 35.537609216988514, -82.56177462956985 35.53752521696861, -82.5616576296057 35.537165216883395, -82.56159262962976 35.53693821683052, -82.56152962965318 35.53671721677902, -82.56150662966921 35.5365882167505, -82.56143362972085 35.53617321665853, -82.56134462981169 35.53548521650938, -82.5614216299276 35.53481321638044, -82.56145363000432 35.534348216289146, -82.56145963001845 35.534262216272204, -82.56145563006169 35.53397621621366, -82.56145063012572 35.533554216127236, -82.5614266301558 35.53333221607958, -82.56140163018716 35.53310121602999, -82.56138063019222 35.533045216016426, -82.5612896302151 35.53279721595664, -82.56114763025396 35.532391215859455, -82.56095263024307 35.53225121581096, -82.56086363023816 35.53218721578881, -82.5607746302333 35.532122215766464, -82.5601296302312 35.5314392155613, -82.55993263027733 35.5309252154365, -82.55980763029639 35.53066621537091, -82.55963863032188 35.53031721528258, -82.5594086303491 35.52989121517233, -82.55928463036372 35.52966221511299, -82.55918063038222 35.5294292150549, -82.55887063043777 35.52873221488121, -82.55863563054612 35.5277722146618, -82.5584606306567 35.526862214458646, -82.55842663072781 35.5263622143534, -82.55839963078422 35.525965214269824, -82.55852863100192 35.524686214022736, -82.55863363113333 35.523943213882376, -82.55875963129029 35.523056213714746, -82.55877463130919 35.52294921369456, -82.55910363149438 35.52209821355509, -82.55942163161886 35.52163021349243, -82.55967663169592 35.521404213472614, -82.5598166317377 35.52128321346232, -82.55999063178933 35.521134213449876, -82.56056063193545 35.520798213439896, -82.56124863210867 35.520413213432064, -82.56170063222552 35.5201402134229, -82.56209363234947 35.519757213385255, -82.56254563250083 35.519259213330216, -82.56289863263262 35.5187822132694, -82.56340963283515 35.51801421316542, -82.56378763295814 35.51762121312416, -82.56392063300137 35.517483213109784, -82.56415663314816 35.51678121299109, -82.5644706332885 35.516206212906255, -82.5649116334648 35.51553321281453, -82.56497363348987 35.515437212801324, -82.56503663351485 35.51534221278846, -82.56510863354349 35.515233212773644, -82.56539463366258 35.51476621270791, -82.56574863385404 35.513900212567954, -82.56605063397963 35.513408212498746, -82.56622763405312 35.51312021245833, -82.56640463412668 35.512832212417855, -82.56655363418852 35.51259021238388, -82.56728063440508 35.51196421233098, -82.56729063440842 35.51195321232973, -82.56770163454425 35.51151221228216, -82.56788963460636 35.511310212260284, -82.56862363480901 35.51078321222822, -82.56936863501454 35.51024821219579, -82.57006763522303 35.509645212144676, -82.57067963539293 35.50919921211659, -82.57088363542458 35.50921321214034, -82.57107363545411 35.509226212162446, -82.57126363548379 35.509238212184364, -82.57149463551968 35.50925421221131, -82.57225163560236 35.50953421234586, -82.5732346356576 35.51023721258972, -82.57423663571853 35.51092421283228, -82.5749156357477 35.511469213012745, -82.5749916357508 35.51153121303316, -82.57506763575402 35.51159221305335, -82.57565263577926 35.51206121320879, -82.57621663581557 35.51243421334253, -82.57635563582463 35.512526213375494, -82.57641763582855 35.51256721339018, -82.57674563586511 35.51268421344764, -82.57800963600573 35.513134213668756, -82.5781946360269 35.513197213700565, -82.57912963613283 35.51351821386173, -82.58044663630001 35.51385321406492, -82.58158563648675 35.51386821418473, -82.58290263672222 35.51375721429704, -82.5837476369261 35.51334221429914, -82.58398863698683 35.51320721429636, -82.58443563709926 35.51295721429127, -82.58447563711024 35.51292921428969)))",6430,37,021,002302,370210023024,873,873,73,853,744,31,5,19,1,53,20,669,46,623,660,586,24,5,14,1,30,9,441,389,52
census_2010_blockgroups_view.fid--2dc29038_13ec899ba8f_-2606,"MULTIPOLYGON (((-82.54801663611167 35.47997820384821, -82.54784563608962 35.479937203822416, -82.54763363605956 35.47990420379397, -82.54740963602664 35.47987620376533, -82.54724363600053 35.47986720374644, -82.54716663598828 35.479864203737925, -82.5468926359421 35.479869203710905, -82.54668463590515 35.479885203692824, -82.54620663581585 35.47995120365733, -82.54582063574242 35.4800122036302, -82.5454896356803 35.48006020360607, -82.5449196355728 35.480145203564916, -82.54442163547891 35.480219203528954, -82.54431563545856 35.48023720352174, -82.54414863542617 35.48026820351097, -82.54400863539902 35.48029420350193, -82.54394663538639 35.48030920349866, -82.54361863531884 35.480395203482516, -82.54344763528157 35.48045420347705, -82.54335663526095 35.48049020347501, -82.54321963522976 35.48054520347212, -82.5431676352173 35.48057020347187, -82.54299563517571 35.48065620347177, -82.54279363512428 35.4807732034749, -82.5425836350662 35.48092520348431, -82.54230363498706 35.48113920349916, -82.54224363496807 35.481198203504974, -82.54212163492913 35.48132020351728, -82.54183063483251 35.48163620355174, -82.54140263469421 35.48207620359739, -82.54106663458418 35.48243120363522, -82.54086263451912 35.48263520365584, -82.54067563446607 35.48277920366595, -82.54052663442691 35.48287320366979, -82.54035763438438 35.4829682036718, -82.54020563434939 35.48303220366922, -82.5400356343129 35.48308620366284, -82.53989463428391 35.48312320365588, -82.53972463425099 35.483154203644766, -82.53961963423171 35.48316620363648, -82.53953263421563 35.48317720362985, -82.53937163418775 35.48318520361489, -82.53902263413129 35.48317620357735, -82.53859963406552 35.48314720352804, -82.53850063405058 35.483138203516084, -82.53850463404764 35.48316220352139, -82.53855063400674 35.48347820359038, -82.5385756339852 35.483646203627124, -82.538588633959 35.48383120366612, -82.53859363393046 35.484023203705654, -82.53859863385665 35.484510203805264, -82.53860263381671 35.4847752038596, -82.53859563380334 35.48485520387515, -82.53858863378959 35.48493720389106, -82.53855363376256 35.48507620391582, -82.53854063375164 35.48513320392607, -82.53853763375034 35.48513820392677, -82.5384676337097 35.48532820395822, -82.53833663364003 35.485641204008495, -82.53825063359172 35.485863204044804, -82.53822063357373 35.485948204059085, -82.53817963354831 35.486070204079624, -82.53813163351674 35.486224204106065, -82.53808963348897 35.4863602041295, -82.53808163348334 35.48638820413433, -82.53795663338602 35.486888204223234, -82.53792563336106 35.48701720424631, -82.53791763335397 35.48705520425322, -82.53786163330149 35.487337204304836, -82.53784263328167 35.487446204325025, -82.53777963321419 35.4878182043943, -82.53773563315008 35.488189204465264, -82.53769763307552 35.48863420455191, -82.53769063306028 35.48872620456982, -82.53770663304891 35.488818204590245, -82.53768863301323 35.48903120463172, -82.5371116329023 35.48913120459297, -82.53695763287409 35.489149204580826, -82.53660463280895 35.48919220455334, -82.53619463273519 35.489230204519096, -82.53553363261878 35.48927520446051, -82.53519763255747 35.489311204433385, -82.53474663247637 35.48935320439572, -82.53465863246043 35.48936220438855, -82.53446863242691 35.48937520437169, -82.53445763242493 35.4893762043708, -82.53430763239864 35.4893852043572, -82.53400863234687 35.48940020432963, -82.5336476322843 35.4894182042963, -82.53346663225275 35.489428204279754, -82.53294563215908 35.48947620423615, -82.53256863209015 35.48951820420602, -82.53238763205697 35.48953920419173, -82.53229263203974 35.489548204183855, -82.5322096320247 35.489557204177174, -82.5321206320085 35.48956620416989, -82.53184963196026 35.48958820414661, -82.531585631913 35.48961120412419, -82.53137563187481 35.48963320410717, -82.53110263182346 35.48967320408727, -82.53085963177658 35.48971620407115, -82.53077663176035 35.48973220406583, -82.53076163175733 35.48973620406516, -82.53042263169068 35.48980420404424, -82.52999563160706 35.4898882040176, -82.52996663160137 35.48989420401584, -82.52950063150878 35.489994203988424, -82.52922563145496 35.49004820397124, -82.52882663137805 35.490118203944526, -82.52869063135344 35.49013220393346, -82.52859563133795 35.490130203923286, -82.52856863133348 35.4901302039205, -82.52842763131201 35.49011820390363, -82.52824563128931 35.49006920387503, -82.52814963128044 35.49002320385586, -82.52805263127331 35.48996520383406, -82.52801663127131 35.48993920382517, -82.52791963126599 35.48986920380093, -82.52777863125547 35.48978520376934, -82.52765063124441 35.4897192037428, -82.52761263124026 35.48970520373613, -82.52746663122414 35.489652203710385, -82.52729263120177 35.48961020368396, -82.52728663120112 35.48960820368298, -82.52694363115302 35.489551203636175, -82.52673663112218 35.489528203610284, -82.5265536310948 35.48950920358765, -82.52638863106884 35.48950020356899, -82.52621663104166 35.48949120354952, -82.52593363099432 35.4894942035211, -82.52589363098794 35.489493203516766, -82.52572863096071 35.48949220349962, -82.52560363094027 35.48949020348643, -82.5253786309055 35.48947420346016, -82.52522963088235 35.48946420344279, -82.52491663083585 35.48942920340363, -82.52459163078913 35.48938220336077, -82.52433563075158 35.489351203328205, -82.52398663069738 35.489327203287544, -82.52397963069376 35.489343203290076, -82.52395963068268 35.489393203298185, -82.52395363067915 35.48941020330107, -82.52380663066052 35.48937320327845, -82.52379763065917 35.48937220327735, -82.52357163062419 35.48935620325094, -82.52340963059831 35.48935020323309, -82.52331963058482 35.48934020322182, -82.52328963058036 35.48933720321815, -82.52316063055912 35.4893362032047, -82.5230916305466 35.489343203199034, -82.52308463054537 35.489344203198485, -82.52295863052348 35.48935020318683, -82.52288663051192 35.489348203179084, -82.52281863050065 35.48934820317202, -82.52273063048641 35.48934620316264, -82.52264663047261 35.489345203153825, -82.5224696304453 35.489332203133095, -82.52238263043162 35.489327203123125, -82.5222556304121 35.48931720310812, -82.52187763035396 35.48928820306337, -82.5217516303344 35.489279203048625, -82.52179263039451 35.48893120298206, -82.52191963057538 35.48788820278303, -82.52196263063571 35.48754120271682, -82.52203463073175 35.4869922026125, -82.52206263077 35.486773202570895, -82.5220946308114 35.48653720252617, -82.52215563090178 35.48601320242584, -82.52219463095989 35.48567620236125, -82.5221956309699 35.48561220234832, -82.52220063099786 35.48543520231288, -82.52217563107926 35.484877202196856, -82.52212663113482 35.484461202107134, -82.52210763115679 35.48429720207188, -82.52205563124102 35.48369120194331, -82.52203963125501 35.48358220191946, -82.52202763126552 35.483501201901795, -82.52200463129923 35.48325620184958, -82.52199563131428 35.48314820182665, -82.52198463132501 35.483066201808846, -82.52195263135707 35.48282220175601, -82.52194263136786 35.482741201738534, -82.5219076314123 35.48241320166824, -82.52181763152788 35.48156120148569, -82.52180863153849 35.481482201468694, -82.52180363154552 35.48143120145778, -82.52176963158998 35.481104201387794, -82.52174863161792 35.48089920134403, -82.52168863170215 35.480284201212754, -82.52166963173039 35.48007920116915, -82.52164363176269 35.47984020111784, -82.52162363178788 35.47965420107796, -82.52160763180862 35.479501201045174, -82.52156563185729 35.47913820096704, -82.52156363185932 35.479123200963805, -82.52153063189013 35.47888620091226, -82.5214996319389 35.47853420083753, -82.52149763194241 35.478509200832185, -82.52147863196839 35.47831920079158, -82.52143463199079 35.478125200747584, -82.52139163201018 35.47795220070807, -82.52131563203419 35.477713200651685, -82.52122863205003 35.47751520060248, -82.52108863207656 35.47719120052216, -82.52104663208225 35.477108200500986, -82.52092963210718 35.4768192004302, -82.52084963212144 35.476639200385414, -82.52011563225226 35.47499119997508, -82.51987163229592 35.474442199838364, -82.51996863231663 35.47441219984225, -82.52002963233492 35.47435819983751, -82.5202286323988 35.47415619981676, -82.52033563242986 35.47406919981006, -82.5205866324961 35.47390819980304, -82.52064763251317 35.4738631998002, -82.52073463253843 35.473792199794616, -82.52097063260632 35.473604199780574, -82.5210906326433 35.47349219977007, -82.5212736327069 35.47327519974472, -82.52135763273128 35.4732061997393, -82.52147963276431 35.47312219973477, -82.52161663279647 35.47306119973641, -82.52167463280897 35.47304219973841, -82.52175763282689 35.47301519974145, -82.52191263285239 35.47301619975756, -82.52214263289596 35.47298019977378, -82.52239163294249 35.47294519979217, -82.52243563295062 35.47294019979565, -82.52270563299896 35.472916199818464, -82.52383163321164 35.47274619989926, -82.52431163330195 35.47267519993399, -82.52434263330329 35.47270019994225, -82.52572163337358 35.47373320029362, -82.52641563341548 35.47421020046176, -82.52715563342822 35.474927200683446, -82.52772063346751 35.47528220081356, -82.52833863353901 35.47548420091798, -82.52950563373707 35.475453201031215, -82.52966563376579 35.47543820104451, -82.53047463391216 35.475358201111156, -82.53052063387952 35.475621201169375, -82.53062963388743 35.47568720119402, -82.53090163390466 35.47586920125885, -82.53153263395282 35.476237201398376, -82.5321756340205 35.47649120151585, -82.53307663416223 35.47654020161822, -82.53499163446672 35.47662420183153, -82.53719663487051 35.47637320200635, -82.5380746350452 35.476182202057466, -82.53915263525926 35.47595120212088, -82.54071063554866 35.47574720223901, -82.54208763575272 35.47590520241223, -82.5421226357579 35.47590920241662, -82.54272963584377 35.47600520249828, -82.54353963597018 35.47605620259169, -82.5445536361188 35.47618320272137, -82.5451286362068 35.47623120279005, -82.54558463623843 35.47651820289519, -82.54591963622406 35.476974203022266, -82.54629763621416 35.47744820315737, -82.54627863616719 35.47773420321366, -82.54674063622807 35.47783720328191, -82.54682863623357 35.47789620330292, -82.54690863624243 35.477925203317106, -82.54702263625896 35.477940203331826, -82.54786963637471 35.478101203451295, -82.54802263639317 35.478146203476086, -82.54815163640522 35.478207203501775, -82.54825163640999 35.47828420352766, -82.54834263641182 35.478371203554644, -82.54841863640678 35.47848620358586, -82.5484576363963 35.478597203612516, -82.54846163639175 35.47863120361976, -82.54847363638419 35.478693203633625, -82.54847263636967 35.47878720365263, -82.54845863635512 35.47886720366745, -82.54842563633412 35.47896820368468, -82.54804163612737 35.47990320383557, -82.54801663611167 35.47997820384821)))",6404,37,021,002204,370210022043,1129,1129,318,1082,681,120,2,30,7,242,47,849,210,639,828,553,84,2,24,5,160,21,514,476,38
census_2010_blockgroups_view.fid--2dc29038_13ec899ba8f_-2605,"MULTIPOLYGON (((-82.594797647588 35.455667203690666, -82.59479764761389 35.45549820365631, -82.59479964769169 35.45499120355333, -82.59480064771749 35.4548232035192, -82.59480164774902 35.45461820347752, -82.59479364780027 35.45427420340674, -82.59479364783566 35.45404220335952, -82.59479364788633 35.45371120329204, -82.59478264795996 35.453217203190434, -82.59478364801146 35.45288120312212, -82.59476864806585 35.452509203044876, -82.59476864808781 35.45236520301555, -82.59477564810938 35.45223220298925, -82.59479064813645 35.452071202958, -82.59482964819878 35.45170520288744, -82.59484464822134 35.451574202862396, -82.59487964826154 35.451349202820104, -82.59493764831635 35.45105320276588, -82.5949596483309 35.45098220275361, -82.59498164834032 35.45094420274808, -82.59503064835944 35.45087220273847, -82.59507964837474 35.45082520273395, -82.59523864841636 35.4507252027299, -82.59529164843022 35.45069220272851, -82.59548164847475 35.45060720273072, -82.59594764857748 35.45044020274435, -82.59619664863156 35.45035720275292, -82.59641964867986 35.4502832027607, -82.59652364870176 35.450253202765275, -82.59672664874405 35.450196202774436, -82.59675164874945 35.45018820277537, -82.5971936488428 35.450057202793936, -82.59736964888103 35.449998202799904, -82.59743164889505 35.449973202801125, -82.59745164889951 35.44996620280173, -82.59757264892824 35.44990920280255, -82.59764464894648 35.44986820280157, -82.59768064895563 35.449847202801, -82.59779164898656 35.44976520279564, -82.5979116490224 35.4496612027867, -82.59815764909314 35.44946520277201, -82.59828864912767 35.44938120276828, -82.59843664916538 35.449295202765946, -82.59847564917523 35.449273202765454, -82.59883664926524 35.44907620276233, -82.5991586493434 35.44891420276224, -82.59928264937086 35.44886920276577, -82.59961564944084 35.44877220278012, -82.59973264946804 35.448721202781705, -82.59983664949728 35.44864320277643, -82.59984164949846 35.44864020277638, -82.59994964953309 35.448531202765196, -82.6000156495619 35.44841420274814, -82.60005264958838 35.44828120272486, -82.6000496496078 35.448151202698085, -82.600025649621 35.44803820267266, -82.59997564963273 35.44790720264082, -82.59990264965835 35.447660202583144, -82.59988264967677 35.447518202552125, -82.59988764969748 35.447388202526184, -82.59989164970412 35.447349202518666, -82.59991064973207 35.44718620248744, -82.59999864984415 35.446548202366614, -82.60001564987313 35.44637720233351, -82.60001764987607 35.446360202330226, -82.60004664997345 35.44575420220987, -82.60005765000618 35.445552202169864, -82.60009465009111 35.44503620206862, -82.60013965018028 35.44450120196433, -82.60015465021925 35.44426220191725, -82.60016265024683 35.44409020188301, -82.60016565025593 35.44403420187199, -82.60016865027859 35.443889201842715, -82.60017665032316 35.44360620178595, -82.60018865035056 35.44343920175314, -82.60019465037784 35.44326720171875, -82.60019565038192 35.443242201713815, -82.60019165042927 35.442927201649184, -82.60017865044405 35.442816201625334, -82.60014765045237 35.44272820160421, -82.59999765048278 35.44236620151519, -82.59998065049973 35.4422372014872, -82.59998165052022 35.44210420146023, -82.59999165054704 35.44193920142773, -82.60001465056887 35.44182120140598, -82.60001065058789 35.44169220137932, -82.5999856506068 35.44154120134607, -82.59993865061809 35.441416201315874, -82.59985465063085 35.44124120127158, -82.59975365063781 35.4410862012297, -82.59962965064092 35.440931201185464, -82.59934865063269 35.44068020110562, -82.59922065062962 35.440561201068306, -82.59911265062864 35.44045020103468, -82.59902865063101 35.44034320100437, -82.59897265064058 35.440220200973556, -82.59893365065595 35.44007720094048, -82.59888665069772 35.43975220086951, -82.59885265071364 35.439611200837284, -82.59879365073067 35.4394352007954, -82.59870865074654 35.43923920074691, -82.59861965076048 35.43905120069949, -82.59854265077067 35.438901200661135, -82.5984656507768 35.43877720062802, -82.59841865078235 35.43869020060545, -82.59839365079036 35.43861020058666, -82.59838965080638 35.43850120056403, -82.59841065083044 35.438366200538695, -82.59844665086477 35.438180200504505, -82.59848965089823 35.438008200473874, -82.59854165093002 35.437856200448266, -82.59861265096352 35.43771420042665, -82.59865665098128 35.437645200417066, -82.5987046510003 35.437573200407314, -82.59879565103466 35.437447200391, -82.59887265106065 35.43736020038114, -82.59901765111267 35.43717720035878, -82.59918465113347 35.437222200384994, -82.59946165112025 35.43761020049229, -82.59976965107779 35.438222200648376, -82.60010565106272 35.438686200777184, -82.60050565108513 35.438974200876764, -82.60103365113844 35.43919820097628, -82.60156165120421 35.43934120105941, -82.60165765121116 35.43940020108123, -82.60197765123417 35.439597201154065, -82.60256965130061 35.43980520125698, -82.60412165144557 35.44054120156551, -82.60490465148546 35.441131201765685, -82.60548165151486 35.44156520191306, -82.60588165153229 35.4418852020191, -82.60664965156937 35.44247720221815, -82.60756165164003 35.44300520241891, -82.608265651725 35.44321320253325, -82.60888965182124 35.443261202606855, -82.60924865189776 35.44315020262095, -82.60930565190978 35.44313320262339, -82.60978565201391 35.442973202639834, -82.61055365224394 35.442301202581575, -82.61109765242458 35.4417092025167, -82.61130165248132 35.441559202507015, -82.61156665256186 35.44131920248527, -82.6116066525739 35.44128420248221, -82.61174665261368 35.441176202474594, -82.61196765268491 35.44094920245095, -82.61211865272493 35.440851202446495, -82.61231265278774 35.440651202425606, -82.61257265286693 35.4404152024041, -82.61265065288636 35.44037220240335, -82.61271565290777 35.44030220239571, -82.61277565291981 35.44028920239925, -82.6130526529792 35.440201202409625, -82.61328665301852 35.440198202432924, -82.61342765304524 35.440176202442885, -82.61349165305613 35.44017420244901, -82.61356965307384 35.44014320245073, -82.61371865310242 35.44011820246083, -82.61388965314036 35.4400552024655, -82.61430265323342 35.43989420247491, -82.61466065332229 35.439701202472236, -82.61513665343016 35.43951220248246, -82.6154626535096 35.43934620248196, -82.61583865359432 35.43920020249071, -82.61596765362668 35.43912820248929, -82.61611765365757 35.43908920249662, -82.61631065370601 35.438981202494425, -82.61672565380361 35.43879320249854, -82.61705065388155 35.438636202499794, -82.61737165395799 35.43848420250174, -82.61749765398984 35.43841220249997, -82.61783565406517 35.43828620250881, -82.61798565410761 35.43817120250077, -82.61820865416404 35.43804420249767, -82.61856765424835 35.43788220250144, -82.61893365433978 35.43768120249793, -82.61966765452213 35.43728420249213, -82.61985265456703 35.43719120249216, -82.62031865468455 35.4369282024862, -82.62068765483232 35.436361202408534, -82.62071065483904 35.436342202407005, -82.62078265485938 35.436287202403165, -82.62080665486613 35.43626920240197, -82.62135865502285 35.4358422023714, -82.62147465505565 35.43575320236514, -82.62184465516044 35.43546920234519, -82.62210565519477 35.435528202383935, -82.62243865521417 35.43576320246575, -82.62286965524628 35.43602120256238, -82.62322865522833 35.43652920270251, -82.62337665521947 35.43674820276219, -82.62358765520682 35.43706020284735, -82.62382065518372 35.43746520295365, -82.6238276551806 35.437493202960006, -82.6238486551708 35.437580202979866, -82.62385565516746 35.437609202986465, -82.62382565516256 35.43760920298343, -82.62373465514739 35.4376092029741, -82.62370565514263 35.437609202971146, -82.62415365514798 35.438061203109, -82.62480965523733 35.438189203202164, -82.62521665527264 35.438400203286754, -82.62586565533688 35.43868520341112, -82.62692265548294 35.438877203558235, -82.62751465554457 35.43911720366768, -82.62820465560151 35.43949420381495, -82.62941865570185 35.44015720407409, -82.63058665578332 35.440893204343354, -82.63268265606045 35.44135720465207, -82.63420265620522 35.44206120495091, -82.63511465628582 35.44252520513862, -82.63877865671346 35.44370820575409, -82.64069865699562 35.44394820599923, -82.64183465710606 35.44446020621965, -82.64198265709526 35.44469220628207, -82.64239465706466 35.44534020645613, -82.64259765706815 35.44553820651719, -82.642962657047 35.44607420666364, -82.64308865703151 35.44631220672505, -82.64311765693682 35.44696420686076, -82.64303365687476 35.447279206916406, -82.64321065681096 35.44788920705865, -82.64350265678695 35.4483642071853, -82.64400765678278 35.44894120735448, -82.64407765678212 35.449021207377896, -82.64416765678135 35.44912420740806, -82.64459165676534 35.449690207566725, -82.64461165677008 35.449681207566925, -82.64558265684805 35.45022620777721, -82.6469716570021 35.45072820802145, -82.64757965705977 35.45101120814129, -82.64788365708755 35.451160208202694, -82.64886865723817 35.451245208320714, -82.65100665743232 35.452299208753935, -82.65131565743097 35.45264420885586, -82.65196265737681 35.45370220913752, -82.65290165729856 35.45523620954595, -82.65483365777935 35.4541892095302, -82.65688865816298 35.45391220968382, -82.65692865817319 35.45388920968324, -82.65736665830059 35.45353120965514, -82.65766465838652 35.45329220963685, -82.65838865855552 35.452973209645926, -82.6595796587729 35.45284520974168, -82.65957965873672 35.45308220978989, -82.6595796586436 35.453692209914166, -82.65935565845493 35.45468421009327, -82.6593096584358 35.45475921010388, -82.65901665831235 35.45524921017374, -82.65897265829337 35.45532521018475, -82.65873665820268 35.45566221022925, -82.65772565795342 35.45619521023451, -82.65752565781963 35.45685321034811, -82.65761865779665 35.45710521040893, -82.65782465774667 35.45765621054219, -82.65786565763821 35.45841121070016, -82.65815765764964 35.458654210779564, -82.65874065779764 35.45831921077093, -82.65895465789396 35.45792121071177, -82.6595046579262 35.45830821084683, -82.65970265790254 35.4586782109424, -82.65963165777808 35.45941621108548, -82.65971565774036 35.45975421116293, -82.65991665766317 35.460478211330965, -82.66042965755457 35.461747211641956, -82.66033865747072 35.462197211724316, -82.66042965746085 35.46236121176709, -82.66053565744943 35.462551211816525, -82.66090765750616 35.4625842118613, -82.66145665761417 35.462474211895085, -82.66205565771335 35.46247621195671, -82.66229765772655 35.462653212017564, -82.66249365771971 35.46291121209011, -82.66252865769128 35.46313521213936, -82.66201665753366 35.46361021218371, -82.66149865738971 35.463989212207984, -82.66145765737818 35.464020212210116, -82.66106165726411 35.46433621223401, -82.66050565714053 35.4645402122187, -82.65955665693751 35.464837212182175, -82.65916265683352 35.46508921219319, -82.65915165676878 35.46550121227599, -82.6590146566974 35.465819212326785, -82.65874865660004 35.46616721237045, -82.65856365655343 35.46627121237269, -82.65818965645903 35.466482212377514, -82.65779865638946 35.466512212343694, -82.65763865636488 35.46649921232457, -82.65737365632421 35.466477212293, -82.65729465631847 35.46642921227518, -82.65689565628904 35.466188212185266, -82.65684065628491 35.46615521217294, -82.65621465620552 35.4659942120761, -82.65582765619526 35.465640211964406, -82.6556896561849 35.465558211933626, -82.65566665618321 35.465544211928425, -82.65524865613345 35.46541521185938, -82.65490765608756 35.465345211810266, -82.65480065607296 35.46532421179506, -82.65464165604621 35.465326211779136, -82.65441665600383 35.46535921176294, -82.65412865595084 35.465393211740334, -82.6538946558952 35.465502211738716, -82.65359565582388 35.46564421173693, -82.65358465582025 35.4656562117383, -82.65332965573397 35.46594321177065, -82.65289765565232 35.46600821173976, -82.65235365552788 35.46623121172955, -82.65206665543872 35.466502211755355, -82.6517116553196 35.466896211799295, -82.6516346552937 35.466982211808954, -82.65125165516436 35.467412211857415, -82.65112365509665 35.46771621190617, -82.6500216548624 35.46805121186175, -82.6493496546824 35.46849821188409, -82.64895065458681 35.46869021188239, -82.64824665445275 35.468802211833214, -82.64797465435636 35.469137211873594, -82.64746365426416 35.469185211831096, -82.64714365416712 35.4694722118568, -82.64682465405306 35.46987121190544, -82.64620065389589 35.47022221191316, -82.64596865383794 35.4703492119153, -82.64588165381598 35.470398211916404, -82.64537065363096 35.47105321199749, -82.64479465344967 35.47161321205267, -82.64434765331447 35.472012212088146, -82.64353665308784 35.47261321212759, -82.6421416526978 35.47364921219597, -82.64106765241019 35.47436321223153, -82.64068665230815 35.4746172122443, -82.64055965224317 35.474904212289744, -82.64038365218961 35.475063212304065, -82.6402616521635 35.475101212299336, -82.63993165209257 35.47520721228719, -82.63989765208672 35.47520821228391, -82.639770652065 35.475212212271664, -82.6383626517064 35.47602821229386, -82.63824465167282 35.4761192123003, -82.6378506515602 35.47642821232294, -82.63724265132957 35.47727621243343, -82.636826651214 35.477580212452814, -82.63661865107662 35.47825221256838, -82.63596265087962 35.478828212618616, -82.63548265072156 35.47934021267376, -82.63516265057785 35.479932212761604, -82.63490765050632 35.48012321277442, -82.63484265048805 35.4801722127777, -82.63465065039745 35.480556212836305, -82.63484265036571 35.48097221294066, -82.63522665035605 35.48145221307769, -82.63524265032932 35.481644213118415, -82.63513765030537 35.481687213116466, -82.63482265023283 35.48181921311111, -82.63471865020874 35.48186321310938, -82.63350164995144 35.48222421305839, -82.63318964988521 35.482318213045666, -82.63287164979789 35.48254421305911, -82.63239464970478 35.48263521302883, -82.63204664957844 35.48308321308445, -82.63072264926971 35.48366421306728, -82.63017964914326 35.48390121305994, -82.62901864887219 35.484412213045175, -82.62909864887814 35.48446021306314, -82.62927764884013 35.48490321317165, -82.62937064882055 35.48513221322782, -82.6296586487386 35.485980213430054, -82.62968564865562 35.486552213549274, -82.62969064864356 35.486636213566854, -82.6294346485374 35.4870522136254, -82.62890264838938 35.48744221365037, -82.62889364838723 35.48744621365028, -82.6283306482453 35.487763213657196, -82.62760864809219 35.48798021362751, -82.62702164796957 35.48814421360087, -82.62637764783481 35.48832621357201, -82.62600564777543 35.48831021353064, -82.62586264775247 35.48830521351502, -82.62511564763284 35.48827621343262, -82.62489264759813 35.48826121340678, -82.62452264754047 35.48823621336378, -82.62404564740204 35.48862321339381, -82.62297364709121 35.48949121346073, -82.61928264602008 35.492485213692625, -82.61832864574336 35.4932582137523, -82.61807864567064 35.4934622137683, -82.61651964531985 35.49406221373079, -82.6165136453183 35.49406621373105, -82.616498645314 35.49407821373196, -82.61649364531232 35.49408321373248, -82.61635364527226 35.494193213740566, -82.61602264517924 35.49444221375732, -82.61600064517275 35.49446021375877, -82.6151716449417 35.49507021379807, -82.61473164481754 35.495404213821, -82.61459664477995 35.495503213827405, -82.61411964464699 35.495854213850016, -82.61375664466897 35.495317213703544, -82.61386964473301 35.49502121365476, -82.61427964496329 35.493962213481126, -82.61448564512423 35.49313421333365, -82.61476864527644 35.49244721322274, -82.61474464529698 35.492286213187505, -82.6147176453218 35.49209521314578, -82.61454364532305 35.49189821308785, -82.61445564533153 35.49174721304818, -82.61444964538157 35.49141421297971, -82.61386564529805 35.49132621290202, -82.61347464522551 35.49137621287214, -82.61340864521311 35.4913852128672, -82.61263464507395 35.491455212802194, -82.61210064494256 35.49173421280433, -82.61139464473901 35.49229821284692, -82.6110696446075 35.49280521291687, -82.61105264460039 35.49283321292087, -82.61074264445979 35.49341521300757, -82.61081264442807 35.49369821307233, -82.6107786444102 35.49377821308516, -82.61083364438964 35.493972213130334, -82.61089564436648 35.49419021318105, -82.61091964433157 35.494444213235234, -82.61086764429885 35.49460221326209, -82.61075264427011 35.49466521326309, -82.61066464425284 35.494682213257576, -82.61060564424102 35.49469521325419, -82.61037664420317 35.49469421323054, -82.61019364418262 35.494630213198725, -82.60982164417165 35.49429821309312, -82.60946164415724 35.49400221299591, -82.60896664410663 35.49379621290336, -82.60870964407098 35.49375021286764, -82.60833264400063 35.49380121283938, -82.60814064396592 35.49381921282343, -82.60781164390632 35.49385221279644, -82.6073266438101 35.49395421276756, -82.60702264376172 35.49394121273377, -82.60674164373543 35.493808212677955, -82.6063006436391 35.49395921266347, -82.60589064352614 35.49425221268115, -82.60522964328028 35.49514121279447, -82.6047216431652 35.49534221278341, -82.60481864305696 35.49615421295862, -82.60485364303383 35.49634321300069, -82.60408564275336 35.497342213125485, -82.603930642675 35.49768621317962, -82.60386164256275 35.49834421330651, -82.60368764251592 35.4984612133125, -82.60346964245689 35.498610213320596, -82.60305764234978 35.49886321332983, -82.60269064227738 35.49893821330748, -82.60242364222566 35.49898621328992, -82.60289464225659 35.49929521340118, -82.60322164223902 35.49976421353008, -82.60314064221393 35.49984021353724, -82.60309064219547 35.499906213545636, -82.60307664218352 35.49996921355695, -82.60307364217181 35.50004221357149, -82.60308664216039 35.50013121359101, -82.60309664213938 35.500279213622136, -82.60311664212338 35.500405213649834, -82.60310364209319 35.50058821368576, -82.60303764205754 35.500749213711785, -82.60302564205328 35.500764213713616, -82.60291664201372 35.50090421373094, -82.60274864197146 35.50099821373286, -82.60249364191229 35.50110821372917, -82.60221764185148 35.501206213720856, -82.60195964180052 35.50125921370519, -82.60174364176713 35.50124321367984, -82.60146264172886 35.50118821363984, -82.60106464167698 35.50109521358017, -82.60065964161909 35.50103521352647, -82.60042264157957 35.50103621350235, -82.600007641507 35.50106021346475, -82.5999646414981 35.50107121346257, -82.59971364144543 35.50114321345155, -82.599560641408 35.50122221345193, -82.59949964138711 35.501292213459934, -82.59941064135825 35.501384213469564, -82.59932364133557 35.50143821347168, -82.59921664131048 35.501486213470514, -82.59909864128939 35.50149521346021, -82.59901764127582 35.50149621345211, -82.5992556412689 35.501799213538185, -82.59939364125646 35.50203021359933, -82.5996596412723 35.502215213664286, -82.59968364124427 35.502424213709226, -82.5995766412253 35.502432213699905, -82.59929564117505 35.502455213675795, -82.59911264114245 35.50247021366013, -82.59880364109695 35.50243221362078, -82.59851064105447 35.50239221358257, -82.59807764097727 35.502427213545324, -82.59724664076896 35.502886213553715, -82.59696764063607 35.503451213640155, -82.59622064046923 35.50373121362061, -82.59619664046369 35.50374121362021, -82.59583564032212 35.50427421369172, -82.59565164019996 35.504872213794606, -82.59537564022283 35.50442421367518, -82.59525464023267 35.50422821362282, -82.59513464024084 35.504045213573306, -82.5949506402438 35.50382621350984, -82.59451464023536 35.50340921338031, -82.59435564023545 35.50323621332881, -82.59435364023561 35.503233213328, -82.59425664024252 35.50308321328754, -82.59410964026618 35.50276921320849, -82.59403564028042 35.50259621316576, -82.59391964030304 35.502323213098265, -82.59381464032323 35.50207721303741, -82.59374164033746 35.50190521299495, -82.5936466403557 35.50168321294, -82.5933626404106 35.50101721277534, -82.59326864042885 35.50079621272068, -82.59323464043518 35.50071821270139, -82.59313964045377 35.50049421264602, -82.59313464045432 35.50048521264367, -82.59310064046049 35.50040821262453, -82.59306464046666 35.50032821260452, -82.59302864047301 35.50024821258455, -82.59297564048823 35.50009121254718, -82.59297364048908 35.50008321254534, -82.59295264049848 35.49999921252607, -82.59295164049934 35.49999321252474, -82.59294864050214 35.49997121251999, -82.59293964051352 35.499887212501946, -82.59293664051724 35.49985921249594, -82.59292964052499 35.499801212483405, -82.59293164054188 35.49969321246168, -82.59293364054903 35.49964921245289, -82.592956640575 35.49950421242571, -82.59302964063241 35.49920821237299, -82.59307064066374 35.499048212344576, -82.59315364073328 35.49868421227899, -82.59319164077377 35.49846121223745, -82.59320164080333 35.498279212201425, -82.59319164082764 35.49810921216583, -82.59314664084917 35.49792021212275, -82.59306564086754 35.49771221207214, -82.59302564087186 35.49764121205357, -82.59301364087321 35.49761921204779, -82.59299164087584 35.49757821203725, -82.59296764087833 35.497536212026255, -82.59279164088302 35.497314211963, -82.5925946408862 35.49708021189515, -82.59252364088822 35.49699021186958, -82.591438640901 35.49573121150217, -82.5906326409077 35.49481421123297, -82.59022464091287 35.4943382110942, -82.59021464091288 35.494327211090955, -82.58924664091748 35.493248210772194, -82.5887756409122 35.49277221062704, -82.58875864091206 35.49275521062183, -82.5884096409009 35.49244921052381, -82.58832664089714 35.49238421050208, -82.58721564084603 35.49151421021114, -82.5866896408218 35.491102210073485, -82.586583640817 35.49101921004571, -82.58649464081279 35.49095021002255, -82.58602664079082 35.490586209900485, -82.5859106407852 35.49049720987061, -82.58571564077573 35.4903482098202, -82.58543964076233 35.490136209748776, -82.5854006407602 35.490108209739134, -82.5850286407387 35.48984520964753, -82.58473364071578 35.48967520958268, -82.58437664068104 35.489515209513556, -82.58429264067279 35.48947820949738, -82.5840036406386 35.48938820944946, -82.58376864061088 35.48931520941056, -82.58376464061033 35.489314209409976, -82.58309764052524 35.48914720930764, -82.5830546405199 35.489135209300805, -82.58281864049044 35.48907220926381, -82.58274764048166 35.48905220925247, -82.58268064047337 35.489034209241886, -82.58260064046426 35.48900620922806, -82.58254264045952 35.488975209215795, -82.58247864045413 35.488941209202295, -82.5824036404478 35.488901209186494, -82.58233664044415 35.488852209169636, -82.5822166404376 35.48876520913959, -82.58206464043668 35.48860620909172, -82.58198664044062 35.48849620906131, -82.58194964044239 35.488444209047, -82.58191164045084 35.48834820902351, -82.58173864048999 35.48790520891559, -82.58172564049295 35.487871208907386, -82.58149164056039 35.48717720874213, -82.5812946406234 35.486552208594745, -82.58122564064584 35.48633120854274, -82.58117564067378 35.48609420848935, -82.58116264068114 35.486032208475436, -82.58112364070266 35.48584920843422, -82.58111164071006 35.48578820842057, -82.58110164071564 35.48574120840996, -82.58108664072417 35.48566920839379, -82.5810806407338 35.48559920837889, -82.58105764076599 35.485364208328654, -82.58101964082509 35.48493720823788, -82.58103464092173 35.48432220811426, -82.58107264100272 35.483834208018855, -82.5811796411448 35.4830222078645, -82.58131664133569 35.481923207654866, -82.58141564146437 35.481190207515795, -82.58142364147191 35.48114920750828, -82.58142564147963 35.481101207498746, -82.58146064152614 35.48083520744811, -82.581469641538 35.48076720743528, -82.58159164170725 35.47979420724969, -82.58163864176554 35.47946420718732, -82.58166764180508 35.479237207144095, -82.58168364183972 35.47902820710319, -82.58167564186641 35.47884520706516, -82.58165264189013 35.478665207026125, -82.5816226419131 35.4784822069858, -82.58159464192347 35.478384206963, -82.58156864193488 35.47828120693936, -82.58147664196166 35.47800720687422, -82.58138564198325 35.47776720681608, -82.58113964204159 35.47711920665901, -82.58081964211767 35.47627520645439, -82.5806916421476 35.47594120637332, -82.58045864220196 35.47533320622578, -82.58038964222007 35.47514020617939, -82.580372642224 35.475096206168764, -82.5801026422871 35.474391205997584, -82.58001364230806 35.474157205940806, -82.57998564231461 35.47408420592309, -82.57990264233452 35.47386420586982, -82.57987564234098 35.473792205852384, -82.57984964234703 35.47372520583611, -82.57977464236531 35.47352420578756, -82.5797496423714 35.4734572057713, -82.57974564237219 35.47344820576914, -82.5797366423745 35.47342320576309, -82.57973364237517 35.47341520576114, -82.57973064237578 35.473408205759405, -82.5797236423777 35.47338820575459, -82.57972164237829 35.473382205753246, -82.57959464240832 35.4730482056722, -82.57921464249857 35.472046205429365, -82.57911364252266 35.47177920536475, -82.57908764252846 35.471713205348635, -82.57900264254741 35.47149720529592, -82.57898664255106 35.47145620528599, -82.5787566426058 35.470849205138876, -82.57867564262533 35.47063320508663, -82.57854664265632 35.47029120500384, -82.57848764267102 35.47013120496525, -82.57826564271643 35.469593204832954, -82.57821464272563 35.46947820480432, -82.57817964273191 35.46939920478473, -82.57812264274051 35.46928120475489, -82.57796364276433 35.46895320467181, -82.57780764278648 35.46863920459194, -82.57744764283787 35.467913204407374, -82.57733864285228 35.46770020435284, -82.57717964287355 35.46738920427326, -82.57706164288913 35.467159204214354, -82.57670964293588 35.46647220403851, -82.57667464294057 35.46640320402092, -82.57661964295076 35.46627720398957, -82.5766086429552 35.46623620398012, -82.57675764299279 35.46615220397828, -82.57680464300469 35.46612520397761, -82.57704164306377 35.465996203975635, -82.5772496431161 35.46587920397308, -82.57739364315312 35.46579320397032, -82.57758864320309 35.46567820396691, -82.57821464336378 35.46530620395535, -82.57842364341677 35.465186203952264, -82.5788306435196 35.46495520394692, -82.57897464355486 35.464881203946554, -82.57931064363257 35.46473720395167, -82.57947364366957 35.46467220395515, -82.57963764370882 35.4645932039559, -82.57983664375867 35.46448320395388, -82.58015864384066 35.464296203948756, -82.58029464387282 35.46423320394988, -82.58040864389808 35.464192203953246, -82.58047064391124 35.46417320395567, -82.58051864392128 35.464159203957685, -82.58064764394726 35.46412920396483, -82.58081164397804 35.464106203976925, -82.58108164402799 35.46407220399767, -82.5813606440793 35.464039204019485, -82.58164864413396 35.46399420403977, -82.58182464416863 35.46395820405048, -82.58189864418323 35.46394320405503, -82.58203764421104 35.46391220406292, -82.58205864421531 35.46390720406408, -82.58217764424002 35.463874204069555, -82.58219564424367 35.463870204070496, -82.58232964427285 35.46382420407487, -82.58247564430641 35.46376320407744, -82.58258064433153 35.463713204078054, -82.58271164436272 35.46365120407874, -82.58287364440108 35.46357620408013, -82.58297664442392 35.4635382040829, -82.58299864442864 35.46353120408381, -82.5831196444545 35.4634932040884, -82.58335864450295 35.463436204101264, -82.58349764453156 35.46339920410797, -82.58360764455509 35.46336520411231, -82.58375764458991 35.46330020411443, -82.58380064460037 35.46327820411432, -82.58389964462422 35.463229204114505, -82.58403364465538 35.46317120411641, -82.58406564466205 35.463162204117914, -82.58411364467229 35.46314720411977, -82.58415664468129 35.463135204121706, -82.58426264470081 35.463122204129874, -82.58427564470318 35.46312120413106, -82.58431364470947 35.46312120413491, -82.58448564473827 35.463119204152136, -82.58479064478747 35.46312820418514, -82.58481264479114 35.463128204187434, -82.585043644829 35.46313120421164, -82.58523064486229 35.463116204227774, -82.58532264488042 35.463097204233264, -82.58541664490113 35.463064204236254, -82.5854866449196 35.46301920423428, -82.585548644938 35.46296620422978, -82.5856236449633 35.46288220422039, -82.58593464507692 35.46247620416954, -82.5859946450985 35.4624002041602, -82.58613564514883 35.46222420413885, -82.58630964520997 35.462013204113724, -82.58632864521675 35.46198920411077, -82.58637964523425 35.46193020410395, -82.58644864525749 35.461853204095384, -82.58660664530802 35.46169420407912, -82.58668364533244 35.46161720407138, -82.58678364536348 35.4615232040625, -82.5869386454112 35.46137920404906, -82.58708864545669 35.461244204036916, -82.58709364545817 35.461240204036606, -82.58718964548784 35.46115020402814, -82.58738964554996 35.4609612040101, -82.58741264555758 35.46093620400736, -82.58762064562583 35.460715203983725, -82.58774364566814 35.46057220396716, -82.58801664576511 35.46023420392629, -82.58806364578165 35.4601772039195, -82.58821764583419 35.46000020389927, -82.58827064585236 35.45993920389231, -82.58839764589352 35.45980720387835, -82.5885036459277 35.459699203867295, -82.58861564596263 35.45959220385699, -82.58890464604893 35.4593412038354, -82.58898164607191 35.45927420382973, -82.58903364608723 35.459230203826046, -82.58918464613147 35.45910520381608, -82.589217646141 35.45907820381389, -82.58929964616237 35.45902720381192, -82.58936064617815 35.458990203810686, -82.58947064620362 35.45894320381231, -82.5895046462108 35.458933203813764, -82.58956364622307 35.45891720381657, -82.58966364624084 35.45890920382515, -82.58976164625632 35.45891420383625, -82.59014964631284 35.458965203886265, -82.59027764633366 35.45896820389999, -82.5904006463551 35.45896120391122, -82.59055864638513 35.458936203922256, -82.59059564639257 35.4589282039244, -82.59086264644445 35.45887820394161, -82.5909566464617 35.45886720394894, -82.59119264650451 35.458843203968236, -82.5912916465242 35.458822203974094, -82.59138764654519 35.458789203977226, -82.59149164657065 35.458735203976794, -82.59164264661011 35.45864120397316, -82.59176364664324 35.45855520396809, -82.59192864668834 35.4584392039613, -82.59206264672653 35.458335203953844, -82.59227464679071 35.458145203936866, -82.59273264693994 35.45766620388621, -82.59284664697479 35.45756120387651, -82.59292564699808 35.45749520387115, -82.59308164703904 35.45739620386704, -82.59341764712372 35.457207203862886, -82.59362664717533 35.457096203861724, -82.59376064720747 35.45703120386217, -82.59386964723267 35.45698520386396, -82.59390564724075 35.45697120386481, -82.59435964734017 35.45681320387908, -82.59450964737594 35.45674220388, -82.5946736474201 35.45663120387422, -82.59475864744698 35.45654720386577, -82.59478464746321 35.45646920385255, -82.59479164746746 35.4564492038492, -82.5947976475098 35.456179203794896, -82.59479764755741 35.45586720373142, -82.594797647588 35.455667203690666)))",6265,37,021,002301,370210023011,1344,1344,59,1319,1259,12,8,12,1,27,25,1007,38,969,994,949,12,8,6,1,18,13,643,511,132
census_2010_blockgroups_view.fid--2dc29038_13ec899ba8f_-2604,"MULTIPOLYGON (((-82.57049260680515 35.69462924984921, -82.5704966068077 35.69461724984722, -82.57051060683064 35.69448424982159, -82.57054260687826 35.69421024976907, -82.57054260690316 35.69404924973631, -82.57054360690796 35.69401924973026, -82.5705396069251 35.69390424970641, -82.57053760692992 35.693871249699534, -82.5705356069429 35.69378524968177, -82.57053360694441 35.69377324967916, -82.57052960694871 35.69374124967217, -82.57050260697262 35.693557249631944, -82.5704546070084 35.69327424956936, -82.57043960701608 35.69320924955455, -82.570381607046 35.69295324949652, -82.57031160708621 35.69261824942109, -82.570244607119 35.6923342493563, -82.57021960714184 35.69215924931812, -82.57023360716187 35.692045249296314, -82.57029360719393 35.69190224927344, -82.5703626072186 35.691817249263174, -82.57046760724593 35.691753249261005, -82.57050760725502 35.69173724926184, -82.57059060727347 35.69170724926427, -82.57072260730021 35.69167624927152, -82.57083060732332 35.69164324927592, -82.57090460734102 35.69160824927638, -82.57096060735785 35.69155924927223, -82.57097560736722 35.69151524926477, -82.57097960736986 35.69150224926251, -82.57097960737788 35.69145024925196, -82.57089760738111 35.69134124922136, -82.57074160738462 35.69115124916656, -82.57060160739361 35.69094224910957, -82.57043760742125 35.69058724902042, -82.57034760742934 35.69043824898081, -82.5702546074332 35.690313248945756, -82.57018760743277 35.69024424892482, -82.57020860744231 35.690205248919035, -82.57023860746266 35.69010624890194, -82.57025460748584 35.689973248876605, -82.57028460751916 35.689790248842364, -82.57033060754682 35.689660248820594, -82.57040660757778 35.68954224880439, -82.57048360760484 35.689450248793634, -82.57058260763188 35.689381248789715, -82.57064360764731 35.68934724878912, -82.57075760766921 35.68932824879698, -82.57088760769149 35.68932424880949, -82.5715206077825 35.6894162488934, -82.57174160781689 35.68943124891925, -82.57182560783254 35.68942024892561, -82.57190260784951 35.68939324892804, -82.57195860786562 35.68934924892493, -82.57199160787849 35.68930224891869, -82.57199560788473 35.68926524891157, -82.57199760788858 35.689243248907246, -82.57193760789049 35.68916624888541, -82.57183860789058 35.68905924885342, -82.57172060790033 35.688869248802646, -82.57161760790622 35.68872024876164, -82.57159260790763 35.68868424875179, -82.57152360790288 35.688641248735955, -82.57146160789469 35.688627248726704, -82.57132060786851 35.68864524871586, -82.57120060784686 35.68865624870568, -82.57101360781711 35.68864724868461, -82.5708226077908 35.688612248657854, -82.57060860777543 35.68848124860916, -82.57051960776556 35.6884492485934, -82.57007660771048 35.68832924852343, -82.56985960768199 35.6882802484911, -82.56981060767752 35.688256248481146, -82.56972660766995 35.6882152484642, -82.56970960766836 35.68820724846081, -82.56953160765363 35.688111248422885, -82.56917260761506 35.68797424835803, -82.56911560760997 35.687946248346485, -82.56901560759891 35.687910248328905, -82.56842360753768 35.68766924821886, -82.5683226075268 35.68763124820077, -82.56823260751716 35.68759724818457, -82.56781960747229 35.68744324811068, -82.56725260740618 35.687261248015226, -82.56672560734162 35.687112247930685, -82.56607960726018 35.68694424782994, -82.56587360723333 35.686896247798956, -82.56563460720224 35.68684024776291, -82.56525860715135 35.68676524770895, -82.56511060713417 35.686717247683994, -82.5650586071322 35.686674247669856, -82.56500860713565 35.68659824764919, -82.56496160714846 35.68646524761733, -82.56493860715582 35.68639224760006, -82.56490860716603 35.68629424757702, -82.5648696071874 35.68611424753637, -82.56480660719642 35.68598824750422, -82.56473360719977 35.6858882474763, -82.56461360720873 35.68570124742593, -82.564521607212 35.685581247391966, -82.56443860721514 35.68547124736107, -82.56432260721509 35.685347247323904, -82.56430560721505 35.685329247318435, -82.56425560721507 35.6852752473023, -82.56423960721503 35.68525824729718, -82.56435960725373 35.685137247284906, -82.56472260736989 35.684776247248735, -82.56479660739349 35.68470324724148, -82.56484560740871 35.68465724723718, -82.56486160740951 35.684669247241274, -82.56491060741214 35.68470524725367, -82.56492760741293 35.68471824725807, -82.56498560741588 35.68476124727274, -82.56501060741671 35.68478324727978, -82.56513460742062 35.68489124731455, -82.56525260742438 35.68499324734753, -82.56528160742522 35.68501924735577, -82.56532860742531 35.685069247370826, -82.56534860742525 35.685091247377336, -82.56538360742528 35.68512824738849, -82.56541160742549 35.685157247397264, -82.56543260742538 35.685180247404105, -82.56571960742575 35.68548624749595, -82.56576060742147 35.68555824751483, -82.56585460742026 35.68566724754671, -82.56592860740535 35.685843247590185, -82.56596160738884 35.68598524762245, -82.56599660737237 35.68612924765541, -82.56604960736084 35.6862612476878, -82.56613060736244 35.68633824771175, -82.56621860736682 35.68640424773426, -82.56662960741978 35.68650324779677, -82.5668116074348 35.686602247835644, -82.56693960745099 35.68663524785551, -82.56711460747846 35.68664524787554, -82.56790260760782 35.68665624795893, -82.56814460764294 35.686689247990536, -82.56822560765298 35.68671124800337, -82.56831960766183 35.68675524802207, -82.56845460766384 35.68688724806283, -82.5685016076596 35.68696524808356, -82.56864960764692 35.68720624814785, -82.56871760764552 35.687288248171505, -82.56901360765897 35.68751924824907, -82.56920460767425 35.68762624829049, -82.56939760768981 35.6877332483322, -82.56953260770277 35.68779424835846, -82.56968060772158 35.68783224838146, -82.56969460772308 35.68783724838386, -82.56988260774393 35.68790424841689, -82.56997760775292 35.68794824843568, -82.57029360779205 35.688035248485924, -82.57052960782869 35.688052248513635, -82.57075860787019 35.68803024853277, -82.57085260789259 35.68798624853341, -82.57112260796379 35.68781624852662, -82.57118960797665 35.68780524853124, -82.57121060798026 35.6878042485332, -82.57133760800137 35.68780424854629, -82.57144560801498 35.68783224856307, -82.57171360803899 35.68796524861777, -82.5718226080487 35.68801924864001, -82.5719746080641 35.68808324866868, -82.57244260811113 35.68828224875743, -82.57248960811395 35.68831524876899, -82.57263760812994 35.688370248795316, -82.57276160814149 35.68842924882011, -82.57276560814186 35.688431248820976, -82.5729746081664 35.68849724885595, -82.57303760817503 35.68850924886483, -82.57316960819291 35.688535248883746, -82.5734126082283 35.68856824891547, -82.57421060834902 35.6886452490133, -82.57504960847582 35.68872724911637, -82.57572260856321 35.68888624921801, -82.57595160859105 35.68895224925502, -82.57644360865754 35.68905124932582, -82.57710360874444 35.689199249423915, -82.57769460883524 35.6892472494945, -82.57770960883751 35.689249249496456, -82.57797260888557 35.68922124951778, -82.57822860893391 35.68918324953643, -82.57863760901483 35.6891002495616, -82.57885960905865 35.68905524957529, -82.5788966090661 35.68904724957749, -82.57890860906838 35.689045249578285, -82.57901060908748 35.68903124958595, -82.57904860909468 35.68902624958885, -82.57928160913819 35.68899524960651, -82.57943460916687 35.68897424961806, -82.57944560916884 35.6889732496189, -82.5795356091844 35.688969249627355, -82.57982460923996 35.68892124964729, -82.58020460930477 35.68891024968421, -82.58056260936932 35.688878249714534, -82.58077660940783 35.68885924973267, -82.58083560941945 35.688847249736284, -82.58092260943829 35.68881924973961, -82.58103760945932 35.68880724974899, -82.58113860947763 35.68879724975734, -82.58127360950006 35.68879724977118, -82.58134060950778 35.68881924978258, -82.58138060950841 35.68885824979463, -82.58143460950552 35.68893524981587, -82.58144860947891 35.68912224985545, -82.58143760946362 35.689209249872036, -82.58140160940899 35.68952324993223, -82.58139760935501 35.68986825000214, -82.58139460930602 35.69018225006581, -82.58143560925929 35.69052825014041, -82.58146660920049 35.690942250228005, -82.58147560918435 35.691056250252096, -82.5815496091201 35.69155125036059, -82.58161760910602 35.691715250400954, -82.58171160909781 35.69186925044193, -82.58180560909548 35.69198525047531, -82.58195460909911 35.69212225051853, -82.58204260910519 35.69217725053881, -82.58222360912774 35.69222625056739, -82.5824196091553 35.6922592505943, -82.58294460924259 35.69225925064838, -82.58322060929193 35.69223725067229, -82.58369260938235 35.69216025070523, -82.58390060941942 35.692144250723274, -82.58435860949234 35.69216525077471, -82.58448760950604 35.69221525079822, -82.58480360951454 35.69250025088875, -82.5848576095133 35.692566250907795, -82.58504660951584 35.69275325096534, -82.58513460950245 35.692934251011266, -82.58516160945837 35.693248251077996, -82.58515460939613 35.693643251157724, -82.58519460936532 35.69388525121111, -82.585282609346 35.69410525126501, -82.58534960934682 35.6941712512853, -82.58547160932306 35.69445625135593, -82.58566660929768 35.694830251452196, -82.58574760929238 35.69495125148518, -82.58588260929277 35.695094251528175, -82.58601960929826 35.69520625156516, -82.58605760929979 35.695237251575335, -82.58640160932313 35.69545625165537, -82.58646860933162 35.6954732516657, -82.58654960934507 35.695473251674095, -82.58663060936196 35.695451251677916, -82.58667060937204 35.69542925167753, -82.58675860940198 35.695330251666476, -82.58679860942398 35.69523125165041, -82.5868326094559 35.69506125161924, -82.58683860947826 35.694923251591796, -82.58681160951872 35.694632251529754, -82.58678460954228 35.69445125149007, -82.58671060957174 35.69418125142744, -82.58667660963226 35.69375325133682, -82.58660960963223 35.69368125131523, -82.58658960963474 35.6936432513054, -82.5865426096669 35.69338525124807, -82.58652860966798 35.69336325124206, -82.58647460969303 35.69314325119174, -82.58641360970236 35.69301725115987, -82.5863266097866 35.69237925102092, -82.58632660980696 35.69224725099402, -82.58634660982219 35.69217025098041, -82.5863866098416 35.692088250967764, -82.58650760988475 35.69193925094988, -82.58678360996882 35.69169225092799, -82.58691461000038 35.69162925092859, -82.58725561008217 35.69146725093076, -82.58748461013387 35.69137925093644, -82.58761961016647 35.69131325093682, -82.58788861023422 35.691164250934136, -82.58812461029906 35.690999250924875, -82.58867661043416 35.69071925092463, -82.58883161046431 35.69069125093484, -82.58912061051554 35.69067025096033, -82.58913161051755 35.6906692509612, -82.58922861053372 35.690669250971226, -82.58949161057316 35.69069725100397, -82.58971361060249 35.690746251036835, -82.58994261062605 35.69084025107955, -82.5900906106389 35.690916251110266, -82.59025961065004 35.69102625115006, -82.59039361067234 35.69102625116386, -82.59048861068987 35.69101525117138, -82.59072461075293 35.69086125116428, -82.5911686108547 35.69068025117318, -82.59134361090344 35.69055325116529, -82.59138461091794 35.69050425115956, -82.59141061093655 35.69041125114323, -82.59132361094933 35.69023525109842, -82.59102661095508 35.68987825099517, -82.59090561097408 35.68962525093114, -82.59077761099879 35.6893282508575, -82.5907566110079 35.68924625083863, -82.59084461103794 35.68914725082753, -82.59101961107382 35.68910325083658, -82.59169161118453 35.68911025090709, -82.59254861132565 35.68911925099719, -82.59267661134614 35.68912425101138, -82.59286561137255 35.689157251037564, -82.59299961138798 35.68920125106022, -82.59321561140361 35.6893332511094, -82.59340461141122 35.68948725116024, -82.59351261141211 35.68959725119372, -82.59365361140591 35.68978925124732, -82.59381561140742 35.689954251297635, -82.5938256114078 35.689962251300265, -82.59395061141284 35.69006425133396, -82.59400761141598 35.690105251348115, -82.594192611426 35.69023925139446, -82.59426061143215 35.69027225140821, -82.59440861145174 35.69030525143015, -82.59465061149348 35.69029525145306, -82.59469761150145 35.69029425145765, -82.594825611527 35.69026725146528, -82.5948756115388 35.6902442514658, -82.59492061154957 35.69022325146619, -82.59497461156023 35.6902122514695, -82.59506861158273 35.69016825147014, -82.59509461158987 35.690150251469134, -82.59514961160471 35.69011325146732, -82.59520261162206 35.690058251461544, -82.59522961163503 35.69000325145315, -82.59524361166791 35.68980525141422, -82.59521661168901 35.68964025137787, -82.59515361169981 35.689502251343285, -82.59512861170403 35.689448251329665, -82.59501961170804 35.689305251289305, -82.59496161171013 35.68922925126793, -82.59478961171631 35.68900425120432, -82.59473261171844 35.688929251183225, -82.59473061171853 35.68892625118237, -82.59455361173495 35.68862925110367, -82.5944416117453 35.688442251054084, -82.5943066117447 35.6883002510112, -82.59422561173982 35.688245250991734, -82.59402661175588 35.687927250906434, -82.5939616117676 35.68778125086997, -82.59395361176927 35.687762250865305, -82.59395361178139 35.687683250849176, -82.59398961180493 35.6875702508299, -82.59407261183416 35.68747025081809, -82.59419061186739 35.68738225081228, -82.59437661190466 35.68734125082306, -82.59462761195012 35.68731725084401, -82.59470061196318 35.68731125085036, -82.59527061206468 35.687268250900196, -82.59545361209425 35.68727425092023, -82.59561061211576 35.6873042509425, -82.59572161212537 35.68736125096557, -82.59579661212572 35.6874392509891, -82.59584161210391 35.68762925103251, -82.59591561203771 35.68813725114356, -82.59607161198598 35.68863925126186, -82.59627761195749 35.68904525136581, -82.5964066119486 35.689241251419, -82.59668161196225 35.689449251489684, -82.59705361200797 35.68955425154935, -82.59739861205921 35.68959325159277, -82.5977026121006 35.689653251636315, -82.59794261213513 35.68968825166807, -82.59818261217855 35.68966525168816, -82.59845661223777 35.68957725169841, -82.59866861230182 35.68939125168234, -82.59880361236998 35.68909525163591, -82.59888561243496 35.68876325157669, -82.5988946124421 35.68872725157032, -82.59893361250325 35.688373251502256, -82.59892761254063 35.68812525145109, -82.5988666125699 35.68787025139286, -82.59876361260257 35.68754825131665, -82.59861461261809 35.68728725124818, -82.59849161263695 35.687033251183735, -82.59845361267922 35.68671825111565, -82.5984776127043 35.68658225109043, -82.59854061274233 35.68640425106061, -82.59864561278323 35.68625225104052, -82.59878961282449 35.686140251032505, -82.59890661284916 35.68610625103764, -82.59908561288351 35.68607725105009, -82.59919461289911 35.6860932510646, -82.59933161291593 35.68613225108662, -82.59975861295638 35.68633025117088, -82.60004061297536 35.68651125123677, -82.60026461297642 35.68674525130752, -82.60041861296894 35.68695925136689, -82.60060461293048 35.68740825147755, -82.6006926129054 35.68766525153897, -82.6007886128847 35.68790225159709, -82.6009126128695 35.68813425165716, -82.60114161288084 35.68830725171595, -82.60130961290618 35.68832425173668, -82.60145061293366 35.68829825174597, -82.60162061298496 35.68814925173304, -82.60188661309712 35.68771025167095, -82.60206961318505 35.68733825161407, -82.60222161323661 35.68716825159501, -82.60242661328235 35.68709325160086, -82.60285561336588 35.68701425162884, -82.60351761347418 35.68702625169944, -82.60385861352168 35.687086251746784, -82.60409861354812 35.68717325178914, -82.60428161355716 35.68731225183628, -82.60432561354348 35.68744825186858, -82.60430061351725 35.68759025189495, -82.60435261348277 35.68786925195712, -82.60431861343518 35.688141252009004, -82.60423761340067 35.68827725202842, -82.60410861336018 35.68840025204018, -82.60401461333649 35.68845225204106, -82.60380461329144 35.68851725203276, -82.6034526132256 35.688564252006074, -82.60336761320008 35.68863825201238, -82.60333961317734 35.68875525203342, -82.60338361314696 35.68899925208761, -82.60345961313065 35.68918625213356, -82.60357761312774 35.68933225217547, -82.60370461311574 35.68954625223211, -82.60385761311652 35.6897062522804, -82.6042646131405 35.68998925237997, -82.60459061316638 35.69017225245079, -82.6050816132143 35.69039125254592, -82.60573161325097 35.69085325270692, -82.60578461325395 35.69089125272018, -82.60615161325853 35.69125625283229, -82.60652761325478 35.691685252958365, -82.60659961325103 35.69178725298655, -82.6067696132329 35.692087253065175, -82.60692861318 35.69260025318603, -82.60700261314503 35.692906253256, -82.60712761312146 35.693193253327316, -82.6072226130937 35.69347525339457, -82.60748261303466 35.69413725355619, -82.60759561298542 35.69457725365751, -82.60771861294558 35.694967253749645, -82.60793261296003 35.69510425379955, -82.60794861296232 35.69510625380154, -82.60810661298444 35.69513325382336, -82.60829661302485 35.69507625383123, -82.60844461308724 35.6948322537968, -82.60889461329671 35.693962253665816, -82.60925261340311 35.69365925364089, -82.61003261358671 35.69331125365026, -82.61031161363951 35.69327025367067, -82.6104746136623 35.6932982536931, -82.61096861371881 35.69346425377775, -82.61264761384984 35.69442425414612, -82.61309761389894 35.69459125422644, -82.61354561393419 35.69484525432435, -82.61350061388625 35.69510725437307, -82.61333161386943 35.6950342543408, -82.61320361385843 35.69496725431395, -82.61286661382974 35.69479025424326, -82.61231161377438 35.69455025413723, -82.61201061374426 35.694421254079955, -82.6115146136957 35.69420125398408, -82.61110661365986 35.693994253899966, -82.61076961362298 35.69387025383997, -82.61069561361475 35.69384325382696, -82.61031161355724 35.69380225377901, -82.60994861348229 35.69389625376081, -82.6096316134077 35.69403725375696, -82.60932861332333 35.694257253770616, -82.6091276132583 35.69446125379146, -82.60895561319003 35.69471725382598, -82.60880861311676 35.69503325387518, -82.60864061305534 35.695249253901906, -82.60847961300462 35.69540425391691, -82.60830161294017 35.69562925394444, -82.60819361288375 35.69587825398406, -82.6081256128307 35.69614825403213, -82.60801561278107 35.696350254061976, -82.60801161278002 35.696353254062146, -82.60780461271315 35.696562254083446, -82.60762061264762 35.696788254110515, -82.60739461255267 35.69715925416284, -82.60720061247754 35.69743625419935, -82.60710561245047 35.697509254204476, -82.60686361238088 35.69769825421807, -82.60682261236865 35.69773325422096, -82.60673361234136 35.697814254228305, -82.60667461232349 35.69786625423283, -82.6065466122845 35.697980254242886, -82.60650061227003 35.69802425424714, -82.60644561225224 35.698080254252886, -82.60636661222722 35.69815725426042, -82.606078612148 35.69835925427194, -82.605781612083 35.698460254261924, -82.60536661202076 35.698416254210265, -82.60535861201942 35.698416254209384, -82.60497361196444 35.69835725415785, -82.60480461194142 35.6983242541337, -82.60477261193691 35.69831925412937, -82.60475061193395 35.698314254126096, -82.60459361191245 35.69828425410387, -82.60412361183751 35.69826325405123, -82.60368661174715 35.6983772540294, -82.60350561169032 35.69855025404606, -82.60337661163153 35.69879125408189, -82.60327161156536 35.699106254135245, -82.60317361149488 35.69945625419648, -82.60307161140321 35.69993925428437, -82.60307761137996 35.70009625431697, -82.6030826113664 35.700189254336465, -82.6030626113024 35.70058125441424, -82.60302061121699 35.7010882545132, -82.60301461118522 35.701287254553186, -82.60301061116874 35.70138925457354, -82.60300761114755 35.70152325460054, -82.6029846111173 35.701694254633004, -82.60297561110463 35.701766254646735, -82.60296761109885 35.701795254651785, -82.60291561105889 35.701997254687626, -82.60281361100081 35.702263254731285, -82.60275661097926 35.70234125474133, -82.60268661095249 35.70243925475409, -82.6025016108903 35.702642254776414, -82.60225561082503 35.70279925478307, -82.6012626105931 35.70323025476868, -82.60101861053592 35.7033372547654, -82.600719610467 35.70346125475985, -82.60030561036842 35.703653254756354, -82.59997061028987 35.70380025475183, -82.599943610284 35.70380925475093, -82.5997676102451 35.70387125474536, -82.59959661021155 35.70390425473453, -82.59944761018338 35.7039262547237, -82.59926161015102 35.70393525470635, -82.5990756101211 35.703928254685756, -82.59833761001013 35.70385225459438, -82.59780760993164 35.703789254526974, -82.59741760987286 35.703749254478616, -82.59711860982769 35.70372025444194, -82.59677860977988 35.70366325439534, -82.5965846097578 35.70359725436196, -82.59645060974267 35.70355125433883, -82.59621660972125 35.70343825429163, -82.59608760971241 35.70335625426168, -82.59579960969602 35.70315225419042, -82.59546360967929 35.70289925410439, -82.59489260964877 35.702482253960625, -82.59470860963556 35.702370253918886, -82.59454660961997 35.70229625388709, -82.59437060960121 35.70222825385517, -82.59421860958156 35.70219225383213, -82.59406560956072 35.70216225381032, -82.59384160952698 35.70213925378257, -82.5935086094737 35.70212525374543, -82.59314060941591 35.70210325370308, -82.5929836093907 35.702097253685686, -82.59277160935655 35.70209025366241, -82.59257060932384 35.7020852536407, -82.59228860927448 35.702101253614984, -82.5921416092462 35.702126253604945, -82.59199960921869 35.70215125359538, -82.5919356092051 35.70217025359268, -82.59190960919243 35.70222425360098, -82.59185260914721 35.70245525364223, -82.591841609135 35.70252225365473, -82.59183760912566 35.70257825366566, -82.5918536091026 35.702744253701205, -82.59187760909501 35.702819253718914, -82.59196760907507 35.70304525377426, -82.59200560906353 35.703160253801556, -82.59202760905369 35.70324725382155, -82.59205160901969 35.70349325387417, -82.5920526090183 35.70350325387624, -82.5920716089815 35.703761253930786, -82.59208460897129 35.703841253948376, -82.59217260892716 35.70422125403488, -82.59221060890505 35.704405254076235, -82.59221660888575 35.70453625410361, -82.59220560886575 35.704653254126264, -82.59216460883854 35.704785254148945, -82.59209560880684 35.70491625416851, -82.59198260876433 35.70506925418805, -82.59185560871921 35.705224254206556, -82.59179160869367 35.705320254219565, -82.59174560867118 35.705416254234386, -82.59174260865957 35.705488254248706, -82.59177560864678 35.70560625427615, -82.59189260862898 35.705847254337336, -82.59191660861373 35.70597125436504, -82.59192560860147 35.70606025438412, -82.59188760856566 35.706251254419094, -82.5918216085295 35.70641325444536, -82.5917646085031 35.70652325446185, -82.59172860847738 35.70665025448398, -82.5917116084582 35.70675625450387, -82.59172360843989 35.70688725453177, -82.59180160839044 35.70729025462193, -82.59181360838079 35.707366254638664, -82.59185660834623 35.707635254697834, -82.59189860832139 35.70784125474415, -82.5920376082089 35.708717254936886, -82.59206360818831 35.70887825497238, -82.5921086081491 35.7091802550385, -82.59220860806417 35.709836255182495, -82.59221560804342 35.709978255212064, -82.59221160802984 35.71006125522859, -82.59219660801375 35.710149255245014, -82.59211660796205 35.71039725528727, -82.59205460793159 35.71052725530744, -82.59204160792632 35.71054725531015, -82.59194460788463 35.710712255333796, -82.59181360783643 35.71088325535508, -82.59178460782302 35.71093825536326, -82.59176860781575 35.7109682553678, -82.59176660781144 35.710994255372846, -82.59176560780926 35.71100725537542, -82.5917766078047 35.71104825538489, -82.59180660780184 35.71109925539834, -82.59183960780237 35.7111312554083, -82.59189060780402 35.711175255422525, -82.59211860781609 35.71134225548001, -82.59234160782783 35.71150625553637, -82.59268260784769 35.71174425561999, -82.59299360786397 35.711973255698624, -82.59321560787727 35.71212625575272, -82.59341460789447 35.71222925579416, -82.59354260790661 35.712288255819324, -82.59392260794228 35.71246625589471, -82.59406260795629 35.712526255921404, -82.59441160799018 35.71268225598913, -82.5944506079939 35.71270025599673, -82.59471060801833 35.71282225604841, -82.59493960804159 35.71291825609157, -82.59539460809007 35.71309425617423, -82.59547560809962 35.7131192561877, -82.59566960812283 35.7131782562197, -82.59584460814439 35.71322725624767, -82.59594960815733 35.71325625626435, -82.59613960817946 35.71331725629637, -82.59631460819779 35.713387256328645, -82.59649360821038 35.71349825636965, -82.5965426082138 35.71352925638101, -82.59664660821733 35.71361825640987, -82.59685660821401 35.71386525648179, -82.5970266082091 35.714079256542966, -82.59716660820646 35.71424725659162, -82.59728260820829 35.71436025662658, -82.59739460821424 35.714442256654806, -82.59752260822823 35.71448925667753, -82.59770460825527 35.714510256700585, -82.59793860829608 35.71449825672218, -82.59819660834283 35.71447325674366, -82.598258608354 35.71446825674907, -82.59851560839425 35.714484256778725, -82.598712608421 35.714523256807006, -82.59883460843201 35.714583256831745, -82.59887260843284 35.71461925684301, -82.59891160843343 35.71465725685478, -82.59891760843364 35.714662256856386, -82.59896360842767 35.714750256879135, -82.5989796084216 35.71480625689217, -82.59899460841575 35.7148602569047, -82.598963608362 35.71517425696543, -82.59896260836138 35.71517725696599, -82.59895860833603 35.71533625699795, -82.59899760831101 35.71554025704355, -82.59907060829079 35.71574925709363, -82.59915060827159 35.71595925714468, -82.59920960826128 35.71608925717726, -82.59924160825565 35.71616025719504, -82.59931060824532 35.71630125723083, -82.59933860823755 35.71638125724999, -82.59934760823471 35.716409257256615, -82.59937760822675 35.71649325727683, -82.59938760822406 35.71652125728354, -82.59942160821497 35.71661625730641, -82.59939260819064 35.71674225732914, -82.59922860812088 35.71701625736802, -82.59911160807117 35.71721225739597, -82.5988536079608 35.717647257457976, -82.59870960789442 35.717921257499015, -82.59864660785577 35.71810325752963, -82.59860960781727 35.71831225756837, -82.59861360778679 35.71851325760972, -82.59861560778013 35.718558257619094, -82.59864160770698 35.71905925772382, -82.59864160770637 35.719063257724606, -82.59863860768982 35.71916625774534, -82.59863760768104 35.71922225775661, -82.59864860766072 35.7193652577869, -82.59866460764661 35.719473257810584, -82.5986796076333 35.719576257833076, -82.59868960761787 35.7196862578565, -82.5987076075923 35.7198702578959, -82.59873660757471 35.72001525792838, -82.59874260757111 35.720045257935155, -82.59876660756315 35.72012225795329, -82.59879160755447 35.72020525797277, -82.59879360755407 35.72021025797399, -82.59886860754106 35.72037425801514, -82.59890960753755 35.72044125803298, -82.59895560753357 35.720516258053, -82.59897860753152 35.72055425806313, -82.59910860752318 35.720748258116025, -82.59913460752195 35.72078425812608, -82.59930860751415 35.72102125819224, -82.59955460750709 35.721331258280784, -82.59972060749972 35.721557258343935, -82.59978660749694 35.72164625836884, -82.59990060748805 35.721826258417266, -82.59994460748466 35.721895258435815, -82.60016560746978 35.722229258526696, -82.60038460745957 35.72253025861049, -82.60040260745899 35.722553258617076, -82.60047360745673 35.72264425864294, -82.60052860744703 35.72276625867349, -82.60054560743833 35.722840258690255, -82.60054960742679 35.722919258706774, -82.60052360740742 35.723016258723895, -82.60048260738937 35.72308925873454, -82.60035860734715 35.723228258750055, -82.60012860727947 35.72341825876508, -82.5997556071771 35.72367825877967, -82.59950260710183 35.723892258797235, -82.5994076070659 35.724022258813896, -82.59933660702794 35.72419125884102, -82.59923860696306 35.724504258894704, -82.59918960693777 35.724615258912266, -82.59914360691324 35.724724258929776, -82.59902460686278 35.72492225895789, -82.59890160682444 35.725037258968655, -82.59877960679205 35.725115258971925, -82.59858160674347 35.725216258972154, -82.59838560669722 35.72530425896986, -82.5982086066498 35.72542025897524, -82.59808460660682 35.725564258991824, -82.5980026065773 35.72566725900441, -82.5979736065665 35.72570525900915, -82.597860606522 35.725871259031315, -82.59782460650707 35.725929259039376, -82.5977616064804 35.72603325905413, -82.59768460643367 35.72625225909076, -82.59764060638982 35.726488259134335, -82.59762160634979 35.72672625918089, -82.59758660630683 35.726966259226195, -82.59748860624507 35.727259259275755, -82.59728760613326 35.72776525935818, -82.59727560612623 35.72779725936348, -82.59715660606734 35.728050259402785, -82.59701860600393 35.72831125944168, -82.5969356059727 35.72842325945603, -82.59691460596507 35.72845025945932, -82.59687660595053 35.72850325946622, -82.59685060594187 35.72853125946926, -82.59682760593404 35.728557259472154, -82.59673160590188 35.72866125948353, -82.59663160586801 35.72877225949579, -82.5964356058057 35.72896425951468, -82.59641260579825 35.728987259517034, -82.5963336057736 35.72906225952418, -82.59562660558768 35.72950225954103, -82.59551560555707 35.729580259545465, -82.59546160553855 35.72964225955257, -82.5954166055229 35.729695259558724, -82.59537460550102 35.72979125957391, -82.59532860546945 35.729945259600555, -82.59527060541129 35.73025825965837, -82.59526660540696 35.730282259662864, -82.5952416053729 35.730475259699574, -82.59523260536052 35.73054525971291, -82.59521360533397 35.73069625974175, -82.59521060532434 35.73075525975348, -82.595208605313 35.73082625976772, -82.5952016052801 35.731031259808745, -82.5952056052676 35.73111625982645, -82.59521260525247 35.731221259848624, -82.59524060523981 35.73133325987431, -82.59530160522883 35.73146925990831, -82.59538560522327 35.73159525994263, -82.59558560522058 35.731827260010526, -82.59560960521891 35.73186426002048, -82.59564560521663 35.73191726003504, -82.59567760520959 35.73199726005458, -82.5956906052014 35.73206426006956, -82.5956866051894 35.73213726008409, -82.59559360517018 35.73216126007939, -82.59545260513823 35.732216260076065, -82.59525760507684 35.732403260094095, -82.5950556050041 35.73265526012466, -82.5949546049711 35.732760260135606, -82.59488060494327 35.73286026014836, -82.59477860490423 35.73300226016675, -82.59434860477393 35.7333812601997, -82.5941126046971 35.73362326022469, -82.59403160466492 35.73374426024101, -82.5939436046359 35.733837260250816, -82.59378860459476 35.73393626025509, -82.59342560452745 35.7339802602266, -82.59329060449049 35.73407426023183, -82.59306160442162 35.73427226024863, -82.59301360440857 35.7343052602504, -82.59291960438604 35.73434926024969, -82.5924956042916 35.734503260237425, -82.59233960425976 35.734541260229044, -82.59216660422223 35.734598260222874, -82.59155860408978 35.73479926020112, -82.59143060405812 35.73486626020159, -82.59128260402501 35.73492126019763, -82.59112060399126 35.734965260189895, -82.59095260396319 35.73496526017259, -82.5908846039536 35.73495426016333, -82.59060660392373 35.734848260113026, -82.59059460392241 35.734844260111025, -82.59045360390495 35.7348052600886, -82.590358603896 35.734761260069774, -82.59022360388694 35.73467426003816, -82.59012960389185 35.734542260001604, -82.5900756038905 35.73449225998582, -82.58999460388466 35.73444325996752, -82.58990060387414 35.73441025995106, -82.58973160385285 35.734366259924755, -82.58915860375743 35.73436625986567, -82.58908460374514 35.73436625985806, -82.58888960372293 35.73430025982454, -82.58867360370742 35.73416825977535, -82.58863360371524 35.73407525975233, -82.58859960373077 35.7339382597209, -82.58861960375378 35.73381125969714, -82.58868060378435 35.73367925967651, -82.58876060381633 35.733559259660275, -82.58884860384113 35.733493259655916, -82.58919960392512 35.73332825965846, -82.58925260393572 35.73331725966162, -82.58930660394901 35.73328925966153, -82.5895226039952 35.73322325967033, -82.58977860404627 35.73316825968547, -82.58985960406663 35.73312425968485, -82.5899066040772 35.73310625968602, -82.59026360415675 35.73297625969637, -82.59037860418441 35.732921259696944, -82.59063460425696 35.73272825968405, -82.59070160428006 35.732651259675244, -82.59074160430032 35.73256325966145, -82.59076860433534 35.73236625962406, -82.59075560435294 35.73223925959684, -82.59072160436335 35.73213525957219, -82.59066760436971 35.732036259546454, -82.59054660436828 35.731915259509364, -82.59042460435819 35.731849259483354, -82.59018960433006 35.73177825944463, -82.58997960430023 35.73174525941633, -82.58979860426767 35.73176125940096, -82.58967660424399 35.73178325939284, -82.58946760419973 35.73184425938372, -82.58940060418342 35.73187725938353, -82.58906360410951 35.73199225937223, -82.58885460405601 35.73211325937534, -82.58878060403255 35.73218525938245, -82.58874060401736 35.732240259389485, -82.58852460395244 35.73242725940534, -82.58835660390575 35.73254825941266, -82.58807360383473 35.7327022594149, -82.58791160379168 35.73280625941943, -82.58784360377693 35.73282825941684, -82.58772260375336 35.73285025940894, -82.58754760372591 35.73283925938862, -82.58746660372348 35.732768259365834, -82.5874396037251 35.73272925935504, -82.58739960374061 35.73258625932181, -82.58741260376146 35.732465259298515, -82.58745360378872 35.732333259275876, -82.58747660380153 35.7322752592664, -82.58752760382986 35.73214725924559, -82.5875676038451 35.73209225923855, -82.58759460385983 35.732026259227894, -82.58760760388242 35.73189425920228, -82.5875946038914 35.7318222591863, -82.58755360389809 35.73173525916433, -82.58743260389588 35.73161925912821, -82.58729160388611 35.73153125909579, -82.58708860386415 35.73145425905918, -82.58696760384919 35.73142125904002, -82.58685960383973 35.73136625901766, -82.58671160382022 35.73133325899567, -82.58642860377982 35.731290258957806, -82.58634560377128 35.73125625894229, -82.58633360376996 35.73125125894007, -82.58614460376576 35.73107625888493, -82.58600360377456 35.73086725882782, -82.58599660377686 35.730845258822676, -82.58598960377911 35.730823258817445, -82.58594960378096 35.73076825880211, -82.58590860378784 35.73068025877998, -82.58585460380435 35.730515258740766, -82.58579460384554 35.73018525866741, -82.58579460385309 35.7301362586574, -82.58574060385702 35.73005325863495, -82.58566660385304 35.729999258616274, -82.58561960384858 35.72997725860694, -82.58552460383285 35.729977258597216, -82.58543060381201 35.73001025859427, -82.58530960377487 35.73012025860418, -82.5852076037291 35.730306258631515, -82.58517860371299 35.73037825864325, -82.58507360365473 35.73064225868613, -82.58503360363956 35.73069725869329, -82.58495160361564 35.730763258698296, -82.58487060359657 35.73079925869719, -82.58485760359333 35.730806258697385, -82.58434560349095 35.730917258667176, -82.58417460346189 35.73092125865043, -82.58395460342422 35.73092825862922, -82.58353660335545 35.73092225858487, -82.58335560332796 35.730906258562975, -82.5831056032838 35.73092225854043, -82.5827146032119 35.730966258509206, -82.58242560316383 35.730966258479384, -82.58216860312604 35.73093425844639, -82.5821286031228 35.73091225843773, -82.58208760312478 35.73085525842194, -82.58208160312516 35.73084625841953, -82.58204060313709 35.73072525839065, -82.58200660316142 35.73053225834781, -82.58193260317712 35.73035125830332, -82.58182560317974 35.73021925826537, -82.58181960317957 35.73021425826374, -82.58173060317424 35.730153258242176, -82.58157560316198 35.73006525820823, -82.58156860316137 35.73006225820693, -82.58103660310456 35.72985725811037, -82.58073860306736 35.72977725806339, -82.58066560305814 35.729758258051966, -82.58044960302486 35.72974125802622, -82.58030860300299 35.72973125800971, -82.5801606029844 35.72969225798654, -82.58003860297597 35.7296152579583, -82.57995860297811 35.72951625792982, -82.57991060298714 35.729406257902504, -82.57988360302868 35.72910925783925, -82.57988360303021 35.72909925783718, -82.57992360307604 35.72884625778979, -82.58001860315832 35.72841725771216, -82.5801866032501 35.72800525764551, -82.58023360328261 35.727846257617976, -82.58022060328649 35.727807257608745, -82.5801936032861 35.72778025760039, -82.58015960328318 35.727763257593466, -82.58004460326566 35.72775225757944, -82.57917560308877 35.7279612575324, -82.57910160307544 35.72796725752601, -82.57899360305412 35.72798925751942, -82.5789266030429 35.72798925751256, -82.57884560303289 35.72796725749962, -82.57872260303087 35.72784825746274, -82.57852860302786 35.7276592574043, -82.57843460301902 35.72761525738564, -82.57827260299631 35.727588257363394, -82.57813760296695 35.72763225735854, -82.5780506029457 35.727676257358496, -82.57799660292477 35.72775325736862, -82.57795460290203 35.72785525738502, -82.57794260289536 35.727885257389914, -82.57790860286335 35.72805525742105, -82.57787260284141 35.728158257438345, -82.57783460281789 35.728269257457015, -82.57720960262954 35.7288132575034, -82.57712760260483 35.72888525750967, -82.57701960257832 35.72894025750975, -82.57695060255907 35.72899025751281, -82.57688460254055 35.729039257516, -82.5766896024732 35.72926425754174, -82.57640660238694 35.7295172575641, -82.57638160237887 35.72954225756661, -82.57617760231126 35.72975925758981, -82.57594160224649 35.72992425759904, -82.57590160223732 35.72994025759826, -82.5755916021721 35.7300282575842, -82.57544360214412 35.73005025757345, -82.57499760206547 35.73007825753316, -82.57427060194043 35.73010525746376, -82.5741756019212 35.730127257458435, -82.57416260191829 35.730132257458145, -82.57404760189138 35.73018225745645, -82.57396060187007 35.730226257456486, -82.57389960185317 35.73027025745916, -82.57383960184052 35.73028725745645, -82.57368360181376 35.7302922574414, -82.57363060181176 35.730248257427014, -82.5735626018124 35.730171257404244, -82.57354260181921 35.73010525738881, -82.57354460182555 35.73006725738123, -82.57355560185361 35.72989725734776, -82.57358260186251 35.72986925734486, -82.57365060189505 35.72973225732393, -82.57381860194856 35.72956725730766, -82.57389260196946 35.7295122573041, -82.57398060199091 35.72946825730417, -82.5741876020327 35.72942025731576, -82.57434460206433 35.729385257324736, -82.57445160209919 35.72927525731336, -82.57451960213412 35.729122257289255, -82.57453260217208 35.72889125724352, -82.57464760221266 35.728753257227226, -82.57472860223638 35.72868725722213, -82.57481560227284 35.728545257202185, -82.5748356022915 35.728446257184096, -82.57481560231125 35.728297257151695, -82.57477560232073 35.72819325712643, -82.57470760232135 35.72811625710366, -82.57464060231703 35.728072257087845, -82.57451960230543 35.728017257064145, -82.57446560230574 35.727957257046405, -82.5743976023149 35.72782525701243, -82.57429660231776 35.72769825697621, -82.57403360230451 35.727501256908965, -82.57382460228675 35.72739125686504, -82.57367460228349 35.72725125682113, -82.57348760227919 35.727078256766546, -82.57342660228778 35.726957256735666, -82.57337360230112 35.72681425670107, -82.57330560230521 35.72671525667387, -82.57319160229812 35.72663825664643, -82.57300960227465 35.72659425661882, -82.5730006022746 35.726585256616026, -82.57288860227503 35.72646225657936, -82.57282060227224 35.72640725656118, -82.57272660225833 35.72639625654926, -82.57261860224034 35.72639625653814, -82.57242960220069 35.72644925652943, -82.57240260219498 35.72645725652833, -82.5723356021838 35.72645725652136, -82.57226760217415 35.726446256512105, -82.5721736021671 35.72639125649126, -82.57211960216567 35.72634225647573, -82.5719786021729 35.72614425642084, -82.57180260217349 35.72595125636338, -82.5716476021987 35.72562225628042, -82.5714866021992 35.72544625622806, -82.5713376021922 35.72533125618919, -82.57122360217663 35.725309256172984, -82.57113560216126 35.725314256164936, -82.5710546021418 35.725353256164546, -82.57103460213658 35.725365256164935, -82.57059660201972 35.72564925617764, -82.57047660199197 35.72569925617556, -82.57038760197135 35.725737256174085, -82.57029360195307 35.725754256167846, -82.57001660190785 35.72574825613808, -82.5699476018936 35.72576625613457, -82.56987560187841 35.7257872561315, -82.56970060184588 35.72580925611794, -82.56932260178735 35.72578125607327, -82.56922860176823 35.7258032560681, -82.56906660172422 35.7259132560738, -82.5688106016749 35.72595725605638, -82.56855460160916 35.726106256060376, -82.5684336015806 35.72616125605909, -82.56842560157892 35.72616325605871, -82.56819060152986 35.72622725604752, -82.5678946014816 35.72622125601579, -82.56786660147992 35.72620225600906, -82.56779960147604 35.726155255992495, -82.56779160147723 35.726139255988464, -82.5677776014793 35.72611025598108, -82.56777260148002 35.72610025597857, -82.56777260149202 35.72602325596286, -82.56781360151584 35.725913255944725, -82.56790760154254 35.72584225593991, -82.56794160154989 35.725831255941195, -82.56797760155976 35.72580625593983, -82.56800860156778 35.72578725593922, -82.56812360160404 35.7256772559286, -82.5681576016267 35.72556725590965, -82.56812960163901 35.7254572558844, -82.56802260163568 35.72536425585447, -82.56781960163852 35.72512825578542, -82.56778660163735 35.725100255776354, -82.56768560162475 35.725073255760414, -82.56750060159524 35.72506525573977, -82.56728060156001 35.72505625571525, -82.56709860152709 35.72507325569993, -82.56700160150847 35.72508925569327, -82.56677560146481 35.72512825567783, -82.56671360145145 35.72514825567556, -82.5666746014429 35.7251612556742, -82.56661860143225 35.72517025567027, -82.56640560139137 35.72520525565539, -82.56637060138573 35.7252042556516, -82.56623060136285 35.72520125563659, -82.56611560134408 35.72519925562438, -82.56575760129041 35.72516125557975, -82.56558260126734 35.72512225555371, -82.56540760125529 35.72501225551334, -82.56527260123785 35.72497925549268, -82.56510060120794 35.72498825547678, -82.56507760120381 35.72499025547479, -82.56496260117099 35.725078255480895, -82.56489560115651 35.72510025547851, -82.5648216011449 35.72509525546979, -82.5647676011386 35.72507825546079, -82.56475160113801 35.7250652554565, -82.56474960113778 35.72506425545613, -82.56469360113562 35.725018255440965, -82.56467360114324 35.724947255424404, -82.56469960116631 35.724826255402505, -82.56474560118735 35.72474025538974, -82.56475360119065 35.72472725538789, -82.56479460120433 35.72468325538316, -82.56480760121329 35.724639255375465, -82.56484760122679 35.72459525537069, -82.56496960128456 35.72435325533395, -82.56500360131236 35.72421025530833, -82.5650036013311 35.72408925528374, -82.56494960134255 35.72395725525122, -82.56485460134026 35.723870255223716, -82.56474760132743 35.72383825520619, -82.56466660131747 35.72381525519315, -82.56453160130526 35.7237492551658, -82.56445060129526 35.72372725515303, -82.56441060129286 35.72369925514315, -82.56432260128756 35.72363925512185, -82.56412060129139 35.72339725505175, -82.56406660128758 35.72336425503948, -82.56397460127694 35.7233342550239, -82.56392860127164 35.72331925501609, -82.56367560124211 35.72323825497356, -82.56358160123496 35.72318325495271, -82.56329160122597 35.722930254871315, -82.56317060121091 35.72289725485208, -82.5630756011951 35.722897254842295, -82.56291460117176 35.722875254821204, -82.5625366011659 35.72250725470736, -82.56251460116444 35.72249325470222, -82.56241560115774 35.72243025467921, -82.56201760111365 35.72228725460907, -82.5619816011103 35.722270254601895, -82.56181560109452 35.72219425456932, -82.56159360107725 35.72206725452055, -82.56139760106511 35.72193525447352, -82.56123660106464 35.72176525442231, -82.56119360106915 35.72169025440255, -82.56116160107264 35.7216332543877, -82.56104760110388 35.72130925430996, -82.56095960114794 35.72093025422365, -82.56091260115988 35.72080325419306, -82.56084560116219 35.72071625416842, -82.56071060115599 35.72061125413307, -82.56055560113607 35.720573254109375, -82.56006360105859 35.72054525405297, -82.55993560103468 35.72056225404329, -82.55979360100602 35.720595254035395, -82.55972660098972 35.72062825403518, -82.55951760094904 35.720666254021396, -82.55926860090332 35.72069425400139, -82.55911360088022 35.720677253982, -82.55896960086262 35.720636253958794, -82.55891760085616 35.72062225395061, -82.55874260084062 35.7205342539146, -82.55857460083318 35.72040225387045, -82.55849360083158 35.72032525384647, -82.55837660083405 35.72018425380567, -82.55826460083604 35.72005125376705, -82.55823860084035 35.71999525375294, -82.5583306008835 35.71981525372581, -82.55834760089132 35.719783253721, -82.55860960101285 35.719280253645636, -82.558703601056 35.71910225361904, -82.5587566010808 35.71899925360348, -82.55891860115558 35.718690253557234, -82.55897260118036 35.71858825354204, -82.55919960128556 35.71815325347685, -82.5594866014181 35.71760525339486, -82.5599146016038 35.716866253288465, -82.56016160171052 35.71644225322755, -82.56047560184034 35.71594125315782, -82.56053560186454 35.71584925314526, -82.56098460204471 35.71516825305287, -82.56131460217239 35.71469825299113, -82.56166960230684 35.714211252928564, -82.56173460233131 35.71412325291732, -82.56200060243033 35.713769252872616, -82.56215960248818 35.7135662528477, -82.56237560256689 35.713290252813685, -82.56248660260641 35.71315425279743, -82.56274960269965 35.71283425275941, -82.56318360285118 35.71232225269983, -82.56350560296215 35.7119512526574, -82.56351060296359 35.711947252657104, -82.5638626030813 35.71156525261558, -82.56423060320448 35.71116525257204, -82.56429260322496 35.71109925256496, -82.56465960334377 35.71072625252678, -82.56515460350211 35.710235252477766, -82.56538660357464 35.71001625245706, -82.56578360369821 35.709644252422244, -82.56586060372204 35.70957325241569, -82.56621760382902 35.70926525238977, -82.56633860386466 35.709165252381794, -82.56649460391024 35.70903825237203, -82.56686960401856 35.70874125235018, -82.56717460410466 35.70851325233512, -82.56746860418653 35.708300252322054, -82.56788360429978 35.70801425230654, -82.5681086043606 35.70786325229896, -82.5683426044237 35.707707252291264, -82.56871960452493 35.707458252279395, -82.56899960460078 35.70726925226976, -82.56901960460594 35.70725725226936, -82.56982560482292 35.70672125224318, -82.56992060484892 35.70665525223956, -82.57021860493028 35.70645025222852, -82.5703366049625 35.70636825222391, -82.57068160505877 35.70611725220837, -82.57073460507335 35.706080252206284, -82.57112960518573 35.70577825218539, -82.57132160524071 35.70562925217485, -82.57167960534625 35.70533225215126, -82.57200960544664 35.70503825212539, -82.57201760544896 35.7050322521249, -82.57237060555873 35.70470225209404, -82.57242660557627 35.70464925208902, -82.572621605637 35.70446625207189, -82.57265260564648 35.70443825206932, -82.57289860572597 35.704189252043975, -82.57318160581957 35.70388825201181, -82.57322060583246 35.70384725200746, -82.57335960588017 35.703688251989405, -82.57353760594115 35.70348525196638, -82.57367660599073 35.70331425194585, -82.57368260599308 35.70330525194466, -82.57390660607243 35.70303325191231, -82.5742526062 35.70258125185586, -82.57452160630386 35.70219925180578, -82.57456160631976 35.70213925179768, -82.5746456063526 35.70201725178147, -82.57477460640462 35.701820251754675, -82.57483160642794 35.701730251742184, -82.57463560635654 35.701981251773084, -82.57458660633881 35.702043251780694, -82.57409660615916 35.70267725185944, -82.5739416061091 35.70283425187543, -82.57381360607094 35.70294325188447, -82.57376560605641 35.70298525188803, -82.57355460599504 35.70315525190088, -82.57350060598107 35.7031872519019, -82.57346160597618 35.70317725189586, -82.57343160597289 35.70316625189043, -82.57322760594964 35.703097251855404, -82.57315960594194 35.70307425184376, -82.57310460593587 35.70305425183401, -82.5730316059304 35.70301125181778, -82.57257160588959 35.7027802517233, -82.57188860582897 35.70243825158338, -82.57170560581122 35.70235625154781, -82.57151260578844 35.70229625151569, -82.57071760567557 35.70217125140838, -82.57006860558326 35.70207025132102, -82.56974560553724 35.70202025127756, -82.56954860551166 35.70197425124792, -82.56947060550142 35.70195625123627, -82.56935560548821 35.70191825121662, -82.56924560547814 35.70186525119453, -82.56903960546444 35.70173225114624, -82.56870160544476 35.701496251063325, -82.56832360542084 35.70124425097315, -82.56819560541216 35.701163250943445, -82.56800960539935 35.70104625090041, -82.56773960537733 35.70089825084248, -82.56755260536109 35.700802250803704, -82.56754560536056 35.700798250802166, -82.56739660534878 35.70071425076975, -82.5672306053377 35.70060725073086, -82.56703560532866 35.70045625068001, -82.56703160532844 35.70045325067898, -82.566875605324 35.70031425063462, -82.56670060531911 35.700158250584835, -82.56660560531648 35.70007325055768, -82.56616560530055 35.69970325043706, -82.56605760529672 35.699612250407384, -82.56598960529494 35.69955025038777, -82.56607260530835 35.699553250396896, -82.56632360534824 35.69956525042523, -82.5664076053615 35.699569250434664, -82.56667660540441 35.69958125046488, -82.56689060543825 35.6995922504891, -82.56748660553382 35.69961525055515, -82.56775660557696 35.69962625058524, -82.56779260562247 35.699371250537, -82.56781560566003 35.69915325049496, -82.56784260569353 35.69896525045944, -82.56784860570049 35.69892725045228, -82.56791860574133 35.69873825042101, -82.56801960578463 35.698567250396614, -82.56817460584105 35.698369250372245, -82.56860360599383 35.69784325030928, -82.56886760608917 35.697510250268685, -82.56899560613493 35.697352250249686, -82.56928860623889 35.69699525020716, -82.5693906062782 35.69685025018812, -82.56940160628396 35.69682525018418, -82.56945560631232 35.69670025016424, -82.56947760634361 35.69652125013006, -82.56948960637263 35.69634725009583, -82.56949060637534 35.69633025009245, -82.56951460641322 35.69611125005035, -82.56954860644451 35.69594525002003, -82.56961460647939 35.6957912499955, -82.56975060652894 35.69561724997405, -82.57010360664627 35.6952382499332, -82.57023560669307 35.695077249914036, -82.5702466066969 35.695064249912534, -82.57036360673686 35.694932249897754, -82.57044560677333 35.69478424987599, -82.57049260680515 35.69462924984921)))",6458,37,021,002702,370210027021,2175,2175,104,2150,2072,20,3,17,0,38,25,1761,59,1702,1746,1697,17,3,11,0,18,15,1070,962,108
census_2010_blockgroups_view.fid--2dc29038_13ec899ba8f_-2603,"MULTIPOLYGON (((-82.61358961392574 35.69494725434961, -82.6137996139798 35.69482425434617, -82.61389961399837 35.69481125435379, -82.61451061411184 35.69473525440119, -82.6147146141495 35.69471125441728, -82.61433661394447 35.6956302545656, -82.6143366139227 35.69577125459439, -82.61433661387194 35.6960992546612, -82.61432961381949 35.69643125472816, -82.61423161370263 35.69708125485047, -82.61435261359499 35.69790725503124, -82.6146956135306 35.69869325522673, -82.61537461351497 35.69952525546617, -82.61648061349554 35.700841255848054, -82.61669761348115 35.70116825593705, -82.61682461346852 35.701386255994585, -82.61690061346165 35.70151225602803, -82.61722861340765 35.70221425620485, -82.61741161332895 35.70292025636762, -82.61786161320751 35.70419025667265, -82.61809861307228 35.70531925692711, -82.61828861302132 35.70585325705545, -82.6187236130011 35.706452257222345, -82.61919661301668 35.70686025735419, -82.61986061305805 35.70730725751353, -82.62118861311815 35.70834825786234, -82.62181161318468 35.708588257975386, -82.6218526131878 35.70861225798449, -82.62192961319369 35.70865725800164, -82.62201061319982 35.7087052580197, -82.62176961312439 35.70893325804139, -82.62141161301216 35.709273258073786, -82.62159261302682 35.70937325811283, -82.62176061297437 35.70989325823608, -82.62184761294766 35.71015925829924, -82.6221356128517 35.71108925851841, -82.62215461284656 35.71114325853135, -82.62223861282291 35.71138625858953, -82.62239361277906 35.71183625869729, -82.62247861276218 35.712037258746925, -82.62258761274052 35.71229425881052, -82.62289261273499 35.71265825891617, -82.62293461273414 35.71270925893081, -82.62300461273401 35.71278525895345, -82.62334761273262 35.713163259065844, -82.6234396127323 35.71326425909589, -82.62346161273196 35.71329025910344, -82.62411861272408 35.71404825932561, -82.62478361271337 35.71483325955398, -82.62548061269435 35.71570625980367, -82.6259856126908 35.716272259970985, -82.62606161269555 35.716323259989146, -82.62609161269751 35.71634325999633, -82.6261226126997 35.71636226000342, -82.62616461270208 35.71639226001384, -82.62622261270567 35.71643126002777, -82.62644561272197 35.716566260078274, -82.62656261273152 35.71663026010331, -82.62661061273553 35.71665626011361, -82.62705561277998 35.716847260198286, -82.62728861280516 35.71693526024021, -82.62750861283038 35.71700926027796, -82.62766561284964 35.71705426030326, -82.62804461289572 35.7171642603647, -82.62808661290084 35.7171762603715, -82.62852961295678 35.71729126044049, -82.6288916130033 35.717380260495894, -82.62963461309732 35.71757226061149, -82.62989061312963 35.71763926065152, -82.63024961317551 35.7177292607068, -82.63036361318997 35.71775826072444, -82.63084461324792 35.71790126080317, -82.63150461332154 35.71813626091895, -82.63224261340096 35.71841726105215, -82.63307861349148 35.718732261202405, -82.63352161354115 35.71888826127982, -82.6338796135829 35.71900326134017, -82.63430561363506 35.71912526140881, -82.63499861371955 35.71932526152094, -82.63570361380722 35.719517261632625, -82.63589061383225 35.71955726166003, -82.63595161384039 35.71957026166898, -82.63619861387652 35.71960226170087, -82.63645961391754 35.71961826173099, -82.63652061392789 35.71961726173707, -82.6368166139775 35.71961526176712, -82.63842261425293 35.71956426192201, -82.63905761436182 35.71954426198329, -82.63935461441272 35.719535262011995, -82.63972061447645 35.71951726204607, -82.63999561452792 35.71948026206682, -82.64022961457263 35.71944326208336, -82.6404146146114 35.71939226209194, -82.6410286147451 35.71918926211383, -82.64119561477926 35.71914826212259, -82.64135961481061 35.7191222621342, -82.64214761495397 35.71904426219933, -82.64256161503145 35.7189892622308, -82.64278961507672 35.71894226224469, -82.64404661532603 35.71868426232138, -82.64425661536538 35.71865626233732, -82.64441061539243 35.71864726235135, -82.64455861541613 35.71865326236778, -82.64476361544685 35.71867526239335, -82.645112615493 35.71875326244518, -82.64549861553854 35.71887426250961, -82.64596461559461 35.71901426258613, -82.64641161564919 35.71914226265818, -82.64670761568846 35.719207262701836, -82.64695761572347 35.71925026273636, -82.64758561581486 35.719336262818494, -82.64788361585595 35.71939126286037, -82.64816761588871 35.71948526290879, -82.64842261591316 35.71960226295888, -82.64865361593007 35.719741263011045, -82.6489346159461 35.719940263080446, -82.64920161595809 35.72015026315076, -82.64951061596989 35.72040726323496, -82.64999961597381 35.72090826338743, -82.6502036159662 35.7211772634633, -82.65024061595719 35.72127526348705, -82.65026361594246 35.72139526351388, -82.6502636159301 35.72147526353021, -82.65020261587311 35.72177726358549, -82.65015561584433 35.7219132636084, -82.65001361578315 35.722155263643145, -82.64992761574877 35.72228526366077, -82.649790615701 35.722446263679565, -82.649450615594 35.72277126371077, -82.64919661551832 35.722987263728676, -82.64902761546337 35.72316026374649, -82.64884261540718 35.72332426376094, -82.6487136153565 35.72351226378599, -82.64856461529486 35.7237502638191, -82.64851661527483 35.72382826383014, -82.64834961520273 35.724114263871215, -82.64812861510292 35.72452126393146, -82.64794061501632 35.72487826398491, -82.64772761490342 35.72537826406488, -82.64754761479476 35.7258862641499, -82.64724061464081 35.72655026425374, -82.64710561456988 35.72686326430362, -82.64703661451786 35.72712526434993, -82.64702961450404 35.72720726436596, -82.64702561449728 35.72724626437347, -82.64701961448297 35.7273322643904, -82.64701961447768 35.72736626439731, -82.64702161447173 35.72740726440587, -82.64702461445746 35.727502264425574, -82.6470706144357 35.727692264469006, -82.64717161441452 35.72793826452963, -82.64725361440235 35.728105264572015, -82.64728161439842 35.72816026458613, -82.64740861438607 35.728377264643456, -82.64754961437839 35.72857826469897, -82.64771961437702 35.72877026475566, -82.64797161438327 35.7290012648286, -82.6485886144156 35.72945626498494, -82.64883961443066 35.72962926504601, -82.64896661443821 35.72971726507701, -82.64944861446591 35.73005726519596, -82.64948061446768 35.73008026520392, -82.64979561448747 35.730291265279384, -82.64991361449633 35.73036126530578, -82.65015161451416 35.73050226535901, -82.65056361455123 35.73070626544305, -82.65069961456527 35.73076226546841, -82.6513206146286 35.73102126558514, -82.65171261467667 35.73113326564835, -82.65196561470621 35.731214265690916, -82.65227261474104 35.73132026574411, -82.65258261477054 35.7314632658052, -82.6528586147946 35.7316052658625, -82.6534086148424 35.73188826597681, -82.65427361491122 35.732375266165164, -82.65460561493667 35.73256826623873, -82.65470361494418 35.73262526626036, -82.65506561497355 35.73282526633845, -82.6554496150075 35.73301926641754, -82.65589161505099 35.73321426650275, -82.6559416150559 35.733236266512414, -82.65609161507072 35.73330226654131, -82.65614161507563 35.73332426655088, -82.6565006151111 35.73348126661988, -82.65662461512288 35.73353926664454, -82.65693761515199 35.73368826670706, -82.65739961519161 35.73392926680383, -82.657751615225 35.734093266873415, -82.65805661525538 35.7342252669317, -82.65854261530367 35.734436267024805, -82.65881161533055 35.734552267076104, -82.65934261538487 35.73477326717587, -82.65957761540857 35.73487326722041, -82.65972761542346 35.73493826724914, -82.65983761543457 35.734985267270034, -82.66036861548642 35.73522226737304, -82.66087061553836 35.73542726746648, -82.66137661558756 35.73565426756488, -82.6614406155934 35.73568526757778, -82.66162961561065 35.73577726761598, -82.6619426156367 35.73594626768262, -82.66230761566422 35.73616126776405, -82.66260261568414 35.736350267832954, -82.66273061569264 35.736433267863056, -82.66299661571159 35.73659726792389, -82.66336361573961 35.7368112680053, -82.66356861575616 35.73692526804966, -82.66371161576768 35.737005268080665, -82.66389161578265 35.73710226811895, -82.66405761579632 35.73719226815445, -82.66440961582711 35.7373722682274, -82.66451161583555 35.737428268249296, -82.66486661586453 35.737623268325606, -82.66490161586742 35.737642268333076, -82.66519361589242 35.737795268394294, -82.66534761590549 35.73787626842669, -82.66535261590592 35.73787926842783, -82.66575761593738 35.73811226851697, -82.66582361594277 35.738148268531155, -82.66598361595612 35.73823426856512, -82.66669161601367 35.738625268717776, -82.66099461469307 35.741019268619524, -82.65942661432884 35.7416832685935, -82.65858161413236 35.74204226857974, -82.6540646130848 35.74394326850226, -82.65036761222778 35.74549726843847, -82.6455116111031 35.747532268353325, -82.64160461019667 35.74917926828676, -82.64045360992954 35.74966526826732, -82.63958660973066 35.75001626824959, -82.63805660937908 35.75063926821903, -82.6318206079466 35.75317626809386, -82.62905560731166 35.75430026803822, -82.62756860696865 35.754914268010104, -82.62737260692283 35.75499926800729, -82.62154260556288 35.75750526791737, -82.62035460528597 35.75801426789874, -82.61981060515971 35.75824426788951, -82.61983360524381 35.75772626778637, -82.61985760525447 35.75768326778002, -82.61992860528618 35.75755526776128, -82.61998560531838 35.75740926773739, -82.62002960534227 35.757302267720135, -82.62014260539175 35.75710426769139, -82.62042660550959 35.756650267628096, -82.62043960551554 35.75662526762438, -82.62059060558131 35.75636326758656, -82.6205946055837 35.75635226758466, -82.62060960559086 35.75632226758013, -82.6206146055933 35.75631226757864, -82.620645605609 35.75624426756793, -82.62066760561974 35.75619826756084, -82.620720605654 35.7560342675329, -82.62074360566871 35.75596426752096, -82.62080160570628 35.75578426749027, -82.62083160572435 35.75570026747624, -82.62086760574533 35.755603267460145, -82.62094660578659 35.755422267431356, -82.62109060585276 35.755150267390775, -82.62122260590205 35.75497426736858, -82.62122560590343 35.75496826736761, -82.62135060595901 35.754744267334864, -82.62136060596369 35.754725267332006, -82.62154660604998 35.75436826727841, -82.62169660612324 35.75405726723042, -82.62184060618861 35.753790267190865, -82.62184860619226 35.75377526718869, -82.62216860632664 35.75325226711505, -82.62240360641559 35.7529312670738, -82.62302560663058 35.752213266991554, -82.62331160672764 35.75189426695594, -82.62372860686598 35.751450266908414, -82.623873606913 35.7513022668932, -82.6241466070013 35.75102626686509, -82.62441760709125 35.750737266834115, -82.62460660715564 35.75052526681035, -82.62442660714001 35.750432266772805, -82.62436160713428 35.75039926675944, -82.62388360709083 35.750166266662696, -82.6237026070743 35.750078266626105, -82.62361560706648 35.75003526660842, -82.62335460704254 35.74990926655586, -82.62326760703439 35.74986826653854, -82.62306160701512 35.749771266497476, -82.62298360700781 35.74973426648188, -82.62247160695962 35.749495266380436, -82.62244360695682 35.749483266375115, -82.62225860693792 35.74940626634038, -82.62223360693501 35.74939826633619, -82.6220006069078 35.74932326629691, -82.62179860688265 35.749268266264885, -82.62170160687047 35.749242266249595, -82.62138960682793 35.74918226620527, -82.6210956067844 35.749146266167564, -82.62078160673512 35.749127266131346, -82.62051060669029 35.74912526610304, -82.6204496066795 35.74912926609753, -82.62021960663866 35.74914526607717, -82.6199996065972 35.749176266060815, -82.6199086065802 35.74918826605384, -82.61979560655892 35.74920426604543, -82.61963560652968 35.74922126603243, -82.61954560651286 35.749232266025395, -82.61947260649654 35.74925926602342, -82.61941360648315 35.749282266021986, -82.61937160647386 35.74929726602076, -82.61925560644792 35.74934026601756, -82.61918360643158 35.749368266015864, -82.61880360634618 35.749510266005665, -82.61861460630215 35.74959126600269, -82.61840960625011 35.749707266005245, -82.61824960620757 35.74980926600957, -82.61802260614513 35.749968266018584, -82.61751760599917 35.75036726604784, -82.61671760576709 35.751004266095244, -82.61654160571871 35.75112726610215, -82.616378605677 35.751221266104565, -82.61604460560064 35.7513552660974, -82.61577060554082 35.75144626608771, -82.6153156054437 35.75158426606901, -82.61461360529343 35.7517992660405, -82.61449060526702 35.75183726603554, -82.61426760521951 35.75190426602625, -82.61408360518014 35.7519602660187, -82.61351760505916 35.75213226599545, -82.6132316049981 35.752219265983754, -82.61288660492404 35.75232626596999, -82.61259660486182 35.7524152659582, -82.61172760467598 35.75268126592287, -82.61143860461385 35.752771265911434, -82.61103860452786 35.75289626589575, -82.61080360447842 35.75296226588495, -82.61053860442257 35.75303826587312, -82.61010160433297 35.753146265850084, -82.60988960429158 35.75318526583622, -82.6095146042199 35.7532452658098, -82.60924160417039 35.75327126578698, -82.60897960412385 35.75329026576388, -82.60885060410163 35.75329426575133, -82.60864460406597 35.75330326573199, -82.60821460399504 35.75329926568684, -82.60818860399083 35.75329826568397, -82.60803660396658 35.753291265666846, -82.60799260395977 35.75328726566151, -82.6077966039296 35.753272265638266, -82.60759960390011 35.75325026561356, -82.60740960387271 35.7532232655884, -82.60721660384459 35.753197265563244, -82.607178603839 35.753192265558305, -82.60698960381302 35.75315726553174, -82.60642560373473 35.75305626545303, -82.60630760371667 35.75304626543881, -82.60620760370124 35.75303826542686, -82.60611760368543 35.753043265418654, -82.60607860367803 35.75304926541578, -82.60603360366943 35.753056265412674, -82.6058706036341 35.7531092654066, -82.60583960362631 35.75312626540688, -82.60576260360612 35.75317326540846, -82.60567060357988 35.75324426541348, -82.60554460353931 35.75337026542614, -82.6054096034915 35.753533265445455, -82.60531260345566 35.75366026546139, -82.60527060344003 35.75371626546842, -82.605155603399 35.75385726548535, -82.60494560332452 35.75411226551572, -82.6048796033009 35.75419326552548, -82.60476060326346 35.754307265536305, -82.6046566032351 35.75437826554013, -82.60454160320758 35.75443226553927, -82.60442260318325 35.75446126553294, -82.60430760316116 35.754480265524954, -82.6041566031365 35.75447726550875, -82.60408360312493 35.754473265500394, -82.60407660312411 35.75447126549928, -82.60394260310723 35.75443626547829, -82.60381760309411 35.7543862654553, -82.60376660308953 35.7543612654449, -82.60353660306892 35.75424726539799, -82.60351660306712 35.75423726539387, -82.60318960303921 35.7540662653254, -82.6030196030213 35.753999265294226, -82.60290660300697 35.75397026527663, -82.60274160298097 35.75396026525755, -82.602716602977 35.75395926525477, -82.60255060294678 35.75397626524116, -82.60246560293042 35.753990265235316, -82.60244060294303 35.75388226521069, -82.60241960295765 35.75376526518467, -82.602389602972 35.75364026515609, -82.60229360301798 35.75324126506488, -82.60223360304053 35.75303126501589, -82.60216560305817 35.75284426497077, -82.6020856030734 35.752660264925055, -82.60206660307645 35.75262026491493, -82.60191360310084 35.75229826483354, -82.6018386031146 35.75212926479141, -82.60180160312494 35.752023264766, -82.60178560313389 35.751948264749046, -82.60178060314261 35.751886264735894, -82.60178460315788 35.75179226471719, -82.60180060317573 35.75169426469886, -82.6018336031963 35.751597264682516, -82.6018546032071 35.751550264675096, -82.60188260322121 35.75148926466552, -82.60192960324233 35.75140326465282, -82.6021026033121 35.75113926461685, -82.60243360343472 35.75070426456237, -82.60269460352983 35.75037126452141, -82.60275260355299 35.75028426450966, -82.60279860357367 35.750200264497245, -82.60282460359062 35.750118264483234, -82.60283860360232 35.750058264472464, -82.60284260361395 35.74998726445834, -82.60283860362338 35.7499222644447, -82.60281460364685 35.74974526440614, -82.60276860367513 35.74951326435414, -82.60265460374704 35.748927264223035, -82.60262960377142 35.74874326418297, -82.60261260379728 35.74855826414345, -82.60261160379767 35.74855426414256, -82.6026056038257 35.74836726410388, -82.60261460385416 35.7481932640693, -82.60264160389082 35.74798626402996, -82.60265860391297 35.747861264006275, -82.6026686039243 35.74779926399456, -82.6027206039813 35.74748726393641, -82.6027356039929 35.74742826392594, -82.60275760401026 35.74734026391023, -82.6027606040122 35.74733126390872, -82.60281860404365 35.747190263885955, -82.60288460407286 35.747072263868745, -82.60307260414133 35.74683326383941, -82.60360260433052 35.74618226376132, -82.60390460443801 35.745813263717295, -82.6039376044503 35.74576926371172, -82.60403860448761 35.74563726369525, -82.60407260449995 35.745594263689924, -82.604197604546 35.7454312636696, -82.60422060455436 35.74540226366604, -82.60444660463364 35.74513326363454, -82.60458260468451 35.74495126361148, -82.60466260471415 35.74484626359833, -82.60470660473058 35.744787263590815, -82.60483760477942 35.744613263568894, -82.60497260482956 35.74443426354626, -82.60522460492527 35.74408726350155, -82.60531760496052 35.743960263485256, -82.60535160497389 35.74391026347858, -82.60538960498931 35.743852263470664, -82.60550760503594 35.74367826344736, -82.60554760505141 35.74362126343988, -82.60573060512323 35.74335426340434, -82.60595060520915 35.743036263362185, -82.6061766052972 35.74271126331924, -82.60641260539124 35.74235826327161, -82.60654160545765 35.742068263225825, -82.60656260546854 35.742020263218215, -82.60658460549797 35.74185426318664, -82.60664760558053 35.74138926309832, -82.60671760563235 35.74113026305279, -82.60673260563975 35.741098263047824, -82.60693960574197 35.74066126298013, -82.60702460578862 35.740451262946046, -82.60703960579737 35.740411262939496, -82.60706560581136 35.74034926292947, -82.60707660582217 35.74029126291882, -82.60708460582981 35.740250262911275, -82.60710960585511 35.7401142628861, -82.6071286058726 35.74002126286913, -82.60715660592625 35.73970526280763, -82.60716360593784 35.73963826279469, -82.60716260594852 35.7395682627803, -82.6071566059825 35.739342262733636, -82.60712860601384 35.7391102626835, -82.60705460603687 35.73888226262938, -82.60699060604182 35.73878126260226, -82.6069116060482 35.73865526256847, -82.60674760605905 35.73840926250142, -82.60658660606725 35.73818326243882, -82.60651760607634 35.738050262404585, -82.60646760610454 35.73781426235129, -82.60638360616467 35.737336262245286, -82.60633660618784 35.73713626219964, -82.60624360620277 35.73694026215018, -82.60612960621506 35.736738262097205, -82.60599960621771 35.73658126205182, -82.60598260621816 35.73656026204584, -82.60584060621491 35.736428262004274, -82.60567460620094 35.73634026196926, -82.6052876061568 35.73620926190278, -82.60524860615239 35.736196261896005, -82.60495260613051 35.73601926182949, -82.60490360612529 35.73600026182058, -82.6048176060944 35.73610726183356, -82.60479160608509 35.73613926183739, -82.60471360605891 35.736224261846694, -82.60467860604689 35.73626426185121, -82.60438060595185 35.73655726188026, -82.60436660594723 35.73657226188185, -82.60427660591627 35.73667526189355, -82.60420760589257 35.73675426190255, -82.6041246058611 35.73686826191725, -82.60408260584498 35.736927261924926, -82.60392160577894 35.73718026195987, -82.6038526057465 35.737315261980314, -82.60376260570135 35.73751026201078, -82.60374860569404 35.73754226201584, -82.60367160565069 35.73773926204805, -82.60365360564069 35.73778426205532, -82.60350260555296 35.73818826212209, -82.60345960552786 35.738304262141284, -82.60302960528857 35.73938626231749, -82.60297660525771 35.73952826234094, -82.60288560520392 35.73977726238233, -82.6028156051608 35.7399802624165, -82.60269860508856 35.74032126247389, -82.60265660506211 35.740446262495034, -82.60257060502107 35.740619262521484, -82.60251260499723 35.740710262534, -82.60239060495337 35.74086226255243, -82.60224560490518 35.74101726256904, -82.60206560485027 35.74117826258328, -82.60206060484867 35.74118326258385, -82.6019076048046 35.74130326259253, -82.60177860477215 35.74137426259372, -82.60176760476945 35.74137926259355, -82.60167160474641 35.741425262593076, -82.60160860473296 35.74144426259043, -82.60158060472675 35.741454262589585, -82.60149560471014 35.741470262584066, -82.60133760468214 35.741481262570126, -82.60112960464875 35.74147326254704, -82.60109660464373 35.74147026254299, -82.60092560461707 35.741458262522926, -82.60085560460637 35.74145226251446, -82.60038260453285 35.741418262458815, -82.60007760448686 35.74138726242111, -82.59977960444485 35.741338262380424, -82.59972660443795 35.74132626237248, -82.59966560442886 35.74131926236477, -82.59931460438115 35.74125026231456, -82.59891760432802 35.74116626225662, -82.59867360429475 35.741119262221844, -82.5985116042727 35.74108726219863, -82.59802660420654 35.74099326212947, -82.59786560418449 35.74096226210661, -82.59755260414182 35.74090126206194, -82.59723560409945 35.740834262015596, -82.59714560408739 35.74081526200245, -82.59682660404638 35.740737261953704, -82.59660960402219 35.74066026191563, -82.5964706040081 35.74060226188958, -82.59627460399003 35.74050826185018, -82.59583660395379 35.74027126175682, -82.59564160393839 35.74016126171428, -82.59549660392345 35.74010226168734, -82.59546860391998 35.74009426168277, -82.59538460390975 35.74007026166921, -82.59527660389351 35.74005926165587, -82.59517160387402 35.74007226164772, -82.59506360385092 35.74010526164331, -82.59491760381621 35.740172261641945, -82.59485960380147 35.74020526164269, -82.59471260376375 35.74029026164488, -82.5946066037325 35.74037826165182, -82.59447660369369 35.740489261661054, -82.59407160356758 35.74086726169633, -82.5939236035228 35.740997261707584, -82.5938976035148 35.74102126170979, -82.59371160346448 35.741146261716075, -82.59366960345405 35.74116826171625, -82.59359360343534 35.74120726171638, -82.59355760342629 35.74122726171676, -82.59336460338253 35.74130226171213, -82.59335660338093 35.7413042617117, -82.59327560336351 35.741329261708515, -82.59289660328254 35.74144426169284, -82.5926866032377 35.74150826168431, -82.59258560321189 35.74156626168565, -82.59251760319202 35.74162126168988, -82.5924766031766 35.741677261697035, -82.59244260315879 35.74175526170941, -82.59241160313351 35.741885261732705, -82.59236760305613 35.74233726182029, -82.59236560305237 35.74235926182453, -82.59234860298814 35.7427552619035, -82.59234560297837 35.74281526191552, -82.59234160296462 35.742899261932095, -82.59235460295201 35.742994261952795, -82.59235560295174 35.74299726195349, -82.59237560294608 35.743055261967434, -82.59238060294447 35.74307126197121, -82.59242760293868 35.74315926199399, -82.59248960293644 35.74324026201687, -82.59258760293504 35.74335426205013, -82.59259460293532 35.74336026205215, -82.59281060294158 35.74355126211329, -82.59309460295242 35.74378626219045, -82.5933036029594 35.743966262248634, -82.59344960296177 35.744107262292445, -82.5935186029629 35.74417426231315, -82.59358560295716 35.74428326234226, -82.59362660294865 35.744382262366685, -82.59363460294264 35.74442926237708, -82.59365060292988 35.74452826239887, -82.59365860291352 35.74464326242312, -82.59365460287839 35.744865262467926, -82.59365060284112 35.74510126251566, -82.59361560279937 35.74533326255935, -82.59358960278045 35.74542726257581, -82.59352360274639 35.74557626259929, -82.5934776027254 35.7456622626121, -82.59335060267227 35.74586826264099, -82.59321260261831 35.74606826266756, -82.5930356025488 35.746326262701864, -82.59295060252043 35.74641826271184, -82.59291860250977 35.74645226271549, -82.59278360246795 35.746577262727065, -82.59265160243199 35.74666726273176, -82.59250160239243 35.746761262735475, -82.59246460238293 35.746783262736095, -82.59244560237819 35.746793262736176, -82.59220960231828 35.74692626273901, -82.59212260229607 35.74697626274018, -82.59200260226316 35.74705926274473, -82.59183060221444 35.74718926275348, -82.59162460215106 35.74737626277041, -82.59132560205725 35.74766026279748, -82.59119260201346 35.74780026281228, -82.59111160198907 35.747870262818154, -82.59100860195629 35.747971262828116, -82.59092160192533 35.748077262840745, -82.59088460191049 35.74813326284839, -82.59086160189801 35.74818926285737, -82.59084860188237 35.748276262873816, -82.59085360186985 35.74836226289182, -82.590884601862 35.74844626291212, -82.59102260185065 35.7486672629714, -82.59105160184608 35.74872826298677, -82.59107460183691 35.748812263006315, -82.59107660182492 35.7488912630226, -82.59105560180939 35.74896926303628, -82.59105260180829 35.74897326303683, -82.59099160178198 35.749077263051696, -82.59087160174165 35.74920826306607, -82.59049560162819 35.74953626309415, -82.59041260160431 35.749601263098796, -82.5902976015712 35.74969126310528, -82.59027360156429 35.749710263106685, -82.58986660144397 35.750049263133825, -82.5898306014331 35.750080263136425, -82.58973260140354 35.75016526314371, -82.58925660125986 35.75058126317929, -82.58921660124875 35.75061026318107, -82.58916560123426 35.75064826318364, -82.58906860120844 35.75071126318646, -82.58896360118382 35.75075726318497, -82.58886360116193 35.75079126318162, -82.58876560114257 35.75081026317539, -82.58866160112422 35.75081726316608, -82.58852760110251 35.75081326315146, -82.58815960104468 35.75079126310904, -82.58797860101468 35.75079026309025, -82.58760960095097 35.750805263055256, -82.58739760091395 35.75081626303559, -82.58723060088413 35.75082926302101, -82.58722160088251 35.75083026302031, -82.58700760084287 35.75085626300362, -82.5868616008139 35.75088626299461, -82.58655460075103 35.75096226297844, -82.58654560076285 35.75087626296008, -82.58652860078705 35.75070226292286, -82.58650660079591 35.750621262904055, -82.5864976007995 35.75058826289638, -82.58647360080263 35.750542262884515, -82.58643860080731 35.75047426286708, -82.58638660081652 35.75035926283828, -82.58634260082943 35.75022926280726, -82.58633960083044 35.75021926280498, -82.58630760084446 35.75009426277621, -82.58627760087282 35.749879262729316, -82.58627060089664 35.749718262695794, -82.58627660094952 35.749384262628354, -82.58626560097319 35.749219262593584, -82.5862636009789 35.74918026258546, -82.58626660100904 35.74898926254684, -82.58628160102815 35.748882262526564, -82.5862926010428 35.74879926251086, -82.5863436010822 35.748600262475485, -82.58641760113082 35.74836626243549, -82.58648960117797 35.74813926239663, -82.58653660120582 35.7480102623752, -82.58664160126486 35.747742262331414, -82.58668060128079 35.74768126232301, -82.58679160133461 35.74745326228805, -82.58701960142923 35.74708826223713, -82.58711960146971 35.74693426221604, -82.58713460147553 35.74691326221332, -82.58722560150714 35.74680726220115, -82.5873016015299 35.74674126219551, -82.58744560156656 35.74666026219385, -82.5875156015817 35.74663726219643, -82.58754460158742 35.74663126219817, -82.58759360159733 35.746620262200956, -82.5876156016016 35.74661626220243, -82.58773460162914 35.74656626220448, -82.5877466016318 35.746562262204925, -82.5877756016404 35.74653726220279, -82.58779460164615 35.746521262201576, -82.58780460165009 35.746506262199496, -82.58782260165682 35.74648226219643, -82.58785060167017 35.74642626218794, -82.58785760167657 35.746392262181736, -82.58786760168462 35.74635126217434, -82.58788860170212 35.746261262158214, -82.58789860171292 35.74620226214723, -82.58792860174316 35.746039262117165, -82.58795660178056 35.745828262077, -82.58795860179252 35.74575326206192, -82.58796060180218 35.745693262049876, -82.58795460181526 35.745602262030744, -82.58795060182527 35.745533262016274, -82.58793960183263 35.745474262003114, -82.58791860184662 35.745361261977976, -82.58784260187444 35.74510026191693, -82.58780660188758 35.74497726188816, -82.5878016018895 35.74495926188398, -82.5877486018962 35.744859261858196, -82.5877176019062 35.74476126183496, -82.58771560191488 35.74470326182293, -82.587715601922 35.74465726181364, -82.58772360193821 35.74456126179485, -82.58774360196331 35.7444212617684, -82.58774460198062 35.74431026174591, -82.58772760199298 35.74421226172418, -82.5877056020196 35.74401726168218, -82.58767760204329 35.74383426164199, -82.5876766020449 35.74382326163966, -82.58764660208311 35.74354426157976, -82.58763360209882 35.74342926155499, -82.58763160210945 35.743358261540266, -82.5876296021327 35.743206261509116, -82.58764360216297 35.74302626147387, -82.58769960219797 35.74286026144579, -82.58771860220808 35.74281526143866, -82.58776060222974 35.74272126142384, -82.58781460224839 35.74265826141655, -82.58786260226493 35.74260326141026, -82.58789360227411 35.742577261408144, -82.58798160230039 35.742502261401924, -82.58798760230206 35.74249826140178, -82.58814260234983 35.74235626138878, -82.58824360238822 35.74221726137091, -82.58834960243192 35.74204926134759, -82.58838960245296 35.74195626133279, -82.58842560247125 35.741877261320376, -82.5884886025015 35.741749261300804, -82.58855360253288 35.74161726128058, -82.58863360256727 35.74148126126114, -82.58867660258542 35.74141026125112, -82.58883460264758 35.7411782612201, -82.5890156027155 35.74093526118926, -82.58918360277183 35.74075226116931, -82.58919360277498 35.74074226116831, -82.58929060281113 35.74061326115201, -82.58933260283459 35.74050726113474, -82.58933460283723 35.74049226113188, -82.58935560286207 35.74035426110594, -82.58935860286525 35.74033726110278, -82.58934960288951 35.74017126106799, -82.58932460292148 35.73993826101802, -82.58931760293113 35.73986826100302, -82.58932860294334 35.73980126099045, -82.58934260296024 35.739707260972736, -82.58936460298467 35.73957326094773, -82.58941060301416 35.73943226092371, -82.5894386030315 35.739351260910134, -82.58944060303297 35.739343260908726, -82.58949660307093 35.73915826087675, -82.58953960312826 35.73883526081542, -82.58959460318029 35.73855826076467, -82.58961860319623 35.738481260751456, -82.58965560321946 35.738371260732826, -82.58981560330469 35.737993260672326, -82.58999360339288 35.73761526061364, -82.59011160344426 35.737410260584035, -82.59019460347582 35.73729626056934, -82.59028760350675 35.73719626055854, -82.59036960353187 35.73712226055191, -82.59044360355729 35.73703826054241, -82.59055860360732 35.736838260513586, -82.59066260366185 35.736598260475375, -82.59086060376117 35.736170260408606, -82.59092860379477 35.73602626038624, -82.59106760385559 35.73578326035105, -82.5912146039126 35.73557326032344, -82.59133560395478 35.73543126030695, -82.59137560396904 35.735382260301066, -82.59139460397544 35.73536126029878, -82.59151660401061 35.73526526029182, -82.59152260401225 35.73526126029158, -82.59158160402589 35.73523626029253, -82.5916516040424 35.73520526029348, -82.59176260406564 35.7351742602986, -82.59197660410692 35.735138260313256, -82.5922236041532 35.735104260331774, -82.59239060418628 35.73507026034207, -82.5925376042178 35.735025260348074, -82.59267460424674 35.73498526035407, -82.59295560430566 35.73490726036708, -82.59321660435637 35.73486026038439, -82.59348560440684 35.7348232604046, -82.59366460444186 35.73478926041609, -82.59380260447182 35.73474426042113, -82.59387960449106 35.73470326042071, -82.59401260452977 35.734596260412594, -82.59407860455472 35.73450626040108, -82.5941546045869 35.73438026038321, -82.594359604692 35.733922260311054, -82.59444760473082 35.73376626028835, -82.59453360476255 35.73365326027411, -82.59466760480439 35.73352726026225, -82.59476360483268 35.73344826025611, -82.5948106048462 35.733411260253334, -82.5949656048878 35.73330926024857, -82.59522160495959 35.733121260236615, -82.59538660501711 35.732927260214076, -82.59547460505331 35.73278826019485, -82.59548760505854 35.73276826019209, -82.59549660506308 35.73274826018897, -82.59555960509283 35.732624260170255, -82.59558060510263 35.732583260163985, -82.59562160512236 35.732500260151284, -82.59562760512492 35.732490260149945, -82.59565760514592 35.732387260132036, -82.59567860516484 35.732287260113814, -82.59568160517433 35.732229260102294, -82.5956866051894 35.73213726008409, -82.5956906052014 35.73206426006956, -82.59567760520959 35.73199726005458, -82.59564560521663 35.73191726003504, -82.59560960521891 35.73186426002048, -82.59558560522058 35.731827260010526, -82.59538560522327 35.73159525994263, -82.59530160522883 35.73146925990831, -82.59524060523981 35.73133325987431, -82.59521260525247 35.731221259848624, -82.5952056052676 35.73111625982645, -82.5952016052801 35.731031259808745, -82.595208605313 35.73082625976772, -82.59521060532434 35.73075525975348, -82.59521360533397 35.73069625974175, -82.59523260536052 35.73054525971291, -82.5952416053729 35.730475259699574, -82.59526660540696 35.730282259662864, -82.59527060541129 35.73025825965837, -82.59532860546945 35.729945259600555, -82.59537460550102 35.72979125957391, -82.5954166055229 35.729695259558724, -82.59546160553855 35.72964225955257, -82.59551560555707 35.729580259545465, -82.59562660558768 35.72950225954103, -82.5963336057736 35.72906225952418, -82.59641260579825 35.728987259517034, -82.5964356058057 35.72896425951468, -82.59663160586801 35.72877225949579, -82.59673160590188 35.72866125948353, -82.59682760593404 35.728557259472154, -82.59685060594187 35.72853125946926, -82.59687660595053 35.72850325946622, -82.59691460596507 35.72845025945932, -82.5969356059727 35.72842325945603, -82.59701860600393 35.72831125944168, -82.59715660606734 35.728050259402785, -82.59727560612623 35.72779725936348, -82.59728760613326 35.72776525935818, -82.59748860624507 35.727259259275755, -82.59758660630683 35.726966259226195, -82.59762160634979 35.72672625918089, -82.59764060638982 35.726488259134335, -82.59768460643367 35.72625225909076, -82.5977616064804 35.72603325905413, -82.59782460650707 35.725929259039376, -82.597860606522 35.725871259031315, -82.5979736065665 35.72570525900915, -82.5980026065773 35.72566725900441, -82.59808460660682 35.725564258991824, -82.5982086066498 35.72542025897524, -82.59838560669722 35.72530425896986, -82.59858160674347 35.725216258972154, -82.59877960679205 35.725115258971925, -82.59890160682444 35.725037258968655, -82.59902460686278 35.72492225895789, -82.59914360691324 35.724724258929776, -82.59918960693777 35.724615258912266, -82.59923860696306 35.724504258894704, -82.59933660702794 35.72419125884102, -82.5994076070659 35.724022258813896, -82.59950260710183 35.723892258797235, -82.5997556071771 35.72367825877967, -82.60012860727947 35.72341825876508, -82.60035860734715 35.723228258750055, -82.60048260738937 35.72308925873454, -82.60052360740742 35.723016258723895, -82.60054960742679 35.722919258706774, -82.60054560743833 35.722840258690255, -82.60052860744703 35.72276625867349, -82.60047360745673 35.72264425864294, -82.60040260745899 35.722553258617076, -82.60038460745957 35.72253025861049, -82.60016560746978 35.722229258526696, -82.59994460748466 35.721895258435815, -82.59990060748805 35.721826258417266, -82.59978660749694 35.72164625836884, -82.59972060749972 35.721557258343935, -82.59955460750709 35.721331258280784, -82.59930860751415 35.72102125819224, -82.59913460752195 35.72078425812608, -82.59910860752318 35.720748258116025, -82.59897860753152 35.72055425806313, -82.59895560753357 35.720516258053, -82.59890960753755 35.72044125803298, -82.59886860754106 35.72037425801514, -82.59879360755407 35.72021025797399, -82.59879160755447 35.72020525797277, -82.59876660756315 35.72012225795329, -82.59874260757111 35.720045257935155, -82.59873660757471 35.72001525792838, -82.5987076075923 35.7198702578959, -82.59868960761787 35.7196862578565, -82.5986796076333 35.719576257833076, -82.59866460764661 35.719473257810584, -82.59864860766072 35.7193652577869, -82.59863760768104 35.71922225775661, -82.59863860768982 35.71916625774534, -82.59864160770637 35.719063257724606, -82.59864160770698 35.71905925772382, -82.59861560778013 35.718558257619094, -82.59861360778679 35.71851325760972, -82.59860960781727 35.71831225756837, -82.59864660785577 35.71810325752963, -82.59870960789442 35.717921257499015, -82.5988536079608 35.717647257457976, -82.59911160807117 35.71721225739597, -82.59922860812088 35.71701625736802, -82.59939260819064 35.71674225732914, -82.59942160821497 35.71661625730641, -82.59938760822406 35.71652125728354, -82.59937760822675 35.71649325727683, -82.59934760823471 35.716409257256615, -82.59933860823755 35.71638125724999, -82.59931060824532 35.71630125723083, -82.59924160825565 35.71616025719504, -82.59920960826128 35.71608925717726, -82.59915060827159 35.71595925714468, -82.59907060829079 35.71574925709363, -82.59899760831101 35.71554025704355, -82.59895860833603 35.71533625699795, -82.59896260836138 35.71517725696599, -82.598963608362 35.71517425696543, -82.59899460841575 35.7148602569047, -82.5989796084216 35.71480625689217, -82.59896360842767 35.714750256879135, -82.59891760843364 35.714662256856386, -82.59891160843343 35.71465725685478, -82.59887260843284 35.71461925684301, -82.59883460843201 35.714583256831745, -82.598712608421 35.714523256807006, -82.59851560839425 35.714484256778725, -82.598258608354 35.71446825674907, -82.59819660834283 35.71447325674366, -82.59793860829608 35.71449825672218, -82.59770460825527 35.714510256700585, -82.59752260822823 35.71448925667753, -82.59739460821424 35.714442256654806, -82.59728260820829 35.71436025662658, -82.59716660820646 35.71424725659162, -82.5970266082091 35.714079256542966, -82.59685660821401 35.71386525648179, -82.59664660821733 35.71361825640987, -82.5965426082138 35.71352925638101, -82.59649360821038 35.71349825636965, -82.59631460819779 35.713387256328645, -82.59613960817946 35.71331725629637, -82.59594960815733 35.71325625626435, -82.59584460814439 35.71322725624767, -82.59566960812283 35.7131782562197, -82.59547560809962 35.7131192561877, -82.59539460809007 35.71309425617423, -82.59493960804159 35.71291825609157, -82.59471060801833 35.71282225604841, -82.5944506079939 35.71270025599673, -82.59441160799018 35.71268225598913, -82.59406260795629 35.712526255921404, -82.59392260794228 35.71246625589471, -82.59354260790661 35.712288255819324, -82.59341460789447 35.71222925579416, -82.59321560787727 35.71212625575272, -82.59299360786397 35.711973255698624, -82.59268260784769 35.71174425561999, -82.59234160782783 35.71150625553637, -82.59211860781609 35.71134225548001, -82.59189060780402 35.711175255422525, -82.59183960780237 35.7111312554083, -82.59180660780184 35.71109925539834, -82.5917766078047 35.71104825538489, -82.59176560780926 35.71100725537542, -82.59176660781144 35.710994255372846, -82.59176860781575 35.7109682553678, -82.59178460782302 35.71093825536326, -82.59181360783643 35.71088325535508, -82.59194460788463 35.710712255333796, -82.59204160792632 35.71054725531015, -82.59205460793159 35.71052725530744, -82.59211660796205 35.71039725528727, -82.59219660801375 35.710149255245014, -82.59221160802984 35.71006125522859, -82.59221560804342 35.709978255212064, -82.59220860806417 35.709836255182495, -82.5921086081491 35.7091802550385, -82.59206360818831 35.70887825497238, -82.5920376082089 35.708717254936886, -82.59189860832139 35.70784125474415, -82.59185660834623 35.707635254697834, -82.59181360838079 35.707366254638664, -82.59180160839044 35.70729025462193, -82.59172360843989 35.70688725453177, -82.5917116084582 35.70675625450387, -82.59172860847738 35.70665025448398, -82.5917646085031 35.70652325446185, -82.5918216085295 35.70641325444536, -82.59188760856566 35.706251254419094, -82.59192560860147 35.70606025438412, -82.59191660861373 35.70597125436504, -82.59189260862898 35.705847254337336, -82.59177560864678 35.70560625427615, -82.59174260865957 35.705488254248706, -82.59174560867118 35.705416254234386, -82.59179160869367 35.705320254219565, -82.59185560871921 35.705224254206556, -82.59198260876433 35.70506925418805, -82.59209560880684 35.70491625416851, -82.59216460883854 35.704785254148945, -82.59220560886575 35.704653254126264, -82.59221660888575 35.70453625410361, -82.59221060890505 35.704405254076235, -82.59217260892716 35.70422125403488, -82.59208460897129 35.703841253948376, -82.5920716089815 35.703761253930786, -82.5920526090183 35.70350325387624, -82.59205160901969 35.70349325387417, -82.59202760905369 35.70324725382155, -82.59200560906353 35.703160253801556, -82.59196760907507 35.70304525377426, -82.59187760909501 35.702819253718914, -82.5918536091026 35.702744253701205, -82.59183760912566 35.70257825366566, -82.591841609135 35.70252225365473, -82.59185260914721 35.70245525364223, -82.59190960919243 35.70222425360098, -82.5919356092051 35.70217025359268, -82.59199960921869 35.70215125359538, -82.5921416092462 35.702126253604945, -82.59228860927448 35.702101253614984, -82.59257060932384 35.7020852536407, -82.59277160935655 35.70209025366241, -82.5929836093907 35.702097253685686, -82.59314060941591 35.70210325370308, -82.5935086094737 35.70212525374543, -82.59384160952698 35.70213925378257, -82.59406560956072 35.70216225381032, -82.59421860958156 35.70219225383213, -82.59437060960121 35.70222825385517, -82.59454660961997 35.70229625388709, -82.59470860963556 35.702370253918886, -82.59489260964877 35.702482253960625, -82.59546360967929 35.70289925410439, -82.59579960969602 35.70315225419042, -82.59608760971241 35.70335625426168, -82.59621660972125 35.70343825429163, -82.59645060974267 35.70355125433883, -82.5965846097578 35.70359725436196, -82.59677860977988 35.70366325439534, -82.59711860982769 35.70372025444194, -82.59741760987286 35.703749254478616, -82.59780760993164 35.703789254526974, -82.59833761001013 35.70385225459438, -82.5990756101211 35.703928254685756, -82.59926161015102 35.70393525470635, -82.59944761018338 35.7039262547237, -82.59959661021155 35.70390425473453, -82.5997676102451 35.70387125474536, -82.599943610284 35.70380925475093, -82.59997061028987 35.70380025475183, -82.60030561036842 35.703653254756354, -82.600719610467 35.70346125475985, -82.60101861053592 35.7033372547654, -82.6012626105931 35.70323025476868, -82.60225561082503 35.70279925478307, -82.6025016108903 35.702642254776414, -82.60268661095249 35.70243925475409, -82.60275661097926 35.70234125474133, -82.60281361100081 35.702263254731285, -82.60291561105889 35.701997254687626, -82.60296761109885 35.701795254651785, -82.60297561110463 35.701766254646735, -82.6029846111173 35.701694254633004, -82.60300761114755 35.70152325460054, -82.60301061116874 35.70138925457354, -82.60301461118522 35.701287254553186, -82.60302061121699 35.7010882545132, -82.6030626113024 35.70058125441424, -82.6030826113664 35.700189254336465, -82.60307761137996 35.70009625431697, -82.60307161140321 35.69993925428437, -82.60317361149488 35.69945625419648, -82.60327161156536 35.699106254135245, -82.60337661163153 35.69879125408189, -82.60350561169032 35.69855025404606, -82.60368661174715 35.6983772540294, -82.60412361183751 35.69826325405123, -82.60459361191245 35.69828425410387, -82.60475061193395 35.698314254126096, -82.60477261193691 35.69831925412937, -82.60480461194142 35.6983242541337, -82.60497361196444 35.69835725415785, -82.60535861201942 35.698416254209384, -82.60536661202076 35.698416254210265, -82.605781612083 35.698460254261924, -82.606078612148 35.69835925427194, -82.60636661222722 35.69815725426042, -82.60644561225224 35.698080254252886, -82.60650061227003 35.69802425424714, -82.6065466122845 35.697980254242886, -82.60667461232349 35.69786625423283, -82.60673361234136 35.697814254228305, -82.60682261236865 35.69773325422096, -82.60686361238088 35.69769825421807, -82.60710561245047 35.697509254204476, -82.60720061247754 35.69743625419935, -82.60739461255267 35.69715925416284, -82.60762061264762 35.696788254110515, -82.60780461271315 35.696562254083446, -82.60801161278002 35.696353254062146, -82.60801561278107 35.696350254061976, -82.6081256128307 35.69614825403213, -82.60819361288375 35.69587825398406, -82.60830161294017 35.69562925394444, -82.60847961300462 35.69540425391691, -82.60864061305534 35.695249253901906, -82.60880861311676 35.69503325387518, -82.60895561319003 35.69471725382598, -82.6091276132583 35.69446125379146, -82.60932861332333 35.694257253770616, -82.6096316134077 35.69403725375696, -82.60994861348229 35.69389625376081, -82.61031161355724 35.69380225377901, -82.61069561361475 35.69384325382696, -82.61076961362298 35.69387025383997, -82.61110661365986 35.693994253899966, -82.6115146136957 35.69420125398408, -82.61201061374426 35.694421254079955, -82.61231161377438 35.69455025413723, -82.61286661382974 35.69479025424326, -82.61320361385843 35.69496725431395, -82.61333161386943 35.6950342543408, -82.61350061388625 35.69510725437307, -82.61354561393419 35.69484525432435, -82.61358961392574 35.69494725434961)))",6325,37,021,002803,370210028031,2939,2939,481,2879,2677,19,13,14,0,156,60,2153,262,1891,2113,1998,15,11,9,0,80,40,1220,1113,107
census_2010_blockgroups_view.fid--2dc29038_13ec899ba8f_-2602,"MULTIPOLYGON (((-82.53719561594036 35.59962722708389, -82.5372956159877 35.599427227053496, -82.53748161601439 35.59945422707809, -82.53804061609438 35.59953722715242, -82.5382276161211 35.59956522717737, -82.53877561619959 35.59964622725013, -82.53882661620688 35.59965422725704, -82.54001461637972 35.59981222741121, -82.54042461644035 35.599860227463104, -82.54097561652166 35.59992622753317, -82.54116461654947 35.599949227557296, -82.5411656165496 35.599949227557396, -82.54173661663484 35.60001122762869, -82.54192761666334 35.60003222765254, -82.54228561671363 35.600091227701384, -82.54247361674005 35.600122227726985, -82.54290561680503 35.600166227780356, -82.54336761687563 35.60020522783579, -82.54372961693076 35.60023722787945, -82.54406061698099 35.60026822791976, -82.54436061702711 35.60029222795552, -82.54550961720331 35.600386228092674, -82.54576161724317 35.60039922812125, -82.5458916172643 35.60040222813514, -82.54619861731481 35.60040522816733, -82.54625961732545 35.60040222817303, -82.54639661734882 35.600397228186054, -82.54668361739971 35.60037622821122, -82.54689261743835 35.60035122822766, -82.5468896174268 35.60042222824181, -82.54688861742035 35.600463228250064, -82.5468826173995 35.60059222827565, -82.54687761739186 35.600636228284124, -82.54687061737977 35.60070722829785, -82.54686161736632 35.60078522831282, -82.54684061727671 35.601344228424445, -82.54681361720826 35.60175922850606, -82.54679761716899 35.601997228552904, -82.54674961705074 35.602713228693695, -82.54674061702697 35.602857228722115, -82.54672961701057 35.60295222874031, -82.54670861697143 35.60318322878517, -82.54669361694124 35.60336322882032, -82.54666761690623 35.603562228858074, -82.54663761685275 35.60387722891915, -82.54661661681357 35.60410922896414, -82.54661161680718 35.604145228970964, -82.5465986167881 35.60425522899198, -82.54659561678191 35.60429222899925, -82.5465616167359 35.60455422904908, -82.54645961659753 35.60534222919903, -82.54645861659593 35.60535122920069, -82.54642161655084 35.60560422924842, -82.54641161653511 35.60569522926591, -82.54638961649931 35.605904229306155, -82.54637961648729 35.60597122931876, -82.5463676164711 35.606063229336314, -82.5463386164337 35.60627522937644, -82.54625361632142 35.606912229497354, -82.54622661628412 35.60712522953792, -82.54620961626125 35.60725522956266, -82.54620761625725 35.60727922956736, -82.54620661625553 35.60728922956925, -82.54616061617129 35.60778622966564, -82.54614661614345 35.607952229698064, -82.54613161611573 35.60811522972971, -82.54611261607958 35.60832922977126, -82.54609961605466 35.60847722980008, -82.54608461603247 35.60860522982461, -82.54606661600431 35.608768229855876, -82.54595161600285 35.60865422982092, -82.54590561599689 35.60864322981394, -82.54588561599435 35.60863822981086, -82.54579961598701 35.60859322979282, -82.54566761597738 35.60851322976305, -82.54551361596357 35.6084372297317, -82.5453486159476 35.608363229699705, -82.54530661594349 35.60834422969153, -82.54515261592533 35.608296229665946, -82.54512861592231 35.608290229662195, -82.54501261591105 35.60823822963975, -82.54471861589447 35.60802922956696, -82.54464761589001 35.607981229549885, -82.54453061588262 35.60790322952196, -82.54429261586398 35.607768229470025, -82.54408561584235 35.607685229431915, -82.54389261582087 35.60761722939825, -82.54374661580336 35.607573229374225, -82.54354761577731 35.607528229344666, -82.54340861575399 35.607529229330595, -82.54320561572004 35.6075312293101, -82.54303561569013 35.607542229294864, -82.54296461567695 35.607551229289484, -82.54285661565696 35.607564229281, -82.54274861563847 35.607568229270676, -82.54273161563576 35.607567229268724, -82.54261961561734 35.607566229257, -82.54247161559526 35.60755022923855, -82.54233361557574 35.60752822921991, -82.5420746155499 35.60741722917068, -82.54205661554778 35.607411229167596, -82.54199461554046 35.60739222915735, -82.54187261552484 35.607362229138715, -82.54182961551781 35.607361229134106, -82.54171861549975 35.607359229122295, -82.54145061545415 35.6073662290962, -82.54128161542425 35.60737822908128, -82.54120861540932 35.607396229077374, -82.54120661540874 35.60739822907761, -82.54119961540437 35.60741922908114, -82.54130061540968 35.60749322910662, -82.5415836154172 35.60774922918781, -82.54164561541532 35.607828229210256, -82.54167261540617 35.60791622923097, -82.54168061539478 35.60799922924868, -82.54166961538174 35.60807222926234, -82.54163361536735 35.60812622926968, -82.54154161534333 35.60818322927185, -82.54122561526827 35.608330229269264, -82.54107361523441 35.60838622926496, -82.54094961520875 35.60841922925899, -82.5408166151858 35.608424229246346, -82.54075861517686 35.608420229239606, -82.54068861516568 35.608417229231726, -82.54058761515451 35.608381229214054, -82.54041961513396 35.60833322918701, -82.5401456150866 35.6083452291613, -82.54009561508593 35.608296229146205, -82.54002761508272 35.60824322912842, -82.53977661508826 35.60793722904031, -82.53965961508736 35.60781722900387, -82.53958461508137 35.607775228987606, -82.53952261507202 35.60776922898002, -82.53946061506099 35.60777422897461, -82.53942761505323 35.60778922897431, -82.53940261504479 35.607816228977285, -82.5393936150369 35.6078582289849, -82.53940461502914 35.607920228998616, -82.539415615025 35.60795922900771, -82.53942561502156 35.607992229015444, -82.53945661501604 35.60806122903269, -82.5394796150083 35.608136229050295, -82.539492614998 35.60821722906814, -82.53958561496398 35.60853822914306, -82.5396376149193 35.60888422921881, -82.53963961490498 35.608979229238344, -82.53962961488554 35.60909422926072, -82.53960261486064 35.609227229285025, -82.53955661482475 35.60941022931745, -82.53952861480929 35.609480229328895, -82.53947761479253 35.60953422933465, -82.53937661476454 35.609607229339076, -82.5393296147532 35.60963022933895, -82.53927861474209 35.609647229337206, -82.53920661472799 35.60966122933264, -82.53898261468863 35.60967522931246, -82.53883861466149 35.60969622930194, -82.53875961464236 35.609735229301705, -82.53867861461843 35.60980322930731, -82.5386346146 35.609875229317424, -82.53860161458024 35.60996822933295, -82.53858561454554 35.61017622937363, -82.53854761452224 35.610286229392095, -82.53848861449565 35.610395229408205, -82.53842361446328 35.61053522942999, -82.53836261443053 35.610682229453595, -82.53836061442905 35.610689229454856, -82.53828661439513 35.61083022947597, -82.53824061437713 35.610897229484884, -82.53817261435685 35.610955229489676, -82.53810561433802 35.61100522949294, -82.53805261432508 35.61103222949305, -82.53796861430823 35.611051229488275, -82.53787261429135 35.611057229479584, -82.53779861428112 35.611044229469364, -82.53774561427521 35.61102522946005, -82.53768761427065 35.61099222944736, -82.53762061426715 35.610943229430454, -82.5375146142699 35.61081122939271, -82.53749661427196 35.610778229384174, -82.53743761428026 35.610661229354356, -82.53735661426147 35.61069522935293, -82.53727461424897 35.61068822934306, -82.53711861423194 35.61063122931541, -82.5370076142224 35.610573229292214, -82.53697361421933 35.61055622928526, -82.53673861420134 35.61042022923344, -82.53667861419534 35.610394229221946, -82.53658861418492 35.61036522920681, -82.53649461416998 35.6103612291963, -82.5361976141182 35.61037722916902, -82.53610461410398 35.61036922915787, -82.53605661409875 35.61035122914929, -82.5359986140926 35.6103292291388, -82.53596061409147 35.610295229127985, -82.5359376140942 35.610253229117035, -82.53592161409968 35.61020022910464, -82.53591461410907 35.6101312290899, -82.5359146141162 35.61008522908052, -82.53594461413063 35.6100242290712, -82.5360446141576 35.60995622906761, -82.53611261417308 35.6099292290691, -82.53619661418934 35.609914229074704, -82.53635461421757 35.609901229088294, -82.53649061424233 35.60988722909952, -82.53656961426202 35.60984422909883, -82.53666861427777 35.609849229110004, -82.53680361430386 35.609825229119, -82.53693161433063 35.60978922912485, -82.5369996143465 35.609759229125665, -82.53707561436684 35.6097092291234, -82.53712661438253 35.60966222911901, -82.5371766143992 35.6096082291132, -82.5372486144255 35.609515229101625, -82.53731761445377 35.6094062290866, -82.537409614495 35.609237229061655, -82.53747461452734 35.609097229039875, -82.53753361456681 35.60890522900679, -82.53756161459425 35.608757228979535, -82.53757061461349 35.60864222895707, -82.53757861467872 35.60822722887345, -82.5375736147171 35.60797322882122, -82.53756161473801 35.60782422878968, -82.53752361475037 35.607703228761125, -82.53745961475305 35.60761722873706, -82.5373516147528 35.607502228702536, -82.53725861475444 35.60739122867042, -82.53722561476117 35.60731222865094, -82.53720961477332 35.607216228629795, -82.53722061478722 35.60713822861504, -82.53726161480658 35.607056228602566, -82.53725161481191 35.60701122859241, -82.53722361482768 35.606878228562444, -82.53721461483302 35.606834228552565, -82.53720861483588 35.60680922854683, -82.53709561485375 35.60657122848678, -82.53701361486313 35.60642222844806, -82.5369796148819 35.60626422841234, -82.5369936149019 35.60614922839044, -82.5369866149148 35.60605822837117, -82.53698061492976 35.605954228349404, -82.5369516149379 35.60587022832929, -82.5368996149425 35.60578422830648, -82.53687561495504 35.60567722828223, -82.53684761496469 35.60558422826041, -82.5367816150005 35.60528122819202, -82.5367626150172 35.605152228163796, -82.53674961503975 35.60499222812986, -82.53671561506044 35.60482122809159, -82.53669461507171 35.60472522806994, -82.536649615084 35.604597228039225, -82.53666461510542 35.604474228015704, -82.5366706151229 35.60436722799459, -82.53667561515819 35.60414322794952, -82.53670761517901 35.60404322793244, -82.53684161522698 35.603876227912195, -82.53697061526962 35.60373822789739, -82.53697761527165 35.60373222789689, -82.5371546153228 35.60359122788638, -82.537193615344 35.60349522787089, -82.53716861535575 35.6033922278473, -82.53705261535484 35.60327322781115, -82.53693561534962 35.60318122778046, -82.53689261535213 35.6031182277632, -82.53687961535309 35.603098227757805, -82.53687961536009 35.603053227748674, -82.53687961536725 35.60300622773908, -82.53690161538559 35.602911227721975, -82.5369036153955 35.6028492277096, -82.53690661540647 35.60278122769605, -82.53684861540285 35.6027422276822, -82.53667961541422 35.60248622761271, -82.53665161541623 35.60244322760106, -82.53657761542365 35.60231522756743, -82.53654661543023 35.60223922754877, -82.53655761545085 35.602117227525035, -82.53659461547257 35.602016227508315, -82.53661461548832 35.60193522749384, -82.53660661549807 35.60186322747845, -82.53658661550865 35.60177322745804, -82.53653961552409 35.601622227422524, -82.53651061553104 35.60154622740406, -82.53649261554739 35.601420227376586, -82.53647861556095 35.601317227354116, -82.53650061558439 35.601189227330316, -82.53653761561144 35.60105322730644, -82.53654961562066 35.601006227298214, -82.5365886156489 35.60086522727348, -82.53660161565816 35.60081922726548, -82.53719561594036 35.59962722708389)))",4341,37,021,000600,370210006001,773,773,30,761,645,76,0,22,0,18,12,692,23,669,683,585,65,0,20,0,13,9,486,428,58
census_2010_blockgroups_view.fid--2dc29038_13ec899ba8f_-2601,"MULTIPOLYGON (((-82.44716861890231 35.483320194188714, -82.44721161889035 35.48344519421853, -82.44734461885724 35.48380419430512, -82.44736561885202 35.48386119431883, -82.44741161883425 35.484026194357135, -82.44742761881513 35.484168194387564, -82.44742161880136 35.48425119440382, -82.44740361878452 35.484342194420485, -82.4473716187632 35.48444619443827, -82.44731161873098 35.484592194461854, -82.44722761868837 35.48477919449123, -82.44702161858041 35.48526119456801, -82.44701461857657 35.48527819457076, -82.44696661854807 35.485412194593046, -82.44686761847942 35.48575319465219, -82.44685961847385 35.48578119465705, -82.4468366184567 35.48586819467242, -82.44682961845102 35.485897194677584, -82.44681961844437 35.485930194683256, -82.44679361842459 35.48603119470111, -82.44678561841798 35.48606519470723, -82.44674161838537 35.486230194736216, -82.44674161838488 35.48623419473701, -82.4467026183505 35.48641619476996, -82.44661561829392 35.486691194816956, -82.44660061828652 35.4867231948219, -82.44656161826624 35.4868131948362, -82.44653161825097 35.48688019484674, -82.44652061824672 35.48689619484885, -82.4464896182338 35.48694719485606, -82.44647961822955 35.48696419485845, -82.4462986181559 35.48724919489783, -82.44617061809693 35.487495194934645, -82.44615261808568 35.48754919494383, -82.44610061805207 35.487712194971586, -82.44602661799564 35.488000195022515, -82.44597061794236 35.48828719507508, -82.44593061788886 35.48859319513313, -82.4459206178611 35.48876319516668, -82.44593261784406 35.48888719519314, -82.4459656178325 35.488998195219025, -82.44601061782433 35.48910019524441, -82.44611761781206 35.48929519529498, -82.44622361780328 35.489467195340815, -82.44630261779679 35.489594195374785, -82.44637661779498 35.48968619540104, -82.44649861778997 35.48985019544686, -82.44659561778151 35.49001019548931, -82.44659961778018 35.490023195492384, -82.44661161777675 35.490058195500765, -82.44663961776882 35.49014019552025, -82.44664461776594 35.490164195525615, -82.4466526177616 35.490201195534, -82.44666761775346 35.49027019554951, -82.44667161773758 35.49037819557185, -82.44667061773724 35.49037919557198, -82.44666061771508 35.49051319559818, -82.44661561768517 35.49065919562326, -82.44650161763167 35.49088519565749, -82.44642061759357 35.49104619568193, -82.44630461754251 35.49125419571228, -82.44630261754187 35.491256195712495, -82.44621561750768 35.491385195729706, -82.44612061747341 35.49150619574451, -82.44598161742815 35.491651195759744, -82.44593661741433 35.491693195763695, -82.44582661738015 35.49179719577353, -82.44581061737499 35.49181319577517, -82.44565561732574 35.49196719579057, -82.44562761731693 35.49199419579315, -82.44558461730308 35.49203819579769, -82.44554961729037 35.49208319580322, -82.44552561728159 35.492115195807294, -82.44547061726169 35.49218519581582, -82.44538161721736 35.492378195845944, -82.44534161718715 35.49253219587305, -82.44533861718234 35.492560195878475, -82.44532561715903 35.492698195905184, -82.44532861712713 35.49290919594846, -82.44538361700566 35.49376019612699, -82.44538761699654 35.493824196140395, -82.44539661696727 35.49402419618192, -82.44541361691684 35.49437119625419, -82.44542761689736 35.49451319628455, -82.44543661688392 35.49461119630534, -82.4454826168591 35.49482219635292, -82.44555461684432 35.4949961963957, -82.44563161683664 35.495129196430575, -82.44566561683489 35.495177196443834, -82.44572061683245 35.495252196464726, -82.44588061682873 35.49544919652115, -82.44605561682637 35.49565319658061, -82.44620961682189 35.49584819663604, -82.44628461681684 35.49596219666691, -82.44682561675097 35.49697419692801, -82.44691361674023 35.49713919697059, -82.44713361670263 35.49762119709115, -82.44727061667871 35.49792519716698, -82.4472766166772 35.49794119717085, -82.44741661664803 35.4982821972545, -82.44749861661475 35.49858719732492, -82.44750061661206 35.498607197329214, -82.44751361659266 35.49874719735893, -82.44751161656643 35.49891619739305, -82.44750661655965 35.49895519740053, -82.44748461652618 35.49914919743766, -82.4474606164986 35.49930319746648, -82.44737861647617 35.499361197469895, -82.44727161644066 35.49947719748249, -82.44710261637988 35.49969119750861, -82.44663061620918 35.50029419758268, -82.44647561615453 35.5004831976052, -82.44637161611904 35.50060219761873, -82.44624461608028 35.50071819762921, -82.44619461606644 35.50075419763146, -82.44610261604079 35.50082219763579, -82.44603561602348 35.500863197637266, -82.44594961600093 35.50091719763941, -82.44556661590795 35.50111019763933, -82.44536261585874 35.50121119763891, -82.44535661585715 35.50121519763909, -82.44475761570953 35.50153119764181, -82.44464061568051 35.501594197642646, -82.44456361565919 35.50165019764611, -82.4444926156396 35.50170119764914, -82.44436261559889 35.50182619766127, -82.4443046155784 35.50189719766974, -82.44416261552793 35.50207319769086, -82.44382861540588 35.50250819774498, -82.44363261533822 35.502738197771656, -82.44340061525759 35.50301319780376, -82.4432606152098 35.50317319782182, -82.4428896150829 35.503600197870554, -82.442841615067 35.50365219787618, -82.44269961501922 35.50381019789366, -82.44269061501645 35.50381919789455, -82.44266461500807 35.50384519789719, -82.44265661500526 35.50385519789843, -82.44243661493448 35.50407919792136, -82.44243461493369 35.50408219792176, -82.44233261489296 35.50423719794283, -82.44229061487164 35.50433119795758, -82.44225261484033 35.50449419798681, -82.44222561480873 35.504671198020006, -82.4421926147624 35.50493719807065, -82.44218661475607 35.50497219807715, -82.44213561470117 35.505274198133236, -82.44213361469966 35.50528219813479, -82.44210561467695 35.5054001981558, -82.44207861465443 35.505517198176776, -82.44201061460703 35.505753198217825, -82.44197761458337 35.50587119823839, -82.44189361452429 35.50616619828972, -82.4418466144839 35.506378198327916, -82.44181461444592 35.506591198367914, -82.44180061441149 35.506800198408996, -82.44181761438301 35.507004198452165, -82.44181861438234 35.50700919845328, -82.4418496143613 35.50718019849121, -82.44190961433772 35.50739819854172, -82.44199461431757 35.50762119859574, -82.44209661430318 35.50782419864749, -82.44238661427181 35.50834119878229, -82.44279161423013 35.509049198967716, -82.44290261421963 35.50923719901735, -82.44300961420758 35.50943019906755, -82.44307661419512 35.50958419910571, -82.44312761417392 35.50977719915018, -82.443140614149 35.509953199187244, -82.44313661412764 35.51008819921425, -82.44311961411174 35.510173199229854, -82.4430706140654 35.51042219927545, -82.44299061401864 35.510640199311474, -82.44289561396995 35.51085519934536, -82.44275861390744 35.51111419938398, -82.44270461387788 35.51124919940585, -82.44269161387095 35.51128019941081, -82.44268961386983 35.51128519941159, -82.44266261385135 35.51137619942731, -82.44265361384485 35.5114091994331, -82.44265161384371 35.51141419943394, -82.44263861382449 35.511525199455214, -82.44262961380983 35.51161119947173, -82.44263761377081 35.511874199525955, -82.44265161374054 35.512086199570504, -82.4426996136427 35.51277519971544, -82.44273061360221 35.513072199778954, -82.44274361356592 35.51332219983111, -82.44278261350385 35.51376819992572, -82.44278861349454 35.51383519994001, -82.44281761347615 35.51398619997362, -82.44286561345618 35.514168200015526, -82.44291361344173 35.51431420005016, -82.44294361343266 35.51440520007171, -82.44298061342234 35.514512200097236, -82.44304061340691 35.51467720013696, -82.44307361339843 35.5147682001588, -82.44312361338532 35.514907200192276, -82.44313861338185 35.514946200201635, -82.4432196133642 35.51514820025104, -82.4433256133413 35.515411200315405, -82.44334861333506 35.51547720033115, -82.44337961332708 35.51556220035157, -82.44340761331692 35.51565820037404, -82.44345461329996 35.515819200411556, -82.44356061326285 35.51617520049476, -82.44357461324768 35.516289200519395, -82.44357261324458 35.5163072005228, -82.44357061324085 35.51632920052713, -82.44356661323283 35.51637720053638, -82.44354061322024 35.51643120054475, -82.4435246132143 35.51645220054736, -82.44351461321162 35.516459200547764, -82.44344561319215 35.5165112005512, -82.44338461317862 35.516534200549614, -82.44335761317352 35.51653820054769, -82.44327661315796 35.51655220054221, -82.44323461315074 35.51655420053829, -82.44282461307947 35.516576200500765, -82.44264661304845 35.516586200484454, -82.44251861302627 35.51659320047274, -82.44205361294394 35.516628200432095, -82.44077961271832 35.51672520032093, -82.44059261268487 35.51674120030501, -82.44047061266208 35.51675820029596, -82.44034061263521 35.5167932002897, -82.44028661262254 35.51681720028902, -82.44021361260515 35.51685220028867, -82.44012161258122 35.51690920029083, -82.44000161254323 35.51702720030245, -82.43984461249002 35.51720420032224, -82.4397166124472 35.517345200337765, -82.4395056123762 35.51758020036391, -82.43935661232972 35.517722200377456, -82.43931961231871 35.51775420038013, -82.43921161228593 35.51785120038871, -82.43917461227569 35.51787820039041, -82.43911661226764 35.51786820038249, -82.43882061220681 35.51794520036773, -82.43864561216431 35.5180332003676, -82.43830961209018 35.5181542003577, -82.43802661203917 35.51818120033415, -82.4377986120032 35.518170200308504, -82.43747561194635 35.51819220027975, -82.43720061189245 35.51824720026274, -82.43706561187254 35.51823120024563, -82.43683061186408 35.51803320018125, -82.43676361186827 35.51793420015428, -82.436723611887 35.51776920011662, -82.43670961191172 35.51759320007939, -82.43668261191736 35.517527200063235, -82.43664261191581 35.51749420005236, -82.43657461190458 35.517494200045455, -82.43634661185672 35.51756020003544, -82.43623861184224 35.51753820001982, -82.43615861183825 35.517478199999466, -82.43614461185112 35.51737919997792, -82.4362056118823 35.51724219995636, -82.43620561190589 35.51708819992501, -82.43609761190415 35.51698319989261, -82.43597661188751 35.516961199875745, -82.43590961188153 35.51692819986211, -82.43582861188074 35.516846199837104, -82.43581561188269 35.516819199830294, -82.43574861191392 35.516544199767566, -82.43571461201473 35.51585119962328, -82.43566761204079 35.51563119957374, -82.43556061204488 35.51548919953386, -82.43549261206239 35.51530219948889, -82.43550661211532 35.51497219942327, -82.43547961213629 35.51480719938703, -82.43542461213971 35.51472519936463, -82.435338612145 35.514598199330024, -82.43527061215991 35.514428199288524, -82.43523061221248 35.514043199206135, -82.43518361222489 35.513911199174565, -82.4351036122269 35.51381219914616, -82.43506961222589 35.513782199136614, -82.43487461221935 35.513615199082665, -82.43472661223534 35.51335119901384, -82.43468661225916 35.513153198969434, -82.43464561226416 35.513076198949584, -82.4345856122661 35.5129991989278, -82.43426261225403 35.51273019883995, -82.43419561226153 35.512609198808526, -82.43415561227691 35.51246619877535, -82.43406161227992 35.51234519874112, -82.4339266122711 35.512257198709406, -82.43371161224567 35.51219119867386, -82.43332861221351 35.511988198593365, -82.43300561218038 35.51185619853331, -82.43289461217287 35.51178519850752, -82.43283161216851 35.51174619849309, -82.43207161213309 35.51115819829561, -82.43185661211956 35.511015198244465, -82.4317866121139 35.510976198229315, -82.43142661208555 35.51077319815113, -82.43125161207766 35.51063619810533, -82.43117161208808 35.510482198065844, -82.431136612113 35.510282198021564, -82.43112461212249 35.510207198005126, -82.43101961214192 35.509968197945796, -82.43098961214743 35.5099001979289, -82.43095561215051 35.509843197913824, -82.43073961217043 35.509481197818126, -82.43071461217284 35.50943819780681, -82.43068161218038 35.50935419778634, -82.43064661218862 35.50926219776407, -82.43062061220463 35.50913019773455, -82.4304976122301 35.50883219766134, -82.43047161223572 35.5087671976455, -82.43025061225406 35.5084101975503, -82.4299686122613 35.50805919744998, -82.42982661227836 35.5077951973818, -82.42981361229306 35.507685197358114, -82.4298676123341 35.507476197321175, -82.4298676123492 35.50737819730126, -82.42986761238139 35.50716819725857, -82.42983361240955 35.5069481972104, -82.42978961241984 35.50683419718276, -82.42973961243106 35.506707197151805, -82.42957861243484 35.506509197095035, -82.42953761244497 35.506399197068454, -82.42955061246896 35.50625719704096, -82.42956461249166 35.50612419701536, -82.42954461251539 35.50594819697754, -82.42947761252528 35.50581119694281, -82.42931661252238 35.50565719689503, -82.42924961252649 35.50555819686805, -82.42920861253833 35.50543719683928, -82.42921561259836 35.505053196761914, -82.42914861261097 35.50489919672383, -82.42904061260833 35.50480019669254, -82.42901361261231 35.504745196678655, -82.42898661262636 35.50462419665124, -82.42898661264773 35.504485196622994, -82.4289876126519 35.50445919661781, -82.42903461270359 35.50417319656457, -82.42902261272461 35.50402319653285, -82.42902061272999 35.50398619652511, -82.4289806127452 35.50384419649222, -82.4288396128046 35.50330519636818, -82.42867861283852 35.50291119627163, -82.42865161284446 35.502843196255064, -82.42860461287967 35.5025631961933, -82.4286176129106 35.50237619615665, -82.4285776129377 35.50215619610788, -82.42831561298885 35.50154119595601, -82.42815361298909 35.50136519590361, -82.42799261298272 35.501233195860266, -82.42724661293948 35.50071119567764, -82.42713761293764 35.50060619564512, -82.4269716129346 35.500447195595754, -82.42674261292369 35.50027119553653, -82.42662861292929 35.50011219549248, -82.42644661292924 35.49991619543398, -82.42628961292928 35.499747195383556, -82.42616861294981 35.49948319531747, -82.42614861296333 35.499373195293124, -82.42615261297016 35.49933319528539, -82.42616161298238 35.49926319527204, -82.42629661303347 35.49907619524797, -82.4262826130531 35.49893319521747, -82.42610861304799 35.49877919516828, -82.42601361304234 35.49871319514521, -82.42573861302205 35.49854919508357, -82.42567161301439 35.49852719507222, -82.42550961300536 35.49841119503208, -82.4253356129986 35.49826819498512, -82.42517361300727 35.49803719492155, -82.42512161301636 35.49792219489282, -82.42488461305895 35.497389194760224, -82.42487461307084 35.49730119474131, -82.4250356131165 35.49717719473266, -82.42522761317142 35.49702619472171, -82.42543161322949 35.49686719471036, -82.42629161347351 35.496204194663974, -82.42664761357425 35.495931194645074, -82.42697461366711 35.49567819462722, -82.42795561394519 35.49492319457457, -82.42828361403795 35.49467219455717, -82.42979861446713 35.49350819447628, -82.42991161449952 35.49341919446978, -82.43009061455035 35.49328019445985, -82.43058061469031 35.49289619443214, -82.43079361475392 35.49271119441643, -82.43096561480894 35.492538194398946, -82.43108261484866 35.492405194383885, -82.43120761489347 35.49224819436487, -82.43132261493636 35.49209219434498, -82.43144061498398 35.49190919431988, -82.43155961503663 35.491694194288385, -82.43169361509996 35.491426194247744, -82.43178561514824 35.49121019421328, -82.43233761542977 35.48997019401802, -82.43234761543503 35.48994719401445, -82.43241361546971 35.48979219398962, -82.43247761550283 35.489645193966346, -82.43255361554115 35.489477193940004, -82.43308861581528 35.48826719374913, -82.43312661583434 35.48818419373612, -82.43333161593765 35.487731193665105, -82.43342661597856 35.487567193641574, -82.43358461604346 35.48731419360638, -82.4337486161034 35.48710019357968, -82.43392861616647 35.486883193554085, -82.43404461620416 35.48676219354141, -82.43423161626264 35.48658319352429, -82.4343686163034 35.486465193514384, -82.43467561638911 35.4862371934995, -82.43467661638944 35.48623619349949, -82.43534661657198 35.48576819347306, -82.43594261673327 35.48535919345119, -82.43606861676759 35.48527119344623, -82.4365346168936 35.48495219342918, -82.43671061694154 35.48482919342229, -82.43724261708583 35.48446219340228, -82.43741961713376 35.48434019339566, -82.43775761722515 35.484109193383404, -82.43779961723659 35.48407919338167, -82.43811761732346 35.483856193369, -82.43893661754598 35.48328819333759, -82.439316617649 35.48302619332335, -82.43948661769522 35.48290819331684, -82.43999661783353 35.48255619329763, -82.44016761787972 35.48243919329141, -82.44033361792489 35.48232319328485, -82.4408346180609 35.481977193265955, -82.44100161810614 35.48186219325972, -82.44165461828352 35.48140919323463, -82.44292761862886 35.48053019318668, -82.44336961874703 35.480236193172274, -82.44362961881518 35.480072193165654, -82.44400961891463 35.47983319315604, -82.44430661899099 35.47965519315036, -82.44432361899553 35.47964419314992, -82.44437661900939 35.479611193148614, -82.44439461901395 35.47960119314844, -82.44444961901425 35.479658193165704, -82.44458961900968 35.47983919321679, -82.4447216190026 35.480027193268526, -82.4448336189937 35.48020619331636, -82.44484161899288 35.48022019332008, -82.44532361894262 35.481068193541795, -82.44545961892952 35.481300193602934, -82.44553661892354 35.481422193635574, -82.44588261890495 35.481916193771504, -82.44605361889427 35.48217019384065, -82.44611761889051 35.48226419386632, -82.44620361888909 35.48236619389583, -82.44629261889104 35.482449193921795, -82.44637461889634 35.48250319394123, -82.44647661890411 35.48256219396371, -82.44658361891437 35.48261119398461, -82.44664461892167 35.48262919399452, -82.44670661892906 35.482647194004535, -82.4467256189314 35.48265319400766, -82.44680261894139 35.48267119401926, -82.44689661895461 35.482686194031956, -82.44696161896368 35.482697194040895, -82.44698461895334 35.48278919406193, -82.44699561894994 35.482823194069965, -82.44712461891423 35.483195194158775, -82.44716861890231 35.483320194188714)))",6055,37,021,003202,370210032022,645,645,11,642,633,2,1,1,1,4,3,489,6,483,487,481,2,1,0,1,2,2,267,242,25
census_2010_blockgroups_view.fid--2dc29038_13ec899ba8f_-2600,"MULTIPOLYGON (((-82.69980165572356 35.51653022683317, -82.6999486557477 35.5165322268486, -82.70029565580683 35.51652322688231, -82.70091865594463 35.51630022690064, -82.70114165599378 35.51622122690728, -82.7014576560666 35.51608922691278, -82.701766656145 35.5159132269085, -82.70188165616916 35.51588022691351, -82.702176656219 35.51587522694272, -82.70266765629401 35.5159192270019, -82.7035006564319 35.515924227088114, -82.70356865643562 35.51597322710518, -82.70394465641661 35.516506227252215, -82.70398365641641 35.51655022726521, -82.7042076564149 35.51680322733966, -82.70442265642303 35.51698422739859, -82.70467765643755 35.51716622746185, -82.70487565645415 35.51727322750386, -82.70507365647074 35.51738022754595, -82.70555165652591 35.517539227627296, -82.70572765654296 35.51761922766157, -82.70597465656697 35.51773122770964, -82.70619665658114 35.51788022776279, -82.70672065662808 35.51814322787003, -82.70678865663167 35.51819322788717, -82.70686265662046 35.51834722792618, -82.70702365662125 35.51851722797726, -82.70792365666044 35.51923922821656, -82.70812565666925 35.51940122827024, -82.70828065668324 35.51947822830183, -82.70840865670127 35.51950022831937, -82.70874665677681 35.51937422832828, -82.7087236567667 35.51941522833429, -82.70865565673607 35.51954122835301, -82.708633656726 35.51958322835938, -82.70857565669982 35.51969122837544, -82.70851365667201 35.51980522839231, -82.70847765665651 35.51986722840132, -82.70832865659318 35.52011922843738, -82.70803965646911 35.52061522850897, -82.70786465640165 35.52086522854199, -82.70769765633699 35.52110622857407, -82.7076716563272 35.521142228578746, -82.70759565629777 35.52125122859325, -82.70757065628801 35.52128822859822, -82.70753265627357 35.52134122860508, -82.70742165623062 35.5215012286264, -82.70738465621625 35.52155522863359, -82.70717465613497 35.52185722867368, -82.70674165597917 35.522404228740854, -82.7063116558145 35.523012228820825, -82.70581665563134 35.52367022890436, -82.70540965548587 35.524178228966235, -82.70495865534207 35.52462722901159, -82.70423065511136 35.52534222908287, -82.70358965489712 35.52604422916036, -82.7029936547201 35.52655222920296, -82.70257165459316 35.52692322923542, -82.7022436544941 35.52721322926092, -82.70157865428584 35.52785022932274, -82.70129765418496 35.5282032293659, -82.70116565413765 35.52836922938631, -82.70068965400111 35.528743229413806, -82.70037265391005 35.52899322943229, -82.70010765383053 35.529224229452275, -82.69964765369241 35.52962622948717, -82.69962665368678 35.52964022948786, -82.69946265364136 35.5297582294951, -82.69907665353539 35.53003122951131, -82.6990446535263 35.53005522951286, -82.69778265317856 35.53095422956699, -82.69716565301007 35.53138422959149, -82.69681765291493 35.531627229605405, -82.6965336528384 35.531818229615276, -82.69652665283525 35.531831229617104, -82.69652265283285 35.53184222961897, -82.69650765282564 35.53187322962381, -82.69650165282236 35.53188822962625, -82.6964986528211 35.531893229627016, -82.69649065281725 35.53190922962935, -82.69648865281602 35.531915229630364, -82.69648165281292 35.531928229632285, -82.69646265280345 35.53196922963873, -82.69645765280039 35.53198322964109, -82.69628165271355 35.532359229699765, -82.69617765266156 35.53258522973513, -82.69575265245238 35.53348922987586, -82.69557665236528 35.53386622993474, -82.69542165228849 35.53419922998682, -82.69537765226805 35.53428522999983, -82.69530365223271 35.53443523002276, -82.69524565220922 35.534525230035214, -82.69517165218176 35.534624230047854, -82.69510465215947 35.53469723005587, -82.69502465213279 35.53478423006536, -82.69492165210181 35.53487423007319, -82.69449965198233 35.535196230095565, -82.69441465195786 35.53526323010054, -82.69407265185956 35.535533230120556, -82.69404965185333 35.53554923012148, -82.6940006518401 35.53558223012322, -82.69397165183206 35.535603230124515, -82.69385165180073 35.53567723012736, -82.69380165178751 35.535709230128724, -82.6939146518085 35.535695230137385, -82.6939286518108 35.5356952301389, -82.69403665182755 35.53570323015156, -82.69416265184402 35.53573223017037, -82.69430365186079 35.535776230193754, -82.69434165186512 35.5357892302003, -82.69442465187416 35.53582023021512, -82.69374965173837 35.53597323017721, -82.69360465170924 35.53600623016907, -82.69316065161729 35.536124230147706, -82.69283165154641 35.53622923013537, -82.69252965147902 35.53634123012734, -82.69210765138057 35.5365252301216, -82.69185665131795 35.53666123012364, -82.69180965130626 35.536686230123905, -82.69155465124237 35.53682623012639, -82.6911996511548 35.53701223012787, -82.69076365104296 35.53726823013548, -82.69058565099792 35.537369230137784, -82.69023965090996 35.53756723014276, -82.68996065083967 35.537723230145986, -82.68970365077517 35.53786523014858, -82.689048650609 35.53823823015755, -82.68873265052866 35.538419230162134, -82.68842065044925 35.53859823016661, -82.68811665037201 35.53877223017101, -82.68764165025222 35.539038230176594, -82.68709465011017 35.53937123018847, -82.68676865002527 35.539571230195854, -82.68648564993399 35.539859230225545, -82.68636964988997 35.54002023024649, -82.6863096498583 35.540162230269324, -82.68627064982267 35.54035223030398, -82.68619264977839 35.54055623033763, -82.68607964971902 35.54082123038003, -82.68590164963707 35.54116223043131, -82.68571764956536 35.54143023046715, -82.68552064949952 35.541646230491, -82.68524064941529 35.541891230512206, -82.6849686493383 35.542098230526605, -82.68494064933029 35.5421202305282, -82.68463364925098 35.54230423053428, -82.68442164919867 35.54241523053515, -82.68418164914279 35.542519230531816, -82.68390964908203 35.54262023052448, -82.68374364904729 35.542667230517075, -82.68324564894252 35.542810230495235, -82.68308064890769 35.54285823048815, -82.68280864885153 35.54292923047473, -82.68235064875678 35.54305023045245, -82.6819956486834 35.54314323043508, -82.68172464862734 35.543215230422014, -82.6814136485622 35.543302230407924, -82.68048364836744 35.54356323036581, -82.68017464830258 35.5436512303521, -82.67973664821142 35.54377023033153, -82.67842464793807 35.544129230270315, -82.67798764784695 35.54424923025002, -82.6776546477781 35.54433723023384, -82.67674364758895 35.54458223019044, -82.67665664757135 35.544602230185575, -82.67632264750358 35.544682230167744, -82.67587664741231 35.54479323014464, -82.67563664736322 35.544853230132325, -82.67536564730881 35.54491423011695, -82.67504064724552 35.544974230095924, -82.67452264714882 35.54504223005671, -82.6744946471436 35.54504623005465, -82.67406764706476 35.545097230021284, -82.67319964691636 35.545123229937666, -82.67310964690091 35.54512622992909, -82.67258164681282 35.54512822987537, -82.67205864672906 35.545107229817496, -82.67059764649255 35.54506422965916, -82.66973064635216 35.545039229565205, -82.66935264629166 35.54502422952348, -82.66821964611002 35.544979229398194, -82.66784264604962 35.54496422935651, -82.66778564604058 35.544961229350065, -82.6676176460139 35.544953229331234, -82.66756164600484 35.54495122932505, -82.66687064589414 35.54492322924863, -82.66559664569017 35.54487222910763, -82.66549864567443 35.544868229096835, -82.66479764556212 35.54484022901934, -82.66410664545118 35.544814228943174, -82.66329364532137 35.544779228852754, -82.66272264523003 35.54475522878939, -82.66198964511021 35.54474222871164, -82.6615166450304 35.544749228664536, -82.66110664496311 35.54474322862135, -82.66085764491807 35.544767228600726, -82.66071664489232 35.54478222858932, -82.66033464482115 35.544832228560395, -82.66005464476609 35.54488722854294, -82.65976664471124 35.54493222852258, -82.65966564469208 35.544948228515516, -82.65937264463318 35.54501422849897, -82.6590726445716 35.54509022848366, -82.65891764453977 35.545130228475905, -82.65863664448153 35.545205228462464, -82.65846164449964 35.54489722838174, -82.6582116445257 35.544456228266284, -82.65785464456307 35.54382522810115, -82.65711164463353 35.54256022776728, -82.65690764465047 35.54222922767894, -82.65689064465205 35.54220022767124, -82.65670464467433 35.54185322758151, -82.65649664469788 35.541474227482986, -82.6564876446988 35.54145822747873, -82.6564606447017 35.54141022746624, -82.65645264470281 35.54139422746218, -82.6564436447036 35.54137922745816, -82.65641964470649 35.54133422744655, -82.65641164470749 35.54131922744265, -82.656095644743 35.5407452272933, -82.65608264474446 35.54072122728706, -82.65618764476689 35.54068922729134, -82.65626264478396 35.54065922729292, -82.65716764499028 35.540295227311454, -82.65737864504155 35.540189227311494, -82.65748464506869 35.54012722730972, -82.65753164508172 35.54009322730758, -82.65764664511428 35.54000622730161, -82.65779664516022 35.53986922728908, -82.65802964523374 35.53964222726672, -82.65842164536245 35.53922822722251, -82.6588006454865 35.53883022718025, -82.65905064557359 35.538533227145315, -82.6591406456066 35.53841522713048, -82.65925064564702 35.53827122711243, -82.65955964576769 35.53781922705195, -82.65971464583286 35.53756222701545, -82.65983164588441 35.537353226984855, -82.65987864590677 35.537258226970295, -82.65995964594467 35.53709922694622, -82.66021564607009 35.53655822686222, -82.660282646109 35.536377226832165, -82.66032164613901 35.536224226805, -82.66034564616993 35.53604822677162, -82.66034564619343 35.535895226740394, -82.66032664621248 35.535750226708906, -82.66029264622917 35.5356042266757, -82.66024464624067 35.53547722664492, -82.66017164624849 35.53534722661097, -82.65994764626075 35.53502422652222, -82.65987864626737 35.53490622649105, -82.65982264627979 35.5347642264564, -82.65978164629448 35.53462422642373, -82.6597696463114 35.53450122639736, -82.65978064633224 35.534377226373316, -82.65981664636318 35.53421422634375, -82.6598896464112 35.53398022630353, -82.65997064645842 35.53376022626698, -82.6600696465059 35.53355722623578, -82.66018464654812 35.533407226216994, -82.66031364658832 35.53328422620511, -82.66047464663232 35.533172226198744, -82.66062964667103 35.5330882261975, -82.66078664670682 35.53302422620063, -82.6609476467398 35.5329842262089, -82.66110664677024 35.532958226219925, -82.66128964680306 35.53294222623538, -82.66132464680922 35.53294022623855, -82.6617846468889 35.53291922628141, -82.66209464694246 35.532906226310494, -82.66249664701228 35.53288722634778, -82.66373764721938 35.53288222647389, -82.6639586472564 35.532880226496104, -82.66414964728844 35.532878226515244, -82.6647256473851 35.53287322657325, -82.66491764741717 35.53287222659269, -82.66512764745238 35.532870226613845, -82.6651346474535 35.532870226614556, -82.66537164749434 35.53286122663699, -82.66575764756371 35.53282722666956, -82.66596264760459 35.532783226681666, -82.66600264761257 35.53277422668385, -82.66629164767136 35.532704226699224, -82.66652664772104 35.532635226709274, -82.66658764773348 35.53262022671244, -82.66695964780837 35.532535226733145, -82.66715264784969 35.53247522674077, -82.66731764788598 35.53241722674579, -82.66748664792424 35.532351226749604, -82.66764864796194 35.532281226752026, -82.66781164800115 35.532202226752574, -82.6679886480444 35.532112226752325, -82.66821264810129 35.53198422674923, -82.6683776481414 35.53190122674916, -82.66844464815762 35.53186822674938, -82.66893064828471 35.53156622673758, -82.66898764829975 35.531530226736045, -82.66908564832525 35.53147022673391, -82.66916264834396 35.5314312267338, -82.66919964835297 35.53141322673391, -82.66921864835886 35.531395226732215, -82.66923564836307 35.53138622673208, -82.6692656483703 35.53137122673218, -82.66939864839819 35.53133322673804, -82.66995364851464 35.531176226762916, -82.67006764853852 35.53114422676798, -82.67014064855235 35.53113322677326, -82.67022364856817 35.53112022677908, -82.6704746486157 35.53108222679707, -82.67055864863154 35.53107022680325, -82.6706656486516 35.53105522681109, -82.67098664871207 35.531009226834584, -82.67109464873215 35.53099522684287, -82.67132764877594 35.5309622268599, -82.67133564877756 35.53096022686037, -82.67188864888244 35.53087622689985, -82.67200064890474 35.53085222690646, -82.6720566489168 35.53083422690851, -82.67211764892969 35.53081622691113, -82.67215964893991 35.53079522691114, -82.67229164896554 35.530771226919775, -82.67248364902618 35.530584226901276, -82.67262164906951 35.530451226888346, -82.67309264920726 35.53006322685751, -82.67313564921966 35.53002922685491, -82.67330064926776 35.529894226844334, -82.6735106493294 35.52972022683037, -82.67414164951391 35.529201226789176, -82.67435264957552 35.529028226775594, -82.67439064958671 35.528996226772946, -82.67450664962068 35.52890022676529, -82.67454564963197 35.528869226762936, -82.67466864966819 35.5287662267545, -82.67504064977723 35.52845822672987, -82.67516464981354 35.52835622672177, -82.67528464984939 35.52825222671289, -82.67537164987519 35.52817822670666, -82.67553664992356 35.52804222669587, -82.67565464995708 35.52795122668943, -82.67578064999294 35.52785422668254, -82.67595965004064 35.52773722667704, -82.67615165008905 35.52762922667465, -82.67625365011341 35.527581226675316, -82.67639565014638 35.527520226677396, -82.67663565020158 35.52742022668163, -82.67687465025404 35.527337226689205, -82.67714765031194 35.52725622670061, -82.67763365040824 35.5271552267298, -82.67786065045262 35.52711222674431, -82.67812165050763 35.52703622675549, -82.67823565053318 35.52699322675844, -82.67839465057004 35.52692522676079, -82.6784066505731 35.52691822676068, -82.67858065061516 35.52683222676089, -82.67879765067035 35.52670822675784, -82.6789956507235 35.52657622675126, -82.67901165072817 35.52656322675026, -82.67908465074997 35.526500226744865, -82.67910665075617 35.52648322674365, -82.67921265078905 35.5263842267343, -82.67929265081548 35.52629822672503, -82.6793596508374 35.52622822671755, -82.6794296508611 35.526149226708675, -82.67949665088207 35.526085226702456, -82.67956365090483 35.52600922669388, -82.67966265093834 35.52589822668133, -82.6799396510254 35.52563022665513, -82.68012365107796 35.52548722664477, -82.6802296511072 35.52541122664011, -82.6802816511215 35.525374226637965, -82.68046665117467 35.525228226627114, -82.6806696512323 35.525072226616125, -82.68097665131701 35.52485322660291, -82.68121265138183 35.524686226592976, -82.68134165141488 35.52461022659072, -82.6815646514688 35.52450022659112, -82.68172465150563 35.52443422659405, -82.68256265168928 35.524145226620966, -82.68267465171415 35.52410422662405, -82.68270665172163 35.5240902266245, -82.68299065178738 35.523969226628935, -82.68328565185729 35.523833226631396, -82.68335965187515 35.523797226631565, -82.68358165192831 35.52369122663274, -82.68365665194612 35.523656226633264, -82.68388365200059 35.523547226634285, -82.68393865201371 35.5235212266347, -82.6841776520723 35.52339822663405, -82.6843756521226 35.523285226631266, -82.68451265215701 35.52320922662978, -82.68454765216651 35.52318522662852, -82.68462165218594 35.52313922662667, -82.68474665222321 35.52303122661751, -82.68485965225949 35.522917226605806, -82.68486065225991 35.522915226605576, -82.68500165230739 35.52275822658797, -82.68517665236945 35.52254322656204, -82.68528065240614 35.52241722654698, -82.68557765251049 35.52205822650425, -82.68586665261151 35.521712226463244, -82.68605865268054 35.52147022643359, -82.6864286528216 35.520951226365675, -82.68647665283969 35.52088522635714, -82.68669265291125 35.52065222633182, -82.6867436529262 35.52061022632846, -82.68685565295907 35.520517226321, -82.68693865298351 35.52044822631537, -82.68695865298919 35.520432226314206, -82.68716865305649 35.52022122629266, -82.6871746530582 35.520216226292234, -82.6872426530807 35.52014322628434, -82.68727265309069 35.5201112262809, -82.68732165310871 35.52004622627265, -82.6873486531217 35.51999122626419, -82.68737365313676 35.51991922625204, -82.68738965315248 35.51983422623645, -82.68741865319627 35.51958022618757, -82.6874416532472 35.51927222612719, -82.6874426532489 35.519262226125235, -82.68746765333084 35.51875422602421, -82.68751165336694 35.51856622599044, -82.68756365339848 35.51841722596542, -82.68781265351444 35.51793022589165, -82.68803065361223 35.51752822583203, -82.68810865364348 35.517409225815776, -82.68831765372353 35.51711322577676, -82.6885216538033 35.51681422573672, -82.68871365387793 35.51653522569953, -82.68903365400438 35.51605722563484, -82.68905965401498 35.516016225629116, -82.68913965404678 35.51589522561262, -82.68916665405746 35.515855225607254, -82.69048765431151 35.51563122569677, -82.69304165480257 35.51519922587009, -82.69446565501785 35.51534022604457, -82.69566265519863 35.515460226191514, -82.69573065520889 35.51546722619988, -82.69579965521926 35.5154742262084, -82.69583065522585 35.515465226209756, -82.69592665524561 35.51544022621447, -82.69595865525206 35.51543322621629, -82.6960136552489 35.5155132262383, -82.6960676552302 35.51569422628066, -82.69647065525683 35.515958226375766, -82.696575655247 35.51613622642277, -82.69682765522374 35.51656222653542, -82.69688765520252 35.51676622658313, -82.69692865520018 35.51682622659956, -82.6970826552115 35.51691922663425, -82.69722365523579 35.51691422664771, -82.69736465526842 35.516854226649905, -82.6976336553586 35.51655722661684, -82.6978086554055 35.516441226611114, -82.69830565550917 35.51630422663403, -82.6986886555729 35.51630422667323, -82.69884865559584 35.51632822669454, -82.6992666556556 35.51639222675031, -82.69980165572356 35.51653022683317)))",6541,37,021,002402,370210024021,2059,2059,322,2026,1756,53,11,1,1,204,33,1531,178,1353,1515,1346,41,9,1,1,117,16,996,867,129
census_2010_blockgroups_view.fid--2dc29038_13ec899ba8f_-25ff,"MULTIPOLYGON (((-82.55972862247752 35.581460225701, -82.55967662234664 35.582254225857326, -82.55964162225501 35.58281222596734, -82.5596386222409 35.582900225984886, -82.5596236222037 35.583126226029414, -82.55958062209483 35.583787226159565, -82.55956462204891 35.58406822621507, -82.55956462204634 35.58408522621856, -82.55954662200718 35.58432022626448, -82.55954262199698 35.58438222627674, -82.55954062199261 35.5844082262818, -82.55953962198679 35.584445226289276, -82.55953662197965 35.58448822629768, -82.55953562197531 35.584515226303054, -82.55953162196465 35.58458022631589, -82.55952862195154 35.584662226332306, -82.55951862193245 35.584775226354246, -82.55951362192151 35.58484122636721, -82.55948062184804 35.585283226453775, -82.55938362162782 35.58660922671372, -82.55935462156091 35.587012226792766, -82.55935162155431 35.587052226800544, -82.55933862152844 35.58720622683062, -82.55930362145122 35.58767022692145, -82.55929162142537 35.5878252269518, -82.5592626213629 35.588200227025126, -82.55922862128577 35.588664227116126, -82.55915762117256 35.58932322724298, -82.55911762110819 35.58969822731519, -82.55908562105833 35.58998722737073, -82.55907462103963 35.590097227391965, -82.55898362090801 35.5908542275367, -82.55894962085765 35.591144227592196, -82.55880962083258 35.59115622758029, -82.55868262081111 35.59115922756787, -82.55843662076911 35.591166227544065, -82.55788062067619 35.59117022748778, -82.5576136206316 35.59117222746076, -82.55737662059195 35.5911742274368, -82.55666662047257 35.5911842273659, -82.55651762044732 35.59118722735116, -82.55643062043384 35.59118122734109, -82.55627262040966 35.59116722732193, -82.55579862033737 35.59112622726496, -82.5556406203131 35.59111322724606, -82.55551962029475 35.59110222723142, -82.55515762023951 35.59107022718771, -82.55513762023638 35.591069227185535, -82.55503862022253 35.59105222717178, -82.5549476202097 35.59103722715939, -82.55477362018273 35.591025227139106, -82.55474562017827 35.59102422713601, -82.554413620128 35.59099222709543, -82.55416762008973 35.59097622706686, -82.5539856200624 35.59095722704433, -82.55397962006137 35.59095722704372, -82.55385662004066 35.59095922703149, -82.55376862002504 35.59096622702386, -82.55371562001483 35.59097522702026, -82.5536406200005 35.59098722701497, -82.55350061997294 35.591015227006295, -82.55315161990393 35.5910872269851, -82.55285961984661 35.59114422696669, -82.55273261982153 35.59117022695899, -82.55264661980421 35.59119022695422, -82.55253861978294 35.5912122269476, -82.55247661977185 35.59121722694226, -82.55232261974386 35.59123322692972, -82.55221661972588 35.59123522691919, -82.55198561968827 35.591231226894706, -82.55196261968469 35.59122922689184, -82.55179161965803 35.59121822687209, -82.55160961962979 35.59120522685079, -82.55108761954885 35.59116822678956, -82.55106661954582 35.59116522678678, -82.5508876195199 35.59114022676332, -82.55098261957595 35.59087922672002, -82.55103361960573 35.59074022669691, -82.55126261974294 35.59009622658942, -82.55135561979853 35.58983522654585, -82.55145361985778 35.589556226499056, -82.55151461989416 35.58938522647061, -82.55163861997518 35.58899322640348, -82.55167362000716 35.588823226372504, -82.55168462002756 35.58870222634902, -82.55170062005486 35.58854222631802, -82.5517056200765 35.58840722629113, -82.55171362011745 35.58814922623938, -82.55172662017998 35.58775722616098, -82.55172462023833 35.5873762260832, -82.55172362027773 35.58711922603076, -82.55172462029853 35.58698522600366, -82.55173162036105 35.58658622592317, -82.55172462038044 35.58645322589536, -82.55172062039125 35.58637822587968, -82.55169662040667 35.58625222585158, -82.55164362042895 35.58605022580504, -82.55161962043897 35.58595922578403, -82.55147762049238 35.58545922566769, -82.55130262055478 35.58486522552879, -82.55125562057162 35.58470522549137, -82.55123562059562 35.5845272254531, -82.55123762060597 35.5844622254401, -82.5512386206196 35.58437522542248, -82.5513216207197 35.58381422531686, -82.55138962081102 35.58329422521802, -82.55140362083654 35.583143225188664, -82.55140362085476 35.58302522516469, -82.55138962086536 35.582941225146186, -82.55134762088214 35.58278722511049, -82.55121962092484 35.58237122501266, -82.5511986209361 35.58227522499099, -82.55130662095561 35.582265225000015, -82.55152262099699 35.58222922501488, -82.55188362106387 35.582184225042795, -82.55211862110944 35.58214122505821, -82.55229362114254 35.582115225070886, -82.55241662116508 35.582101225080656, -82.55268062121584 35.5820562250986, -82.55323562133057 35.581909225125685, -82.55335162135017 35.581907225137215, -82.55344162136893 35.58188222514128, -82.55416662151968 35.581684225175536, -82.554342621554 35.58165122518683, -82.55448462157844 35.58164522520022, -82.55472862161626 35.581663225228894, -82.55495962164686 35.581713225262824, -82.55512962166974 35.581748225287384, -82.55533562169727 35.58179122531736, -82.5555466217277 35.58182122534508, -82.55564362174376 35.58182122535504, -82.55573262175854 35.581821225364166, -82.55581762177373 35.581814225371495, -82.55587362178386 35.5818092253762, -82.55602162181377 35.58177422538429, -82.55610262183201 35.58174322538633, -82.55614862184207 35.581727225387795, -82.55630962188069 35.58165022538861, -82.55688262202557 35.581326225381545, -82.5569016220303 35.581316225381414, -82.55713662209085 35.581176225377114, -82.55722762211445 35.581121225375284, -82.5575036221855 35.5809572253702, -82.5575956222091 35.58090322536866, -82.55777062225381 35.580801225365846, -82.5582966223879 35.58049722535799, -82.55847262243269 35.580396225355486, -82.55871862249609 35.58024922535082, -82.5588596225321 35.580167225348674, -82.55896462255727 35.580117225349255, -82.5591016225888 35.5800602253517, -82.55922062261264 35.58003322535842, -82.55939462264409 35.58001722537301, -82.55953062266644 35.580018225387164, -82.55972562269844 35.58002122540782, -82.55981762271291 35.58002622541832, -82.55978262262141 35.580583225528095, -82.55972862247752 35.581460225701)))",6370,37,021,000900,370210009001,797,797,17,773,316,450,2,1,0,4,24,604,11,593,594,276,312,1,1,0,4,10,399,352,47
census_2010_blockgroups_view.fid--2dc29038_13ec899ba8f_-25fe,"MULTIPOLYGON (((-82.55861661725032 35.6142052322524, -82.5586296172533 35.614199232252474, -82.55888561730615 35.61413223226514, -82.55890761731025 35.614129232266826, -82.55905061733701 35.61411023227765, -82.55918961736059 35.6141072322913, -82.55921361736455 35.614107232293755, -82.56034961754528 35.61415823242089, -82.56094161763936 35.614186232487434, -82.56152661773214 35.6142142325532, -82.56152261772299 35.61426923256403, -82.56151261769544 35.61443723259721, -82.5615106176865 35.6144932326084, -82.56150861768182 35.61452123261395, -82.56150661767987 35.614532232615964, -82.56149561766168 35.614638232636395, -82.56149561765987 35.61465023263882, -82.5614956176536 35.61469023264694, -82.56148561762076 35.614893232687244, -82.5614606175719 35.61518323274375, -82.56145261755347 35.61529423276555, -82.56143861751454 35.61553123281232, -82.56142661747006 35.61580723286724, -82.56140261742918 35.61604623291343, -82.56135361730269 35.616814233064765, -82.5613436172738 35.61699123309976, -82.56132861725898 35.61707123311458, -82.56131861725204 35.61710523312044, -82.56130961724513 35.6171402331266, -82.5612726172247 35.61723323314174, -82.56121961720181 35.61732423315484, -82.5611596171783 35.617412233166554, -82.56109961715696 35.61748623317547, -82.56100861712105 35.61762123319363, -82.56095661709989 35.61770223320473, -82.56082861704732 35.61790523323297, -82.5608036170364 35.61794923323936, -82.56075761701564 35.6180342332519, -82.5607166169956 35.61812023326518, -82.5607116169928 35.61813323326728, -82.56069161697836 35.61820523327994, -82.5606706169587 35.61831023329916, -82.56064661694141 35.61839623331412, -82.56062261692323 35.618488233330474, -82.56059461690276 35.6185912333486, -82.56055361687223 35.61874523337571, -82.5605156168417 35.618902233403695, -82.56049161682166 35.61900623342243, -82.56041161676463 35.61929023347206, -82.56037961674126 35.61940723349256, -82.56035861672144 35.619513233512016, -82.56021361661473 35.62004923360624, -82.56018861659524 35.620148233623794, -82.56017861658704 35.62019123363155, -82.56014961654358 35.62044123367941, -82.56006361653047 35.620434233669194, -82.55988161650095 35.62042923364939, -82.55983961649413 35.62042823364491, -82.55907761636921 35.62041823356459, -82.55880961632505 35.620415233536384, -82.5585566162843 35.62040723350876, -82.55853661628112 35.62040623350651, -82.55771761614676 35.620395233420076, -82.55744561610213 35.62039223339152, -82.5571926160607 35.620388233364736, -82.55643361593636 35.62037723328447, -82.556181615895 35.620374233257934, -82.5560296158702 35.62037123324169, -82.55557461579568 35.62036423319351, -82.55542361577098 35.620362233177595, -82.55521161573631 35.620358233154924, -82.55457861563272 35.62034823308789, -82.55449061561828 35.620347233078576, -82.55436861559753 35.620350233066716, -82.55435161562184 35.620174233029125, -82.55430161569483 35.6196472329167, -82.55428561571918 35.61947223287943, -82.55427161573807 35.61933423284992, -82.55422961579507 35.61891923276114, -82.55421661581407 35.61878223273191, -82.55420661582717 35.618686232711354, -82.55417961586716 35.618398232649874, -82.5541706158803 35.61830323262964, -82.55415561591788 35.61804323257522, -82.55415361594069 35.617893232544475, -82.55415661596746 35.61772223251003, -82.55417161600761 35.61747823246184, -82.55419461603374 35.61733323243469, -82.55422461606227 35.61718123240683, -82.55426361609045 35.61704023238216, -82.55430161611612 35.61691423236035, -82.5544006161714 35.61666223231926, -82.55453061623423 35.616395232278244, -82.55461861628051 35.61618923224539, -82.55467661631533 35.61602623221817, -82.5546806163178 35.616014232216145, -82.55468761632207 35.61599423221275, -82.55476961638301 35.61568723215874, -82.55481961642394 35.61547523212069, -82.55483061643258 35.61543123211285, -82.5548646164591 35.61529623208885, -82.55505661648813 35.61531423211231, -82.55560761657195 35.61536423217903, -82.55648961670411 35.61545723228869, -82.55660161672269 35.615457232300166, -82.55673461674553 35.615452232312826, -82.5569666167938 35.61538923232386, -82.55709661682415 35.615332232325606, -82.55721461685422 35.615264232323874, -82.55770361699446 35.6148812322962, -82.55788161704591 35.614739232285544, -82.5584176172003 35.61431523225434, -82.55844261720738 35.61429623225304, -82.55861661725032 35.6142052322524)))",6166,37,021,000400,370210004002,682,682,16,667,615,41,2,5,0,4,15,641,16,625,627,582,35,2,4,0,4,14,386,366,20
census_2010_blockgroups_view.fid--2dc29038_13ec899ba8f_-25fd,"MULTIPOLYGON (((-82.36686558963848 35.58724420704607, -82.36689658966064 35.58713320702674, -82.36705658972262 35.58690320699654, -82.36713158975138 35.586797206982645, -82.36713858975402 35.58678720698133, -82.36758158991137 35.58624220691632, -82.36808559006339 35.58579720687781, -82.36815359009157 35.585687206862424, -82.36820259011422 35.585593206848436, -82.3682735901463 35.5854612068289, -82.36830059019053 35.585203206779354, -82.36827259020527 35.58507820675105, -82.36826159021068 35.585031206740375, -82.36822959022678 35.584892206708815, -82.36821959023224 35.58484620669847, -82.36836059027596 35.58471420668622, -82.36858259040503 35.584115206587384, -82.36886459053147 35.583598206511475, -82.36894259056997 35.58343220648583, -82.3690665906301 35.58317520644633, -82.3691195906609 35.583032206422764, -82.36913259073005 35.58259820633598, -82.36922659082185 35.58210320624512, -82.36919959088026 35.58169620615966, -82.36915259089587 35.58154420612402, -82.36909859091348 35.581372206083515, -82.36912159093599 35.58125120606133, -82.36914559095858 35.58113020603921, -82.36920159098425 35.5810242060234, -82.36925059101159 35.58089920600312, -82.36930759103257 35.58082420599374, -82.3693195910381 35.58080120599032, -82.36974359117438 35.58037220594679, -82.3699575912495 35.58011420591643, -82.37028159136338 35.57972320587039, -82.37041559142969 35.579437205826146, -82.37058359149385 35.57920120579551, -82.37059559149756 35.57919020579445, -82.37120159167068 35.57871720576081, -82.37128259170024 35.57861220574781, -82.371631591802 35.578326205725695, -82.3717905918584 35.578131205702434, -82.37183259187343 35.57807820569598, -82.37195859191841 35.57792220567727, -82.3720015919335 35.57787020567118, -82.37218559201698 35.577526205620266, -82.37222559203566 35.57744820560849, -82.37234259208846 35.57723120557654, -82.373141592451 35.5757362053551, -82.37337359255406 35.57531720529394, -82.37372659270983 35.57468520520194, -82.37380159274811 35.574517205175525, -82.37382959276195 35.574457205166226, -82.37400259284969 35.57407420510618, -82.37401159286112 35.57400920509392, -82.37403959289367 35.57382820506012, -82.37416959290664 35.573883205084634, -82.37437759292749 35.573971205123875, -82.37457059295234 35.57401720515306, -82.37470859296992 35.57405120517417, -82.37473159297228 35.57406020517846, -82.37478659297784 35.574083205188764, -82.37480359297983 35.57408820519154, -82.37482859298262 35.57409720519589, -82.37484959298395 35.57411120520091, -82.37491459298812 35.57415320521608, -82.37493659298971 35.57416720522126, -82.37513759300461 35.57428620526613, -82.37541759302938 35.57442520532308, -82.3758265930656 35.57462920540663, -82.37631759310845 35.57487720550751, -82.3769115931723 35.57510020561397, -82.37696659317814 35.57512120562392, -82.37741959322447 35.57530620570806, -82.37787059328274 35.575412205776, -82.37793059329042 35.57542620578504, -82.37818559333206 35.575430205812104, -82.37857959339173 35.575465205859814, -82.3791295934824 35.57546720591676, -82.3792575935015 35.57548020593264, -82.37971959357029 35.57552920599011, -82.3797525935753 35.575532205994136, -82.37977859357919 35.575535205997355, -82.37985159359202 35.575530206003876, -82.37988559359798 35.57552820600695, -82.3802505936618 35.57550520603982, -82.3804285936931 35.57549320605582, -82.38070359374122 35.57547620608058, -82.38093959379458 35.575383206086, -82.38135159390195 35.57512820607662, -82.3816275939786 35.57492720606419, -82.38178459402192 35.57481420605742, -82.38186859403912 35.57479320606183, -82.38204059407391 35.57475220607113, -82.38237459415299 35.574597206074046, -82.38258759419732 35.57453820608394, -82.38293059427706 35.574388206088805, -82.38299859429378 35.57435320608871, -82.38354759441688 35.57414320610257, -82.38411259454205 35.5739372061189, -82.38453559463018 35.57381920613839, -82.38528759475159 35.57383820621968, -82.38587459483688 35.5739142062955, -82.38624359486617 35.57412020637536, -82.3868815949222 35.57444120650616, -82.38734759496286 35.57467720660205, -82.38784359499478 35.57500220671909, -82.3881635949801 35.57544020684098, -82.38899559507584 35.57571120698168, -82.38994859523525 35.57570020707753, -82.39087159539842 35.57563120715849, -82.39198559556912 35.575719207291, -82.39237959563265 35.57572920733358, -82.39272659569053 35.57572620736861, -82.3934315957931 35.57581720745961, -82.39351059580446 35.575828207470025, -82.39404059587979 35.57590820754079, -82.3947165959774 35.576000207629114, -82.39524659610016 35.575772207637286, -82.39561159622787 35.575335207586065, -82.39586359635199 35.574801207503526, -82.39602659644527 35.57437020743272, -82.39605459646086 35.57429920742123, -82.39629459658536 35.573749207334124, -82.39648359668153 35.57332820726809, -82.39709159668821 35.5739372074544, -82.39713459668864 35.57398020746753, -82.3982485966865 35.57518920782773, -82.39883959668437 35.57583720802021, -82.39941959668225 35.576473208209094, -82.39952759668991 35.57653920823359, -82.39982359669742 35.57680820831869, -82.39994459669711 35.57694020835797, -82.40015259667214 35.57732520845756, -82.40056959669535 35.57762220856084, -82.4006505966927 35.57772620859032, -82.40071759669698 35.57777020860615, -82.40074459669472 35.57781420861779, -82.40096559670017 35.578015208681364, -82.40104759670237 35.57808920870489, -82.40163859673837 35.57849020884716, -82.40198859679283 35.578512208887595, -82.4020555968022 35.57852320889673, -82.4020965968038 35.578557208907846, -82.40217659681362 35.578579208920594, -82.40249959683332 35.578798208998286, -82.40278859683771 35.5790792090851, -82.4030045968345 35.57933220915875, -82.40337359680751 35.579903209312725, -82.4034815967914 35.580123209368594, -82.40352159679122 35.580167209381635, -82.40356259678028 35.580282209409155, -82.403709596769 35.58051320947119, -82.40375059675547 35.58064520950222, -82.4038445966387 35.58150320968627, -82.40395159659036 35.581931209784216, -82.40401859657607 35.58209620982464, -82.4040865965686 35.5822172098562, -82.40460359657874 35.58270621000878, -82.40471959655565 35.582980210076336, -82.40473859655185 35.58302521008747, -82.40477159651665 35.583289210144486, -82.40496059647518 35.583761210259794, -82.40502759647435 35.583838210282366, -82.40511459645815 35.5840362103315, -82.40520859641606 35.58441021041721, -82.40526259640981 35.5845092104429, -82.40551859641565 35.5847452105172, -82.40555859640871 35.58483321053916, -82.40553859638506 35.584965210563944, -82.40547159634934 35.5851252105895, -82.40547059634835 35.5851302105905, -82.40545759632244 35.58528421062037, -82.40552459628793 35.585580210687496, -82.40552959627995 35.585637210699495, -82.40554459625557 35.58581121073644, -82.4056335962355 35.58603721079153, -82.4056795962253 35.58615221081956, -82.40589459621168 35.58647121090653, -82.4059345962132 35.58650421091736, -82.4059955962013 35.58664721095272, -82.4060045962011 35.586658210955875, -82.40616259619856 35.586844211009904, -82.40624459619701 35.5869422110383, -82.40626459619678 35.586965211044976, -82.40639859620106 35.58708121108232, -82.4065335962115 35.58715821111189, -82.40655559621419 35.58716421111538, -82.40667959622915 35.58720021113543, -82.40680259624412 35.58723521115523, -82.40690259625228 35.58728921117643, -82.40704459626375 35.58736721120686, -82.40733359627856 35.58758121128018, -82.40749259628485 35.58771121132292, -82.40768059629215 35.587865211373575, -82.40772359629396 35.58790021138507, -82.40777259629832 35.58792421139501, -82.40779159630011 35.58793321139876, -82.407844596263 35.58823021146456, -82.40784959626248 35.588239211466956, -82.40788259625866 35.588299211482465, -82.40790159625594 35.5883372114922, -82.40792259625236 35.58838321150363, -82.40799059623619 35.588560211546636, -82.40814759619965 35.58896621164531, -82.4081675961673 35.58919721169429, -82.40816159615802 35.58925121170468, -82.4081405961205 35.589472211747406, -82.40813259611646 35.589489211750056, -82.408032596067 35.5897032117832, -82.4080085960578 35.589737211787586, -82.4077295959474 35.59015321184343, -82.40766259590917 35.59032921187237, -82.40762459588116 35.59047021189705, -82.40755259582772 35.59073921194433, -82.40754159581958 35.590780211951504, -82.40748659579143 35.590904211971, -82.4074405957674 35.591010211987836, -82.40727859569476 35.59130721203151, -82.40722559567598 35.59137221203924, -82.40719859566629 35.59140621204341, -82.40716359564027 35.591537212066434, -82.40709659558999 35.59179121211108, -82.40704459552398 35.59216321218134, -82.407043595522 35.592175212183626, -82.40700959545265 35.59258821226411, -82.40691459539809 35.592840212305546, -82.40668659530101 35.593225212360274, -82.40663259526657 35.59339021238828, -82.4066125952412 35.59353321241529, -82.40673359521216 35.59385121249226, -82.406746595199 35.59395021251377, -82.40674259519591 35.5939662125166, -82.4067195951725 35.59409321254, -82.40665259514618 35.59419221255329, -82.40651059510567 35.594302212561, -82.40637159505812 35.594461212578956, -82.40618459503382 35.59441821255099, -82.40562359496046 35.59429221246764, -82.40543759493615 35.59425021243995, -82.40490559486821 35.59412021235876, -82.40478359485266 35.594090212340184, -82.40452459482059 35.59402021229923, -82.40428159479288 35.59393921225784, -82.40401559476587 35.593829212208036, -82.40384059474977 35.59374621217321, -82.40354759472548 35.59358921211114, -82.40339259471254 35.59350621207832, -82.40319159469603 35.5933982120357, -82.40289759466602 35.59327721198081, -82.40284759462953 35.59346021201285, -82.40283159462076 35.59350021201935, -82.40281859460629 35.59358021203424, -82.40278959458186 35.5937072120571, -82.4027825945622 35.593827212080704, -82.40278159454053 35.59396621210889, -82.40278359453187 35.59402421212086, -82.40279359450415 35.59421521216072, -82.40279859449676 35.594268212172025, -82.40280859448242 35.59437221219417, -82.4028125944743 35.59442921220618, -82.40281759446677 35.59448321221762, -82.40282059446106 35.594523212226065, -82.40283059444455 35.594641212251105, -82.40283059444394 35.59464521225188, -82.40283659443857 35.59468621226085, -82.40283859443196 35.59473121227017, -82.40284559442014 35.59481521228799, -82.4028555944041 35.59493021231236, -82.40287859436572 35.59520321237018, -82.40288959434754 35.59533321239776, -82.40290659431996 35.59553021243946, -82.402957594237 35.59612221256504, -82.40297459420927 35.59632021260702, -82.40303859410517 35.59706321276457, -82.40322459380376 35.59921621322117, -82.40323159379288 35.59929421323766, -82.4032865937104 35.599887213363864, -82.40331659369257 35.60003521339697, -82.40318259366579 35.600065213389286, -82.4030385936367 35.600099213381384, -82.40278359358452 35.600164213368295, -82.40265159355728 35.60019921336187, -82.4026085935484 35.60021021335969, -82.4024825935223 35.60024421335355, -82.40244059351355 35.600256213351706, -82.4023505934949 35.60028021334733, -82.40208159343929 35.60035221333426, -82.40202659342775 35.60036821333187, -82.40199259342062 35.60037821333039, -82.40168659335534 35.600473213318175, -82.40160659333894 35.60049321331401, -82.40146959330936 35.60053821330908, -82.4013705932879 35.60057121330556, -82.40097159320145 35.600703213291304, -82.40026359304392 35.600965213271614, -82.39992459296793 35.60109421326292, -82.3994145928533 35.60129021325029, -82.39908359277922 35.60141521324159, -82.39809059255678 35.601792213215965, -82.39802959254294 35.60181621321457, -82.39776159248245 35.60192121320823, -82.39738959253933 35.60115421301418, -82.39715059258027 35.60063221288346, -82.39694759260577 35.60024921278478, -82.39686159261672 35.60008621274284, -82.39660359264911 35.59960021261752, -82.39651759265969 35.59943921257593, -82.39647559266511 35.599359212555434, -82.39634959268118 35.59912021249383, -82.39630859268655 35.59904121247357, -82.39623259269636 35.59889621243632, -82.39600459272546 35.59846321232483, -82.39595759273162 35.598373212301766, -82.39593659273699 35.59831621228805, -82.39569759268967 35.59836621227358, -82.39552259265226 35.5984212122667, -82.39547559264217 35.59843621226487, -82.39430859238793 35.59883221222522, -82.39403559232835 35.59892621221625, -82.39395759231203 35.598948212212676, -82.39390059230216 35.59895121220737, -82.3938745922977 35.598952212204935, -82.39385559229422 35.59895421220334, -82.39382459229016 35.59894721219873, -82.393804592289 35.5989332121939, -82.39378459228784 35.59891921218896, -82.39374559228574 35.59889121217926, -82.3937295922848 35.59888021217538, -82.39364459228426 35.59879221214873, -82.39361259228426 35.59875821213855, -82.3934115922807 35.5985662120788, -82.39338559228035 35.59854021207087, -82.3929845922756 35.59814121194858, -82.39276359227189 35.59792821188254, -82.39271959227284 35.59787521186722, -82.39264959227401 35.597792211843135, -82.39256459227592 35.59768921181345, -82.39253159228018 35.59762621179732, -82.39245859226469 35.5976482117942, -82.39224159221872 35.597713211785106, -82.39216959220325 35.597736211782305, -82.39185659213682 35.597831211769424, -82.39161559208556 35.59790521175964, -82.39111159197982 35.59805021173726, -82.39091459193985 35.59809821172676, -82.39059859187529 35.59817821171039, -82.39037459183105 35.598224211696724, -82.39021059179873 35.59825821168667, -82.38969859170118 35.59834121165083, -82.3896865916989 35.59834321165003, -82.38947159165951 35.59836821163299, -82.38925559162013 35.59839221161557, -82.38916059160252 35.59840421160825, -82.38862559150864 35.598439211560326, -82.38860859150581 35.59843921155853, -82.38839259146884 35.59844721153792, -82.38823059144117 35.59845321152251, -82.38769959135296 35.5984552114682, -82.38742059130813 35.598447211437815, -82.38450459083838 35.59836621112113, -82.38353359068192 35.59833921101567, -82.38228559048096 35.59830421088002, -82.37854258987807 35.59820021047356, -82.37756458972031 35.5981742103675, -82.37729558967688 35.598167210338346, -82.37696858962404 35.598159210303066, -82.37636158952596 35.59814421023751, -82.3758215894379 35.59813621018035, -82.37529658935038 35.59814121012723, -82.37476658926055 35.59815521007549, -82.37410558914557 35.59819221001493, -82.3734305890252 35.59824920995701, -82.37263758888038 35.598338209893505, -82.37185458873279 35.598455209836565, -82.37119658860567 35.59857420979292, -82.37054858847739 35.59871120975403, -82.36926058821902 35.59900520968112, -82.36863358809273 35.59915220964639, -82.36818558800256 35.599256209621416, -82.36684058773176 35.599570209546684, -82.36639358764162 35.59967520952193, -82.36636258764631 35.59961120950572, -82.36627058766067 35.59942020945741, -82.3662405876654 35.59935720944155, -82.36619258767341 35.59925420941573, -82.36615258768 35.599168209394136, -82.36605858769937 35.598942209338546, -82.36601558770833 35.59883820931298, -82.36589158773404 35.59853920923953, -82.3658695877395 35.59848020922524, -82.36571058777963 35.59805020912154, -82.36554558781826 35.59762320901786, -82.36546758784071 35.59739420896331, -82.36542558785273 35.59727120893406, -82.36538958787952 35.59705920888734, -82.36539858788696 35.597020208880224, -82.3654065878942 35.59698220887335, -82.36541758790273 35.59693920886575, -82.36545758791871 35.59687820885749, -82.36547958792731 35.59684620885325, -82.36549158793208 35.596828208850795, -82.36561858797064 35.59671420884072, -82.36574358800532 35.59662320883516, -82.36588858804541 35.596519208829015, -82.36614758810954 35.596381208827594, -82.36648358818682 35.5962402088336, -82.3666755882298 35.59616720883852, -82.36694658829009 35.59606720884616, -82.36699958830286 35.5960412088463, -82.3671165883311 35.59598320884658, -82.36724858836733 35.59589020884131, -82.36729158838325 35.59583320883409, -82.36732658839581 35.595789208828855, -82.36739658842681 35.5956632088104, -82.36741858845974 35.59547320877415, -82.36741758850715 35.59516520871151, -82.36746958857555 35.59477820863823, -82.36747958858778 35.59470920862526, -82.36752958863009 35.59448920858571, -82.36754958864319 35.59442520857481, -82.36763558870281 35.59413120852394, -82.36764958871214 35.59408620851619, -82.36773658875981 35.5938702084813, -82.36801558889435 35.59329720839372, -82.36804658890897 35.59323620838453, -82.36814358895826 35.59302020835059, -82.3681715889729 35.59295520834031, -82.36824858901174 35.592786208313946, -82.36825958901733 35.59276220831022, -82.36828958903214 35.59269820830025, -82.36815158901179 35.59268220828277, -82.36790958898351 35.59260620824244, -82.36749258894588 35.59240320815827, -82.36700158889609 35.5922002080665, -82.36696058889196 35.59218320805879, -82.36665758887659 35.59195820798195, -82.36634058889882 35.59147420785095, -82.36615958893252 35.59106220774866, -82.36611858895196 35.59089220770994, -82.36584958901433 35.59020020754171, -82.3658085890432 35.589969207490626, -82.36582858908729 35.589705207439046, -82.36613058925431 35.588946207315956, -82.36629158934109 35.588556207253404, -82.3663135893526 35.58850520724529, -82.36652058945856 35.58804020717217, -82.36672858954051 35.587732207131005, -82.36686558963848 35.58724420704607)))",6491,37,021,003002,370210030023,859,859,19,844,756,58,9,9,0,12,15,715,13,702,708,637,52,5,6,0,8,7,409,360,49
census_2010_blockgroups_view.fid--2dc29038_13ec899ba8f_-25fc,"MULTIPOLYGON (((-82.52500563664914 35.45155419570953, -82.52514263668412 35.451474195707256, -82.52531663672588 35.451389195707854, -82.52555663678343 35.45127319570879, -82.52573863682532 35.45119619571171, -82.52580863678817 35.45151519578381, -82.52583863676844 35.451676195819665, -82.52588463674289 35.45189319586851, -82.52593963671258 35.45215119592655, -82.52607563665185 35.45269519605111, -82.52646163653087 35.4539041963365, -82.52647563652695 35.453945196346346, -82.52661063649158 35.45432219643677, -82.52672163647335 35.45456119649678, -82.52674663647099 35.45460419650812, -82.52681463646464 35.45471919653848, -82.52684063646316 35.454757196548876, -82.52693663645762 35.454897196587154, -82.52716263645218 35.455177196667265, -82.52717063645198 35.45518719667008, -82.5272886364505 35.45532519671021, -82.52743463644865 35.45549519675976, -82.5276066364465 35.45569519681805, -82.52787863644458 35.45600219690837, -82.52802863644374 35.45617019695786, -82.52834863644071 35.456536197065084, -82.5285286364395 35.45673919712479, -82.52897163643655 35.45723819727169, -82.52918663643784 35.457462197339254, -82.52932163644145 35.45758519737817, -82.529566636452 35.45778119744303, -82.53022063648952 35.458244197604174, -82.53035463649724 35.45833919763731, -82.53083663652359 35.4586881977576, -82.53093963652834 35.458769197784626, -82.53117063653858 35.4589521978455, -82.53124563654043 35.4590211978673, -82.53131063654217 35.459080197885925, -82.53134163654225 35.45911319789577, -82.53139563654264 35.459169197912715, -82.531444636543 35.45922019792813, -82.53154763654011 35.45935019796513, -82.53155863653987 35.45936419796907, -82.53159263653754 35.45941619798313, -82.5316486365338 35.459501198006116, -82.53169363653096 35.45956819802438, -82.5318086365198 35.45976519807624, -82.53182263651854 35.459789198082504, -82.53185863651437 35.45985519809964, -82.53189163651065 35.459915198115304, -82.53198663649978 35.46008919816033, -82.53199063649907 35.46009819816256, -82.5320186364939 35.460162198178494, -82.53197563648159 35.46019619818097, -82.53184763644465 35.46029919818882, -82.53180563643224 35.460334198191646, -82.53183763643005 35.46038319820485, -82.53187663641744 35.4605081982343, -82.53200963639878 35.46077419830203, -82.53205963639778 35.46083419831932, -82.53211663639459 35.46091719834205, -82.53216663639203 35.460988198361676, -82.5322316363864 35.461095198390055, -82.5323476363871 35.46121619842653, -82.53254163638485 35.461441198492146, -82.53265463638716 35.46154819852555, -82.53276263639103 35.46164019855533, -82.53287063639593 35.46172519858366, -82.53295263639417 35.461825198612416, -82.53297563639278 35.461859198621674, -82.53303063638897 35.461943198644406, -82.53317763637118 35.462219198715566, -82.53321263636148 35.46232019873966, -82.53323463634759 35.462435198765355, -82.53324163633665 35.4625141987822, -82.5332446363337 35.462536198786935, -82.53326663632211 35.46263619880948, -82.53331863630106 35.46283019885431, -82.53336563627407 35.463057198905304, -82.53334663625435 35.46316519892528, -82.53337463623542 35.46331919895947, -82.53342263620411 35.46357619901669, -82.53380263613418 35.464444199232126, -82.53408163607472 35.46513519940123, -82.5340876360736 35.46514919940476, -82.53462363599431 35.466247199682996, -82.53529263596677 35.46715119993537, -82.53566163593405 35.46776420009792, -82.53606463592543 35.46825720023944, -82.53606163590185 35.46840820026985, -82.5360576358691 35.46861720031196, -82.53626163587124 35.46882420037499, -82.53642063580084 35.46945620051981, -82.53683663576582 35.47013520070054, -82.53701263571992 35.47062620081844, -82.53709163569944 35.470845200871025, -82.53728563560976 35.47164120105292, -82.53732063560376 35.471718201072164, -82.53752063556878 35.47216320118313, -82.53772063553377 35.47260820129417, -82.53774663552994 35.472661201307616, -82.53781663552044 35.472799201342845, -82.53782763551892 35.47282120134841, -82.5378546355151 35.47287520136221, -82.53812763554656 35.47296520140843, -82.53894663564049 35.47323820154796, -82.5392206356719 35.47332920159452, -82.53915263525926 35.47595120212088, -82.5380746350452 35.476182202057466, -82.53719663487051 35.47637320200635, -82.53499163446672 35.47662420183153, -82.53307663416223 35.47654020161822, -82.5321756340205 35.47649120151585, -82.53153263395282 35.476237201398376, -82.53090163390466 35.47586920125885, -82.53062963388743 35.47568720119402, -82.53052063387952 35.475621201169375, -82.53047463391216 35.475358201111156, -82.52966563376579 35.47543820104451, -82.52950563373707 35.475453201031215, -82.52833863353901 35.47548420091798, -82.52772063346751 35.47528220081356, -82.52715563342822 35.474927200683446, -82.52641563341548 35.47421020046176, -82.52572163337358 35.47373320029362, -82.52434263330329 35.47270019994225, -82.52431163330195 35.47267519993399, -82.52383163321164 35.47274619989926, -82.52270563299896 35.472916199818464, -82.52243563295062 35.47294019979565, -82.52239163294249 35.47294519979217, -82.52214263289596 35.47298019977378, -82.52191263285239 35.47301619975756, -82.52175763282689 35.47301519974145, -82.52167463280897 35.47304219973841, -82.52161663279647 35.47306119973641, -82.52147963276431 35.47312219973477, -82.52135763273128 35.4732061997393, -82.5212736327069 35.47327519974472, -82.5210906326433 35.47349219977007, -82.52097063260632 35.473604199780574, -82.52073463253843 35.473792199794616, -82.52064763251317 35.4738631998002, -82.5205866324961 35.47390819980304, -82.52033563242986 35.47406919981006, -82.5202286323988 35.47415619981676, -82.52002963233492 35.47435819983751, -82.51996863231663 35.47441219984225, -82.51987163229592 35.474442199838364, -82.51963363234483 35.473865199696604, -82.51961363234821 35.473821199685645, -82.51933663239976 35.47318519952795, -82.51900763246262 35.472419199338425, -82.51881363249895 35.471972199227665, -82.51854663254898 35.47135619907502, -82.51828763259739 35.47076019892727, -82.51751063274246 35.46897219848409, -82.51725263279097 35.46837619833636, -82.51681163286051 35.467445198101814, -82.51667563288217 35.46715619802918, -82.51650863289893 35.466866197953095, -82.5162456329175 35.46646019784357, -82.51521363300029 35.464803197400926, -82.51518463300266 35.46475619738831, -82.51482163302946 35.46418819723568, -82.51466063304156 35.463935197167736, -82.514391633063 35.463504197052536, -82.51422363307836 35.46322219697797, -82.51399763309115 35.46289419688807, -82.513798633098 35.46263419681484, -82.51357463309701 35.46239819674387, -82.51346663309442 35.46229819671246, -82.5130946330857 35.46195219660401, -82.51306663308588 35.461921196594844, -82.51298363308605 35.46183019656779, -82.51295663308616 35.461800196559025, -82.51288063308418 35.46173119653716, -82.51265563307831 35.4615261964724, -82.51258163307646 35.461458196451, -82.51238463306876 35.461295196397636, -82.51236863306822 35.4612811963932, -82.51203563305984 35.46097619629704, -82.5118306330577 35.460768196233744, -82.51165163305575 35.460587196178615, -82.51165263305813 35.46057319617586, -82.51165863306232 35.46055219617218, -82.5116896330827 35.46045219615506, -82.51170063308962 35.4604191961495, -82.5117466331201 35.46026919612367, -82.51176763313377 35.46020319611239, -82.51190663318104 35.46004419609435, -82.51203163322384 35.459900196077804, -82.5121076332496 35.459814196068145, -82.51213263325879 35.459781196064, -82.51215063326295 35.459773196064226, -82.51220563327512 35.45975319606577, -82.51222463327922 35.459747196066466, -82.51231363329889 35.45971519606913, -82.51249263333706 35.45965919607608, -82.51270763338198 35.45959819608568, -82.51281463340416 35.45956919609072, -82.51329163350161 35.459448196115034, -82.51371963359054 35.45933019613484, -82.51404563365527 35.45926019615407, -82.51417963368117 35.459236196162905, -82.51431863370769 35.45921319617241, -82.51452463374649 35.459182196187214, -82.51468063377489 35.45916519619972, -82.51479363379553 35.45915319620889, -82.51488563381194 35.45914519621666, -82.5149436338223 35.45914019622161, -82.51510463385101 35.4591271962355, -82.51550263392114 35.45909919627052, -82.51557963393464 35.459094196277384, -82.51570863395713 35.45908719628916, -82.5158066339742 35.459081196297994, -82.51609363402396 35.45906719632463, -82.5162756340554 35.459058196341346, -82.51651963409908 35.45903719636209, -82.51680663415134 35.45900619638519, -82.5170396341962 35.45896519640076, -82.51724063423681 35.45891719641157, -82.5172486342383 35.45891619641218, -82.5174596342822 35.45885719642181, -82.51761163431459 35.458810196427834, -82.5178786343728 35.458719196436704, -82.5179096343798 35.45870719643743, -82.51814263443106 35.45862419644443, -82.51834563447811 35.45853619644728, -82.51850163451623 35.45845619644704, -82.51867563456166 35.458347196442695, -82.51875463458377 35.45828819643883, -82.51884763460939 35.458221196434636, -82.51900363465467 35.45809419642478, -82.51920263471538 35.45791319640843, -82.51928663474274 35.45782519639907, -82.51931463475194 35.45779519639584, -82.51934963476315 35.457760196392314, -82.51958863484434 35.45748819636154, -82.51968563487699 35.45737919634928, -82.5200416350022 35.45694619629771, -82.52015663504207 35.456810196281836, -82.52023163506779 35.45672319627177, -82.52043263513865 35.4564781962425, -82.52110763537371 35.455672196147745, -82.52193563566185 35.45468519603188, -82.52263163590634 35.453840195931264, -82.52281263597105 35.453613195903635, -82.52311263607808 35.45323819585815, -82.52329563614323 35.45301019583053, -82.52348163620793 35.45278919580457, -82.52363663626043 35.45261319578471, -82.52380263631352 35.45244619576772, -82.52387863633776 35.45237019576007, -82.52407963639777 35.45219519574501, -82.52414963641792 35.4521391957408, -82.52430463646236 35.45201619573166, -82.5245436365282 35.451845195721354, -82.52481763660104 35.451665195712806, -82.52500563664914 35.45155419570953)))",6403,37,021,002203,370210022031,1686,1686,615,1615,1073,319,11,11,3,198,71,1179,343,836,1160,790,242,6,9,1,112,19,720,659,61
census_2010_blockgroups_view.fid--2dc29038_13ec899ba8f_-25fb,"MULTIPOLYGON (((-82.63281862943595 35.61516324006927, -82.63273762945576 35.614947240017, -82.63269262946703 35.61482523998748, -82.6325616295 35.61446923990149, -82.63251562951828 35.61430123986255, -82.63249762953483 35.61417423983481, -82.63249862955868 35.61402023980353, -82.63251262958444 35.61386823977404, -82.63251662959931 35.61377623975569, -82.63252262962015 35.613647239730064, -82.63254262965891 35.61341723968516, -82.63278362968931 35.61348023972275, -82.63281062969271 35.613487239726986, -82.63302062972018 35.61353523975832, -82.63333562976136 35.613608239805565, -82.63351462978554 35.61364423983126, -82.6335786297943 35.61365723984046, -82.63376162982027 35.61368623986518, -82.63383962983124 35.61369923987583, -82.63392662984384 35.61371123988721, -82.63409862986859 35.61373623990997, -82.63433862990428 35.61376423994033, -82.63442662991766 35.61377223995095, -82.63459362994284 35.6137892399716, -82.63461062994524 35.61379123997372, -82.63467062995466 35.61379523998068, -82.63485562998324 35.61380924000258, -82.63487862998709 35.61380924000495, -82.63490162999092 35.61380924000731, -82.6349796300033 35.61381324001606, -82.63511663002515 35.61381924003137, -82.6351346300282 35.61381924003322, -82.63542863007648 35.61382324006421, -82.63559963010518 35.61382124008144, -82.63575563013131 35.61382024009721, -82.63584063014609 35.613816240105095, -82.6359666301677 35.61381224011723, -82.63609863019086 35.61380424012912, -82.63618463020596 35.61379924013697, -82.6365126302651 35.613769240164544, -82.63661763028449 35.61375724017287, -82.63676863031203 35.6137412401851, -82.63714463038323 35.6136852402122, -82.6374786304497 35.613614240232046, -82.63775163050573 35.61354524024604, -82.6378976305365 35.61350324025251, -82.63819663059898 35.613420240266265, -82.63831663062483 35.613382240270866, -82.63864563069552 35.61327824028347, -82.63963263090766 35.612967240321396, -82.63969063092006 35.61294924032361, -82.63996363097793 35.61286824033517, -82.64012463101172 35.61282324034254, -82.64042263107378 35.61274224035662, -82.64060963111145 35.61269924036707, -82.64077363114426 35.612663240376584, -82.64094563117847 35.61262724038687, -82.64095063117931 35.6126272403874, -82.64136463125833 35.61256124041641, -82.64146963127808 35.61254624042417, -82.64162163130645 35.61252624043564, -82.64164463131053 35.61252424043768, -82.64177963133507 35.612511240448804, -82.6418686313511 35.61250324045631, -82.6421636314029 35.61248524048298, -82.64218563140682 35.61248424048503, -82.64232163143016 35.61247924049801, -82.64233863143316 35.61247824049949, -82.6424466314517 35.6124742405098, -82.64271263149628 35.61247224053665, -82.64303163154813 35.61248024057106, -82.64310763156011 35.612484240579676, -82.64331963159356 35.61249624060382, -82.64357263163204 35.612520240634716, -82.6438256316696 35.6125492406666, -82.64405463170249 35.61258324069701, -82.64454963176857 35.612689240769406, -82.64481063180024 35.61276524081172, -82.64505463182748 35.61285224085446, -82.64530463185325 35.61295524090113, -82.6453966318619 35.612998240919374, -82.64565163188556 35.61312024097037, -82.64592463190662 35.61327824103063, -82.64608163191647 35.613384241068296, -82.64617763192244 35.61344924109145, -82.64652063193996 35.61370624117902, -82.6470876319672 35.61414224132605, -82.64757263199031 35.61451624145209, -82.64923363205864 35.61586824189809, -82.64983663208571 35.61634424205697, -82.6500416320955 35.61650224211021, -82.65081063213199 35.61709624231022, -82.65102963213941 35.6172852423712, -82.65092863210775 35.61738124238045, -82.65087163208779 35.617449242388396, -82.6506596320028 35.61777224243245, -82.65050463194257 35.61799624246225, -82.65033763187859 35.61823124249293, -82.6501326317963 35.6185442425357, -82.65007463177103 35.61864524255036, -82.6500316317494 35.61873924256509, -82.65002363174459 35.61876224256903, -82.65000663173275 35.61882024257899, -82.64996563170043 35.61898624260866, -82.64995863168804 35.619059242622846, -82.64995563165839 35.61924824266106, -82.64996163162013 35.61950324271364, -82.64995863160419 35.619603242733675, -82.64995063159215 35.61967324274712, -82.64992363157715 35.61974124275827, -82.64988063156201 35.619793242764395, -82.64981963154803 35.61981824276323, -82.6497536315349 35.61983224275931, -82.64969563152552 35.619830242753, -82.64960963151312 35.61981724274149, -82.64908963144549 35.619695242663234, -82.64863263138096 35.619620242600995, -82.64813363130578 35.619569242539455, -82.64764863123146 35.61952724248108, -82.6473496311865 35.61949624244404, -82.64691263111769 35.619471242394134, -82.64672363108475 35.619480242376504, -82.64632763101046 35.61953524234704, -82.64561063087 35.61967224230145, -82.64558763086542 35.61967724230004, -82.64541663083048 35.61971924229106, -82.6451536307752 35.619794242279376, -82.64506763075585 35.6198272422772, -82.64480363069478 35.61993824227272, -82.64458863064188 35.62004924227337, -82.64440863059544 35.62015624227658, -82.64414563052642 35.62032024228303, -82.64405963050208 35.6203852422874, -82.64400563048574 35.6204332422917, -82.64374963039502 35.620746242329155, -82.64362963033682 35.620994242367445, -82.6435566302997 35.621156242392914, -82.64350763027419 35.621269242410925, -82.64336363020568 35.62155824245505, -82.64325763016171 35.62172924247904, -82.64311663011306 35.62189224249775, -82.64294263005509 35.622081242518426, -82.64268862997245 35.622343242545746, -82.64247362989587 35.62260824257763, -82.64229262982528 35.62287124261269, -82.64221562978423 35.623054242642006, -82.64215962974261 35.62326424267911, -82.6421576297404 35.62327624268127, -82.64212662969862 35.62351424272666, -82.64207062964338 35.62381224278166, -82.64203262961891 35.623930242801755, -82.64200062960428 35.62399024281072, -82.64193162957707 35.62409224282442, -82.64191362956994 35.62411924282805, -82.64183262954283 35.62420824283788, -82.64167562949773 35.624331242846786, -82.64156862947019 35.62439424284871, -82.64146362944331 35.6244552428503, -82.64074162925769 35.62488024286276, -82.64047262919144 35.6250202428637, -82.64026962914669 35.62509124285731, -82.64008662911027 35.625130242846474, -82.63983562906664 35.625142242823124, -82.6396156290282 35.62515424280306, -82.63923862896497 35.62515724276489, -82.63851062884429 35.62515424268955, -82.6381636287916 35.62512124264717, -82.63810162878389 35.62510424263734, -82.63787762875602 35.62504324260191, -82.63758762872554 35.624928242548705, -82.6374356287127 35.624847242516594, -82.63729062870073 35.62476824248559, -82.63698562867984 35.62457424241475, -82.63664362865366 35.62437524233914, -82.63642062863289 35.624269242294616, -82.63620062860855 35.624189242255724, -82.6358586285594 35.62413924221044, -82.63549562849914 35.62413824217298, -82.6351886284453 35.624156242145034, -82.63507062842254 35.624176242137, -82.63502262840998 35.624206242138165, -82.63496162839255 35.62425324214153, -82.6349446283861 35.62427724214472, -82.63491662837463 35.624321242150764, -82.63489062834842 35.624463242177, -82.634834628257 35.62499624227989, -82.63480962823128 35.62513624230584, -82.63472662819247 35.62529824233036, -82.63467362817363 35.62536324233817, -82.63464262818133 35.62528024231806, -82.63458962818727 35.62518424229305, -82.63455662818963 35.62513324227923, -82.63447862819511 35.62501324224681, -82.634307628205 35.624764242178536, -82.63412762821744 35.62448924210398, -82.6340996282194 35.62444624209228, -82.63399162822856 35.62427024204536, -82.63386462824099 35.62405224198796, -82.63382662824472 35.62398724197078, -82.63372062825773 35.62378824191935, -82.63355862827612 35.623494241842764, -82.63349462828114 35.62339224181552, -82.63341462828757 35.62326424178112, -82.63335462828985 35.62318424175867, -82.63303162830405 35.62274324163566, -82.63288762833773 35.62236924154467, -82.63287862837983 35.62208624148608, -82.63283462860402 35.620583241175325, -82.63282362868007 35.620077241071066, -82.63280262886566 35.618849240818676, -82.63278862890907 35.61855224075679, -82.63276762892482 35.61842724072912, -82.63275962892783 35.618399240722624, -82.63272062894248 35.61826224069072, -82.63268562895064 35.618171240668524, -82.63262262895803 35.61805524063842, -82.63256762896378 35.61795824061303, -82.63250462897076 35.6178452405835, -82.63244462897481 35.617754240558845, -82.63235462898811 35.617570240512116, -82.63232762900077 35.6174592404867, -82.6323236290133 35.61737324046879, -82.63233062902505 35.61730424045543, -82.63233862903135 35.617272240449715, -82.63235262904278 35.61721324043918, -82.63238062906086 35.61712624042429, -82.63241662907946 35.617044240411325, -82.6324766291037 35.61695124039855, -82.63248162910568 35.61694424039759, -82.63266962917822 35.61667624036227, -82.63280862923305 35.616470240334614, -82.63287962926454 35.61634224031579, -82.63293462929192 35.616224240297434, -82.63296562931214 35.61612624028061, -82.63298562932935 35.61603624026435, -82.63299262933452 35.616010240259754, -82.63300762935715 35.615879240234634, -82.63300562937391 35.61576824021182, -82.63298862938343 35.615688240193705, -82.63296062939527 35.61558124016903, -82.63294662940125 35.61552724015661, -82.63287762942049 35.61532724010876, -82.63285562942629 35.61526624009408, -82.63283462943231 35.61520424007928, -82.63281862943595 35.61516324006927)))",5922,37,021,002606,370210026064,774,774,134,771,660,32,1,5,5,68,3,584,77,507,583,522,16,1,2,4,38,1,304,285,19
census_2010_blockgroups_view.fid--2dc29038_13ec899ba8f_-25fa,"MULTIPOLYGON (((-82.33345457943754 35.61753920975511, -82.33346657941884 35.617673209783526, -82.33345657932624 35.61826120990188, -82.33344857926889 35.61862420997475, -82.3334375792315 35.6188542100203, -82.33343757918419 35.619160210082434, -82.33343857916752 35.61926921010467, -82.3334415791394 35.61945421014261, -82.3334395791171 35.61959621017117, -82.33343957910007 35.61970621019345, -82.33343957906791 35.61991421023569, -82.33343957901944 35.62022721029922, -82.33343157896961 35.62054121036212, -82.33342957895229 35.620651210384274, -82.33341257893436 35.62074921040247, -82.33340357892389 35.620807210413254, -82.33337657889267 35.62098021044563, -82.33336857888214 35.62103921045677, -82.33335657886784 35.62111921047177, -82.33335257878859 35.621627210574516, -82.33335257877549 35.62171221059173, -82.33334157873848 35.62194021063689, -82.33333857871057 35.62211721067254, -82.33334357867918 35.62232521071525, -82.33334157866415 35.622420210734404, -82.33332457863293 35.62260421076996, -82.33331157856905 35.62300321084962, -82.33332557853552 35.623235210898144, -82.3333445785143 35.62339221093194, -82.33335757850038 35.62349621095443, -82.33340357846684 35.62376221101319, -82.33343057843831 35.62397521105922, -82.33335157842659 35.62396721104945, -82.33328557841708 35.62395821104081, -82.33303257838004 35.62392721100846, -82.33288757836183 35.62389021098596, -82.33285657835826 35.623880210980744, -82.33271757834177 35.6238382109579, -82.3326025783279 35.62380521093932, -82.33227457828771 35.62371421088701, -82.33225857828556 35.62371121088484, -82.33214157826953 35.62369021086844, -82.33224957826616 35.623827210907365, -82.33227957826493 35.6238672109186, -82.33238057826053 35.624003210956715, -82.33264957824518 35.624390211063016, -82.33266757824366 35.624419211070645, -82.33278557823353 35.62461121112186, -82.33280457823173 35.624642211130116, -82.33286257822682 35.62473621115509, -82.3328825782252 35.62476821116374, -82.33291457821922 35.62484121118179, -82.33293257821039 35.624917211199076, -82.33294757819539 35.6250302112236, -82.33295757818591 35.62510221123921, -82.33295657815697 35.62528821127686, -82.332928578066 35.62584621138732, -82.33292057803939 35.62601021141977, -82.33291057802101 35.62611821144065, -82.33290357800858 35.62619121145472, -82.33289257798678 35.626320211479836, -82.33288657797164 35.62641221149793, -82.33288357795966 35.62648621151255, -82.33288357794164 35.626602211536145, -82.33287957793358 35.626650211545446, -82.33287457793269 35.6266512115451, -82.33286057790166 35.626836211581235, -82.33282357781249 35.62737321168645, -82.33282257780952 35.62739121168999, -82.33281957778028 35.62757721172745, -82.33280757771192 35.62800621181335, -82.3328065777005 35.62807921182808, -82.33278657765231 35.62836921188487, -82.3327695776014 35.62868021194629, -82.33275057750325 35.629294212068906, -82.33273757743456 35.629724212154855, -82.33255157741334 35.62966321212338, -82.33246557740377 35.629633212108395, -82.33170657731951 35.62936721197611, -82.33165657731413 35.62934821196709, -82.33138957728538 35.629249211919465, -82.33127557727283 35.629208211899325, -82.33093357723537 35.629085211839175, -82.33082057722284 35.62904521181935, -82.33073657721361 35.62901521180459, -82.33048657718626 35.62892521176055, -82.33040357717704 35.62889621174615, -82.33027957716365 35.62885021172401, -82.3299085771232 35.62871521165834, -82.32990657712303 35.62871421165798, -82.32978457710911 35.62867421163726, -82.32974457710455 35.628661211630536, -82.32962257708776 35.628639211613425, -82.32957757708142 35.62863221160735, -82.32943357705685 35.62863721159354, -82.32932257703597 35.6286532115853, -82.32922657701691 35.62867421157967, -82.3291355769978 35.62870021157562, -82.3289775769646 35.628746211568625, -82.328893576947 35.6287702115648, -82.32878857692599 35.62879421155883, -82.32864457690168 35.6287972115446, -82.32854857688703 35.62878921153308, -82.32843257687198 35.62876321151588, -82.32825957685137 35.628711211487484, -82.32793057681513 35.62859421142985, -82.32783457680671 35.62854621141016, -82.3278325768067 35.62854421140957, -82.3278075768046 35.62853121140431, -82.32772857680133 35.628467211383196, -82.32771957680099 35.628460211380876, -82.32752857680406 35.628236211315624, -82.32746957680311 35.62817921129804, -82.3274195768025 35.628130211282894, -82.32737257680016 35.62809521127097, -82.3272985767965 35.62803921125194, -82.32727057679514 35.62801821124485, -82.3271655767884 35.627949211219985, -82.32706757678069 35.62789521119892, -82.32706257678034 35.6278922111978, -82.32697957677277 35.627852211181136, -82.32681957675854 35.62777321114856, -82.3267995767565 35.627765211144855, -82.32654757672908 35.627673211100216, -82.32649557672168 35.62766521109322, -82.32627657669087 35.62763121106377, -82.32621957668137 35.627631211057874, -82.32608357665883 35.62763221104402, -82.3260205766477 35.62763621103833, -82.3257695766037 35.62765321101591, -82.3256585765841 35.627661211006135, -82.32545957654882 35.62767621098867, -82.32516557649701 35.62769721096255, -82.32508357648321 35.62769921095453, -82.32501857647203 35.627702210948414, -82.32486557644583 35.62770821093387, -82.32476857643039 35.62770421092303, -82.32468357641702 35.62770021091348, -82.32445357638318 35.627673210884325, -82.32419357634805 35.627622210847136, -82.32399257632294 35.62757021081586, -82.32398857632238 35.62756921081521, -82.32374157629609 35.627475210770626, -82.3235255762773 35.627366210726265, -82.32336157626445 35.62727421069063, -82.3231945762542 35.62716221065073, -82.32303257624541 35.62704621061047, -82.32266957622774 35.62677221051741, -82.32211757620233 35.626347210374185, -82.32202457619759 35.6262782103506, -82.32139357616643 35.62580621018974, -82.32138457616604 35.625799210187424, -82.321359576165 35.625779210180774, -82.32135157616464 35.62577321017877, -82.32128957617708 35.62562621014252, -82.32110557621495 35.62518521003401, -82.32104457622762 35.62503820999788, -82.32103557622933 35.62501720999268, -82.32101157623482 35.62495620997788, -82.32100357623656 35.624936209972915, -82.32095157624849 35.62480320994057, -82.32094057625127 35.624774209933534, -82.32088257627046 35.62458820988979, -82.32084457629301 35.62440120984791, -82.32084357629458 35.624390209845586, -82.32083557631528 35.624248209815924, -82.32082457631363 35.6242472098146, -82.32083157634708 35.62403820977287, -82.32083257636218 35.623941209753326, -82.32083357636583 35.623919209748934, -82.32085757641094 35.62365320969746, -82.32086757642723 35.6235582096792, -82.3208735764421 35.62346920966177, -82.32088257645974 35.62336420964132, -82.32090257648787 35.623204209610975, -82.32091457650344 35.6231162095943, -82.32092657652042 35.62301920957584, -82.32096657655408 35.62284420954453, -82.321035576595 35.622653209512784, -82.32106457660974 35.62258920950285, -82.32121857668817 35.62224620944906, -82.32129957672907 35.62206820942127, -82.32154657685219 35.62153620933878, -82.32162957689324 35.62135920931145, -82.32166257691107 35.62127920929864, -82.32175457695895 35.62106820926524, -82.32176657696476 35.6210432092614, -82.32180657698315 35.62096720925007, -82.32189357699606 35.620976209260846, -82.32206157702355 35.62097820927863, -82.3223315770657 35.62099420930973, -82.32256557710528 35.62098820933256, -82.32341757724306 35.621007209424334, -82.32368757728766 35.621007209452124, -82.32368457727033 35.62111620947401, -82.32367857722656 35.62139320952958, -82.32368257721947 35.62144320954019, -82.32368557721512 35.6214742095467, -82.3237055772152 35.621495209553096, -82.32375057721951 35.62151520956181, -82.3238515772347 35.621525209574166, -82.32387157723763 35.62152720957665, -82.3240905772738 35.62152720959922, -82.32415857728522 35.621526209606024, -82.32426157730224 35.62152620961669, -82.32466157736799 35.62152820965831, -82.32486957740056 35.621540209682195, -82.32507857743303 35.621553209706434, -82.32533857747433 35.62156420973547, -82.3256225775211 35.62156420976468, -82.32669357769366 35.62159320988099, -82.32675557770355 35.62159520988781, -82.32700857774383 35.621605209915934, -82.32730257779377 35.62159620994449, -82.3273165778473 35.62126520987872, -82.32733257790434 35.620913209808926, -82.32736257799006 35.62039120970603, -82.32736657800898 35.62027320968243, -82.32738057806237 35.61994320961693, -82.32748657807925 35.619947209628684, -82.32760357809765 35.6199532096419, -82.32769157811123 35.619959209652244, -82.32789757814002 35.61999320968041, -82.32796957814666 35.62002720969471, -82.32806357815333 35.62008420971591, -82.32816357815858 35.62015720974111, -82.32820957816003 35.620197209754, -82.3282755781621 35.62025420977231, -82.32838357816698 35.62033820980047, -82.32848657817156 35.6204182098274, -82.32855457817543 35.62046620984415, -82.32873057818534 35.62059020988741, -82.32893157819568 35.62073820993818, -82.3290825782059 35.620833209973064, -82.32925757821779 35.620943210013436, -82.32926557821843 35.6209472100151, -82.3293545782267 35.620989210032754, -82.32935957822724 35.62099121003373, -82.32946357823775 35.621034210053146, -82.32965757826192 35.62108521008348, -82.3297595782746 35.62111221009948, -82.32983457828388 35.621132210111256, -82.32991057829524 35.6211402101207, -82.32994557830028 35.62114521012534, -82.33003457831519 35.621143210134164, -82.33012757833384 35.62112221013947, -82.33029157836901 35.62107021014584, -82.33035757838392 35.621044210147346, -82.33042557839904 35.62101921014925, -82.3304975784171 35.620979210148576, -82.33068557835912 35.62155521028484, -82.33070357836003 35.6215682102894, -82.33071457838061 35.62144721026599, -82.33073757842087 35.62121121022041, -82.33073057843117 35.62113721020471, -82.33071357843579 35.621089210193205, -82.33067357844 35.621019210174865, -82.33064557843986 35.6209902101661, -82.33073657846504 35.62092421016208, -82.33075157849956 35.62071721012163, -82.33076457852809 35.620546210088186, -82.33075457863377 35.619852209946266, -82.33074957864741 35.619759209926954, -82.33073857868558 35.61950020987316, -82.33073257869381 35.61944120986058, -82.33094657872822 35.61944720988382, -82.3310455787439 35.61945120989495, -82.33130457878347 35.61947220992587, -82.33158757882786 35.61948720995806, -82.33172057884879 35.619494209973226, -82.33180257886302 35.61949020998086, -82.33185457887262 35.61948320998481, -82.33201557889946 35.619482210001195, -82.33210157891365 35.61948221001004, -82.33236757895587 35.619493210039714, -82.33265757900331 35.619496210070224, -82.33287157903817 35.619499210092854, -82.33288857911104 35.61904621000268, -82.3328935791304 35.61892620997882, -82.33290757922163 35.61835120986356, -82.33293657932458 35.61771620973762, -82.33293657932914 35.61768720973178, -82.33295057940138 35.617234209641225, -82.33295157940164 35.617234209641325, -82.33301757941545 35.617215209644286, -82.3332545794415 35.61730020968593, -82.3333525794475 35.617366209709516, -82.33342557944715 35.617446209733195, -82.33345457943754 35.61753920975511)))",6279,37,021,003104,370210031045,892,892,11,881,857,15,0,3,0,6,11,736,10,726,728,709,12,0,3,0,4,8,520,446,74
census_2010_blockgroups_view.fid--2dc29038_13ec899ba8f_-25f9,"MULTIPOLYGON (((-82.68050763190173 35.650691252207494, -82.68063263191087 35.65076725223586, -82.6806576319127 35.6507822522414, -82.68097663194058 35.650946252307676, -82.68102563194564 35.65096625231675, -82.68116263195986 35.65102225234226, -82.6812356319676 35.65105125235566, -82.68130763197499 35.651081252369174, -82.68145863199179 35.65113525239565, -82.68153363200014 35.651162252408874, -82.68159263200671 35.651183252419166, -82.68168363201804 35.65120825243362, -82.68192863204833 35.65127625247267, -82.68214163207683 35.651321252503756, -82.68229563209744 35.65135425252622, -82.68254063213041 35.65140525256179, -82.68327863222945 35.6515602526692, -82.68352463226242 35.65161225270506, -82.68377863229672 35.651664252741774, -82.68386563230894 35.651679252753745, -82.68415063234863 35.65173025279344, -82.6846246324181 35.651791252854565, -82.68490163246075 35.651814252887654, -82.68500763247688 35.65182425290058, -82.68525063251677 35.651828252926336, -82.68546063255128 35.651831252948526, -82.68546363255163 35.65183225294908, -82.68562163257872 35.65182725296424, -82.685878632623 35.65181825298881, -82.68608963266132 35.651797253006215, -82.68629963269946 35.65177725302371, -82.68651163273809 35.651755253040925, -82.6865536327464 35.65174725304361, -82.6870456328419 35.6516592530762, -82.68730863289417 35.65160425309198, -82.68755963294396 35.65155325310737, -82.68768163296855 35.65152525311421, -82.68768663296935 35.651525253114706, -82.68805063304265 35.65144325313534, -82.6881736330674 35.651416253142585, -82.68837563310684 35.65137825315549, -82.68861563315352 35.651335253171304, -82.68898663321974 35.6513062532036, -82.6891086332415 35.65129725321421, -82.68919163325405 35.651305253224386, -82.68956963331141 35.651342253270776, -82.68963863332024 35.6513592532813, -82.68994163335873 35.65143725332833, -82.69027763339126 35.65158925339377, -82.69059663341471 35.65178225346596, -82.69083763342681 35.651964253527794, -82.6909586334328 35.65205625355895, -82.69119263344267 35.65224525362155, -82.6912076334433 35.65225725362549, -82.69125563344542 35.652295253638215, -82.69127163344608 35.652308253642474, -82.69128763344676 35.652321253646754, -82.69133563344872 35.65236025365963, -82.69135263344941 35.65237425366426, -82.69190463347347 35.652815253810864, -82.69282863351374 35.65355225405606, -82.69299163352179 35.65367725409832, -82.69323263353601 35.653845254157275, -82.69422163361222 35.65442025437609, -82.69437663362689 35.654492254406705, -82.69484463367117 35.654711254499425, -82.69500063368594 35.654784254530306, -82.6957426337565 35.655128254676626, -82.6960096337818 35.65525325472961, -82.69712063388586 35.655779254950886, -82.69753663392746 35.65595925503029, -82.69777963395521 35.65604225507221, -82.69780463395725 35.65605625507767, -82.69799263398217 35.656097255105394, -82.69807363399278 35.656116255117475, -82.69838163403713 35.65616125515828, -82.69860763407299 35.656173255183916, -82.69880563410527 35.656178255205305, -82.69883663411042 35.65617825520845, -82.6988756341166 35.65618025521289, -82.69892963412586 35.656178255218, -82.69896163413124 35.65617825522132, -82.69917963416839 35.656173255242635, -82.69923363417739 35.656173255248206, -82.69966563424873 35.656177255293414, -82.69983463427523 35.65618825531298, -82.699948634293 35.656196255326336, -82.70005263430805 35.656211255340054, -82.70007663431154 35.65621425534313, -82.70015163432252 35.656224255352875, -82.70017663432604 35.656228255356204, -82.70034563434963 35.6562582553797, -82.70047263436612 35.65628825539888, -82.70059763438243 35.656318255417816, -82.70086863441432 35.65640425546324, -82.70116963444485 35.65653125552006, -82.70132263445929 35.65660325555038, -82.70159763448515 35.65673325560517, -82.7016036344757 35.6568012556197, -82.70167163442711 35.657189255705795, -82.70170463439202 35.65745325576298, -82.70172363436073 35.65767625581041, -82.70173363433493 35.657854255847795, -82.70171363431791 35.65794325586383, -82.7016696342958 35.65803925587889, -82.70126063411841 35.65874725598133, -82.70111863405933 35.65897725601363, -82.70105263403487 35.65906425602466, -82.70090963398904 35.659207256039124, -82.70072263393378 35.65936325605171, -82.70069863392744 35.659378256052335, -82.7003996338426 35.65960525606787, -82.70014463376971 35.659802256081875, -82.7000696337474 35.659866256087255, -82.70002263373298 35.65990925609121, -82.69998463371829 35.65996325609833, -82.69995363370744 35.66000025610266, -82.69989863368886 35.660061256109444, -82.69985263367364 35.66011025611472, -82.69975163364725 35.66017225611697, -82.69970363363437 35.6602032561184, -82.69948163357755 35.660332256121876, -82.69926563352394 35.66044625612295, -82.69910163348307 35.660534256124095, -82.69902063346304 35.66057625612432, -82.69889863343259 35.66064225612522, -82.69878263340273 35.66071025612719, -82.69873663339074 35.66073825612821, -82.69870563338239 35.66075925612934, -82.69854163333818 35.66086825613469, -82.6984336333088 35.660942256138696, -82.69824663326114 35.661049256141354, -82.69812863323374 35.66109925613945, -82.6980216332093 35.66114225613713, -82.69784063316756 35.66121725613388, -82.69770363313393 35.66128725613407, -82.69763363311583 35.661328256135285, -82.69761563311128 35.66133925613564, -82.69757163309845 35.66137425613831, -82.6975126330816 35.66142025614158, -82.69740863305023 35.661511256149474, -82.69738463304274 35.66153325615154, -82.69720663298749 35.66169925616707, -82.69697663292015 35.661887256181814, -82.69688063289453 35.66195025618477, -82.69682263288021 35.661980256185004, -82.69673663285998 35.662018256183835, -82.69666663284475 35.662041256181354, -82.69657963282681 35.6620632561769, -82.69646863280525 35.66208325616961, -82.69636763278758 35.6620892561605, -82.69623563276627 35.6620842561459, -82.6960146327324 35.66206525611929, -82.6959436327213 35.662060256111, -82.69583963270479 35.662055256099336, -82.69573663268848 35.66204925608747, -82.69563063267148 35.6620452560758, -82.69549063264955 35.66203625605955, -82.69548463264866 35.662035256058736, -82.69546863264623 35.66203425605691, -82.69546363264531 35.6620342560564, -82.69531363262173 35.66202525603918, -82.6951436325937 35.66202325602128, -82.6950616325785 35.66203325601491, -82.69504063257438 35.66203725601358, -82.69499563256532 35.66204725601106, -82.69489363254256 35.66208425600808, -82.69482563252589 35.662119256008204, -82.69470663249234 35.662208256014125, -82.69458063245466 35.66231625602322, -82.69421763234585 35.66262925604975, -82.69415963232618 35.66269425605718, -82.694083632292 35.662834256077815, -82.69407963229004 35.66284225607905, -82.69403763227362 35.66290325608718, -82.69399563225953 35.6629492560923, -82.69394363224669 35.66297625609239, -82.69388663223492 35.66299125608959, -82.69384863222838 35.6629922560859, -82.69379863222095 35.66298625607956, -82.69372863221233 35.66296725606851, -82.6936806321955 35.663024256075204, -82.69348763213169 35.66322925609716, -82.69347663212783 35.6632422560987, -82.69339263210138 35.663323256106565, -82.69315463202885 35.66353625612556, -82.69267863188978 35.66392325615566, -82.69259763186601 35.66399025616097, -82.69240063180945 35.66414425617212, -82.69236663179967 35.664170256173946, -82.69226563177106 35.664247256179245, -82.69223263176139 35.66427425618143, -82.69209063172084 35.664383256189055, -82.69199763169522 35.664449256192924, -82.69199063169306 35.66445525619344, -82.6918796316609 35.66454425620025, -82.69162163158549 35.66475425621653, -82.6914206315223 35.66494625623503, -82.6913456314966 35.66503225624489, -82.69133063149137 35.66505025624705, -82.69120163144417 35.66521625626758, -82.69116863143115 35.66526525627425, -82.69112963141555 35.66532425628222, -82.69111863141097 35.665342256284795, -82.69104863138124 35.66545925630143, -82.69102463136947 35.66550925630924, -82.69099463135446 35.665574256319346, -82.69095663133581 35.66565425633178, -82.69092663132099 35.66571825634173, -82.69087463128993 35.665863256365974, -82.69086263128177 35.66590325637294, -82.69083963126467 35.6659892563881, -82.6908136312474 35.66607325640253, -82.69076363120357 35.666303256444294, -82.6906586311123 35.66678125653104, -82.69056063103709 35.66716325659883, -82.6905156310101 35.66728925661988, -82.69046563098564 35.66739425663623, -82.69045363098049 35.66741425663905, -82.69034963093392 35.66760425666712, -82.69002963080537 35.66809125673355, -82.68973963069044 35.66852325679183, -82.68968563066753 35.6686132568047, -82.68955663061621 35.66880625683075, -82.68943263056737 35.668989256855404, -82.68934363053336 35.6691132568715, -82.68927163050772 35.66920225688228, -82.68909363045007 35.669383256900865, -82.68898563041927 35.6694662569067, -82.68875263035682 35.66961925691397, -82.68863663032684 35.66968825691611, -82.68757163005014 35.670331256937864, -82.68741263001009 35.670419256939475, -82.68734962999507 35.67044825693892, -82.68721162996223 35.67051225693775, -82.68701362991794 35.6705852569323, -82.68665062983943 35.67070225691888, -82.6865526298183 35.67073325691512, -82.68632362977077 35.670794256904095, -82.68611062972501 35.67086025689562, -82.68594262969029 35.67090425688735, -82.6856576296305 35.670983256874216, -82.68556762961155 35.671009256870185, -82.6852316295392 35.6711152568573, -82.685085629505 35.67117925685539, -82.6849636294732 35.67125325685797, -82.68487862944755 35.67132825686451, -82.68486062944176 35.67134625686633, -82.68479562942004 35.67141625687398, -82.6847516294001 35.67149825688612, -82.68471662937849 35.67160025690335, -82.68471062937523 35.67161525690581, -82.68470762937302 35.67162625690769, -82.68470162936633 35.671663256914684, -82.68469962936332 35.67168025691791, -82.68469762936164 35.67168925691951, -82.68469362935683 35.67171625692463, -82.68469262935503 35.67172625692653, -82.68468462934496 35.67178325693732, -82.68467362933478 35.671837256947214, -82.6846646293201 35.67192325696388, -82.68465662930772 35.671994256977534, -82.68464962929595 35.67206325699092, -82.68463462926579 35.67224225702587, -82.6846036292271 35.67245925706689, -82.68455762918171 35.67270425711211, -82.68451262915494 35.672829257132975, -82.68446662912595 35.672967257156415, -82.68437462908423 35.67313825718183, -82.68432862906587 35.67320725719122, -82.68417662901047 35.67340225721531, -82.68407762897812 35.67350525722616, -82.68390962892828 35.67364625723766, -82.68376462888948 35.67374125724211, -82.68361162885041 35.67382925724432, -82.68313862873397 35.67407325724547, -82.68292562867546 35.67422225725406, -82.68278162862939 35.67436525726837, -82.68268562859875 35.67446025727789, -82.6825416285499 35.674621257295875, -82.68249362853288 35.674679257302785, -82.68247462852632 35.67470125730536, -82.68241662850609 35.674770257313426, -82.68239862849953 35.674793257316374, -82.68216762848077 35.674665257266476, -82.68205462847193 35.674600257241615, -82.68102762839094 35.67401625701697, -82.68086262837797 35.6739222569809, -82.68076062837092 35.673857256957106, -82.68068862836519 35.67381725694158, -82.68060362835823 35.67377025692327, -82.68047562834874 35.6736932568944, -82.68041862834424 35.67366125688199, -82.6803086283355 35.67359925685808, -82.67992162830579 35.67337325677222, -82.67979262829745 35.67328825674169, -82.67966362829002 35.67319725670981, -82.67962862828864 35.67316825670032, -82.6795916282874 35.67313625669, -82.67954362828553 35.673096256676935, -82.67943062828368 35.67298625664284, -82.67939962828275 35.67295925663419, -82.67933562828055 35.672904256616434, -82.67924462828125 35.67280125658607, -82.67915462828337 35.67269025655417, -82.6791236282847 35.672648256542445, -82.67907762828662 35.67258625652506, -82.67900362829216 35.6724702564938, -82.67893062829927 35.67234525646079, -82.67885462831012 35.672193256421984, -82.67877662831934 35.67204925638466, -82.67873762832645 35.67196125636266, -82.67873162832754 35.67194725635922, -82.67871262833103 35.67190425634848, -82.67863362834396 35.67173525630586, -82.67854662835879 35.67154525625822, -82.67853862836017 35.67152725625372, -82.67846062837111 35.6713722562141, -82.67840462837769 35.671269256187365, -82.67834862838204 35.6711802561634, -82.67833662838333 35.67115925615798, -82.67823562839023 35.67100525611614, -82.67821062839099 35.67097325610704, -82.6780156283972 35.67072225603585, -82.67776562839707 35.67045325595532, -82.67772262839634 35.67041125594233, -82.67754462839329 35.67023925588903, -82.67751162839275 35.67020725587907, -82.67740962839211 35.67010125584692, -82.67730962838895 35.67001325581871, -82.6770226283852 35.66972825573114, -82.67693562838406 35.669641255704484, -82.67682962838465 35.669523255669475, -82.67674262838885 35.669402255635895, -82.67668062839428 35.66930025560875, -82.67659562840909 35.6691122555617, -82.67656662841905 35.669016255539084, -82.67654562843047 35.66891925551717, -82.676536628435 35.6688802555083, -82.67651662845404 35.66873525547668, -82.67648662854742 35.668097255343525, -82.67648262855101 35.668070255337604, -82.67646862856922 35.66793725530902, -82.67643862858706 35.667789255275814, -82.67641062859657 35.66769725525412, -82.67640362859923 35.667672255248306, -82.6763496286074 35.667561255220114, -82.67629562861126 35.66747725519751, -82.67619762861275 35.66736225516397, -82.67610462861103 35.66727325513621, -82.67598262860454 35.66718325510536, -82.67594162860152 35.66715825509603, -82.67584962859466 35.66710325507538, -82.67572362858267 35.667045255050574, -82.67558462856772 35.666992255025534, -82.67545662855113 35.66696125500608, -82.67527462852512 35.66693325498165, -82.67512562850195 35.66692225496413, -82.67498862847908 35.66692325495027, -82.67483362845202 35.66693125493598, -82.67468862842613 35.66694225492325, -82.67429862835607 35.66697525488997, -82.67400162830484 35.66698625486171, -82.67383262827795 35.666978254842654, -82.67370462825828 35.66696725482731, -82.67359562824274 35.66695025481259, -82.67346762822625 35.66691925479319, -82.67334462821212 35.66687825477221, -82.67323162820024 35.666833254751346, -82.67309662818722 35.666771254724836, -82.6729926281796 35.66670825470134, -82.67285562817106 35.666616254668455, -82.67275362816612 35.66653825464207, -82.67257262816402 35.66635625458646, -82.67251162816535 35.6662812545648, -82.67243562817042 35.66616625453359, -82.67239462817585 35.66608725451329, -82.6723776281782 35.66605325450465, -82.6723226281913 35.66590925446962, -82.67228762820645 35.66577325443829, -82.67227662822363 35.66565025441205, -82.67227562824459 35.665513254383995, -82.67228662826692 35.665380254358, -82.6723676283628 35.66484625425747, -82.67239962839984 35.66464025421875, -82.67240362842041 35.66451125419289, -82.67239162844163 35.66436125416103, -82.6723626284576 35.664226254130554, -82.67227862847773 35.66400525407687, -82.67219562848466 35.66387025404082, -82.67212962848815 35.663776254014856, -82.67202362848901 35.663656253979546, -82.67188762848703 35.66352225393818, -82.67173262848085 35.66339525389639, -82.67135262846318 35.66309925379699, -82.67128162846127 35.66303525377669, -82.67107762845342 35.66286525372111, -82.67095062844737 35.66276725368803, -82.67084662844414 35.66267625365879, -82.6708436284441 35.66267325365788, -82.67074462843914 35.662598253632375, -82.67055062843156 35.6624382535799, -82.67036862842345 35.662294253531805, -82.67007862841272 35.66205025345231, -82.66983962840204 35.66186125338918, -82.66970662839483 35.66176425335577, -82.66954462838412 35.66165925331771, -82.66942162837461 35.66158825329058, -82.66927262836136 35.66151325325997, -82.66913962834847 35.661453253234065, -82.6690206283354 35.661409253212895, -82.66874962830472 35.661315253165974, -82.66822962823834 35.66118425308579, -82.66794862820291 35.66111025304179, -82.66781262818509 35.66107925302155, -82.66771062817259 35.66105025300511, -82.66735962812722 35.66096525295173, -82.66721862810982 35.660925252929125, -82.66712762809742 35.66090725291608, -82.66693962807415 35.660855252886165, -82.66674062804857 35.66080625285571, -82.66668162804089 35.660792252846804, -82.66652362802122 35.66074925282183, -82.66622462798223 35.66067925277683, -82.66582762793189 35.66057725271524, -82.66525462785802 35.66043725262784, -82.6651966278506 35.6604222526188, -82.66502362782835 35.660380252592475, -82.664966627821 35.66036625258375, -82.66472562778992 35.66030725254704, -82.66469362778588 35.660299252542075, -82.66387962768243 35.66009025241584, -82.66382762767581 35.66007725240783, -82.66360962764888 35.66001625237304, -82.66355862764277 35.66000125236469, -82.66351362763712 35.65998925235762, -82.66340762762471 35.659955252339756, -82.66335862761898 35.65993925233151, -82.6632126276019 35.65989225230688, -82.66305962758395 35.65984325228124, -82.66277862755229 35.65974525223237, -82.66263462753584 35.65969625220762, -82.66260862753293 35.65968725220308, -82.66258662753067 35.65967825219901, -82.66244262751499 35.65962425217319, -82.6623956275098 35.65960725216492, -82.6622986274994 35.65957025214741, -82.66228862749836 35.65956625214557, -82.66201362747026 35.659451252093895, -82.66191962746065 35.65941225207624, -82.66189162745776 35.659400252070924, -82.6617586274446 35.659342252045484, -82.66155462742437 35.65925325200631, -82.66146462741557 35.65921325198894, -82.6611366273829 35.65907025192609, -82.6608296273496 35.65895525187113, -82.66035662729081 35.65882525179608, -82.65871962706726 35.658507251563044, -82.65844062703438 35.65841925151635, -82.65826862701856 35.65833625148182, -82.65801262700754 35.65813125141373, -82.6578776270122 35.65795525136398, -82.65778862702265 35.65779125132139, -82.65773262704073 35.65761325127932, -82.65772562704296 35.65759125127415, -82.6577136270759 35.657365251226835, -82.65774362715332 35.65689525113415, -82.65781762734017 35.65576425091121, -82.65778762737814 35.65548525085124, -82.65766962742819 35.655033250746975, -82.6575416274452 35.65478525068325, -82.6574426274583 35.65459325063394, -82.65717562747955 35.65416725051971, -82.65740762751429 35.65419225054864, -82.65813462763687 35.65418225062129, -82.65876762775082 35.65412725067507, -82.65919862783198 35.6540662507069, -82.65925062784078 35.65406525071204, -82.65947462787867 35.65406125073429, -82.65970362792021 35.65403925075334, -82.6598386279495 35.65399525075823, -82.65990562796821 35.65394625075512, -82.66002662800115 35.653863250750575, -82.66009462803699 35.65370425072518, -82.66022262808966 35.653501250696955, -82.66045762817889 35.65317625065485, -82.66059962822702 35.65301725063702, -82.66074762826776 35.65291325063095, -82.66089562830258 35.65284725063275, -82.66117162835786 35.65278625064868, -82.66158262843324 35.652742250681875, -82.66191262850415 35.652638250694665, -82.6619796285221 35.65259425069248, -82.66200662853414 35.652545250685286, -82.66199362854557 35.65245725066606, -82.66195262855473 35.65235325064061, -82.66186562855553 35.652254250611534, -82.66154262854165 35.65199525052554, -82.66137362854656 35.65178125046458, -82.66128662856164 35.651589250416514, -82.66125262858411 35.65140725037589, -82.66127962861816 35.65121525033954, -82.66140162868165 35.65093525029498, -82.66144862871326 35.650781250268395, -82.66142162873926 35.65058325022525, -82.66134762874634 35.65045725019202, -82.66110562874852 35.65018225011105, -82.66106962875527 35.65009925009047, -82.66106462875608 35.65008825008769, -82.66109862877687 35.649990250071205, -82.66119262881115 35.64986925005621, -82.6613606288578 35.64974825004879, -82.66151562891174 35.64956625002764, -82.66161662895136 35.6494182500078, -82.66171762898168 35.64933025000029, -82.66196062903067 35.649275250013964, -82.66218262906678 35.64928125003798, -82.6623506290879 35.649325250064265, -82.66251262909796 35.64943525010335, -82.6626676291011 35.6495822501492, -82.66275462910278 35.64966525017507, -82.66317862910044 35.65013825031504, -82.66354262912961 35.65034225039396, -82.66365662913343 35.65044025042571, -82.66379762912818 35.650627250478294, -82.66397262914451 35.650710250513136, -82.66409162916105 35.65073125052968, -82.66446462921284 35.650798250581666, -82.66489562926017 35.650957250658344, -82.66534662930644 35.65114425074274, -82.66577762935869 35.651271250812954, -82.66651062945793 35.65141925091837, -82.66671962947841 35.651512250958795, -82.66698862950965 35.65160025100438, -82.66722462954631 35.651617251032164, -82.66753462960224 35.65158925105824, -82.66791862967965 35.651502251079904, -82.66803962969642 35.651524251096845, -82.66834262972566 35.6516612511559, -82.66859762973428 35.651881251226946, -82.66892162976279 35.65204625129385, -82.66910962977542 35.65216725133784, -82.66931262978369 35.65233325139257, -82.66938562978676 35.652392251412046, -82.66965462981116 35.65252425146665, -82.66995062983086 35.652716251536134, -82.67018662983702 35.65293125160417, -82.6703686298497 35.653046251646366, -82.6704756298641 35.65306825166183, -82.6706176298885 35.653063251675405, -82.67085262993533 35.653013251689366, -82.670953629953 35.65300825169873, -82.67147963005503 35.65291425173359, -82.6716676300949 35.65285925174167, -82.6717556301197 35.65279325173724, -82.67182963014803 35.65268925172366, -82.67192363016878 35.65265625172658, -82.67199763017699 35.65268325173966, -82.67210563018388 35.65275525176547, -82.67219263019928 35.65274925177313, -82.67227363022292 35.65268325176801, -82.67232763024361 35.65260725175805, -82.67234063026959 35.65245325172799, -82.67232063029425 35.65227125168885, -82.67230063030696 35.6521672516656, -82.67225363033819 35.651914251609135, -82.67209163039847 35.65134825147712, -82.6720586304269 35.65112825142888, -82.67206563046106 35.65091425138599, -82.67213963049542 35.650771251364475, -82.67230763054036 35.650661251359224, -82.67250963058244 35.65060625136881, -82.67269163061522 35.65059025138421, -82.67283263064301 35.65056225139304, -82.67293363067162 35.65048625138791, -82.672960630694 35.65037025136696, -82.67297463071495 35.650249251343716, -82.67292763073674 35.65005725129972, -82.67284663075039 35.64988125125556, -82.67270463074952 35.64973325121082, -82.67245563073007 35.649590251156056, -82.67209863068345 35.64950725110256, -82.67199863068201 35.64940825107207, -82.67195063069589 35.649266251038235, -82.67190363072034 35.64905725099076, -82.67187063075289 35.64881025093701, -82.67181663077271 35.64862325089332, -82.67170263079032 35.64838625083328, -82.67149963078528 35.64819925077433, -82.67142663079497 35.648057250737885, -82.67139963081587 35.6478922507015, -82.67149863089196 35.64750625063299, -82.671587630959 35.647167250572934, -82.67162863098036 35.64707325055806, -82.67172263100187 35.64703525055987, -82.67187063102816 35.647024250572876, -82.67228763108575 35.64710125063142, -82.67244263111165 35.64710125064729, -82.67280663117563 35.64707925068018, -82.67316263123149 35.64710125072126, -82.67316963124888 35.64699625070061, -82.67324363128573 35.646837250675745, -82.67348663137786 35.646502250632444, -82.67350263138327 35.64648425063037, -82.67381663148784 35.64614525059352, -82.67419363161159 35.6457492505515, -82.67439563166563 35.645617250545335, -82.67463063173693 35.64540825052678, -82.67482563180337 35.64518825050199, -82.67496063186303 35.644947250466736, -82.67497363186799 35.64492925046443, -82.67516963194024 35.64467225043217, -82.67532463200334 35.64443025039871, -82.67536863202578 35.64433225038325, -82.67537863203088 35.64430925037954, -82.67540563205995 35.644150250349924, -82.67540663206567 35.64411425034273, -82.67541863210288 35.64388625029748, -82.67546563214707 35.64365025025414, -82.67555263218857 35.64347425022723, -82.67561363221746 35.643353250208804, -82.6756376322342 35.64327025019433, -82.67573463221112 35.643525250256324, -82.6757416322095 35.643543250260684, -82.67588363217548 35.64391725035147, -82.67606863215148 35.64427325044305, -82.67619463213501 35.64451625050558, -82.67635563211402 35.64482625058534, -82.67648263210077 35.64504925064379, -82.6770006320466 35.645961250882955, -82.677420632017 35.64660725105776, -82.6774636320139 35.64667325107562, -82.67773563198942 35.647126251195914, -82.67811663196336 35.64770725135351, -82.67908263189706 35.64918125175327, -82.67926163188548 35.649450251826494, -82.6794016318766 35.64965925188341, -82.67951563187103 35.64981825192763, -82.67967663186865 35.650008251982904, -82.67972463186783 35.65006525199938, -82.6798176318698 35.65015325202695, -82.67995863187258 35.650287252068686, -82.68019363188216 35.65047925213201, -82.68028463188763 35.650542252154246, -82.68044463189722 35.65065225219302, -82.68045263189784 35.650657252194854, -82.68046363189875 35.65066325219721, -82.68049663190105 35.65068425220489, -82.68050763190173 35.650691252207494)))",5755,37,021,002606,370210026062,817,817,52,804,774,11,7,0,0,12,13,611,30,581,604,581,8,5,0,0,10,7,352,325,27
census_2010_blockgroups_view.fid--2dc29038_13ec899ba8f_-25f8,"MULTIPOLYGON (((-82.53489161742193 35.587524224384204, -82.53516761746378 35.58755022441783, -82.53523461747484 35.58755022442478, -82.53533461749129 35.58755122443526, -82.53554961753251 35.58751522444999, -82.53574661757942 35.58742322445151, -82.53591061762582 35.58729822444291, -82.53600761766684 35.58713622441994, -82.53602861768597 35.58703522440156, -82.53605561770873 35.58691622438005, -82.53610961773721 35.58678922435979, -82.53615661775576 35.58671922435034, -82.53620061777346 35.586652224341215, -82.53625361779068 35.58659722433554, -82.53627961779904 35.58657122433292, -82.5364076178333 35.5864862243287, -82.53664561789562 35.58633822432308, -82.53674061792016 35.58628122432123, -82.53677661793058 35.58625222431903, -82.5368436179502 35.58619722431469, -82.53689461796696 35.58614322430897, -82.53691461797335 35.586123224306945, -82.53696961799636 35.58603322429427, -82.53701061802009 35.58592322427615, -82.5370286180423 35.585798224252486, -82.5370166180562 35.58569522423032, -82.53701561805815 35.58568122422738, -82.5369876180683 35.585585224205, -82.53696761807127 35.58554422419453, -82.53692461807734 35.58545822417259, -82.5369196180775 35.58545222417087, -82.53681561807838 35.5853342241362, -82.53673961807412 35.58528022411745, -82.53666761806986 35.585230224099874, -82.53645161804819 35.58513822405896, -82.53604461800414 35.58498522398604, -82.53579961798296 35.58485922393513, -82.53567761798045 35.584744223899285, -82.53559361798331 35.58463422386826, -82.53555561799651 35.584508223838675, -82.53555261800769 35.584432223822965, -82.53554861802407 35.58432122379992, -82.53554861803708 35.584237223782836, -82.53554861809098 35.583886223711396, -82.53553361820138 35.583153223560736, -82.53552561826046 35.582761223480155, -82.5355196183106 35.5824282234118, -82.5355216183326 35.58228822338348, -82.53552561836985 35.58205022333549, -82.53553661839896 35.581873223300526, -82.5355366183994 35.58187022329996, -82.53556761842543 35.581734223275454, -82.53558061843651 35.58167622326498, -82.53560561845268 35.58159822325168, -82.5356416184748 35.58149322323398, -82.53569461850377 35.581362223212814, -82.5357636185368 35.581222223191354, -82.53577061853976 35.58121022318965, -82.53584661857059 35.581092223173435, -82.53598561862107 35.58091422315151, -82.5359866186215 35.5809122231512, -82.53612461866763 35.58076122313462, -82.53648461877587 35.58044622310752, -82.53665661882737 35.580297223094846, -82.53678661886642 35.580183223085065, -82.53718061898445 35.57984122305598, -82.53731161902355 35.57972822304635, -82.53760761911202 35.57947222302467, -82.53773861915035 35.57936522301639, -82.53777061915949 35.579340223014576, -82.53812861926819 35.579019222986005, -82.53870261943874 35.57853022294549, -82.53885261948454 35.57839422293318, -82.5389336195122 35.57830222292275, -82.53896361952911 35.57822422291002, -82.53896461952938 35.5782232229099, -82.53898561954644 35.5781352228942, -82.53897661955992 35.57803822287345, -82.53894161956731 35.5779522228524, -82.53888461957169 35.57786222282825, -82.53880661956975 35.57779122280575, -82.53874861956524 35.577758222793086, -82.53890161958884 35.57776922281102, -82.53936161965999 35.577803222865185, -82.53951561968367 35.577815222883444, -82.53971861971618 35.57782322290596, -82.54033061981353 35.57785022297427, -82.540534619846 35.57785922299708, -82.54058361985375 35.57786122300253, -82.54069461987069 35.57787122301594, -82.54094561990846 35.577896223046764, -82.5411746199423 35.57792322307582, -82.54119761994563 35.57792622307877, -82.54133461996538 35.57794622309689, -82.54155861999806 35.57797522312587, -82.541621620007 35.577984223134145, -82.54181362003749 35.57799322315568, -82.54223562010638 35.57800122320065, -82.54228462011422 35.5780032232061, -82.54246162014486 35.577995223222686, -82.54254662015997 35.57798822322999, -82.54270062018908 35.577965223241115, -82.5427496201981 35.57795922324493, -82.5430206202492 35.57791922326459, -82.54313162026844 35.57791422327497, -82.54327462029201 35.57791522328981, -82.54341962031788 35.57790322330231, -82.54342062031824 35.577902223302225, -82.54353662034039 35.57788322331027, -82.54355062034304 35.577881223311316, -82.54365862036467 35.57785722331752, -82.54382162035328 35.57810722338513, -82.54385562034902 35.57817122340166, -82.54386962034717 35.57819822340854, -82.5438836203421 35.57824622341972, -82.54387662033622 35.57827722342533, -82.5438716203323 35.57829722342891, -82.54383462031926 35.57834222343429, -82.54378862030885 35.57836022343323, -82.54371062029495 35.5783662234264, -82.54350462026551 35.57833522339896, -82.54343162025326 35.578336223391666, -82.54335762023769 35.57835722338832, -82.54329162022047 35.5783982233899, -82.54324062020312 35.57845622339643, -82.54321062018882 35.57851722340585, -82.5431976201766 35.578582223417726, -82.54319762016536 35.578655223432506, -82.54321262015632 35.57873022344934, -82.54328662011245 35.579095223531226, -82.54365762017282 35.57910222357074, -82.54407262024134 35.57910522361401, -82.54409462024516 35.57910422361606, -82.54435762028967 35.57909822364183, -82.54463162033544 35.57909622366953, -82.54481362036506 35.57910022368907, -82.54487362037332 35.579111223697524, -82.54496362038236 35.57914922371446, -82.5450256203898 35.57916822372472, -82.54508262040083 35.57915822372852, -82.54509762040479 35.57914822372803, -82.54512262041155 35.57913122372716, -82.54514762042605 35.579064223715996, -82.54514862042913 35.57904522371229, -82.54516162046436 35.57883022366987, -82.54514262047917 35.57871322364407, -82.54510762048756 35.578621223621774, -82.54506662049361 35.57853722360042, -82.54496762049976 35.57839122356058, -82.54466462050706 35.57801622345313, -82.54463562051292 35.57794722343617, -82.54463562051706 35.577920223430674, -82.54463562052 35.57790122342677, -82.54467862053546 35.57784722342025, -82.54473662055081 35.57781022341862, -82.54483762057427 35.57776622342005, -82.54531662069257 35.57751422341794, -82.5454636206979 35.57763822345831, -82.54565262070864 35.577772223504944, -82.54569862071183 35.57780122351563, -82.54586962072344 35.57791022355532, -82.54610762074296 35.57804022360625, -82.54631762076203 35.57814222364858, -82.54649662078417 35.5781912236769, -82.54671062081376 35.57823022370683, -82.546974620852 35.57826622374128, -82.54703462086182 35.57826722374762, -82.54717862088512 35.57827122376324, -82.54728262090285 35.578268223773314, -82.54737462091965 35.57825822378073, -82.54745062093778 35.57822222378122, -82.54749362095001 35.578189223778885, -82.54752662095946 35.57816322377695, -82.54758662097939 35.578098223769906, -82.54765362099704 35.578056223768215, -82.54771762101348 35.57801822376708, -82.54784662103887 35.57799222377501, -82.54795662105664 35.577995223786935, -82.54826662110351 35.57802522382486, -82.54830062110852 35.57802922382923, -82.54847662113764 35.578030223847506, -82.54852962114012 35.578071223861265, -82.5486886211474 35.578195223902824, -82.54874162114977 35.57823722391684, -82.54880662115265 35.578288223933846, -82.5488096211528 35.57829022393458, -82.5490086211637 35.57843422398431, -82.54907662116742 35.578483224001324, -82.54898862114038 35.57856422400871, -82.54897862113715 35.578574224009735, -82.54880662108711 35.578714224020544, -82.54870862105959 35.57878722402535, -82.5486146210328 35.5788602240306, -82.54849862099923 35.57895322403762, -82.54845162098462 35.57899722404175, -82.54843762098004 35.579012224043346, -82.54842662097221 35.57905122405013, -82.54843162096715 35.579089224058414, -82.54846862096593 35.57913722407199, -82.54854762096934 35.57920022409287, -82.54874962098084 35.57934322414271, -82.54885262098563 35.579423224169616, -82.54888062098694 35.57944522417696, -82.5489576209892 35.579513224198685, -82.54901062098952 35.57956822421538, -82.54894862097345 35.57960622421674, -82.5486386208969 35.579769224218026, -82.54850562086379 35.579841224219116, -82.54824062079541 35.579999224224, -82.54802462074603 35.58008722421972, -82.54788562071094 35.58016522422129, -82.547821620693 35.58021322422454, -82.54758962061723 35.58045522424995, -82.5475476206033 35.58050022425475, -82.54740562055224 35.58067922427662, -82.54732262053126 35.58072622427766, -82.54728762052372 35.58073722427631, -82.54728862051972 35.5807642242819, -82.54728262051276 35.58080322428926, -82.5472496204972 35.580868224299095, -82.5470686204304 35.58110722432914, -82.54681962034537 35.58139122436136, -82.54678262033327 35.58143022436546, -82.54659162027006 35.581635224387625, -82.54652862024768 35.58171222439679, -82.54648062022576 35.58180322441039, -82.54643662019238 35.581972224440236, -82.54640862017007 35.582087224460786, -82.54638662015738 35.58214622447056, -82.54635062014272 35.582202224478216, -82.54627062011379 35.582304224490755, -82.54618562008478 35.58240022450157, -82.54606362004526 35.58252622451467, -82.54602262003309 35.58256122451758, -82.54591162000605 35.582617224517584, -82.54577961997568 35.58267222451528, -82.54570461995748 35.58270922451511, -82.54521961983296 35.58299522452343, -82.5450666197916 35.58309922452888, -82.5449886197677 35.58317022453536, -82.54497861976435 35.58318122453652, -82.54492561974527 35.58324822454477, -82.5448896197265 35.58333122455796, -82.54486361970717 35.583429224575234, -82.5448356196911 35.58350322458744, -82.54477661966669 35.58359822460064, -82.54466861962982 35.583721224614635, -82.54455261959967 35.583792224617106, -82.54446261957719 35.583841224617906, -82.54436661955323 35.58389322461864, -82.54420761951098 35.583996224623206, -82.54407561947819 35.58406722462409, -82.54397561945416 35.58411522462364, -82.54389261943614 35.584143224620846, -82.54379561941771 35.58415822461385, -82.54368361940007 35.58415222460116, -82.54367261939868 35.58414922459944, -82.5435456193816 35.584123224581084, -82.54348761937692 35.5840912245686, -82.54338961937172 35.584019224543844, -82.54326961937274 35.58388322450393, -82.54313361937803 35.58370222445309, -82.54296661939244 35.58342822438012, -82.54288461939798 35.58330422434648, -82.54282561939496 35.58326022433148, -82.5427506193863 35.583235224318734, -82.54267461937323 35.583238224311565, -82.54258061935565 35.58325122430446, -82.54249261933671 35.58327922430118, -82.54241761931736 35.58332422430259, -82.54233561929216 35.583399224309474, -82.54228461927418 35.58346122431681, -82.54225061925982 35.583518224325005, -82.5422286192463 35.58358222433576, -82.54221661923349 35.58365222434873, -82.54222961922153 35.58374422436879, -82.542253619215 35.583812224385106, -82.54230761920938 35.58390722440994, -82.5423746192053 35.58400522443678, -82.54242761919892 35.5841042244624, -82.54242861919882 35.58410622446292, -82.54250161918263 35.58429022450782, -82.5425696191583 35.584521224561854, -82.54257961914497 35.58461922458281, -82.54257261910064 35.58489922463908, -82.54259461909726 35.584945224650646, -82.54256461908608 35.58498522465574, -82.54256261908488 35.584991224656754, -82.542552619077 35.585031224663865, -82.54253161905365 35.58516022468793, -82.54253061905167 35.585172224690325, -82.54251661904273 35.58521522469763, -82.5425016190335 35.58525922470505, -82.5424566190118 35.58535122471914, -82.54229361895187 35.58556522474591, -82.54221561892179 35.585676224760505, -82.54218161890574 35.585744224770856, -82.5421076188615 35.58595122480537, -82.54205761883847 35.58604722481976, -82.54193261878659 35.58624922484805, -82.54191161877715 35.58628822485384, -82.54172361869105 35.58664522490719, -82.54165061866252 35.586751224921294, -82.54154961862658 35.58687622493631, -82.54128361854357 35.58712822496026, -82.54122561852353 35.58719622496816, -82.54112061847991 35.587366224992024, -82.5410726184569 35.58746422500701, -82.54104261844526 35.587507225012686, -82.54101061843258 35.58755522501916, -82.54093261840978 35.58761922502411, -82.5406726183474 35.58774422502287, -82.54059961832817 35.58779022502476, -82.54054461831147 35.58783922502907, -82.54049761829448 35.58789922503643, -82.54043861826977 35.5879962250501, -82.54034261822731 35.588168225075236, -82.54030261820573 35.58826522509089, -82.54018061813441 35.58859722514592, -82.54013761811677 35.58866522515533, -82.53991061803713 35.58893822518756, -82.53987861802474 35.58898422519365, -82.53986761801383 35.58904322520449, -82.53982361798045 35.589212225234384, -82.5398056179695 35.58926422524314, -82.53974661795041 35.58932422524931, -82.53971161793785 35.58936822525465, -82.53968161792186 35.58944022526621, -82.53962361786441 35.58975022532331, -82.53956861782078 35.58997422536329, -82.53950461779617 35.5900652253752, -82.53939961776459 35.59015722538319, -82.53917361769368 35.59037422540411, -82.53914061767809 35.59044022541411, -82.5391306176628 35.59052822543105, -82.53915061762095 35.5908222254929, -82.53917561760191 35.59097222552601, -82.53919261759401 35.59104222554196, -82.53925161758113 35.591189225578006, -82.53934261756775 35.59137422562501, -82.5393646175577 35.591463225645334, -82.53936961754789 35.59153222565987, -82.53936961753253 35.59163222568031, -82.5393606175175 35.59172022569723, -82.53933861749998 35.59181022571326, -82.53930961748232 35.591893225727205, -82.53926261746258 35.59197122573826, -82.53919861744022 35.59204722574712, -82.53912261741658 35.59211922575397, -82.53884961734008 35.59232122576707, -82.53880561732515 35.592371225772695, -82.53888561731635 35.59251422581, -82.53899061727311 35.592908225901006, -82.53904561726333 35.5930312259317, -82.53913161725119 35.593202225975304, -82.53927161724107 35.59341922603386, -82.5393246172332 35.593527226061276, -82.53934261722199 35.59361922608187, -82.53932361720761 35.593692226094745, -82.53917761713839 35.59398422613922, -82.53912661712057 35.594045226146335, -82.53867161700721 35.59429122614963, -82.53863461699763 35.594313226150305, -82.53851561696678 35.59438522615279, -82.53847661695254 35.59443622615916, -82.53842761691341 35.59463722619495, -82.53838861688787 35.59476122621627, -82.5383656168673 35.59487022623602, -82.53834961684021 35.59502822626653, -82.53832061681541 35.595158226290025, -82.53828961680512 35.595192226293776, -82.53826761679478 35.59523522630028, -82.53829161679579 35.59525422630661, -82.53834261680379 35.595257226312405, -82.5383986168156 35.59524122631492, -82.53844761682976 35.5952022263121, -82.53848961684501 35.59514822630536, -82.53852161686713 35.59503922628652, -82.53857661689952 35.5948882262614, -82.53863761692999 35.594756226240804, -82.53864461694539 35.594663226222536, -82.5386366169529 35.594606226210125, -82.53864861695776 35.59458722620756, -82.53868161696404 35.594582226209965, -82.53871561696829 35.59459122621522, -82.53873561696855 35.5946112262214, -82.53873961694734 35.594753226250674, -82.53872961692305 35.594900226279556, -82.53873161689961 35.59505422631109, -82.53870161684752 35.59536022637028, -82.53873461685458 35.59535022637162, -82.5387896168692 35.595314226369986, -82.53882661688478 35.59525322636137, -82.53885261689543 35.595212226355706, -82.53887661691483 35.595112226337825, -82.53890061694325 35.59495322630792, -82.53892661697678 35.594763226271894, -82.53892861697838 35.594755226270465, -82.53895361699655 35.5946642262545, -82.53898861700544 35.59464422625403, -82.53902361701215 35.5946382262565, -82.53904461701569 35.5946382262586, -82.53907861702035 35.5946442262633, -82.53910061702112 35.59466322626942, -82.53911361701971 35.594686226275435, -82.53912161701086 35.594752226289685, -82.5391176169937 35.59485922631105, -82.53909161695535 35.59508022635336, -82.53908961694535 35.59514322636602, -82.5390936169388 35.595190226376005, -82.53910561693588 35.595222226383726, -82.53914361693423 35.59527322639795, -82.53917161693535 35.59529622640554, -82.5392056169387 35.59531122641212, -82.53929061694943 35.59533322642528, -82.53940061696322 35.595362226442504, -82.53951761697529 35.59541022646434, -82.53971361698746 35.595542226511256, -82.53995861700902 35.59566622656175, -82.5400766170169 35.595742226589245, -82.54017761701859 35.59584022661962, -82.54025861701719 35.59593622664748, -82.5403296170102 35.59605822667955, -82.54036861700085 35.596161226704574, -82.54038861699132 35.596244226723506, -82.54038761697892 35.596324226739675, -82.54037961696507 35.59640522675532, -82.540359616947 35.59650122677285, -82.54032961692498 35.596611226792156, -82.54028561690266 35.59670922680758, -82.54023361687318 35.59684422682974, -82.54020161685237 35.59694522684707, -82.54020461683588 35.59705522686963, -82.54023661682456 35.597163226894956, -82.54028361681436 35.59728022692353, -82.54030561681051 35.59732922693574, -82.54040761679381 35.59754722699064, -82.54043761678629 35.59762822701023, -82.54045661676328 35.597798227046745, -82.54049561671167 35.59817522712753, -82.54050761670241 35.59824822714362, -82.54051161669017 35.59833222716111, -82.54050761667851 35.59840322717514, -82.54047261663843 35.59862622721695, -82.54046661663058 35.59867022722526, -82.54046661661724 35.59875722724294, -82.5404796166097 35.598820227257086, -82.5405026166044 35.598879227271446, -82.54053961660375 35.59892322728422, -82.54061161660434 35.59899722730676, -82.54069761661168 35.59904222732473, -82.54078661662247 35.59906822733914, -82.5409016166394 35.59908222735379, -82.54095861664895 35.59908122735942, -82.5411136166795 35.59905022736905, -82.54144761674988 35.59895322738367, -82.54151661676359 35.59893822738772, -82.54152261676475 35.59893722738812, -82.54158761677635 35.598932227393796, -82.54159261677717 35.59893222739425, -82.54168061679124 35.598935227403906, -82.54175561680007 35.5989592274165, -82.54183961680488 35.59901822743715, -82.54192561680736 35.59909522746167, -82.54176661676799 35.59917922746244, -82.54162961673728 35.59923122745898, -82.54147961670543 35.599276227452684, -82.54133761667725 35.59930622744416, -82.54124561665998 35.599319227437434, -82.54117961664748 35.599329227432605, -82.54104061662294 35.5993382274202, -82.54087161659493 35.59933822740283, -82.54071661657218 35.59931922738307, -82.54058261655372 35.59929422736416, -82.5403546165259 35.59922922732752, -82.53916261638955 35.598830227123806, -82.53854561631893 35.59862422701852, -82.53847961631145 35.59860122700703, -82.53821661628132 35.598513226962105, -82.5374286161911 35.5982502268276, -82.53716661616096 35.59816322678294, -82.53691661613249 35.598079226740246, -82.53684561612425 35.59805622672822, -82.53668861610699 35.59799922670051, -82.53661561609901 35.597972226687546, -82.5364516160829 35.597900226655966, -82.53618961605902 35.59777322660321, -82.5359536160375 35.597658226555566, -82.53587961603122 35.597619226540075, -82.53543761600167 35.59733522643686, -82.53530461599313 35.59724722640524, -82.53452861594383 35.59673122622053, -82.53402761591234 35.59639622610085, -82.5336986158907 35.596182226023515, -82.53338761587152 35.59597122594864, -82.53307061585224 35.59575522587207, -82.53285961584278 35.59558922581659, -82.5327756158408 35.59551122579211, -82.53262661583744 35.59537322574873, -82.53262261583754 35.5953682257473, -82.53240061584081 35.595107225671356, -82.53222561584649 35.594882225607606, -82.53215961584858 35.59479722558352, -82.53210561585283 35.594712225560684, -82.53202361585936 35.59458122552556, -82.53177861587919 35.594188225420446, -82.53169761588583 35.5940582253856, -82.53149861590634 35.59371022529442, -82.53148361590804 35.593683225287364, -82.53109661595968 35.5929312250946, -82.53095461598107 35.59263922502062, -82.53088861599107 35.592503224986125, -82.53085361599918 35.592413224964204, -82.53079761601153 35.592272224929786, -82.5306916160352 35.592004224864375, -82.53061361605877 35.59176722480811, -82.5303846161291 35.591064224641535, -82.5302546161766 35.59061522453678, -82.53014561621275 35.590263224453984, -82.53013461621582 35.59023122444629, -82.53010261622659 35.5901272244219, -82.52998661627068 35.589715224326156, -82.53014661636071 35.589303224258735, -82.53019261639061 35.58915922423418, -82.53027061644124 35.5889142241923, -82.5303466164867 35.58870122415681, -82.53043961652763 35.58853522413255, -82.53058561657558 35.588381224116254, -82.53068461660351 35.588306224111136, -82.53074061661931 35.5882642241084, -82.53090761666304 35.58816022410433, -82.53121561673939 35.587996224102625, -82.53150661680831 35.587862224105244, -82.53170961685382 35.5877852241104, -82.53179161687235 35.587753224112326, -82.53192861690235 35.58770622411687, -82.53197361691193 35.5876922241186, -82.532296616979 35.587604224133926, -82.53260761704117 35.58753622415203, -82.53266961705349 35.58752322415572, -82.53283861708421 35.587505224169476, -82.53324761715902 35.587460224202324, -82.53343661719353 35.5874402242176, -82.53371561724104 35.587432224244694, -82.53402861729144 35.587442224278895, -82.53448061735975 35.58748522433409, -82.53489161742193 35.587524224384204)))",5513,37,021,000800,370210008001,805,805,14,795,603,172,2,15,0,3,10,683,7,676,677,521,138,2,15,0,1,6,499,398,101
census_2010_blockgroups_view.fid--2dc29038_13ec899ba8f_-25f7,"MULTIPOLYGON (((-82.76291966743037 35.50870623169316, -82.7631456674554 35.50878923173317, -82.76348466749127 35.50892423179536, -82.7637346675197 35.509010231838474, -82.76426166758432 35.509162231923355, -82.76459866762563 35.509259231977616, -82.76514766769407 35.50941023206451, -82.76523066770524 35.509427232076426, -82.76525066760216 35.51012323222049, -82.76538066757385 35.510450232300514, -82.76552766759004 35.510504232326596, -82.76566866760822 35.51053923234807, -82.76592866763255 35.510663232399985, -82.76598566762668 35.51076423242641, -82.76596366760873 35.51085723244317, -82.76596666759347 35.510960232464456, -82.76595866757827 35.511051232482195, -82.76589466756319 35.51108023248162, -82.76587866755258 35.511132232490525, -82.76589866754466 35.51120523250748, -82.7659456675381 35.51129923253151, -82.76598566753063 35.5113922325545, -82.7659926675281 35.51141623256016, -82.76601166752975 35.51142623256417, -82.76607466753535 35.511458232577155, -82.7661566675346 35.511552232604664, -82.76622466751243 35.511771232656265, -82.76628266751258 35.5118342326751, -82.76631166751122 35.51187423268616, -82.76633466751098 35.511901232694065, -82.76654766754177 35.511931232722, -82.76665466754926 35.51199923274679, -82.7667156675535 35.51203823276093, -82.76693066757599 35.51212523280069, -82.76699866758209 35.5121592328146, -82.76711266759237 35.51221623283789, -82.7673066676099 35.51231323287754, -82.76760266763047 35.5125012329461, -82.76771666763297 35.51260923297974, -82.76780466762746 35.51274123301569, -82.76785766760925 35.51291823305728, -82.76797166761735 35.512989233083395, -82.76840866765495 35.51321923317495, -82.7686536676675 35.51340423323774, -82.76898666768466 35.51365523332306, -82.76914066770556 35.51368623334505, -82.76940966774693 35.51370923337726, -82.76962466778184 35.513715233400475, -82.7700556678084 35.51401123350489, -82.77039066781363 35.514342233606726, -82.77058566781415 35.51455123366929, -82.7707336678212 35.514666233707906, -82.77091466783803 35.51475323374415, -82.7711026678584 35.51482523377808, -82.77162766793678 35.514885233844005, -82.77194366797559 35.514975233894624, -82.77232566801852 35.515111233961456, -82.7725946680463 35.515222234011546, -82.77297166809414 35.51532023407005, -82.77325966812879 35.51540823411753, -82.77353566815289 35.51555123417485, -82.77390566819516 35.51567823423858, -82.7740326682082 35.51573123426241, -82.77416666822195 35.51578723428753, -82.77434166824185 35.51584823431793, -82.77443566825558 35.51586023432991, -82.77461766828364 35.51587523435159, -82.77497366833967 35.51589723439249, -82.77524866837787 35.51594723443076, -82.7755716684165 35.516046234484016, -82.77595466845331 35.516223234559256, -82.7759576684518 35.516236234562214, -82.77596666844735 35.51627523457113, -82.77597066844592 35.51628923457433, -82.77668166854578 35.516411234671914, -82.77881766884579 35.516777234965005, -82.77952966894567 35.51690023506281, -82.77950766892157 35.51703423508797, -82.77944566884955 35.51743723516382, -82.77942466882541 35.517572235189235, -82.77940866880675 35.51767723520897, -82.77920966872554 35.5179902352525, -82.77886866858614 35.518531235328105, -82.7784076684107 35.51917523541235, -82.77826966835792 35.51937023543802, -82.77818966831029 35.519594235475566, -82.77818466830782 35.51960523547732, -82.7781736683009 35.51963823548288, -82.77816966829842 35.51965023548498, -82.77802466821225 35.520055235552796, -82.77824266821641 35.5202662356181, -82.77893966822944 35.52094023582688, -82.7795506682131 35.52171323604714, -82.77962866819028 35.52194723610289, -82.7796276681897 35.52195023610336, -82.77953966806338 35.522680236243296, -82.77953466805685 35.522717236250315, -82.77952166803726 35.52283123627232, -82.77951766803079 35.52286923627959, -82.77947766797332 35.523201236343326, -82.7794046678657 35.523825236463146, -82.77951466782872 35.52418623654805, -82.77955266781642 35.524308236576886, -82.77974066783435 35.52439623661403, -82.78009266786786 35.52456023668348, -82.78044866790187 35.524726236753764, -82.7804006677758 35.525498236906394, -82.7804006677755 35.5255002369068, -82.78004966769205 35.52566323690412, -82.7797626676078 35.52590123692338, -82.77976166760722 35.52590323692368, -82.77983166757336 35.5262012369916, -82.77966466750364 35.52647523703051, -82.77946766740237 35.526922237101545, -82.77931766732523 35.52726323715578, -82.77921366727179 35.52749923719334, -82.77906766721854 35.52768823721698, -82.77884066713546 35.52798323725391, -82.77787766688871 35.52854723727056, -82.7778756668882 35.528548237270584, -82.77756266677704 35.528933237317176, -82.77736666670721 35.52917623734672, -82.77711566665559 35.529240237334115, -82.77545966631367 35.52967023725247, -82.7753426662894 35.52970123724681, -82.77500466618774 35.52999723727267, -82.7743506659908 35.53057223732307, -82.7742406659083 35.53099123739732, -82.77414466583555 35.531362237463235, -82.77406666573256 35.53195023757524, -82.77401466571824 35.53198723757751, -82.77328066551375 35.53252323761178, -82.77218966524663 35.53308023761385, -82.77074266494816 35.53345423754225, -82.770706664941 35.533462237540135, -82.7693286646145 35.5340942375281, -82.7689256645173 35.53429023752694, -82.76887866450213 35.53433823753188, -82.76797366420918 35.535266237628676, -82.76794766420029 35.535296237632174, -82.76749166404012 35.53584623769777, -82.76732966388855 35.53665923784703, -82.76729666385818 35.5368222378769, -82.76706666372937 35.53741323797402, -82.76705166372119 35.537450237979996, -82.7669716636972 35.537519237985904, -82.76678366364095 35.537682237999924, -82.76664866360068 35.53779823800977, -82.7666436635986 35.537806238010894, -82.7665746635676 35.53793423802997, -82.76608766351208 35.53776623794586, -82.76462866334604 35.53726223769383, -82.76414266329063 35.537095237610046, -82.76371966324477 35.53693423753391, -82.7636876632413 35.536922237528124, -82.76244166310133 35.53647923731035, -82.76201566305349 35.536328237235985, -82.7608276629206 35.53590323702772, -82.75726666252201 35.53463023640375, -82.75678766246835 35.534459236319854, -82.75607366238519 35.53422523619906, -82.75591766236576 35.53418223617431, -82.75573366234258 35.534133236145486, -82.7554466623043 35.53407123610357, -82.7552896622831 35.53403823608073, -82.7550726622517 35.534007236052254, -82.75477066220793 35.533965236012705, -82.75442166215286 35.53394423597272, -82.7542046621186 35.53393223594809, -82.75382666205503 35.53393623591021, -82.75269466186423 35.533950235797285, -82.75231766180059 35.53395523575977, -82.75190566173116 35.53396023571864, -82.75154766167061 35.533966235683216, -82.75019066144087 35.53399023554929, -82.74979766137338 35.5340032355118, -82.74924066127981 35.534008235455744, -82.74847166115039 35.53401623537876, -82.74831666112402 35.53402023536368, -82.74785566104522 35.53403323531912, -82.74770166101881 35.53403823530447, -82.74742566097406 35.5340302352746, -82.74737866096626 35.534029235269614, -82.74659866083282 35.53405223519447, -82.74632366078569 35.53406123516813, -82.74591066071676 35.53406123512595, -82.74501266056679 35.53406423503469, -82.74467366050582 35.534093235005884, -82.74450266047505 35.534108234991415, -82.7442636604316 35.53413223497185, -82.74406066039273 35.53416523495785, -82.74393066036748 35.53418823494927, -82.74358566029657 35.534276234931916, -82.74346566027076 35.534314234927386, -82.74327066022857 35.534377234920285, -82.74249566006365 35.53461123488868, -82.74230166002138 35.53467623488206, -82.74207565997459 35.53473623487126, -82.741988659957 35.53475623486638, -82.74177465991356 35.53480723485491, -82.74139765984125 35.534869234828975, -82.74104465977763 35.53490023479921, -82.74072365972197 35.534915234769414, -82.74047065968068 35.534909234742265, -82.74012365962682 35.5348832347015, -82.73975665957524 35.534821234651226, -82.73942665953145 35.53474823460263, -82.73831065939112 35.534450234427645, -82.73805265935789 35.53438623438817, -82.73675465919058 35.53406723419035, -82.73656365916693 35.53401423415996, -82.73636365914192 35.53396023412849, -82.73598865909314 35.533870234071756, -82.73579665906813 35.533825234042915, -82.73502765897126 35.533621233922666, -82.73457665891435 35.533502233852275, -82.73423965887184 35.533413233799614, -82.73372165880228 35.53330423372437, -82.73324265873288 35.53323623366146, -82.73278265866419 35.53318423360385, -82.73227165858138 35.53316923354843, -82.73194565852693 35.533170233515285, -82.73145465844229 35.53318923346897, -82.73083965833031 35.53325123341869, -82.73082765832821 35.533252233417635, -82.73042065824993 35.53332023338978, -82.73007365818253 35.53338323336719, -82.72985965813984 35.533429233354674, -82.72959265808448 35.533500233341805, -82.72881265792523 35.533692233301196, -82.72769565769708 35.533967233242905, -82.72593265733671 35.53440323315143, -82.72242265662129 35.53525723296636, -82.72200365653629 35.53535723294388, -82.72126065638496 35.535537232904595, -82.72010365615003 35.53581323284243, -82.71976765608531 35.53587023281962, -82.7194856560319 35.53591223279936, -82.71921865598213 35.535947232779115, -82.71889065592352 35.53597323275092, -82.71839465583841 35.5359892327034, -82.71802065577681 35.53598523266426, -82.71756265570342 35.535966232613546, -82.71694465561048 35.53590123253702, -82.71639565553481 35.535798232459825, -82.71616665550444 35.5357482324262, -82.71610565549662 35.53573323241686, -82.71579465545716 35.53565223236851, -82.7156876554436 35.535624232351886, -82.7147586553353 35.53532223219524, -82.71451065530638 35.5352412321533, -82.71376865521991 35.534999232028, -82.71352165519104 35.53491923198639, -82.71328665516111 35.53485923195015, -82.71315065514372 35.5348252319293, -82.71283365510027 35.53476423188446, -82.71257165506243 35.53472623184984, -82.71233265502791 35.53469223181846, -82.71223265501247 35.534684231806565, -82.7119356549666 35.53466023177128, -82.71183665495138 35.5346522317595, -82.71184365495765 35.53461923175352, -82.71186165497285 35.534539231739075, -82.71186265497613 35.534519231735054, -82.71186665498185 35.534486231728756, -82.71186065500439 35.53433223169672, -82.71183965502263 35.53419023166562, -82.71183865502277 35.53418823166513, -82.711788655033 35.534067231635326, -82.71174465503887 35.53398123161332, -82.71169865504217 35.53391023159408, -82.71162265504252 35.533825231568976, -82.71157065504069 35.533780231554466, -82.71154165503968 35.53375523154646, -82.71142065503255 35.53367023151673, -82.71130465502478 35.53359523148955, -82.7112376550194 35.53355723147497, -82.71109565500775 35.53347923144445, -82.71099065499772 35.53343023142378, -82.71097165499586 35.533422231420175, -82.71088265498655 35.53338623140371, -82.71086665498478 35.53338023140086, -82.71075965497249 35.53334423138259, -82.71066565496132 35.533315231367034, -82.71058065495015 35.53329523135429, -82.71049565494013 35.533268231340074, -82.7104486549356 35.533247231330975, -82.7103896549297 35.53322123131969, -82.71034465492733 35.53318823130826, -82.7103086549272 35.533149231296676, -82.71028765492902 35.53311523128755, -82.71026465493668 35.533040231269936, -82.71021465497213 35.532754231206525, -82.71016365499145 35.532572231164146, -82.7101206550069 35.53242523112985, -82.71007965502324 35.53227423109481, -82.71005765503628 35.532165231070294, -82.71004065505717 35.532010231036956, -82.71003765507547 35.53188723101156, -82.71005265510601 35.53170423097584, -82.71006165512173 35.53161123095778, -82.710062655138 35.53150623093652, -82.71005365514891 35.53142523091907, -82.7100366551574 35.53135123090222, -82.71000265516558 35.53126123088039, -82.70996165517252 35.531171230857815, -82.70990065517927 35.531060230828956, -82.70983065518297 35.53096023080141, -82.709770655184 35.53088823078058, -82.70975665518421 35.530872230775934, -82.70966565518326 35.53077923074765, -82.70957765518068 35.53070023072251, -82.70938265517344 35.53053523066893, -82.70927265516683 35.53045923064218, -82.70897965515177 35.530239230567304, -82.70893065514917 35.53020323055496, -82.70885365514582 35.530141230534426, -82.70871965514225 35.53001923049582, -82.70866065514234 35.52995423047658, -82.70865165514233 35.52994423047355, -82.70860965514427 35.529886230457514, -82.7085426551472 35.52979423043188, -82.70851065515043 35.52973823041721, -82.70849165515236 35.52970523040848, -82.70846965515538 35.52966123039727, -82.70842865516056 35.52958323037721, -82.7084246551613 35.52957423037489, -82.70833565518082 35.529350230320205, -82.70831965518558 35.52930123030853, -82.708290655195 35.529208230286585, -82.70827465520401 35.52913223026944, -82.70827165522259 35.52900723024363, -82.70828665523888 35.528917230226824, -82.70830065524962 35.52886223021707, -82.70832865526518 35.5287912302055, -82.70845065532303 35.52854623016797, -82.7084776553357 35.528493230159924, -82.70853365536395 35.528369230140434, -82.70868465544581 35.52799923008042, -82.70871165545918 35.52794123007139, -82.70878065548779 35.52782923005556, -82.70882465550297 35.527778230049684, -82.70887265551782 35.52773323004539, -82.70892965553416 35.52768823004204, -82.70899965555212 35.52764723004086, -82.70907265556907 35.52761623004204, -82.7091956555947 35.527582230047685, -82.70941365563773 35.52753823006104, -82.7095286556633 35.52749623006422, -82.70958665567734 35.527467230064325, -82.70964965569463 35.52742323006179, -82.70970265571064 35.527376230057584, -82.70975565572866 35.52731623005078, -82.70979765574492 35.52725523004264, -82.70983565576124 35.52719023003328, -82.70984665576765 35.52716023002827, -82.7098836557884 35.527065230012695, -82.70991265581212 35.526942229990595, -82.70992065582797 35.526847229972034, -82.70991465584058 35.52675822995331, -82.70990365584959 35.52668722993771, -82.70986965586773 35.52653222990263, -82.70986565587572 35.52647522989054, -82.70986465587774 35.52646122988763, -82.70987165588731 35.526406229877104, -82.70989465589984 35.5263492298679, -82.70992765591264 35.526302229861656, -82.70997465592696 35.52625922985764, -82.71002565594071 35.52622522985603, -82.71022065599244 35.526099229850274, -82.71027765600863 35.52605522984706, -82.71035365603343 35.52597622983873, -82.71038365604585 35.52592722983186, -82.71041865606642 35.52583122981588, -82.71042565607434 35.52578722980758, -82.71042865611678 35.52551322975206, -82.71042465612378 35.525463229741426, -82.7104206561351 35.525385229725146, -82.71042365615259 35.525274229702795, -82.71043765617023 35.525174229683834, -82.71044465617477 35.52515222968011, -82.71045365618042 35.52512522967553, -82.71047465618987 35.525086229669704, -82.71050765619992 35.52505622966701, -82.71051765620278 35.525048229666325, -82.71053165620656 35.525039229665936, -82.71056865621634 35.52501522966481, -82.71062765622973 35.52499222966621, -82.71073265625196 35.52496122967063, -82.7107876562636 35.524945229672994, -82.7109026562902 35.52489622967476, -82.7109706563086 35.52485022967234, -82.71103165632694 35.524796229667565, -82.71110065634714 35.524739229663034, -82.71150465647686 35.52433122962116, -82.71174165655555 35.52407522959321, -82.71205465666365 35.523709229550605, -82.71215365669697 35.52359922953834, -82.71236665676174 35.52340822952117, -82.71256565681762 35.52325922951115, -82.71261165682992 35.523229229509745, -82.71264965683868 35.523213229510404, -82.71270165684905 35.52320222951346, -82.71273765685503 35.52320222951716, -82.71277865686123 35.52320622952213, -82.71284765686872 35.52323222953457, -82.71290165687299 35.52326322954635, -82.71297765687457 35.52333522956885, -82.71307665687118 35.523465229605485, -82.71321365685537 35.52371722967084, -82.71329765683967 35.52391122971903, -82.71332865683553 35.5239722297346, -82.71337465683611 35.524018229748705, -82.71345065683947 35.524079229768965, -82.71345765685992 35.523953229743995, -82.71350365689972 35.52374322970584, -82.71352665693675 35.52352622966393, -82.71354965696396 35.523373229635105, -82.71354965698666 35.523225229604925, -82.71354165702449 35.52296922955192, -82.71353465704209 35.52284722952634, -82.71350365705618 35.52272122949749, -82.71348065706631 35.5226302294766, -82.71345065707243 35.52255722945857, -82.71342865707535 35.5225142294476, -82.71341265707782 35.522481229439194, -82.71339465707719 35.52246522943414, -82.71353165710094 35.52245922944689, -82.71365865712637 35.52243122945422, -82.71367965713097 35.52242422945494, -82.71390065718532 35.52230922945405, -82.71396165719963 35.522282229454795, -82.71404565721656 35.52226322945956, -82.71412965723219 35.52225222946592, -82.7142596572557 35.522240229476715, -82.71441165728203 35.522233229490865, -82.7145106572998 35.52222522949932, -82.7146786573288 35.5222182295152, -82.7150986574028 35.52219122955265, -82.71533165744302 35.52218222957467, -82.71539565745417 35.52217922958059, -82.71553365747651 35.52218322959549, -82.71563965749229 35.52219522960879, -82.71573965750602 35.52221422962287, -82.71584565751974 35.52224022963902, -82.71595265753156 35.52227922965797, -82.71605965754189 35.5223282296789, -82.71645465761438 35.522284229710344, -82.71693265766957 35.522443229791676, -82.71740265771322 35.52266922988579, -82.71781965774649 35.522905229976644, -82.71824265780683 35.52297123003337, -82.71872565788739 35.522970230082585, -82.71963765798155 35.52334723025273, -82.72006665806796 35.52324923027665, -82.72043165814121 35.5231672302973, -82.72120965822346 35.523476230439925, -82.72129365825376 35.5233702304269, -82.72262065865635 35.522183230320614, -82.72356665869765 35.52294223057214, -82.7236396582561 35.525906231184, -82.72407365837223 35.525619231169934, -82.72503165862857 35.524987231139065, -82.72649365903739 35.5239062310682, -82.72661865907256 35.52381323106205, -82.72650865907089 35.523704231028525, -82.72616065906593 35.52335823092241, -82.7259756590965 35.52295723082174, -82.725846659118 35.52267623075116, -82.72630965929636 35.52201523066373, -82.72769865983079 35.520034230401976, -82.7281626600091 35.51937423031477, -82.72830366005539 35.519225230298844, -82.72852766014242 35.51890023025546, -82.72877366023779 35.518544230208015, -82.72947866047475 35.51776323012089, -82.72955066049724 35.51769523011435, -82.72970766054564 35.517549230100634, -82.72996266064705 35.51716423004825, -82.73005866067815 35.517065230037886, -82.73004766068858 35.516985230020396, -82.73004366069233 35.51695623001412, -82.7300286607075 35.51684122998909, -82.7300646607268 35.51675422997504, -82.73009666074327 35.51668122996348, -82.73011366075028 35.51665422995969, -82.73016266077526 35.51654422994226, -82.73016366077553 35.51654322994222, -82.73019866079973 35.51642322992125, -82.7302836608466 35.51620922988628, -82.73031566086604 35.516117229870865, -82.73036766089646 35.51597522984716, -82.73039366091193 35.51590222983497, -82.73042266092749 35.51583222982369, -82.73051966097833 35.515605229787255, -82.73058066100731 35.51548222976844, -82.73060466102191 35.5154132297568, -82.73061966103036 35.51537422975044, -82.73066266105249 35.51527622973487, -82.7306636610531 35.51527322973432, -82.73069866107024 35.51519922972279, -82.73073166108621 35.515131229712324, -82.73079866112089 35.51497722968778, -82.73083166113776 35.514903229676, -82.73084866114635 35.51486522967001, -82.73086966115534 35.51482922966483, -82.73091066117233 35.514763229655564, -82.73099466119963 35.51467622964647, -82.73103666121145 35.514644229644176, -82.73103866121197 35.51464322964422, -82.73109866123035 35.51458822963916, -82.73110866123358 35.51457822963809, -82.73117866125375 35.51452222963386, -82.73125766127862 35.514446229626394, -82.73141466133167 35.5142702296066, -82.73147066134956 35.51421422960086, -82.73151266136514 35.51415822959372, -82.73156766138788 35.514069229581246, -82.73164866141511 35.51397922957119, -82.73165066142975 35.513886229552405, -82.73166366144581 35.51379522953515, -82.73170266147176 35.51366822951329, -82.73179866152658 35.51341422947133, -82.73183266154784 35.513312229453994, -82.7318766615802 35.513148229425, -82.7318856615914 35.51308522941307, -82.73188766160229 35.513016229399206, -82.73187366161801 35.51289822937373, -82.73184766162288 35.51283822935883, -82.73180966162614 35.51277522934208, -82.7317566616259 35.51271922932522, -82.73167766162383 35.51264722930247, -82.73163366162191 35.51261122929068, -82.7315886616201 35.51257422927848, -82.73146466161279 35.51248722924812, -82.73105866158882 35.51220222914844, -82.73101166158432 35.51218022913915, -82.73095866157799 35.51216422913047, -82.73093366157482 35.51215722912645, -82.73082066156047 35.51212822910904, -82.73072966154764 35.512113229096606, -82.73068466154133 35.512105229090366, -82.73056066152395 35.512084229073395, -82.73055266152305 35.512081229071974, -82.73051066151785 35.51206922906522, -82.73048966151546 35.51206222906172, -82.73044566151015 35.51204922905457, -82.73043066150883 35.512041229051384, -82.73041266150722 35.51203222904772, -82.7303896615052 35.51202022904286, -82.73033666150039 35.51199422903219, -82.73032166149943 35.51198422902865, -82.73030066149792 35.51197122902381, -82.73027166149582 35.51195322901723, -82.73022666149352 35.51191922900564, -82.73018566149143 35.51188822899512, -82.73002466148607 35.51174822895009, -82.73002166148592 35.51174522894918, -82.72999766148477 35.51172722894309, -82.72995166148281 35.51169022893085, -82.72994466148252 35.51168422892886, -82.72992466148155 35.51166922892377, -82.72991866148112 35.51166522892232, -82.72990266148025 35.51165322891825, -82.72985266147731 35.51161822890601, -82.72975666147157 35.51155122888252, -82.72965366146516 35.51148122885775, -82.7295876614609 35.511437228842006, -82.72958266146051 35.51143422884088, -82.72950566145671 35.511375228820995, -82.72940066145145 35.511295228793905, -82.72928266145128 35.51116822875594, -82.72925266145113 35.51113622874632, -82.7292186614525 35.51109022873347, -82.72918966145379 35.51105022872239, -82.72916366145394 35.51102122871383, -82.72910866145419 35.51095922869557, -82.72900966146072 35.51080922865484, -82.72896166146387 35.51073622863498, -82.72892466146631 35.5106802286198, -82.72888566147056 35.51061022860152, -82.72881666147536 35.5105032285727, -82.72879866147682 35.51047422856496, -82.72870266147798 35.51036222853231, -82.72866266147696 35.51032522852061, -82.72858566147242 35.51027122850171, -82.72851566146821 35.510222228484594, -82.7284246614614 35.51016822846426, -82.72815866143821 35.510030228408915, -82.72801066142517 35.50995422837826, -82.72791866141827 35.50989922835771, -82.72786466141416 35.50986722834563, -82.72780266140924 35.50983222833214, -82.72773366140507 35.509784228315254, -82.72770766140306 35.50976922830955, -82.72767266140025 35.50974922830192, -82.7276546613991 35.509737228297666, -82.72749066138927 35.509623228257546, -82.7274786613885 35.50961522825474, -82.72736866138594 35.50951222822252, -82.72726266138632 35.5093942281876, -82.72715766139673 35.50921222813968, -82.7271356614022 35.50915222812528, -82.72712866140395 35.50913322812062, -82.72708866141399 35.50902422809434, -82.72707366142085 35.508963228080376, -82.72703366143476 35.508828228048785, -82.72701466144188 35.508761228033194, -82.72699366145034 35.50868322801509, -82.7269246614786 35.50842322795499, -82.7268896614934 35.508288227923906, -82.7269926615124 35.50827622793195, -82.72714266153979 35.50826022794411, -82.72726866156384 35.50824022795287, -82.7273026615706 35.50823322795494, -82.72740566159077 35.50821322796142, -82.72747766160488 35.50819922796588, -82.72758666162736 35.50817122797134, -82.7277676616671 35.50810822797703, -82.72785766168793 35.50807022797843, -82.72793666170702 35.508031227978606, -82.72815266176305 35.507900227973934, -82.72818066177108 35.50787822797233, -82.72836666182359 35.50773722796258, -82.72877166194763 35.50736722792865, -82.72911266204925 35.50707422790364, -82.73010266234853 35.5061952278257, -82.73012466235501 35.50617622782412, -82.730560662488 35.5057812277881, -82.73072666254089 35.50561622777145, -82.73091266260019 35.505431227752744, -82.7311526626765 35.50519322772874, -82.731462662778 35.50486722769395, -82.73164366283726 35.50467722767376, -82.73181466289307 35.5044982276547, -82.7318646629098 35.50444322764865, -82.73212866299792 35.50415422761665, -82.73239166308363 35.50388022758769, -82.73251566312712 35.503731227569986, -82.73255566314076 35.503685227564695, -82.7326906631974 35.503462227532985, -82.7327026632056 35.50342122752587, -82.73273866323 35.50330122750515, -82.73275166323823 35.50326122749827, -82.73286266326133 35.50323122750348, -82.73296566328442 35.503192227506084, -82.73310166331451 35.50314322750999, -82.73361066342271 35.50299022753087, -82.7338276634686 35.50292622753997, -82.73384866347303 35.50292022754086, -82.73401066350638 35.50287822754888, -82.73435666357341 35.50281722757184, -82.73495866368079 35.50277022762384, -82.73643366394379 35.502656227751366, -82.73678566400585 35.50263422778287, -82.73757866414377 35.50259522785605, -82.73810566423754 35.50255622790192, -82.73838666428468 35.50255422793028, -82.73868566433472 35.5025522279604, -82.73908766440076 35.502558228002755, -82.73939266444894 35.502575228037365, -82.73953066446944 35.50259122805474, -82.73973766450042 35.5026142280806, -82.74019666456753 35.50267522814002, -82.74035566459034 35.50269922816115, -82.74054166461698 35.50272722818582, -82.74081466465525 35.502774228223316, -82.74104166468486 35.50282822825759, -82.74120066470434 35.50287422828323, -82.74129266471192 35.50292422830279, -82.74137566471636 35.50298622832398, -82.74146566471855 35.503069228350085, -82.74158766472554 35.503156228380256, -82.74170666473444 35.50322822840712, -82.74184066474635 35.503296228434735, -82.74236866479784 35.50353422853729, -82.74255866481451 35.503632228576684, -82.74261866481922 35.50366722858995, -82.74303966485124 35.50391622868375, -82.7431686648618 35.503987228711395, -82.74333666487402 35.504090228749675, -82.74339566487791 35.5041292287636, -82.74343766487922 35.504166228775425, -82.7437256648885 35.50441922885643, -82.74382666489339 35.50449722888267, -82.74383666489403 35.50450422888513, -82.74394166490161 35.50456922890917, -82.74406566491274 35.50463122893448, -82.74420566492715 35.5046892289606, -82.74436666494364 35.50475722899096, -82.74453266496191 35.50481822902036, -82.74468366498002 35.504864229045154, -82.74483666499974 35.50490222906856, -82.74498066501958 35.50492922908878, -82.74544266508546 35.505001229150764, -82.7454816650911 35.50500722915599, -82.74562966511009 35.50504422917867, -82.74585366513602 35.50511822921662, -82.74616266517297 35.50521322926756, -82.74632066519335 35.50525222929171, -82.74639666520295 35.50527222930349, -82.7466536652354 35.50534022934367, -82.74737966532786 35.50552622945579, -82.74750466534306 35.50556322947615, -82.74758766535238 35.505592229490496, -82.7477016653635 35.505644229512775, -82.74785666537964 35.50570722954155, -82.74800866539412 35.50577822957154, -82.748028665396 35.50578722957539, -82.74820466541117 35.50588022961237, -82.74837066542348 35.50598022964978, -82.74848366543391 35.50603522967252, -82.74850766543669 35.50604322967659, -82.74859966544761 35.50607222969191, -82.74866166545608 35.50608422970074, -82.74877166547395 35.50608722971262, -82.74884266548622 35.50608422971924, -82.74887466549168 35.50608322972229, -82.74898866551582 35.50604922972699, -82.74914066554811 35.506004229733364, -82.74926966557294 35.505982229742116, -82.74937566559284 35.50596722974985, -82.74945166560614 35.505963229756794, -82.74954766562163 35.505966229767225, -82.7496306656339 35.50597622977774, -82.74977466565333 35.506006229798636, -82.75037666573215 35.50614722988891, -82.75043266573908 35.50616222989766, -82.75058566575822 35.50620422992188, -82.7509036657953 35.50630722997537, -82.75100866580753 35.506342229993294, -82.75132266584177 35.50646023004947, -82.75142766585313 35.50650023006834, -82.7517506658873 35.50662923012767, -82.75188266590112 35.506682230151974, -82.75191866590485 35.50669723015878, -82.75208966592336 35.506762230189516, -82.75274566599806 35.506988230302646, -82.75309766603742 35.50711423036432, -82.75324366605444 35.50716223038903, -82.75327366605788 35.50717223039418, -82.75373766611038 35.50733423047468, -82.75378366611564 35.50735023048257, -82.75394766613715 35.50738823050713, -82.754267666179 35.50746323055511, -82.7544026661957 35.50750123057667, -82.7545746662149 35.507563230606884, -82.75460966621866 35.50757623061316, -82.7547076662309 35.507603230628625, -82.75478666624313 35.50760923063795, -82.7548166662486 35.50760623064038, -82.75486466625723 35.50760223064452, -82.75490766626639 35.50758923064622, -82.75493766627261 35.507581230647624, -82.75494666627435 35.50757923064825, -82.75501666629083 35.50754823064901, -82.75525166635308 35.50739723064223, -82.75532666637379 35.507343230638924, -82.75560066644944 35.507147230626934, -82.75598266655858 35.50684923060519, -82.7561566666055 35.50673223059908, -82.75629466664012 35.50665623059771, -82.75645066667693 35.506585230599185, -82.75646166667936 35.50658123059942, -82.75661966671368 35.50652923060501, -82.75670966673188 35.506508230609974, -82.75681066675067 35.506495230617645, -82.75690766676803 35.50648723062589, -82.756946666775 35.506484230629276, -82.757047666792 35.50648323063939, -82.75722366682135 35.50648223065725, -82.7573626668439 35.506487230672384, -82.75746766686011 35.506495230684784, -82.75747766686162 35.50649623068598, -82.75760766688086 35.50651223070258, -82.75773266689711 35.50654223072151, -82.75775466689979 35.50654823072499, -82.75780366690569 35.506563230732965, -82.7580726669346 35.506667230781694, -82.75817866694511 35.506714230802196, -82.75831766695862 35.50677723082917, -82.75843466697016 35.506829230851835, -82.75873766699817 35.50697623091274, -82.7587506669992 35.506983230915495, -82.7595156670663 35.50737823107425, -82.75985366709753 35.507542231142295, -82.75996266710912 35.50758523116215, -82.76004466711865 35.507612231176054, -82.76038366715785 35.5077252312338, -82.76049966717065 35.50776823125443, -82.76051766717258 35.50777523125773, -82.76072866719412 35.507864231297404, -82.76096366721616 35.507976231344294, -82.76117066723675 35.50806723138401, -82.76142166726399 35.50816223142906, -82.76184566731021 35.50832223150501, -82.7623366673633 35.50851023159358, -82.76265366739928 35.50862023164841, -82.76291966743037 35.50870623169316)))",6577,37,021,002401,370210024012,1251,1251,62,1222,1187,4,4,4,4,19,29,928,32,896,919,898,2,4,4,2,9,9,576,491,85
census_2010_blockgroups_view.fid--2dc29038_13ec899ba8f_-25f6,"MULTIPOLYGON (((-82.55763660535189 35.69020724762519, -82.5576696053578 35.69020424762795, -82.55777760537855 35.69018624763546, -82.5581796054556 35.69012024766333, -82.55820060546007 35.69011424766432, -82.55833960548857 35.69007924767146, -82.55839460550003 35.690064247674115, -82.5585446055307 35.69002724768206, -82.55856060553428 35.69002124768244, -82.55861560554602 35.69000424768465, -82.55890260560798 35.68991224769545, -82.55921660568012 35.68978324770157, -82.55934560571166 35.68971824770152, -82.55937460571882 35.68970324770151, -82.55948760574623 35.68964724770177, -82.55971360580398 35.68951624769832, -82.55976760581763 35.689486247697744, -82.55996460587144 35.68935024769035, -82.5600456058936 35.689294247687286, -82.56008560590534 35.68926124768469, -82.56028560596322 35.689102247672935, -82.560432606008 35.68897024766114, -82.56045060601339 35.68895524766003, -82.56054460604213 35.68887024765232, -82.56056860605013 35.688844247649506, -82.56064360607401 35.688770247642196, -82.56066960608207 35.68874624763992, -82.56090060615608 35.68851624761691, -82.56114460623402 35.68827424759272, -82.56159760637804 35.68783024754899, -82.56160660638075 35.6878222475483, -82.56182960645194 35.68760124752623, -82.56201160651027 35.68742024750806, -82.56202460651424 35.687408247506966, -82.5620256065148 35.687406247506686, -82.56210560653963 35.68733124749962, -82.56267460671872 35.686785247447006, -82.56273460673762 35.68672724744143, -82.56275360674333 35.686711247440144, -82.56276260674606 35.68670324743944, -82.56277760675069 35.686689247438146, -82.56280460676476 35.686627247428255, -82.5627696068008 35.686356247369474, -82.5627496068094 35.68627924735181, -82.56273160681694 35.686211247336026, -82.56267060683555 35.686025247291845, -82.56250260685839 35.68569724720778, -82.56243060686378 35.68558524717755, -82.56240360686559 35.685544247166405, -82.56233460687794 35.685390247128005, -82.56229860689223 35.68525924709766, -82.5622966069001 35.68520624708662, -82.5622936069084 35.68514924707464, -82.56230160691443 35.68511924706944, -82.5623156069238 35.68507324706146, -82.5624346069637 35.684943247047215, -82.56246260697219 35.684918247045026, -82.56252960699203 35.68486224704053, -82.56269360701819 35.68486924705883, -82.56291260705301 35.684879247083465, -82.5631836070936 35.68490824711716, -82.56323160710063 35.68491424712337, -82.5633456071156 35.68494024714043, -82.5634226071257 35.68495724715176, -82.56342660712627 35.684958247152416, -82.56361660714552 35.68503824718821, -82.56364460714883 35.68504624719278, -82.563721607158 35.68507024720555, -82.56382660717038 35.685103247223125, -82.5641426072071 35.68520524727646, -82.56418560721207 35.685219247283726, -82.56423960721503 35.68525824729718, -82.56425560721507 35.6852752473023, -82.56430560721505 35.685329247318435, -82.56432260721509 35.685347247323904, -82.56443860721514 35.68547124736107, -82.564521607212 35.685581247391966, -82.56461360720873 35.68570124742593, -82.56473360719977 35.6858882474763, -82.56480660719642 35.68598824750422, -82.5648696071874 35.68611424753637, -82.56490860716603 35.68629424757702, -82.56493860715582 35.68639224760006, -82.56496160714846 35.68646524761733, -82.56500860713565 35.68659824764919, -82.5650586071322 35.686674247669856, -82.56511060713417 35.686717247683994, -82.56525860715135 35.68676524770895, -82.56563460720224 35.68684024776291, -82.56587360723333 35.686896247798956, -82.56607960726018 35.68694424782994, -82.56672560734162 35.687112247930685, -82.56725260740618 35.687261248015226, -82.56781960747229 35.68744324811068, -82.56823260751716 35.68759724818457, -82.5683226075268 35.68763124820077, -82.56842360753768 35.68766924821886, -82.56901560759891 35.687910248328905, -82.56911560760997 35.687946248346485, -82.56917260761506 35.68797424835803, -82.56953160765363 35.688111248422885, -82.56970960766836 35.68820724846081, -82.56972660766995 35.6882152484642, -82.56981060767752 35.688256248481146, -82.56985960768199 35.6882802484911, -82.57007660771048 35.68832924852343, -82.57051960776556 35.6884492485934, -82.57060860777543 35.68848124860916, -82.5708226077908 35.688612248657854, -82.57101360781711 35.68864724868461, -82.57120060784686 35.68865624870568, -82.57132060786851 35.68864524871586, -82.57146160789469 35.688627248726704, -82.57152360790288 35.688641248735955, -82.57159260790763 35.68868424875179, -82.57161760790622 35.68872024876164, -82.57172060790033 35.688869248802646, -82.57183860789058 35.68905924885342, -82.57193760789049 35.68916624888541, -82.57199760788858 35.689243248907246, -82.57199560788473 35.68926524891157, -82.57199160787849 35.68930224891869, -82.57195860786562 35.68934924892493, -82.57190260784951 35.68939324892804, -82.57182560783254 35.68942024892561, -82.57174160781689 35.68943124891925, -82.5715206077825 35.6894162488934, -82.57088760769149 35.68932424880949, -82.57075760766921 35.68932824879698, -82.57064360764731 35.68934724878912, -82.57058260763188 35.689381248789715, -82.57048360760484 35.689450248793634, -82.57040660757778 35.68954224880439, -82.57033060754682 35.689660248820594, -82.57028460751916 35.689790248842364, -82.57025460748584 35.689973248876605, -82.57023860746266 35.69010624890194, -82.57020860744231 35.690205248919035, -82.57018760743277 35.69024424892482, -82.5702546074332 35.690313248945756, -82.57034760742934 35.69043824898081, -82.57043760742125 35.69058724902042, -82.57060160739361 35.69094224910957, -82.57074160738462 35.69115124916656, -82.57089760738111 35.69134124922136, -82.57097960737788 35.69145024925196, -82.57097960736986 35.69150224926251, -82.57097560736722 35.69151524926477, -82.57096060735785 35.69155924927223, -82.57090460734102 35.69160824927638, -82.57083060732332 35.69164324927592, -82.57072260730021 35.69167624927152, -82.57059060727347 35.69170724926427, -82.57050760725502 35.69173724926184, -82.57046760724593 35.691753249261005, -82.5703626072186 35.691817249263174, -82.57029360719393 35.69190224927344, -82.57023360716187 35.692045249296314, -82.57021960714184 35.69215924931812, -82.570244607119 35.6923342493563, -82.57031160708621 35.69261824942109, -82.570381607046 35.69295324949652, -82.57043960701608 35.69320924955455, -82.5704546070084 35.69327424956936, -82.57050260697262 35.693557249631944, -82.57052960694871 35.69374124967217, -82.57053360694441 35.69377324967916, -82.5705356069429 35.69378524968177, -82.57053760692992 35.693871249699534, -82.5705396069251 35.69390424970641, -82.57054360690796 35.69401924973026, -82.57054260690316 35.69404924973631, -82.57054260687826 35.69421024976907, -82.57051060683064 35.69448424982159, -82.5704966068077 35.69461724984722, -82.57049260680515 35.69462924984921, -82.57044560677333 35.69478424987599, -82.57036360673686 35.694932249897754, -82.5702466066969 35.695064249912534, -82.57023560669307 35.695077249914036, -82.57010360664627 35.6952382499332, -82.56975060652894 35.69561724997405, -82.56961460647939 35.6957912499955, -82.56954860644451 35.69594525002003, -82.56951460641322 35.69611125005035, -82.56949060637534 35.69633025009245, -82.56948960637263 35.69634725009583, -82.56947760634361 35.69652125013006, -82.56945560631232 35.69670025016424, -82.56940160628396 35.69682525018418, -82.5693906062782 35.69685025018812, -82.56928860623889 35.69699525020716, -82.56899560613493 35.697352250249686, -82.56886760608917 35.697510250268685, -82.56860360599383 35.69784325030928, -82.56817460584105 35.698369250372245, -82.56801960578463 35.698567250396614, -82.56791860574133 35.69873825042101, -82.56784860570049 35.69892725045228, -82.56784260569353 35.69896525045944, -82.56781560566003 35.69915325049496, -82.56779260562247 35.699371250537, -82.56775660557696 35.69962625058524, -82.56748660553382 35.69961525055515, -82.56689060543825 35.6995922504891, -82.56667660540441 35.69958125046488, -82.5664076053615 35.699569250434664, -82.56632360534824 35.69956525042523, -82.56607260530835 35.699553250396896, -82.56598960529494 35.69955025038777, -82.56605760529672 35.699612250407384, -82.56616560530055 35.69970325043706, -82.56660560531648 35.70007325055768, -82.56670060531911 35.700158250584835, -82.566875605324 35.70031425063462, -82.56703160532844 35.70045325067898, -82.56703560532866 35.70045625068001, -82.5672306053377 35.70060725073086, -82.56739660534878 35.70071425076975, -82.56754560536056 35.700798250802166, -82.56755260536109 35.700802250803704, -82.56773960537733 35.70089825084248, -82.56800960539935 35.70104625090041, -82.56819560541216 35.701163250943445, -82.56832360542084 35.70124425097315, -82.56870160544476 35.701496251063325, -82.56903960546444 35.70173225114624, -82.56924560547814 35.70186525119453, -82.56935560548821 35.70191825121662, -82.56947060550142 35.70195625123627, -82.56954860551166 35.70197425124792, -82.56974560553724 35.70202025127756, -82.57006860558326 35.70207025132102, -82.57071760567557 35.70217125140838, -82.57151260578844 35.70229625151569, -82.57170560581122 35.70235625154781, -82.57188860582897 35.70243825158338, -82.57257160588959 35.7027802517233, -82.5730316059304 35.70301125181778, -82.57310460593587 35.70305425183401, -82.57315960594194 35.70307425184376, -82.57322760594964 35.703097251855404, -82.57343160597289 35.70316625189043, -82.57346160597618 35.70317725189586, -82.57350060598107 35.7031872519019, -82.57355460599504 35.70315525190088, -82.57376560605641 35.70298525188803, -82.57381360607094 35.70294325188447, -82.5739416061091 35.70283425187543, -82.57409660615916 35.70267725185944, -82.57458660633881 35.702043251780694, -82.57463560635654 35.701981251773084, -82.57483160642794 35.701730251742184, -82.57477460640462 35.701820251754675, -82.5746456063526 35.70201725178147, -82.57456160631976 35.70213925179768, -82.57452160630386 35.70219925180578, -82.5742526062 35.70258125185586, -82.57390660607243 35.70303325191231, -82.57368260599308 35.70330525194466, -82.57367660599073 35.70331425194585, -82.57353760594115 35.70348525196638, -82.57335960588017 35.703688251989405, -82.57322060583246 35.70384725200746, -82.57318160581957 35.70388825201181, -82.57289860572597 35.704189252043975, -82.57265260564648 35.70443825206932, -82.572621605637 35.70446625207189, -82.57242660557627 35.70464925208902, -82.57237060555873 35.70470225209404, -82.57201760544896 35.7050322521249, -82.57200960544664 35.70503825212539, -82.57167960534625 35.70533225215126, -82.57132160524071 35.70562925217485, -82.57112960518573 35.70577825218539, -82.57073460507335 35.706080252206284, -82.57068160505877 35.70611725220837, -82.5703366049625 35.70636825222391, -82.57021860493028 35.70645025222852, -82.56992060484892 35.70665525223956, -82.56982560482292 35.70672125224318, -82.56901960460594 35.70725725226936, -82.56899960460078 35.70726925226976, -82.56871960452493 35.707458252279395, -82.5683426044237 35.707707252291264, -82.5681086043606 35.70786325229896, -82.56788360429978 35.70801425230654, -82.56746860418653 35.708300252322054, -82.56717460410466 35.70851325233512, -82.56686960401856 35.70874125235018, -82.56649460391024 35.70903825237203, -82.56633860386466 35.709165252381794, -82.56621760382902 35.70926525238977, -82.56586060372204 35.70957325241569, -82.56578360369821 35.709644252422244, -82.56538660357464 35.71001625245706, -82.56515460350211 35.710235252477766, -82.56465960334377 35.71072625252678, -82.56429260322496 35.71109925256496, -82.56423060320448 35.71116525257204, -82.5638626030813 35.71156525261558, -82.56368060304963 35.71157425259864, -82.56313460295404 35.711605252548715, -82.56295360292222 35.711616252532345, -82.56292160291676 35.711617252529265, -82.5625356028489 35.71164125249435, -82.5624556028346 35.71164725248732, -82.5617896027185 35.71168225242583, -82.56128360262831 35.711721252381665, -82.56099960257767 35.711743252356904, -82.56086960255183 35.71177025234901, -82.56084260255197 35.71174025234014, -82.56076760256032 35.71160625230515, -82.56069660257549 35.7114322522624, -82.56062260259812 35.711206252208704, -82.56060960260292 35.71116125219825, -82.56056160262335 35.710978252155996, -82.5605256026537 35.71074325210444, -82.5605176027033 35.71041425203661, -82.56051560275691 35.71006625196558, -82.56052160289629 35.70917225178411, -82.56052260291644 35.70904325175793, -82.56051560298124 35.70861725167051, -82.56051660299241 35.708546251656145, -82.56051760299873 35.70850625164804, -82.56051760300615 35.70845825163835, -82.56051760302847 35.708314251609, -82.5605186030359 35.70826725159952, -82.56051860305418 35.70814925157549, -82.56051960307558 35.70801225154771, -82.56051960310869 35.707798251504094, -82.56052060312702 35.707681251480395, -82.56052060314755 35.70754825145332, -82.56052360319084 35.70727225139745, -82.56052360320984 35.70714925137241, -82.56052460323065 35.70701625134541, -82.56052460323815 35.70696725133539, -82.56052460326102 35.70682025130551, -82.56052560326847 35.70677225129581, -82.56052560330227 35.706554251251426, -82.5605286034037 35.70590225111897, -82.56052960343742 35.70568525107485, -82.56052960345659 35.70556225104979, -82.56052960351333 35.70519525097508, -82.56052960353226 35.7050732509502, -82.56052860355297 35.70493825092261, -82.56052860357958 35.7047662508876, -82.5605386035907 35.704705250876266, -82.56053460361609 35.70453725084161, -82.56053160363628 35.704403250814, -82.56053160365197 35.704302250793425, -82.56053160369872 35.70400025073192, -82.5605326037143 35.70390025071173, -82.56053260372131 35.70385525070253, -82.56053260374175 35.70372325067564, -82.56053360374872 35.70367925066675, -82.5605346037763 35.70350225063081, -82.56053960385053 35.70302825053482, -82.56053860385863 35.70297425052369, -82.56053760388573 35.702798250487795, -82.56053760389521 35.70273725047541, -82.56053760389578 35.70273325047458, -82.5602486038499 35.70271925044199, -82.56014960383396 35.70271625043111, -82.5598336037825 35.7027092503972, -82.55949860372971 35.70269025035882, -82.5589856036477 35.70266925030168, -82.55878760361587 35.70266225027986, -82.55859860358511 35.70265825025955, -82.55835460354572 35.70265025023281, -82.5582366035266 35.70264725022009, -82.55799360348604 35.702648250195274, -82.55790960346954 35.70266425018987, -82.55783360345212 35.70269525018833, -82.55778060343744 35.702733250190605, -82.55770560341456 35.702800250196574, -82.55767960340611 35.70282725019933, -82.5576386033926 35.70287025020389, -82.55750360335061 35.70299625021561, -82.55736360331183 35.70309725022187, -82.5572806032918 35.70313725022144, -82.55722560327843 35.70316425022122, -82.5571286032579 35.703193250217105, -82.55704160324228 35.70320025020958, -82.55693760322733 35.70318525019583, -82.55687560322059 35.70316225018476, -82.55672260321465 35.70303625014337, -82.55669960321221 35.703027250139144, -82.55671560322787 35.70294325012368, -82.55671460323319 35.70290825011643, -82.55670160323515 35.70288125010964, -82.55666860324023 35.70281325009242, -82.55660460324215 35.70273225006926, -82.55654160324042 35.70267525005119, -82.55645560323836 35.70259625002626, -82.5562886032276 35.702486249986656, -82.55622660322956 35.70240724996417, -82.55621960323174 35.70238524995897, -82.55620360323837 35.7023252499451, -82.55621460328331 35.70204724988962, -82.55615460330257 35.70185824984496, -82.55590860333369 35.70139324972496, -82.55574060333439 35.70120824966996, -82.55573760333431 35.701205249669144, -82.55548760333039 35.70096224959382, -82.55540960332438 35.70091724957662, -82.55535060330125 35.70100324958812, -82.55531660328735 35.70105624959537, -82.55524760325716 35.70117724961286, -82.55517760323315 35.70125724962206, -82.55517260323201 35.70125924962188, -82.55512760321946 35.701292249624004, -82.555083603209 35.70131224962353, -82.55505260320172 35.70132624962314, -82.5549526031814 35.70135024961773, -82.55493160317755 35.70135224961598, -82.554850603163 35.70135924960906, -82.55477160314992 35.701359249600934, -82.5542546030635 35.701362249548325, -82.55384960299317 35.70138124951046, -82.55381660298787 35.7013802495068, -82.55366360296267 35.70137924949093, -82.5535006029386 35.70135924947005, -82.55328960290876 35.70132524944135, -82.55310160288325 35.70128824941447, -82.55281560284438 35.7012322493736, -82.55269560282909 35.70120224935522, -82.55260360281827 35.70117324933974, -82.55248460280686 35.70111924931655, -82.55246160280502 35.70110624931155, -82.55238060279872 35.70106024929378, -82.552287602795 35.70098424926874, -82.55218260278889 35.70091124924307, -82.5520946027811 35.70086724922507, -82.55200960277095 35.70084124921103, -82.5519916027685 35.70083824920857, -82.55190960275655 35.70082724919782, -82.55161760270968 35.70081624916555, -82.55158860270522 35.700814249162136, -82.55142660267998 35.70080324914327, -82.55123160265096 35.70078124911871, -82.55101060261919 35.70074924908942, -82.55097460261373 35.700745249084825, -82.5506946025713 35.70071924905074, -82.55019760249222 35.7006962489949, -82.54997860245872 35.70067724896846, -82.54955760239338 35.700647248919026, -82.54943660237502 35.700636248904274, -82.54934660236327 35.700615248890735, -82.54926360235368 35.70058824887669, -82.54918660234601 35.70055524886203, -82.54914660234256 35.70053424885362, -82.54910860233943 35.70051424884562, -82.54900960233222 35.70045424882323, -82.54870760231564 35.70023724874796, -82.54865760231023 35.70021824873894, -82.54862560230578 35.70021224873442, -82.54863460231047 35.70019224873126, -82.54873160234759 35.700056248713594, -82.54883060238946 35.69989224869038, -82.54916560253649 35.69930224860469, -82.54923360256585 35.6991852485879, -82.54930160259755 35.699053248568035, -82.5493526026236 35.698940248550294, -82.54943760268429 35.69863924849776, -82.54951760277719 35.6981252484014, -82.54956560284501 35.69773824832755, -82.54968760301452 35.69677424814383, -82.5497456031125 35.69620324803354, -82.54974960311887 35.69616624802637, -82.54979160322428 35.6955302479012, -82.54982160328854 35.695147247826355, -82.54983660332326 35.69493924778557, -82.54985560336706 35.69467624773392, -82.54989160342878 35.694316247664375, -82.54991360346452 35.69410924762443, -82.54992960349408 35.69393524759071, -82.54996160355073 35.69360324752636, -82.54998060358288 35.69341624749024, -82.5499996036128 35.693243247456955, -82.55006660373397 35.69253224731911, -82.55006860373646 35.692518247316464, -82.55010460378591 35.692237247263016, -82.550165603844 35.691927247206145, -82.55025760391291 35.69158124714517, -82.55033960396716 35.69131824710004, -82.55046860404117 35.690978247044065, -82.5504796040455 35.69096224704204, -82.55058360410438 35.690693246997945, -82.5506686041501 35.69048924696513, -82.55066860415043 35.690487246964814, -82.5507966042138 35.690215246922584, -82.55091960426985 35.68998524688842, -82.55100160430338 35.68985624687054, -82.55104260431992 35.689793246862, -82.55130460441364 35.68946924682296, -82.55140660444994 35.689344246808005, -82.55146460446929 35.68928124680117, -82.5517116045528 35.68900724677084, -82.55230060474778 35.68837924670356, -82.55239160477763 35.68828424669366, -82.55258560484005 35.688089246673904, -82.55263860485924 35.6880222466657, -82.55282260486067 35.68821024672294, -82.55326060486429 35.68865724685903, -82.55337760486617 35.68877124689427, -82.55338560486639 35.68877824689653, -82.55356760486944 35.68895424695117, -82.55370060487157 35.689083246991125, -82.55377660487476 35.6891442470113, -82.55397260488293 35.689302247063715, -82.55423160489839 35.68948024712657, -82.55447760491718 35.689623247181025, -82.55449860491882 35.68963524718559, -82.55473260494006 35.68974924723295, -82.55482460494838 35.68979424725156, -82.55488760495403 35.68982524726439, -82.55511060497855 35.689906247303846, -82.55520760498929 35.68994124732096, -82.55536860500729 35.68999824734909, -82.55567960504644 35.69007924739763, -82.5558256050646 35.69011824742061, -82.55644660515208 35.690220247505295, -82.55650060516055 35.6902232475115, -82.55700860524101 35.69024924756907, -82.55714460526434 35.69024424758209, -82.55730460529182 35.69023924759751, -82.55763660535189 35.69020724762519)))",6435,37,021,002702,370210027022,1904,1904,40,1843,1786,36,0,7,0,14,61,1544,30,1514,1504,1464,24,0,4,0,12,40,907,829,78
census_2010_blockgroups_view.fid--2dc29038_13ec899ba8f_-25f5,"MULTIPOLYGON (((-82.60653163149271 35.57338522886087, -82.60675163152807 35.57339322888505, -82.60741163163355 35.57342022895828, -82.60763263166895 35.57342922898283, -82.60763863165009 35.57355822900968, -82.60772463158767 35.57405722912017, -82.60776163156092 35.574271229167515, -82.60779563152757 35.57452522922274, -82.60787863146685 35.575009229329844, -82.6079276314369 35.57525722938533, -82.60796063140732 35.575485229435216, -82.60800663138045 35.57571022948569, -82.60803963135174 35.57593222953433, -82.60804063135075 35.575940229536016, -82.60813663128184 35.5764922296583, -82.60814163127094 35.57656822967435, -82.60822363128239 35.57658222968564, -82.60836163130261 35.57660022970341, -82.6085046313234 35.576619229722006, -82.60868363135027 35.576638229744205, -82.60885563138028 35.576629229759995, -82.60902563141275 35.57660122977171, -82.60903563141463 35.57660022977259, -82.60924063145744 35.57654322978198, -82.60949663151138 35.57646922979324, -82.60954763152272 35.57645022979456, -82.60975763156877 35.57637822980143, -82.60994563161381 35.57628822980242, -82.61010863165781 35.57617822979676, -82.61013463166583 35.57615422979454, -82.61020663168838 35.57608522978779, -82.61027763171667 35.575978229773355, -82.61030263173141 35.57590922976182, -82.61036563176813 35.5757382297335, -82.61042663179752 35.57561322971428, -82.61051863182627 35.575525229705825, -82.61056563183777 35.57550122970572, -82.6106056318475 35.57548122970572, -82.61074063187253 35.575464229716154, -82.61088363189573 35.57546822973164, -82.61104563192008 35.57548522975176, -82.61109963192779 35.57549322975887, -82.61122863194616 35.57551322977616, -82.6112786319539 35.57551722978209, -82.61137563196917 35.57552222979308, -82.61154063199525 35.57553122981189, -82.61166663201757 35.57552222982296, -82.6116746320189 35.57552222982379, -82.61175863202811 35.575553229838754, -82.61190263207554 35.57540022982239, -82.61195763209332 35.57534422981659, -82.61215063215407 35.57515722979824, -82.61233263220508 35.57502222978943, -82.61238063221771 35.574992229788315, -82.61243863223281 35.57495622978694, -82.61256763226336 35.57489722978813, -82.61263163226819 35.5749352298024, -82.61266663226537 35.57499122981747, -82.61266863226415 35.575001229819634, -82.61272363223823 35.57522922987172, -82.61276863221272 35.57544422992013, -82.61280063219526 35.57559222995358, -82.61300163224695 35.57547322994992, -82.61301163224954 35.57546722994975, -82.613359632334 35.575294229950195, -82.61367463240857 35.575149229952984, -82.61389863246154 35.57504722995521, -82.61395863246267 35.575104229972965, -82.61414163246673 35.57527623002684, -82.61420363246805 35.575334230044916, -82.61368963233829 35.57562323005112, -82.6133956322637 35.57579023005492, -82.6130116321653 35.57601523006137, -82.61266463206658 35.576282230080146, -82.61244063199834 35.57648423009829, -82.61227163194292 35.57666223011724, -82.61219663191807 35.576742230125845, -82.61189263181053 35.57711323017018, -82.61177263176124 35.57730423019676, -82.61155863166107 35.577724230260415, -82.6115296316442 35.57780323027352, -82.61146063160301 35.57799623030571, -82.61138263154757 35.57827223035389, -82.6113056314559 35.578785230450535, -82.61127863137456 35.57928523054955, -82.61126463124438 35.5801172307176, -82.61126463124086 35.58014023072228, -82.61123863111996 35.58089823087404, -82.61121563109441 35.581039230900394, -82.61114863101778 35.581465230980264, -82.61112763099226 35.581608231007266, -82.61109863096475 35.58175623103439, -82.61101363088187 35.58220323111671, -82.61098663085441 35.58235223114431, -82.61080963074025 35.58290323123837, -82.61076663071476 35.583023231258395, -82.61060563061697 35.58348523133597, -82.61027063045248 35.584192231445655, -82.61008463036656 35.584550231499385, -82.60989863028638 35.58487023154553, -82.60985563026975 35.58493223155376, -82.60945963011393 35.58551723163226, -82.60945463011298 35.58551823163193, -82.60939163010293 35.585515231624896, -82.60930963009237 35.58549523161238, -82.60919563007936 35.585457231593, -82.60916163007676 35.585437231585395, -82.60901563006543 35.5853532315533, -82.60850263003583 35.5849912314269, -82.60838863002827 35.58491723140014, -82.60830063002226 35.58486123137971, -82.60811663000594 35.58476823134187, -82.60811163000577 35.58476423134053, -82.60793562998721 35.58469423130819, -82.60791262998741 35.58466823130054, -82.60769962996767 35.5845662312579, -82.60763562996355 35.584524231242774, -82.60757762995975 35.58448623122909, -82.60745862995637 35.58437923119513, -82.60709662995164 35.58401923108467, -82.60695762994953 35.58388223104243, -82.6067356299462 35.5836642309753, -82.60659662994408 35.58352823093334, -82.60657662994353 35.583509230927426, -82.60637262993869 35.583321230868165, -82.60617462993537 35.583128230808526, -82.60603662993324 35.58299323076688, -82.6060206299329 35.58297823076218, -82.60592962992438 35.58293523074408, -82.60577262990947 35.58286223071316, -82.60560362989588 35.58276823067663, -82.60549662988701 35.582710230653824, -82.60542462988116 35.582670230638314, -82.60533962987351 35.5826282306211, -82.60519262986014 35.58255623059126, -82.60496862984792 35.58239423053528, -82.60490262984614 35.58233423051627, -82.60477362984298 35.582215230478866, -82.60484362986364 35.58215623047398, -82.60498462990883 35.58201523045976, -82.60504062992777 35.581952230452686, -82.60505562994125 35.58188123043973, -82.60506863000636 35.5814712303576, -82.60507463003124 35.581316230326635, -82.605093630164 35.580473230156905, -82.60507163028325 35.5796742299919, -82.60511563039523 35.57899322985772, -82.60511763040964 35.578902229839365, -82.60512463044222 35.57869722979834, -82.60514763049778 35.57836122973231, -82.60518363054985 35.578061229674894, -82.60517963055112 35.57804922967201, -82.60516063055681 35.57799122965826, -82.60508563055174 35.57794322964082, -82.60505963054997 35.57792622963471, -82.60469163051886 35.577731229557216, -82.60455963050752 35.57766222952957, -82.60458863051834 35.57762322952459, -82.6045946305221 35.577605229521545, -82.60466963056378 35.57741522949059, -82.60469463057748 35.577353229480536, -82.60471663058993 35.57729622947119, -82.60476263061287 35.5771962294555, -82.6047796306211 35.57716122945015, -82.604882630651 35.57707822944384, -82.60509863069471 35.57702722945558, -82.60521763071677 35.57701222946472, -82.60538763074817 35.5769922294781, -82.60539163079487 35.57669222941743, -82.60539863081277 35.576583229395936, -82.60540963083665 35.57644022936797, -82.6054206308801 35.576169229313905, -82.60546063094793 35.575771229236935, -82.60547063098495 35.57554122919112, -82.60548263101451 35.57536222915587, -82.6055056310664 35.5750492290945, -82.60552063108321 35.57495622907712, -82.605531631096 35.574885229063746, -82.60553963112145 35.574728229032566, -82.60554363113056 35.57467322902178, -82.60557663119303 35.57430222894967, -82.60558363123401 35.574043228897615, -82.60558963126057 35.57387722886445, -82.60559463127095 35.57381522885228, -82.60560163128653 35.57372122883391, -82.60560663129658 35.57366122882217, -82.60562963133454 35.57343922877934, -82.60563963135047 35.57334622876142, -82.60581763137904 35.57335322878108, -82.60635263146415 35.57337722884088, -82.60653163149271 35.57338522886087)))",5565,37,021,001200,370210012002,716,716,45,687,644,26,0,4,0,13,29,598,30,568,581,547,22,0,4,0,8,17,357,327,30
census_2010_blockgroups_view.fid--2dc29038_13ec899ba8f_-25f4,"MULTIPOLYGON (((-82.60305362475371 35.613426236659, -82.60304162475033 35.61343523665965, -82.6029306247189 35.6135192366653, -82.60282462468784 35.61360623667222, -82.60276362466878 35.613664236677714, -82.60271762465565 35.61370023668033, -82.60267062463986 35.61375223668605, -82.60259062461017 35.61385823669944, -82.60251062457174 35.6140212367244, -82.60245462453413 35.614205236756156, -82.60243862452288 35.61426123676589, -82.60239862448628 35.61445523680134, -82.6023726244509 35.61465723683982, -82.60236562443266 35.61476823686166, -82.60235962441651 35.61486623688108, -82.6023636243637 35.615213236952115, -82.60237962431292 35.61556023702441, -82.60238262428882 35.615720237057374, -82.60236962422839 35.616098237132974, -82.6023656242083 35.616224237158185, -82.6023526241615 35.61651423721602, -82.60236262412958 35.616732237261424, -82.60236762412003 35.61679923727554, -82.60237862411253 35.6168602372891, -82.60238562410791 35.616897237297394, -82.60241862409038 35.617047237331334, -82.60249062406379 35.61729723738966, -82.60251862405575 35.61738023740943, -82.60254662404742 35.61746423742935, -82.60257762404134 35.61753723744747, -82.60264262404618 35.617575237461885, -82.60269262404734 35.61762223747658, -82.60269662404734 35.61762623747782, -82.60272362404429 35.61767523749056, -82.60273962403711 35.61773923750526, -82.60273962402864 35.61779423751642, -82.60272462401468 35.617868237529954, -82.60271762401096 35.61788523753275, -82.60271162400713 35.617903237535806, -82.60270262400125 35.617932237540785, -82.60265462397842 35.618028237555365, -82.60259162394802 35.61815823757535, -82.60256462393487 35.618214237584084, -82.60252562391219 35.61831923760135, -82.60248062388423 35.61845223762387, -82.60246662387482 35.618498237631734, -82.60243962384948 35.61863323765647, -82.60243962382876 35.618768237684, -82.60245662381614 35.61886823770609, -82.60247662380927 35.6189342377216, -82.60250762380473 35.61899723773762, -82.60254762380177 35.61905923775434, -82.60275462380078 35.619289237822485, -82.60283562380047 35.619379237849195, -82.6029616237986 35.61952723789219, -82.60302162379688 35.61960223791366, -82.60304762379741 35.6196272379214, -82.60308262379813 35.619660237931775, -82.60318762380412 35.61973523795778, -82.60324062380919 35.61975923796818, -82.60332862382013 35.619783237982055, -82.60340062383042 35.61979423799172, -82.60345262383778 35.619802237998734, -82.60353362385041 35.61980823800823, -82.60359962386062 35.61981323801598, -82.60370962387918 35.61981123802689, -82.60379862389615 35.6197972380332, -82.60387662391211 35.61977723803716, -82.60394562392753 35.619752238039105, -82.604013623944 35.619718238039226, -82.60413862397623 35.619644238037, -82.60424762400581 35.619569238032874, -82.60436262403938 35.619476238025705, -82.60443762406064 35.61941923802188, -82.60446062406693 35.61940323802088, -82.60461662410717 35.619310238017995, -82.60466562411773 35.619294238019776, -82.60468562412215 35.61928723802043, -82.60476462413747 35.619273238025755, -82.60484462415079 35.619273238033884, -82.60492362416068 35.619294238046294, -82.60498662416603 35.61932723805951, -82.60503762416865 35.61936523807245, -82.60507662416762 35.61941423808647, -82.60508962416186 35.619465238098215, -82.60506762414103 35.619577238118765, -82.6050446241274 35.61964023812922, -82.60499962410748 35.61972123814111, -82.60481662402053 35.62008823819708, -82.6047726239976 35.62018923821309, -82.60469562395214 35.6204012382484, -82.604674623936 35.6204832382629, -82.60465262391514 35.620595238283514, -82.60463662389476 35.620710238305264, -82.60462562386768 35.62087423833755, -82.60463262384543 35.62102623836919, -82.60464362383752 35.62108923838316, -82.60466562383068 35.62115723839926, -82.60472862382093 35.62128823843242, -82.60480362381776 35.621390238460954, -82.60493162382267 35.621496238495624, -82.60497562382673 35.62151723850441, -82.60507562383602 35.62156523852445, -82.60523462385527 35.62161223855038, -82.60542262388505 35.62162123857158, -82.6057906239493 35.62160123860529, -82.60589562396392 35.62162023861995, -82.60596562397075 35.62165123863345, -82.60584862394894 35.62166623862447, -82.60567662391466 35.62170323861433, -82.60558662389668 35.62172323860917, -82.60540462385518 35.621796238605334, -82.60523462381855 35.62185023859886, -82.6050866237909 35.62187023858775, -82.60489562375955 35.62186723856755, -82.60482262375044 35.62184723855593, -82.60471962373758 35.62182023853986, -82.60460862372243 35.621798238523965, -82.60453562370967 35.62180223851728, -82.60449362370241 35.62180423851338, -82.60443062368871 35.6218252385112, -82.60438462367557 35.62186123851376, -82.6043586236618 35.62192223852358, -82.6043246236135 35.6221992385765, -82.60430862357765 35.622414238618624, -82.60430162356039 35.6225192386393, -82.60426562353089 35.622671238666555, -82.60422362350606 35.6227872386859, -82.60415062347468 35.62291223870381, -82.60390862340563 35.62309923871708, -82.60371362335532 35.62321523872064, -82.60364662332893 35.62331423873395, -82.60356862330005 35.623417238746896, -82.60348062327118 35.62351023875683, -82.60338362324309 35.623587238762575, -82.60314662318707 35.62369523876015, -82.60281362311004 35.62383623875471, -82.60275862309719 35.62386023875395, -82.60246362302527 35.624008238753795, -82.6022676229731 35.624135238759465, -82.6022146229506 35.624224238772236, -82.60216862293734 35.624261238774984, -82.60203062289742 35.62437123878319, -82.60198562288407 35.62440923878633, -82.60185862287925 35.62430323875171, -82.601480622865 35.62398823864868, -82.60135462286016 35.62388323861436, -82.60133362285471 35.62389623861488, -82.6012736228387 35.62393523861669, -82.6012536228332 35.62394923861744, -82.60111562279936 35.62402023861771, -82.60099962277069 35.62408123861828, -82.60074462270777 35.62421423861916, -82.60070262269758 35.62423523861911, -82.60065562268571 35.62426123861962, -82.6005656226637 35.62430723861967, -82.6002376226554 35.624007238525, -82.59943362260852 35.6234442383276, -82.59923762259703 35.623307238279615, -82.59867162252033 35.623194238198415, -82.59816962245245 35.62309323812624, -82.59766862238459 35.622993238054455, -82.59692862228438 35.62284523794829, -82.59673762225844 35.62280723792095, -82.59602762211888 35.622947237876446, -82.59502262192127 35.62314523781358, -82.5935206216258 35.623442237719686, -82.59101262113272 35.623937237562885, -82.59038362100901 35.62406123752354, -82.58959462082225 35.624422237515994, -82.5883456205265 35.62499423750412, -82.58705262022035 35.625586237491774, -82.58691862018865 35.625647237490426, -82.58669562015945 35.62559623745712, -82.5852876199749 35.6252752372471, -82.58388061979059 35.62495423703717, -82.58276561964459 35.62469923687062, -82.58210961960707 35.62423523670875, -82.58063661960156 35.62268323624132, -82.5798546196748 35.62136523589262, -82.57973861968571 35.62116923584077, -82.57954161970402 35.620838235753126, -82.57833661981682 35.61880723521571, -82.57775561992817 35.61745823488137, -82.57699362007398 35.61569023444311, -82.57681362005948 35.6155902344042, -82.57687762015242 35.61505623430204, -82.57692462022004 35.61466823422793, -82.57701162031145 35.61416823413502, -82.57713462044022 35.61346523400451, -82.57722762053717 35.612936233906346, -82.57722962057125 35.61271723386197, -82.57723162059146 35.612588233835936, -82.57723562064571 35.61224023376545, -82.57723662066626 35.61210823373869, -82.57723662067318 35.61206323372952, -82.57723662070676 35.61184523368512, -82.577197620722 35.61170423365242, -82.57708062076776 35.61128123355425, -82.57704162078286 35.611141233521764, -82.57715662081368 35.611065233518104, -82.57729862085158 35.61097223351373, -82.57750362090624 35.610838233507536, -82.5776196209371 35.61076323350425, -82.57767162097382 35.61058123347245, -82.5777716210041 35.61049223346464, -82.57779862101209 35.61046923346269, -82.57800362110272 35.610102233409016, -82.57799862111855 35.609994233386566, -82.57812662115707 35.609882233376865, -82.57823262120736 35.60967023334462, -82.57832962125285 35.60947923331568, -82.57841162127755 35.60940723330944, -82.57848062128025 35.60946423332814, -82.57869062128884 35.60963523338453, -82.57876062129165 35.60969223340334, -82.5787986212932 35.60972323341354, -82.57891362129787 35.60981723344448, -82.57895262129936 35.609849233455, -82.57914062130673 35.61000423350589, -82.57922262131001 35.610071233527925, -82.57931562131382 35.61014723355301, -82.57935562131652 35.610172233562196, -82.57941062132058 35.61020523357451, -82.57951762133025 35.61025823359634, -82.57959262133853 35.610285233609574, -82.5796576213467 35.61030223361966, -82.57973862135894 35.61031023362959, -82.5798216213733 35.61030623363729, -82.5799296213941 35.61028823364474, -82.580021621414 35.6102582336481, -82.58014062144441 35.61018923364624, -82.58023162147263 35.61010423363831, -82.58030162149964 35.61000423362516, -82.58032862151752 35.60991723361018, -82.58033462153251 35.609826233592315, -82.58031762154049 35.609756233576306, -82.58028962154816 35.60967623355712, -82.58024762155054 35.60961523354036, -82.58021162155129 35.60957223352791, -82.58018762155169 35.609543233519545, -82.58003062154671 35.60940623347555, -82.57998062154661 35.60935323345957, -82.57996862155443 35.6092892334453, -82.57997862156331 35.60924223343682, -82.58002962157995 35.609189233431245, -82.58003962158243 35.60918423343123, -82.58041562161232 35.609395233512814, -82.58051062161923 35.609453233534424, -82.58056962162225 35.6094972335495, -82.58060262162232 35.609532233559925, -82.58063162161885 35.60958623357388, -82.58065162161188 35.6096532335896, -82.58066862159679 35.609769233614976, -82.58067862158858 35.60983323362908, -82.5806866215254 35.61025223371521, -82.58068062151516 35.61031223372678, -82.58066662150284 35.61037723373862, -82.58064762149053 35.610436233748636, -82.58060862147256 35.61051123375987, -82.58054662143404 35.6106942337908, -82.58054562142509 35.61075123380235, -82.5805606214149 35.610833233820564, -82.58059162140994 35.61089923383715, -82.58064662140828 35.61096923385708, -82.58071862141024 35.611034233877696, -82.58078862141558 35.61107523389322, -82.58090162142835 35.61111423391276, -82.58114962145761 35.61119123395396, -82.58138762148693 35.611258233992096, -82.58156662150962 35.611303234019616, -82.58165362152351 35.611307234029404, -82.58173362153916 35.61129223403448, -82.58183762156115 35.61126123403886, -82.58204362160697 35.61118623404479, -82.58276662176733 35.61092523406593, -82.58290262179743 35.61087623406989, -82.58294862180762 35.61085923407119, -82.58308962183881 35.61080923407548, -82.58313662184908 35.61079323407697, -82.58316562184984 35.61082023408552, -82.58323062184698 35.610908234110084, -82.58323462184691 35.61091323411157, -82.58330662184251 35.611019234140514, -82.5833766218385 35.61112123416847, -82.5834776218305 35.61128223421165, -82.58351762182726 35.61134623422881, -82.583553621823 35.61141223424593, -82.5838006218946 35.61121423423095, -82.58381862189971 35.61120023422992, -82.58401662195334 35.611066234223046, -82.584127621982 35.610999234220735, -82.58418962199636 35.61097323422183, -82.58428762201586 35.61095223422764, -82.58441962203766 35.61095323424142, -82.58455162206036 35.610948234253875, -82.58473662209127 35.61094723427281, -82.58476962209745 35.61094223427512, -82.58482762210834 35.61093423427946, -82.5850196221469 35.61089123429042, -82.58509362216546 35.61085023428963, -82.58511562215944 35.61091323430473, -82.5851226221554 35.610947234312384, -82.58513962214617 35.611025234330064, -82.5852236221278 35.61123523438144, -82.58522662212755 35.611240234382784, -82.58527062212158 35.6113262344048, -82.58532662211408 35.611435234432705, -82.58534462211203 35.6114682344413, -82.58545362209928 35.61166823449323, -82.58549162209442 35.61174123451202, -82.58553562208878 35.61182523453363, -82.58561362208413 35.611939234564844, -82.58567962208684 35.61199323458263, -82.58577962209654 35.61203823460209, -82.58587862210878 35.612065234617724, -82.58628562216565 35.61213523467379, -82.58656862220818 35.61216423470871, -82.58671162223104 35.61217023472466, -82.5867536222375 35.612173234729575, -82.58697962227185 35.612194234757055, -82.58711762229136 35.612216234775694, -82.58721962230467 35.61224023479107, -82.58724662230303 35.61228023480204, -82.58728762230625 35.61230323481091, -82.58736662231432 35.61233623482578, -82.58748462232816 35.61237323484542, -82.58781962236611 35.612488234903246, -82.58793262237926 35.612525234922366, -82.5880986223984 35.61258023495064, -82.58823462241696 35.612606234969924, -82.58835562243604 35.612613234983755, -82.5884426224524 35.61260023499009, -82.58852662247345 35.61255423498935, -82.58855562248789 35.61249223497963, -82.5885686225011 35.61242023496634, -82.58857062251762 35.61231523494515, -82.58855262257237 35.61194023486694, -82.58851962264131 35.61145723476518, -82.58851862267224 35.61125523472394, -82.58853162273246 35.6108782346485, -82.58853362273791 35.61084523464199, -82.58855862279145 35.6105242345792, -82.58855962282131 35.61033223454019, -82.58857162286391 35.61006823448766, -82.58858262288794 35.60992423445946, -82.58859262290765 35.60980723443669, -82.58861862294405 35.60959823439675, -82.58863762296295 35.60949623437796, -82.58864462296926 35.60946323437204, -82.58865762297813 35.60941923436431, -82.58867262299017 35.609357234353226, -82.58866462299291 35.60933123434717, -82.58867962304896 35.60898323427783, -82.58868362306167 35.60890523426233, -82.58871062322666 35.60786323405296, -82.58871062322753 35.60785723405175, -82.58871362328573 35.60748223397569, -82.58928562337168 35.60754123404639, -82.58938762338698 35.60755223405915, -82.58956862341589 35.60756023407935, -82.58971762344261 35.607547234091975, -82.58978862345687 35.607531234096, -82.58986362347349 35.60750423409824, -82.58992862348877 35.60747523409904, -82.59001262351035 35.607425234097455, -82.59009462353256 35.60737023409466, -82.59043262362692 35.60712223407892, -82.59066762368843 35.60697623407328, -82.5908246237268 35.60689623407316, -82.59094562375617 35.60683623407335, -82.59122362382303 35.606702234074596, -82.59134362385124 35.606648234075955, -82.59155362384594 35.60690923415072, -82.5916836238426 35.60707123419701, -82.59182862384239 35.60722923424406, -82.5919406238459 35.607327234275495, -82.59199862384914 35.607369234290026, -82.59230662387112 35.60755823436013, -82.59230962387132 35.60756023436088, -82.59244962387919 35.60766023439563, -82.59255562388046 35.6077662344281, -82.59256462388014 35.60777823443144, -82.59269362387383 35.60795823448131, -82.59271962387264 35.60799423449135, -82.59279862386572 35.60812423452593, -82.59295162385511 35.608358234589296, -82.5930076238538 35.60842723460918, -82.59307662385432 35.608498234630645, -82.59308562385449 35.60850723463347, -82.59318162385888 35.60858223465853, -82.59325962386549 35.6086232346749, -82.59338562387958 35.608668234697014, -82.59348062389267 35.60868523471029, -82.59360762391209 35.60869623472556, -82.59372162393088 35.60869723473739, -82.59401562398313 35.608675234763176, -82.5944196240597 35.608614234792185, -82.59454962408326 35.60860123480297, -82.59455362408399 35.608601234803324, -82.59463562409746 35.608602234812025, -82.59472962411016 35.60862123482545, -82.59483562411728 35.60868923485019, -82.59489162412012 35.6087312348645, -82.59494862411759 35.608809234886266, -82.59502862410535 35.60897523492825, -82.59525962405203 35.609570235073235, -82.59529462404723 35.60963923509087, -82.59533662404559 35.609695235106564, -82.59540362404599 35.60976523512769, -82.5955306240517 35.60986523516111, -82.59586462407007 35.61010623524455, -82.5959766240785 35.61017223526941, -82.59605762408621 35.610209235285275, -82.5961456240969 35.61023523529965, -82.5962636241127 35.61026023531681, -82.59639762413232 35.61027723533408, -82.59693562421513 35.6103202353981, -82.5971216242465 35.61031723541657, -82.59742762430024 35.61029823544415, -82.59750762431348 35.6102992354525, -82.59757362432113 35.61032023546362, -82.59762362432501 35.61034923547462, -82.59763062432556 35.610353235476154, -82.5976616243248 35.610391235487086, -82.59768262432186 35.61043323549781, -82.59769162431722 35.61047323550684, -82.59768562430807 35.61052623551706, -82.59766362429681 35.61057523552479, -82.5976206242797 35.61064023553356, -82.59733162418547 35.61094023556504, -82.59706662410258 35.611192235589115, -82.5969956240797 35.61126423559651, -82.59694162405891 35.61134123560658, -82.59690962404672 35.61138523561229, -82.59688362403658 35.611423235617394, -82.59685262401486 35.61153123563614, -82.59685062401343 35.61153823563738, -82.59684062400339 35.61159223564734, -82.59682962399329 35.611646235657275, -82.59681662397051 35.61178023568316, -82.59680762395342 35.611881235702896, -82.59680662393878 35.61197523572186, -82.59682362392637 35.6120742357438, -82.5968626239133 35.61220123577365, -82.59690962390037 35.61233523580575, -82.5969226238972 35.612370235814254, -82.59696562388159 35.612518235848746, -82.59702162385818 35.612730235897786, -82.59704662384094 35.612869235928585, -82.59705762383355 35.61292923594194, -82.59706862381164 35.613083235974415, -82.59705462378871 35.61321723600027, -82.59700162375637 35.61337023602601, -82.59691862371574 35.61354423605288, -82.59680262366238 35.61376523608606, -82.59673462363378 35.613877236101885, -82.59665962360164 35.614005236120185, -82.59654262355478 35.6141832361444, -82.59646762351504 35.614360236172786, -82.59644262349379 35.61447123619283, -82.59643262347693 35.614570236212025, -82.59644462346405 35.61466623623273, -82.59646962345124 35.614776236257725, -82.5965386234328 35.61497023630434, -82.59669962339652 35.615380236404405, -82.59674262338952 35.61547223642754, -82.59678262338504 35.61554423644626, -82.59682262338339 35.615598236461395, -82.59688562338532 35.61565323647907, -82.59697162339094 35.61570923649935, -82.59709562340328 35.615763236523065, -82.59733962342966 35.61585523656687, -82.59745162344052 35.61590623658871, -82.59760162347908 35.615817236586054, -82.59791762355535 35.61566323658713, -82.59817362362836 35.615465236573115, -82.59883962380432 35.615042236555354, -82.59990962408035 35.61440423653532, -82.60037262418976 35.614194236540115, -82.60062262424889 35.61408023654254, -82.60091662430848 35.614010236558464, -82.60106662433884 35.61397523656678, -82.60126862437579 35.61395323658302, -82.60158462444187 35.613865236597555, -82.60177962448954 35.61376623659745, -82.60225162461978 35.613430236577464, -82.60235162464734 35.613359236573245, -82.60244962467641 35.61327623656642, -82.60271462475421 35.61305723654902, -82.60286062480662 35.612874236526764, -82.6033196249716 35.61229823645655, -82.60353562503715 35.6121062364397, -82.60377062511932 35.611826236406785, -82.6040126252198 35.611435236351966, -82.60452262538874 35.61088823629298, -82.60446062535986 35.611009236311205, -82.60424662527178 35.611350236358696, -82.60422362526197 35.611389236364225, -82.60418662524529 35.611457236374356, -82.60411562520997 35.61161023639823, -82.60403662516602 35.61181023643082, -82.60390262509658 35.612116236479345, -82.60361062495936 35.61269223656672, -82.60354762493147 35.61280523658324, -82.60345662489085 35.612970236607545, -82.60332662483755 35.61317623663618, -82.60324962481343 35.613250236643296, -82.60321062480139 35.61328623664665, -82.60313562477748 35.61336023665397, -82.60309362476559 35.61339223665615, -82.60305362475371 35.613426236659)))",6259,37,021,001400,370210014003,1019,1019,76,984,866,60,11,7,0,40,35,834,47,787,820,739,44,7,5,0,25,14,389,358,31
census_2010_blockgroups_view.fid--2dc29038_13ec899ba8f_-25f3,"MULTIPOLYGON (((-82.39873357770657 35.69845823292435, -82.39875957770604 35.69848923293337, -82.39880357770691 35.698530232946275, -82.3988795777127 35.69857423296308, -82.39899057772462 35.69861623298303, -82.39907057773615 35.69862723299351, -82.39917757775311 35.698632233005554, -82.39926157776772 35.698627233013205, -82.39944757780368 35.69859423302567, -82.39952457781848 35.69858123303106, -82.39984357788529 35.69849123304563, -82.4002965779858 35.69832723305905, -82.40038957800579 35.6982972330626, -82.40051857803196 35.69826623306961, -82.40061157804921 35.69825423307675, -82.40072057806658 35.698259233089054, -82.40082057808074 35.69827423310236, -82.40087157808601 35.698295233111914, -82.40091757808898 35.698325233122695, -82.40096057808846 35.698374233137116, -82.40099157808523 35.698428233151354, -82.40100457807758 35.69849123316545, -82.40100457806689 35.69856023317953, -82.40099157805683 35.69861123318845, -82.40095957804331 35.69866423319602, -82.40091657803016 35.698703233199446, -82.40084557801065 35.69875323320225, -82.40077657799341 35.69879023320268, -82.40069657797525 35.69882223320089, -82.4001305778554 35.69899023317669, -82.3998105777838 35.699110233168064, -82.39977957777683 35.69912223316726, -82.39963757774319 35.69918723316582, -82.3992985776577 35.69937623316929, -82.3991745776249 35.69945523317257, -82.39900957757897 35.69957523317989, -82.39891657755147 35.699653233186154, -82.39966157767539 35.69965023326241, -82.40058057782798 35.69964723335661, -82.4018995780436 35.69966623349662, -82.40264557816535 35.69967823357605, -82.403158578232 35.69979623365295, -82.40416957836334 35.70002923380463, -82.40468657842266 35.70019923389249, -82.40518757848002 35.700364233977794, -82.40520757848246 35.70037023398103, -82.40524257848634 35.70038223398715, -82.40526257848671 35.70040123399305, -82.40527857848706 35.70041623399771, -82.40638857850689 35.701474234327286, -82.406944578518 35.70199623449077, -82.40744257854794 35.70233523461107, -82.40806357863424 35.702442234696974, -82.40988057888397 35.70277323495168, -82.41068257898041 35.70300823508222, -82.41069157898109 35.70301323508412, -82.41085857899311 35.703114235121944, -82.4113505790287 35.70341023523288, -82.4117995790748 35.70359323531644, -82.41199957906645 35.703860235391346, -82.41250557900497 35.70479723563398, -82.41266657899223 35.705051235702214, -82.4129065789732 35.705430235804045, -82.41324857897592 35.705778235910074, -82.4143475790737 35.706322236134056, -82.41551757913325 35.707188236430824, -82.41709757921384 35.708356236831364, -82.41754157921935 35.70879523696637, -82.41828557918495 35.70981223724987, -82.41850257918392 35.71005023732069, -82.41973657930122 35.710612237562295, -82.42004357931823 35.71083123763847, -82.42021157930722 35.711081237706665, -82.42046757929025 35.7114642378109, -82.42121157924865 35.71252723810386, -82.42168957926543 35.71292923823484, -82.42224357932503 35.713137238334326, -82.42327057948519 35.713202238453555, -82.4240695796245 35.71315823852705, -82.42494857978822 35.713042238594156, -82.42514757982526 35.713016238609406, -82.42519557983418 35.713010238613144, -82.42562357990555 35.71300723865672, -82.42592957993236 35.71316123871957, -82.42657057992211 35.7139122389384, -82.42665057991736 35.71402823897033, -82.42713157988857 35.71472823916221, -82.42808857990237 35.71566123945073, -82.42849757992785 35.71593423954834, -82.42856757989661 35.71621023961171, -82.4285165798222 35.71663523969288, -82.4284205797217 35.71718023979382, -82.4285035796855 35.71750223986782, -82.42876657964003 35.71807624001168, -82.4287995796343 35.71814824002971, -82.42915657961022 35.718685240175716, -82.42964657956372 35.71950824039366, -82.42974957955197 35.71969424044206, -82.42999157952468 35.720128240555304, -82.43009857952937 35.720212240583436, -82.43032857954181 35.720378240640876, -82.43095957964599 35.72038124070662, -82.43209957986011 35.720219240791394, -82.4330695800389 35.720103240867914, -82.43429858022522 35.7202162410177, -82.43442158024378 35.720228241032856, -82.43560158037992 35.72061124123244, -82.43688358051591 35.72110524146526, -82.43762458057533 35.721514241624895, -82.43827358057233 35.72222724183678, -82.43871858050113 35.72316124207265, -82.43915158042518 35.72411324231098, -82.4395535803913 35.72476124248419, -82.44006858039752 35.72527124264109, -82.44162758046771 35.72648524304889, -82.44252358047689 35.72738324332391, -82.44327058065767 35.72701724332662, -82.44383158079913 35.726705243321064, -82.44388158081156 35.72667824332069, -82.44437858093255 35.72643024332157, -82.4458015812193 35.72610324340199, -82.44644858133546 35.7260462434571, -82.44743758151274 35.72596124354189, -82.44800058160725 35.725954243598565, -82.44820358157725 35.72636424370288, -82.44846758153837 35.72689724383851, -82.44857458152269 35.7271122438933, -82.44875758149598 35.727480243987, -82.44881958148919 35.7275902440158, -82.44904658146488 35.72798924412041, -82.44908458145748 35.728077244142234, -82.44930758142735 35.72851024425333, -82.4493365814236 35.72856524426744, -82.44945558137023 35.729036244375486, -82.44983058128915 35.72995924460193, -82.4499445812817 35.73012924464833, -82.45009758127166 35.7303572447105, -82.45033158127902 35.730560244775894, -82.45052058127183 35.73080824484583, -82.45072258127276 35.731018244909365, -82.45087758126105 35.73125924497439, -82.45091758126429 35.73128124498301, -82.45101258125462 35.731445245026116, -82.45122858125102 35.7316992451001, -82.45144458125966 35.73187424515796, -82.45161858127257 35.73197724519691, -82.45197658129916 35.73218824527674, -82.45231358133813 35.732297245333775, -82.45290658142024 35.7324022454163, -82.45306858144043 35.73244524544173, -82.45337858148861 35.73246624547798, -82.45363458151898 35.732544245520295, -82.45389058154612 35.73264324556686, -82.45413358156001 35.732813245626545, -82.45454458159084 35.73305424571792, -82.454746581602 35.73319824576809, -82.45558258168359 35.733566245929225, -82.45625058176608 35.733748246035184, -82.45678958182859 35.73392224612617, -82.4570125818555 35.73398724616241, -82.45701858185615 35.73398924616343, -82.45738258190899 35.734038246210964, -82.45751758192456 35.734082246233875, -82.45840658204405 35.73426224636223, -82.45852858205754 35.73430624638375, -82.45879758207997 35.73444924644061, -82.45886358208294 35.7345002464578, -82.45901558209016 35.7346162464971, -82.45914158209605 35.73471324652981, -82.4593265821008 35.73488024658287, -82.45945158210408 35.73499324661881, -82.45957358210724 35.73510324665371, -82.45958958210616 35.73512724666021, -82.45976158209588 35.735377246728895, -82.4600255820422 35.73600524688382, -82.46019358202912 35.73626924695489, -82.46021058202955 35.73628424695966, -82.4606785820416 35.73670724709405, -82.46085458205015 35.736840247139234, -82.46117158207272 35.73703324721127, -82.46127858208729 35.73705424722661, -82.46153558211296 35.73716324727523, -82.46166958212315 35.7372412473049, -82.46195358213436 35.73747224738122, -82.46220958215802 35.73759324743232, -82.46242558218287 35.737664247469006, -82.46245158218416 35.73768424747578, -82.46369758233938 35.7380162476719, -82.46383358235614 35.738053247693436, -82.46404958237498 35.73816324773814, -82.46408958236616 35.738262247762385, -82.46407658234031 35.738415247792126, -82.46409758230948 35.73863624783929, -82.46407058225223 35.73897624790568, -82.46404458223047 35.73908824792578, -82.46412158223242 35.739158247947955, -82.46418458223602 35.73920224796341, -82.46428758224177 35.739275247988914, -82.46450658226166 35.739381248033034, -82.46467358228116 35.739434248061094, -82.46484658230119 35.73949024809035, -82.46483258229733 35.739500248090884, -82.46481058228822 35.73953524809577, -82.46473558225715 35.73965524811243, -82.46438258210385 35.74026524820013, -82.46428758206095 35.740440248225894, -82.46419658201954 35.74060924825093, -82.46409858197055 35.74082024828365, -82.46391858187819 35.74122224834687, -82.46385758184061 35.741399248376595, -82.46377858178634 35.74166424842233, -82.46372558173887 35.74191324846751, -82.4636835816906 35.742179248517274, -82.46367758166683 35.742326248546604, -82.46371158161392 35.7427032486268, -82.46370458158778 35.742864248658776, -82.46368558155888 35.7430292486904, -82.46361958151739 35.74322624872362, -82.46352458146276 35.74347624876471, -82.46346758143511 35.74359324878258, -82.46340358140328 35.74373024880386, -82.46325858134125 35.74397424883857, -82.4631575813068 35.74408824885133, -82.46276758118944 35.744427248879994, -82.46272058117543 35.74446724888336, -82.46260458114045 35.74456824889185, -82.46258158113352 35.74458824889357, -82.46253658111962 35.74463024889747, -82.46239858107697 35.744757248909046, -82.46230258104436 35.74486424892089, -82.46227258103379 35.74490024892515, -82.46215258098209 35.74510524895444, -82.46198258090327 35.745431249003225, -82.46188458084808 35.74568124904398, -82.46185958083328 35.74575024905545, -82.4617885807898 35.74595424908964, -82.46176358076808 35.74606724911003, -82.46173258074026 35.74621324913647, -82.46171058068916 35.74651824919626, -82.46168458064176 35.74679624925015, -82.46163858059428 35.74705224929749, -82.46157458053773 35.747348249351035, -82.46157158053553 35.74735924935297, -82.461481580467 35.74770424941394, -82.46137558038181 35.74813924949143, -82.46127558029634 35.74858224957127, -82.46107758012671 35.74946324972998, -82.46096358002059 35.75002424983232, -82.46090257995886 35.75035624989358, -82.46087957993444 35.75048924991829, -82.46084857991205 35.7506002499376, -82.46076457986966 35.75078324996621, -82.46065757982822 35.75093524998605, -82.46049757977306 35.75111925000696, -82.46033957971628 35.75131625003072, -82.46028457969038 35.75142425004708, -82.46015657960525 35.75183525011739, -82.46009357955796 35.75207225015914, -82.46000957949481 35.75238925021495, -82.45985657941131 35.75276325027521, -82.4597505793541 35.75301825031614, -82.45957257926332 35.75341225037786, -82.45950657922768 35.753571250403446, -82.45931957912698 35.754019250475274, -82.4592525790828 35.754232250511706, -82.45919457903723 35.75446325055268, -82.45914757900358 35.754629250581594, -82.45904757895205 35.75485425061702, -82.45898057891921 35.754994250638596, -82.45891057888501 35.75513925066088, -82.45880457882613 35.75540525070403, -82.45877957881373 35.75545825071224, -82.45871557878223 35.75559225073285, -82.45860957873467 35.75578525076118, -82.45850157869705 35.75591225077591, -82.45815557858008 35.75629525081804, -82.458109578562 35.75636225082693, -82.45807457854498 35.75643425083797, -82.45805457852943 35.756513250851995, -82.45804157850941 35.75662825087401, -82.45801757844741 35.75700125094744, -82.45801257843368 35.7570842509638, -82.45801357836675 35.75751625105175, -82.4579985782764 35.75808125116517, -82.45798157820492 35.75852325125338, -82.45793757815782 35.758779251300815, -82.45784957811303 35.758973251331206, -82.45773757806789 35.759144251354414, -82.45767557804251 35.75924125136777, -82.4575385779842 35.75947025140019, -82.45738957791617 35.75974825144133, -82.45737457790864 35.75978125144656, -82.45724657784325 35.76006525149106, -82.45717057780138 35.76025325152145, -82.45713957778365 35.76033425153479, -82.45709957774766 35.76052325156911, -82.45708857772338 35.76066725159725, -82.4570955776804 35.760951251655754, -82.45710157767859 35.76096925165996, -82.45713057763669 35.76127025172424, -82.45713657760939 35.761452251761874, -82.45713057758303 35.76161525179443, -82.45711257756753 35.761695251808796, -82.45708557755033 35.76177725182275, -82.45708457754952 35.76178125182343, -82.45705057753052 35.76186725183741, -82.45697957749634 35.76201125185934, -82.45688157745195 35.7621922518861, -82.45686057744108 35.762240251893644, -82.45677257739472 35.762444251926105, -82.45674157737294 35.762551251944586, -82.45672557735226 35.76266725196658, -82.45672957733343 35.76279225199246, -82.4567545773098 35.76297125203143, -82.45679457729477 35.76311025206383, -82.45685557727896 35.7632772521041, -82.45686657727641 35.76330525211087, -82.45693457726925 35.76342425214219, -82.4570575772607 35.76361025219266, -82.45713057724831 35.763768252232325, -82.45716257723414 35.76389325226104, -82.45717657721367 35.76404025229246, -82.45717957719775 35.76414525231415, -82.45717457716617 35.76434325235383, -82.45716257712951 35.76456625239806, -82.457127577081 35.764841252450275, -82.4570005769622 35.76546925256498, -82.45694157689411 35.76584425263516, -82.45691957686424 35.76601325266723, -82.45691957684947 35.76610825268656, -82.4569285768313 35.766234252713126, -82.45694857680773 35.76640725275041, -82.45694957680648 35.76641625275235, -82.45697657679015 35.76655025278242, -82.45711757673924 35.76702825289416, -82.45714357672593 35.76714125291991, -82.45716957670689 35.767292252953204, -82.45717357669223 35.767390252973634, -82.45717057667964 35.767468252989175, -82.45716957667479 35.76749825299514, -82.4571525766462 35.76766425302716, -82.45714557661553 35.76785325306489, -82.45715557652177 35.768467253190835, -82.45716857640309 35.769244253350195, -82.4571645763755 35.76941725338503, -82.45715157635266 35.76955025341076, -82.4571215763257 35.76969125343635, -82.45708257629849 35.76982525345953, -82.45701757625731 35.770020253492476, -82.45691357619764 35.77029325353732, -82.45675557611618 35.770648253593166, -82.45670257608688 35.77078025361455, -82.45666957606588 35.770880253631546, -82.45664757604631 35.77098225364994, -82.45663857602861 35.77108625367022, -82.45663657600701 35.77122325369785, -82.45664757598487 35.771377253730364, -82.4566575759679 35.771497253755754, -82.45672857590297 35.77199025386338, -82.4567665758877 35.7721292538956, -82.45678657588357 35.7721772539074, -82.4568305758824 35.772231253922946, -82.45689357588334 35.7722922539419, -82.45691457588373 35.772312253948066, -82.4569595758846 35.772355253961514, -82.45699757588152 35.772415253977684, -82.4570175758754 35.77247625399214, -82.45708757582214 35.7728932540842, -82.45709257581875 35.77292025409021, -82.45716357578948 35.77318425415122, -82.45728757574643 35.773593254247224, -82.45733657573356 35.773728254279774, -82.45739357572435 35.77384825431004, -82.45744957571875 35.7739442543354, -82.45755457571224 35.77409825437754, -82.45774157570547 35.77434125444631, -82.45785657570278 35.77448125448662, -82.45790557570265 35.77453425450249, -82.45796757570257 35.774601254522494, -82.45819357570609 35.77481925459031, -82.45836357571373 35.77495225463487, -82.45839557571361 35.774987254645275, -82.45853957571599 35.775125254688206, -82.45855457571635 35.77513925469258, -82.45863957571548 35.775235254720904, -82.45870757571294 35.775324254746025, -82.45877957570686 35.7754402547771, -82.45894857568788 35.775742254856, -82.4590225756795 35.77587525489064, -82.45905757567137 35.77596525491268, -82.45906757566895 35.775991254918935, -82.45908657565526 35.776099254942864, -82.45909057564619 35.77616225495614, -82.45908557563703 35.77621525496638, -82.4590825756302 35.77625625497443, -82.45905857560258 35.776408255002906, -82.45890657549246 35.7769542550982, -82.45883957544316 35.77719925514112, -82.45882957543805 35.77722125514456, -82.45882657543586 35.7772322551465, -82.45881557542924 35.77726325515168, -82.45879857542296 35.777285255154354, -82.45879657542245 35.77728625515437, -82.45878357541707 35.777307255157325, -82.45889057542068 35.77739825518689, -82.45890857542119 35.777414255191985, -82.45919757543805 35.77761425526256, -82.45923657544002 35.777643255272444, -82.45935057544568 35.777728255301554, -82.45928757543375 35.777738255297095, -82.45918957541491 35.77775425529018, -82.45870657532211 35.77783525525683, -82.45866057531317 35.77784325525364, -82.45854457529293 35.77785025524304, -82.4585235752902 35.77784525523989, -82.45846357528254 35.77783025523066, -82.45844357527982 35.777826255227765, -82.45841357527584 35.77782025522352, -82.45832357526353 35.777803255210664, -82.45829457525946 35.77779825520667, -82.45823257525095 35.777787255197985, -82.45798257521331 35.777762255167104, -82.45781257518692 35.7777502551471, -82.45774657517663 35.77774625513948, -82.45749257513441 35.77774625511323, -82.45723157508985 35.77775425508789, -82.45685157502302 35.77777825505358, -82.45636357493544 35.777820255011704, -82.4558815748489 35.7778622549704, -82.45565457480744 35.77788625495182, -82.4551455747146 35.77794025491029, -82.4549755746815 35.77797125489901, -82.45486757466048 35.77799125489189, -82.45475557463625 35.778027254887625, -82.45441657456331 35.77813425487435, -82.45412157449411 35.778264254870294, -82.45333657430939 35.778614254860415, -82.45303357424149 35.77872725485216, -82.45228157408492 35.7789312548159, -82.45221257407078 35.77894825481226, -82.4515555739359 35.77911425477809, -82.45040757370035 35.779403254718275, -82.448866573384 35.779792254638245, -82.44846957329901 35.77991525462217, -82.4481905732343 35.780033254617365, -82.44793757317103 35.78017025461906, -82.44713057295749 35.78068125463963, -82.44698757291948 35.780773254643584, -82.44608657269767 35.78123725464486, -82.44586057264571 35.781330254640466, -82.44518357248968 35.78161025462744, -82.44513857247934 35.781629254626665, -82.44495357243927 35.78168925461967, -82.44447757233631 35.78184325460182, -82.44370257217672 35.78204225456226, -82.44356457214965 35.7820682545532, -82.4423025719016 35.78231625447332, -82.43991257143756 35.78274925431436, -82.43931657132009 35.78286825427697, -82.4383045711203 35.78307325421409, -82.43790857103932 35.7831712541931, -82.43778057101325 35.783202254186165, -82.437711570999 35.783220254182666, -82.4373995709339 35.7833052541677, -82.43727357090759 35.783340254161836, -82.43686857082312 35.78345125414254, -82.43585157060947 35.78373925409596, -82.43471657037082 35.78406225404434, -82.43401657022444 35.78425625401152, -82.43333857008142 35.78445225398126, -82.43263056993372 35.784646253947535, -82.43158856971475 35.784942253899985, -82.43128656965106 35.785029253886464, -82.43052856949231 35.78524125385128, -82.43016956941561 35.78535125383657, -82.43012156940547 35.78536525383444, -82.42997956937515 35.78540825382847, -82.42993256936505 35.78542325382668, -82.4297725693309 35.78547225382006, -82.42935456924485 35.78557925379862, -82.42896356916403 35.78568125377894, -82.42762556888272 35.7860622537181, -82.42760056887731 35.786070253717185, -82.42704856876219 35.7862212536908, -82.42681156871261 35.786287253679745, -82.4264845686437 35.78638125366504, -82.4261405685745 35.78645925364532, -82.42609756856645 35.78646525364212, -82.42585556852086 35.78650025362424, -82.4255135684596 35.78652925359475, -82.42525756841474 35.786544253571385, -82.4251065683883 35.78655325355753, -82.42509656838666 35.78655325355651, -82.42501056837143 35.78655925354886, -82.42415956823643 35.78651925345276, -82.4238355681858 35.786499253415144, -82.42378956817821 35.78649925341046, -82.4236415681533 35.78650125339553, -82.42323656808274 35.786523253358126, -82.42304356804651 35.78655025334369, -82.42282456800407 35.78658925332894, -82.42278956799719 35.78659625332674, -82.42208856785255 35.78677825329129, -82.42181356779584 35.786849253277374, -82.42098956762581 35.78706325323565, -82.42071556756912 35.787135253222, -82.42045956751636 35.787201253208934, -82.41969256735801 35.787401253170316, -82.4196025673393 35.78742525316584, -82.41943756730554 35.787466253157135, -82.41890356719624 35.78759925312897, -82.41840656709634 35.78771125310042, -82.41805756702861 35.787774253077075, -82.41758356693839 35.787849253043326, -82.41745456691429 35.78786625303349, -82.41497056645377 35.788177252839866, -82.41442656635243 35.788248252798034, -82.41363856620573 35.78835125273754, -82.41355756619053 35.78836225273142, -82.41291456607173 35.78844025268072, -82.4122705659526 35.78851925263026, -82.41210856592265 35.78853925261753, -82.411346565781 35.7886362525585, -82.41086056568915 35.788709252523034, -82.41046656561191 35.788785252497775, -82.40997756551023 35.788917252474, -82.40947556539902 35.78909725245872, -82.40853256518672 35.78945525243401, -82.40828956513185 35.789549252427975, -82.40700756484087 35.79005225239767, -82.40692656482254 35.790083252395625, -82.40655656473234 35.79026825239498, -82.40653856472798 35.79027725239488, -82.40623656465276 35.7904382523964, -82.40599456458907 35.790590252402275, -82.40581456454235 35.79069825240567, -82.40567356450715 35.79077425240652, -82.4055475644776 35.79082925240467, -82.40539956444468 35.79088325240031, -82.40521756440573 35.79093925239294, -82.40513956439051 35.79095425238792, -82.4050835643795 35.79096525238433, -82.40490356434559 35.790991252370986, -82.40476356432126 35.79099825235798, -82.40462256429825 35.79099625234293, -82.40456456428879 35.79099525233677, -82.40435456425782 35.790970252309926, -82.40432856425413 35.790966252306475, -82.40411156422324 35.79093325227726, -82.40392956420273 35.790871252245864, -82.40373956418262 35.79079825221137, -82.40353556416468 35.79069625216957, -82.40350156416292 35.79067125216098, -82.40336756415604 35.79057225212697, -82.40327256415355 35.79048725209986, -82.40318056415107 35.79040525207368, -82.40296756414995 35.79018625200706, -82.40291656415062 35.79012725198983, -82.40250056415667 35.789645251848825, -82.40210856415563 35.789235251724925, -82.4020275641531 35.7891652517023, -82.40188656414838 35.78904525166338, -82.40186756414762 35.78903025165829, -82.40166756413818 35.788877251606564, -82.40145456412459 35.788738251556275, -82.40141456412198 35.78871225154685, -82.40123156410675 35.78861525150818, -82.40115356410037 35.78857325149162, -82.40084256406845 35.78844725143379, -82.4005435640359 35.78833725138051, -82.40052556403369 35.78833225137762, -82.40028156400405 35.78826325133835, -82.40027256400298 35.78826025133678, -82.3999735639634 35.78819625129291, -82.39994256395883 35.78819225128892, -82.39972156392653 35.788164251260355, -82.39938056387474 35.78813425121897, -82.39890756379795 35.78812325116784, -82.39864656375569 35.78811725113961, -82.39856256374107 35.78812125113175, -82.39818656367626 35.78813725109611, -82.3978505636177 35.78815525106501, -82.39770256359184 35.78816425105158, -82.39716056349549 35.78820525100384, -82.39669756341422 35.78823425096187, -82.39633156334921 35.78826225092973, -82.39613456331507 35.788271250911144, -82.39595856328754 35.78826125089088, -82.3957205632541 35.78822225085835, -82.39560056323718 35.78820325084216, -82.39538856320625 35.78817625081464, -82.39521356317536 35.78818825079894, -82.39502556313978 35.78821625078523, -82.39501556313748 35.78822025078504, -82.39499456313308 35.788226250784064, -82.39493356311955 35.788248250782225, -82.39491356311491 35.78825625078181, -82.39483256309724 35.788284250779114, -82.39466256305457 35.78837725078044, -82.39414156291316 35.78873025079836, -82.39401556288307 35.78878925079725, -82.39365556280637 35.788898250782175, -82.3935185627794 35.78892525077357, -82.39348656277306 35.788932250771644, -82.39321456272297 35.788964250750006, -82.3927495626395 35.78900525071029, -82.39256956260604 35.7890282506963, -82.3924425625791 35.789066250690894, -82.39226356253937 35.78913025068534, -82.39197556246422 35.78930625069135, -82.39170356237369 35.78959825072259, -82.39156656232323 35.789776250744644, -82.3913065622344 35.79006925077729, -82.39119956220394 35.79015125078283, -82.39101556215932 35.790241250782174, -82.39081656211313 35.79032625077886, -82.39041056202988 35.790428250757564, -82.39021356198712 35.790493250750444, -82.39019356198273 35.79050025074974, -82.3898295618898 35.790709250754624, -82.38968156184478 35.790841250766064, -82.38949556179048 35.79099125077733, -82.38934456174616 35.79111525078692, -82.3890975616756 35.79130525079997, -82.38895556163726 35.791400250804664, -82.38882356160445 35.791470250805254, -82.38837456150176 35.79165125079555, -82.38816056145464 35.7917262507887, -82.38813556144939 35.79173325078752, -82.38796056141214 35.79178625078018, -82.38778256137157 35.79185725077629, -82.38762056133328 35.79193025077429, -82.3873705612606 35.79213125078926, -82.38735556125604 35.7921442507904, -82.38711756119851 35.79226025078936, -82.38697456117231 35.79227625077779, -82.38683356115395 35.79224425075668, -82.38666056113237 35.792198250729484, -82.3864595611083 35.7921392506967, -82.38623056107201 35.79212825067069, -82.38574156099013 35.79213325062116, -82.38545956093968 35.792157250596865, -82.38491456083388 35.792256250560605, -82.38481256081342 35.79227925055473, -82.38440956073175 35.79237425053234, -82.38406856065761 35.79248725052004, -82.38397056063845 35.79250625051377, -82.38385656061611 35.79252825050649, -82.38372856059095 35.792553250498266, -82.38351556055004 35.79258925048355, -82.38340256052827 35.792609250476, -82.38287956042751 35.792699250440144, -82.38268256038607 35.79275525043115, -82.38265256037968 35.79276425042986, -82.3824535603316 35.79286125042899, -82.3820935602402 35.793065250433216, -82.3817515601518 35.79326825043913, -82.38144256007708 35.793419250437815, -82.3811255600052 35.79354325043025, -82.38084055993954 35.79366125042476, -82.380702559909 35.793710250420375, -82.38059355988486 35.79374925041708, -82.3804245598483 35.79380425041076, -82.38020755980644 35.79384225039604, -82.37998855976572 35.79387025037903, -82.37992255975342 35.793879250374076, -82.3796095596993 35.793893250344524, -82.37951455968276 35.79389825033568, -82.37909955961509 35.79389125029136, -82.3788795595783 35.79389325026898, -82.37847155951289 35.79387925022391, -82.37841155950312 35.79387825021756, -82.37823755947691 35.79386125019606, -82.37809455945616 35.79384225017744, -82.37787055942388 35.79381125014794, -82.37769055939572 35.79380025012712, -82.37753055936756 35.79381025011254, -82.37727755930983 35.79391225010708, -82.37716655927893 35.79399225011186, -82.37701655924131 35.794074250113, -82.37683655920074 35.79414325010841, -82.37668855917443 35.79415425009537, -82.3766385591654 35.794159250091205, -82.37634055910559 35.79422625007401, -82.37614155905553 35.79433525007549, -82.37598155900648 35.794480250088455, -82.37594655898799 35.7945612501013, -82.37581055893621 35.79474925012553, -82.37561555887554 35.79493125014221, -82.37548955884063 35.79502025014735, -82.37529055879915 35.795075250137906, -82.3749645587453 35.79507425010397, -82.37465055869033 35.7950932500753, -82.37453755866481 35.79513625007239, -82.37445355864043 35.795203250077265, -82.37429155858523 35.79538525009755, -82.37390355845001 35.79584025014985, -82.37371155839692 35.795976250157636, -82.37352555835304 35.79606025015547, -82.37325055829098 35.79616625014851, -82.37306855825737 35.79618825013414, -82.37297755824363 35.79617925012292, -82.37292755823614 35.796174250116714, -82.37269455820861 35.79610325007821, -82.37254055819184 35.79604725005086, -82.37244655818546 35.7959882500292, -82.37225155817886 35.79582324997546, -82.37204855817093 35.79565824992092, -82.37182955815493 35.795528249871836, -82.37168255813158 35.79552124985516, -82.37166055812813 35.7955202498527, -82.37157655810574 35.79557424985498, -82.37159455808742 35.795711249884675, -82.37167755807374 35.79588724992904, -82.37174055806666 35.79599924995831, -82.37176355804998 35.796131249987496, -82.37169455802118 35.796242250003004, -82.37161055799933 35.79629325000467, -82.37154755798275 35.796332250006095, -82.37122955791111 35.79645424999796, -82.37105855787568 35.79649924998939, -82.37089055784028 35.79654824998193, -82.37065955778665 35.79664624997797, -82.37048655773911 35.796767249984676, -82.37030455768607 35.796914249995716, -82.3701525576407 35.79704325000621, -82.37001355760195 35.79714425001236, -82.36990255756386 35.79727025002645, -82.36972555748673 35.7975772500705, -82.36953255739719 35.79794625012558, -82.36949855738285 35.79800225013344, -82.36942455735087 35.79812825015132, -82.36916855725563 35.79846725019377, -82.36903755720365 35.79866125021959, -82.36897855717393 35.798789250239544, -82.36893055714978 35.798893250255695, -82.36891055713618 35.79895925026706, -82.36888555711876 35.79904425028177, -82.36885055709469 35.79916125030191, -82.36875255706478 35.799249250309636, -82.36866555704565 35.79927925030673, -82.36857155703244 35.79926425029397, -82.3685535570313 35.79925225028963, -82.3684935570276 35.79921225027527, -82.36846655703023 35.79916625026315, -82.3684675570395 35.79910825025151, -82.36846755704335 35.799083250246454, -82.36852755707352 35.798954250226394, -82.36872355713554 35.79876425020807, -82.36884755717972 35.7986132501902, -82.36885355718158 35.79860725018963, -82.3688895572108 35.79845825016301, -82.36886455725994 35.79811625009094, -82.36887555729079 35.79793025005427, -82.36896355735134 35.79763525000345, -82.36894955737023 35.79749924997438, -82.36889955738266 35.79736624994219, -82.3687915573885 35.7972142499001, -82.36871955739528 35.797094249868266, -82.36875055741976 35.7969702498463, -82.36886155745076 35.79688924984134, -82.36888955745931 35.79686424983906, -82.36897755748548 35.79679024983319, -82.36902955752055 35.796620249804, -82.36904655753871 35.79652224978589, -82.36903955754401 35.796480249776614, -82.36896855754622 35.79639124975114, -82.36888955753898 35.796353249735326, -82.36876855750916 35.796416249735564, -82.36870655748174 35.796526249751516, -82.36868255745901 35.79664624977339, -82.36863155743279 35.796760249791326, -82.3685035573977 35.7968492497961, -82.36837955736749 35.796911249795905, -82.36832255734697 35.7969822498044, -82.36832155733256 35.79707324982281, -82.36835455732891 35.79713224983818, -82.3683735573269 35.79716524984693, -82.36844555732452 35.797257249873084, -82.36850555731948 35.79735324989877, -82.36854755731024 35.797457249924264, -82.36854155729408 35.79755424994336, -82.36851155727494 35.797645249958734, -82.36843155724601 35.797745249970724, -82.36823455718692 35.79791524998489, -82.36812355715665 35.797991249988904, -82.36799955712081 35.79808924999596, -82.36793755709806 35.79816925000583, -82.36790955708273 35.79823825001695, -82.36790655706706 35.798335250036374, -82.36790955704286 35.79849325006873, -82.36787255702293 35.79858225008301, -82.3677735569942 35.79866125008878, -82.36768255697008 35.79871925009118, -82.367492556891 35.79902425013346, -82.36739055685824 35.799126250143736, -82.36725555682337 35.79920625014597, -82.36711355679535 35.799235250137144, -82.36700055677652 35.79923525012544, -82.36676755674 35.79922225009872, -82.36674555673653 35.799221250096224, -82.36611455663333 35.79921225002916, -82.36584755658754 35.7992222500035, -82.36571455656251 35.79924124999357, -82.36567755655544 35.79924724999098, -82.36528055647301 35.79935424997167, -82.36517955645172 35.79938324996715, -82.36472355635492 35.79951924994755, -82.36456255632152 35.79956224993962, -82.36437455628504 35.79959624992703, -82.36421655625827 35.79960024991152, -82.36354655614785 35.79959624984133, -82.3635305561452 35.799596249839716, -82.36335255611249 35.799617249825545, -82.36318155607448 35.79967924982047, -82.36307155604793 35.799732249819876, -82.3630265560358 35.799762249821285, -82.3629475560143 35.799816249824076, -82.3628135559612 35.80001424985046, -82.36276755593494 35.800134249870034, -82.36272655590886 35.80025724989081, -82.3626165558461 35.80054324993758, -82.36257155582601 35.80062424994936, -82.36254755581089 35.80069524996134, -82.36247755577801 35.80083224998194, -82.3623785557469 35.80092624999074, -82.36223755570674 35.801034249998125, -82.36207355566984 35.801096249993776, -82.36194855564554 35.80111924998549, -82.36186955563247 35.80111924997729, -82.3617985556207 35.80111924996991, -82.36151155558173 35.80106424992905, -82.36135955555888 35.80104924991025, -82.36123255553674 35.80105624989852, -82.36111755551077 35.80110024989563, -82.36101955548475 35.80116324989824, -82.36095855546132 35.801248249909236, -82.36091555543992 35.80134024992348, -82.36087155540285 35.80153024995747, -82.36078755530261 35.80208425006139, -82.36072055526616 35.802247250087575, -82.36063355522923 35.80239125010789, -82.36058255520405 35.80249825012427, -82.3605955551911 35.80259525014535, -82.36059055517326 35.802704250167025, -82.36054355514476 35.8028372501892, -82.36036155507907 35.80306525021663, -82.36027855505749 35.803115250218184, -82.36018755504519 35.80309725020511, -82.36011655503974 35.80305725018963, -82.36008255504221 35.8030052501756, -82.36005555504771 35.80294125015973, -82.36004655505583 35.80287925014624, -82.36005055506978 35.80279425012939, -82.3600635550866 35.802700250111585, -82.36006255510075 35.802608250092774, -82.36001155510593 35.8025212500699, -82.35978155510048 35.80231125000339, -82.35970655510492 35.80220324997364, -82.35965755511474 35.802088249945236, -82.35966755513202 35.801988249926005, -82.35971155515801 35.801868249906185, -82.35983855521373 35.8016462498741, -82.35982855523167 35.80152024984757, -82.35979755524306 35.80141424982279, -82.35977855524773 35.80136424981063, -82.3597085552753 35.801113249752376, -82.35970955528946 35.801023249734236, -82.359737555305 35.80095324972285, -82.35978855532343 35.80088924971513, -82.35986355534837 35.800809249706674, -82.35987055535044 35.80080324970618, -82.36001555539177 35.80069224969862, -82.36018555544499 35.80053224968366, -82.36030655549075 35.80036724966266, -82.36037655552865 35.80019824963564, -82.36041555556231 35.800024249604235, -82.36045955561629 35.79972424954785, -82.36050255564152 35.79960824952874, -82.36062755568425 35.79946724951304, -82.36071855571682 35.7993552494997, -82.36072655572437 35.79931524949239, -82.36069455572377 35.79928524948298, -82.36061755571447 35.79926324947052, -82.36049855568993 35.79929424946454, -82.36037355565665 35.79937424946783, -82.36029955562651 35.799489249483585, -82.36027455560925 35.79957324949802, -82.36023155557201 35.79976624953279, -82.36019555553956 35.79993624956361, -82.36015755551371 35.800061249585085, -82.3600905554872 35.800160249598264, -82.35999655545618 35.80025924960868, -82.35970355538315 35.80041624961021, -82.35952955534562 35.80047224960362, -82.35929455529711 35.80053324959174, -82.35926355529166 35.8005352495889, -82.35913855526525 35.800572249583496, -82.35904255524039 35.80062924958514, -82.35892855520271 35.80075024959795, -82.35873955513767 35.800966249622206, -82.35870855512904 35.80098824962347, -82.35861355510245 35.801058249627886, -82.35847555506678 35.80114024963022, -82.35834855503889 35.80118424962602, -82.35821855501322 35.801210249617874, -82.35806955498892 35.80120824960207, -82.35798055497433 35.80120724959266, -82.35785055495074 35.80122024958179, -82.35773355492807 35.80124124957397, -82.3576285549066 35.80126724956842, -82.357363554851 35.80134224955618, -82.35703055478095 35.80143724954101, -82.35690055474656 35.801520249544446, -82.35682155471893 35.8016132495552, -82.35677355469447 35.801719249571704, -82.35675355467089 35.8018492495961, -82.35672455465155 35.80194224961202, -82.3566845546348 35.80200724962103, -82.35659755461018 35.80207224962525, -82.35647455458403 35.80210924962002, -82.35631755455881 35.80210424960278, -82.35605255452084 35.80206624956761, -82.35586155448948 35.8020642495475, -82.35572755446195 35.80209824954044, -82.35570355444443 35.802185249555656, -82.35570555443873 35.80222424956378, -82.3557075544337 35.80225824957092, -82.35579055442251 35.802418249612046, -82.35581655441587 35.80248824962896, -82.35584555440478 35.80259024965264, -82.35583155438327 35.802713249676245, -82.35574655435877 35.802780249681035, -82.35566255433766 35.80282624968164, -82.3556485543341 35.80283424968185, -82.35541955428194 35.80292524967662, -82.35498955417812 35.803134249674585, -82.35463855408888 35.803333249678666, -82.35433755402046 35.80345224967173, -82.3540505539626 35.8035182496554, -82.35392855394258 35.80351724964259, -82.35373155391663 35.803474249613444, -82.35362055390013 35.8034622495995, -82.35355255388448 35.80349024959813, -82.35354555387335 35.80355424961043, -82.35358655386624 35.80364324963274, -82.35370155385597 35.80383124968288, -82.35373255384849 35.803912249702556, -82.35374555383376 35.80402024972584, -82.35374255382644 35.80406424973445, -82.35362955378586 35.80420424975124, -82.35356455375984 35.80430224976442, -82.35350955373316 35.80441424978145, -82.35347655370695 35.80454724980502, -82.35342755365942 35.8048002498514, -82.35334455362806 35.80491324986575, -82.35314755357324 35.80505524987421, -82.35306655354063 35.805178249890886, -82.35305655352178 35.80528824991215, -82.35308255351318 35.805371249931696, -82.353157553513 35.80545224995592, -82.3532585535191 35.8055202499802, -82.35345755353647 35.80562025002115, -82.35358555354924 35.80567425004534, -82.35372555356511 35.80572125006939, -82.35419755362693 35.805826250139596, -82.35431255363879 35.80587225016084, -82.35437555364133 35.80592325017776, -82.35441055363758 35.80598425019375, -82.35443555363112 35.80605225021014, -82.35447255360761 35.806242250252616, -82.3545045535572 35.80659925032847, -82.35450055353576 35.806732250355076, -82.35440955348636 35.80695225039028, -82.35426555343705 35.807115250408565, -82.354078553379 35.80728925042451, -82.35397955335196 35.807357250428154, -82.35388155332778 35.80740825042837, -82.35367555328331 35.807474250420405, -82.35358055326618 35.80748325041239, -82.35317355319795 35.80748825037132, -82.35289655315562 35.80746525033791, -82.35279255314074 35.80745025032414, -82.35270955312625 35.80745525031658, -82.35265655311635 35.80746225031253, -82.35250455308261 35.80751725030789, -82.35233755303888 35.807620250311594, -82.35216755299786 35.80770225031062, -82.35205055297456 35.80772725030355, -82.35193455295541 35.807727250291585, -82.35184055294135 35.80771725027979, -82.35168755291758 35.807707250261934, -82.35158255289639 35.807731250255976, -82.35147055287038 35.80777925025408, -82.35133055283112 35.8078822502605, -82.35126655280679 35.80797025027176, -82.35109655274596 35.80817925029669, -82.35104455272378 35.80826625030894, -82.35087355264372 35.80859825035873, -82.35084055262355 35.80869225037439, -82.3508295526092 35.808772250389495, -82.35083955260092 35.80883625040359, -82.35089355259564 35.80892725042759, -82.3509755525933 35.809029250456824, -82.35108355259685 35.80912125048673, -82.35123655260878 35.80920725052007, -82.35164155265015 35.809372250595494, -82.35180355266355 35.809458250629774, -82.35194355267117 35.809558250664566, -82.35194955267153 35.809562250666005, -82.35242955270287 35.8098712507785, -82.35271755272416 35.81004025084267, -82.3529265527334 35.810203250897395, -82.35310055274336 35.81032425093992, -82.35321655274824 35.81041625097072, -82.35332355274738 35.81053525100591, -82.35341255274243 35.81066125104075, -82.35355055273193 35.81087525109854, -82.35362655272924 35.81097325112628, -82.35372255273047 35.81106725115538, -82.35396155273948 35.81126325121994, -82.3541565527494 35.81140625126917, -82.35450655277344 35.81162425134972, -82.35466655278515 35.81171925138559, -82.35484455280013 35.81181225142292, -82.35517755283253 35.81195825148704, -82.35543755285624 35.81208225153915, -82.35570555288722 35.81216825158442, -82.35598755292622 35.81221825162377, -82.35639655298539 35.812273251677304, -82.35653155300744 35.8122752516917, -82.35661855302585 35.81224925169541, -82.35682655307873 35.812131251692996, -82.35693555310877 35.81205525168875, -82.35702955313165 35.81200825168899, -82.35717655316093 35.811976251697736, -82.3574555532119 35.81194625172053, -82.35781555328671 35.81184925173807, -82.35812555334948 35.81177625175533, -82.3582585533693 35.81179025177193, -82.3583045533702 35.81183325178549, -82.35850655340468 35.81182725180513, -82.3586885534312 35.811850251828616, -82.35867955337396 35.81220725190029, -82.35839455330321 35.81235825190139, -82.35761155314135 35.812564251862256, -82.35728155306104 35.81272825186136, -82.35678755293213 35.8130292518714, -82.35600155280046 35.813038251791845, -82.35452955260017 35.8127592515827, -82.35357355247467 35.81254825144087, -82.35225755225034 35.81258825131277, -82.35187455220141 35.8124952512542, -82.35161555216833 35.81243225121459, -82.35072655205428 35.812219251079235, -82.3503445520052 35.8121282510212, -82.34926155188955 35.81171925082593, -82.34869655186314 35.8112882506799, -82.34814755188303 35.81057825047878, -82.34807055189698 35.81040725043601, -82.34782255194912 35.809809250288815, -82.34761355206837 35.808823250066936, -82.34733755209943 35.808331249938334, -82.3471315521258 35.80794424983842, -82.34698355216656 35.80752524973791, -82.34702455232446 35.806557249545534, -82.34690655237524 35.80610624944169, -82.34669955238121 35.80584824936779, -82.3464335523749 35.80560624929106, -82.34602955234823 35.805348249196854, -82.34568455237286 35.80482424905469, -82.34517155234947 35.8044292489213, -82.3447665523353 35.80409024881056, -82.3440365522533 35.803840248684104, -82.34339555219259 35.803549248558625, -82.34325255217857 35.80348724853126, -82.34240855209569 35.8031222483697, -82.34146055201803 35.80261324816808, -82.34085855200134 35.80208124799774, -82.33924055185798 35.801282247667864, -82.3390635518513 35.80113724762007, -82.33901455186707 35.800984247583976, -82.3390145518872 35.80085524755776, -82.33914355199158 35.80032324746303, -82.33917455209095 35.799719247343496, -82.33920555230227 35.798397247078185, -82.33890155238407 35.79755024687461, -82.3382915524994 35.79616324652971, -82.33885455262396 35.79596224654714, -82.33936855277572 35.795535246513644, -82.33975455295148 35.794818246407964, -82.34009155308895 35.79429424633635, -82.34104955333554 35.79373024632095, -82.34187955356228 35.7931582462907, -82.34217655368674 35.792675246223254, -82.3424245537907 35.792272246167094, -82.34291855391895 35.79197424615764, -82.34341255406234 35.79157924612856, -82.34353255422546 35.790660245954236, -82.3442635544508 35.78999224589424, -82.3443535545436 35.78949224580194, -82.34479955477963 35.78845224563678, -82.34522455493546 35.787904245569464, -82.34601455519069 35.78710624548908, -82.34605555520366 35.787066245485214, -82.34646055532227 35.786736245460055, -82.34547555542672 35.785019245009345, -82.34486555550286 35.78388224471525, -82.34409755555923 35.78270524439668, -82.3437625556407 35.78182624418343, -82.34348755571084 35.78108424400421, -82.34348855578867 35.780585243902905, -82.34354855589912 35.77994024377812, -82.34369755602431 35.779295243662496, -82.34358955607172 35.77887624356625, -82.34358955610696 35.77865024352032, -82.3435905561988 35.778062243400974, -82.34369155642777 35.7767002431347, -82.34378155657586 35.77584524297033, -82.34367355661698 35.77546624288217, -82.34355555663768 35.77520824281754, -82.34316155661627 35.774926242719474, -82.34260855655745 35.77471624261964, -82.34220455652458 35.774498242533554, -82.3419385565319 35.77416824243895, -82.34177055657001 35.77374524233568, -82.34164355659868 35.77342624225776, -82.34135855666322 35.77270924208258, -82.34124055667388 35.77251524203097, -82.3409545566592 35.77230524195871, -82.34085555668204 35.77205324189728, -82.34075755670449 35.77180524183684, -82.34042255670295 35.77145924173181, -82.33989055672544 35.770749241532606, -82.33964355674232 35.770378241431615, -82.33931855675378 35.769959241312876, -82.33874755677236 35.76923324110635, -82.33781155678186 35.768177240795026, -82.33779955678315 35.76815624078956, -82.33771255679183 35.76800824075048, -82.33771355681073 35.76788724072596, -82.33788155689133 35.76754824067452, -82.3382975570958 35.76667824054079, -82.3383975572053 35.76608124042987, -82.3382705573222 35.76519524023681, -82.33784755740551 35.764211239993124, -82.33757155741867 35.76383323988783, -82.33719755742719 35.76338123975739, -82.33668555751433 35.762277239480106, -82.33600755765946 35.76062423907419, -82.33576255776823 35.75966523885412, -82.33561655790969 35.75860123862287, -82.33577455802485 35.75802923852306, -82.33616055819685 35.75733523842203, -82.33626055827864 35.75691623834725, -82.3362215583136 35.7566502382892, -82.335995558394 35.75589323811208, -82.3356415584923 35.75488523787067, -82.33534955853176 35.75432123772596, -82.33509155856686 35.75382123759771, -82.33503255858855 35.75361923755055, -82.33500355863899 35.753264237475484, -82.33503455885115 35.7519342372085, -82.33504655899104 35.75104823702984, -82.33500755913026 35.750112236835655, -82.33515155920075 35.74981223678964, -82.33513855924888 35.749489236722674, -82.33513955925372 35.74945923671665, -82.33517155925857 35.74946223672066, -82.33533055928636 35.74945223673506, -82.33545855931163 35.74942623674304, -82.3356225593484 35.74936423674735, -82.33596355942832 35.749213236751935, -82.33645155954942 35.74895423674981, -82.33685055964443 35.74876823675331, -82.33693755966489 35.74872923675431, -82.33736055975749 35.74858423676865, -82.33774755983815 35.748477236786954, -82.33815755991881 35.74839523681272, -82.33862856000891 35.74831723684549, -82.3389365600706 35.74824823686337, -82.33907856010065 35.748206236869486, -82.3391835601261 35.74815423686981, -82.33928856015497 35.74808023686565, -82.33936856017993 35.748005236858674, -82.33942856020072 35.747935236850644, -82.33948256022302 35.747849236838796, -82.33953656025321 35.74771323681674, -82.33955556026925 35.74763023680184, -82.33955556028135 35.74755223678603, -82.33954456030554 35.74738523675094, -82.33946556033645 35.7471022366853, -82.33927656038999 35.74655723655501, -82.33891656049781 35.745481236299256, -82.33883756052275 35.745237236241564, -82.338490560632 35.74416523598797, -82.33841456066143 35.74389523592518, -82.33831756068506 35.74364023586339, -82.33826656070403 35.743464235822366, -82.33821756072192 35.74329723578344, -82.33820056074057 35.74315923575364, -82.33820656077776 35.742926235706896, -82.33822656079974 35.74280623568463, -82.3382675608265 35.74267823566287, -82.33832856085678 35.74254823564276, -82.33845356090843 35.7423492356153, -82.33850556092712 35.74228423560749, -82.33852756093498 35.74225723560424, -82.33862756096441 35.7421742355977, -82.33882356102004 35.742025235587725, -82.3391425610994 35.741854235585926, -82.34002756130616 35.741467235598876, -82.34024556136065 35.741348235597236, -82.34034756138941 35.741272235592305, -82.34044256141864 35.74118523558446, -82.3405105614411 35.7411132355769, -82.34056356146293 35.74102923556527, -82.3405975614824 35.74094023555074, -82.34062256150216 35.74084023553303, -82.3406395615219 35.7407312355126, -82.34064456154019 35.74061923549041, -82.34062556162347 35.74006323537548, -82.34063256165462 35.739870235337, -82.34064456167674 35.73974123531205, -82.34065456168618 35.73969123530297, -82.34066556169493 35.73964623529494, -82.34073256173528 35.73945823526366, -82.34084456178414 35.739263235235654, -82.34102456184743 35.7390482352106, -82.34124856192078 35.738814235186254, -82.34138556196373 35.73868423517394, -82.34203756212328 35.73835223517392, -82.3420435621246 35.738350235174174, -82.34271456233313 35.73772323511617, -82.34328956260475 35.73658823494507, -82.34362156276111 35.735936234846996, -82.34372556280745 35.73574923481973, -82.34392956290259 35.73535423476061, -82.34405156296252 35.73509923472142, -82.34418356303004 35.73480523467525, -82.34442856316778 35.734180234573714, -82.34455356325049 35.733781234505564, -82.34483856343876 35.732873234350535, -82.3449245634911 35.73262823430966, -82.34503056354228 35.73241223427676, -82.34520056360722 35.73217523424619, -82.34542256367789 35.73195723422484, -82.34562956373698 35.73179723421371, -82.34576256377034 35.73172423421268, -82.34589856380363 35.731655234212774, -82.34604756383808 35.73159223421531, -82.34618356386768 35.73154623422005, -82.34634056390097 35.731499234226746, -82.34652856393852 35.731458234237785, -82.34678056398722 35.73141323425472, -82.34702056403134 35.73138523427383, -82.34729156408252 35.73134423429354, -82.34755356413339 35.73129623431084, -82.347720564168 35.73125123431893, -82.34791156421151 35.731174234323085, -82.34829956430931 35.730958234319274, -82.3490145644948 35.7305262343054, -82.34925056455737 35.73037523429911, -82.34958956464352 35.73018223429499, -82.3499495647323 35.729994234294004, -82.34995256473317 35.72999223429389, -82.35019756478984 35.72988823429805, -82.35040356483266 35.729832234307985, -82.35068856488931 35.72977123432508, -82.3512575649916 35.72971923437327, -82.35180656508862 35.7296792344219, -82.3519765651219 35.72964623443276, -82.352119565152 35.7296052344392, -82.35224056518221 35.729539234438306, -82.35232556520735 35.72946823443268, -82.35239156522854 35.729402234426104, -82.35244956525123 35.72931823441502, -82.35248256527079 35.72922723439999, -82.35250156528801 35.72913723438363, -82.35251256531123 35.72899923435671, -82.35247856533391 35.728817234316196, -82.35243056535322 35.728641234275514, -82.3523625653709 35.72845523423072, -82.35231156539265 35.72826123418604, -82.35226056540941 35.7280992341479, -82.35220356544716 35.72779523408026, -82.35218656547937 35.727570234032775, -82.3521805655037 35.727407233999024, -82.35220756553834 35.72721323396246, -82.35227156559219 35.72693423391233, -82.35232656562617 35.72677423388549, -82.35241756567274 35.7265722338539, -82.35251956571842 35.72638623382666, -82.35272356579807 35.72609123378782, -82.35292156587204 35.72582623375439, -82.35322456598003 35.72545423371022, -82.35337956603757 35.72524923368456, -82.35348856608103 35.725085233662526, -82.35357356612177 35.72491323363641, -82.35364056616213 35.72472523360511, -82.35369256620213 35.7245232335694, -82.35381856636 35.723641233403264, -82.35386956639408 35.72347623337501, -82.35393256643202 35.72329923334562, -82.35400256646292 35.72317523332762, -82.35404756648232 35.72309823331666, -82.35425956656447 35.72279523327702, -82.35440256662172 35.72257923324788, -82.35450756666614 35.722405233223405, -82.35462056671622 35.72220323319402, -82.35478756680193 35.72182923313534, -82.35500356692195 35.72128723304752, -82.35514756699925 35.720943232992546, -82.35530756707259 35.720641232947735, -82.35547256714062 35.720379232911526, -82.35569156722585 35.72006423287013, -82.35592156730799 35.719780232836236, -82.35619056739739 35.71949123280529, -82.35658556751642 35.719146232776026, -82.35692556761292 35.718887232758554, -82.35730256771103 35.718657232750765, -82.35765656779895 35.718468232748904, -82.35795856786918 35.71833823275376, -82.35829456793813 35.718252232770965, -82.35857156798676 35.718234232795915, -82.35891056804152 35.71824323283277, -82.35926156809676 35.71826123287265, -82.35948856813327 35.71826823289754, -82.35967456816678 35.71825123291333, -82.35985156820288 35.718207232922644, -82.36001256824125 35.71813123292389, -82.36013656827926 35.71801923291392, -82.3602445683187 35.71788023289682, -82.36034756836726 35.71767723286627, -82.36065356853165 35.71694523274916, -82.36082356862039 35.716555232687476, -82.36094156867556 35.716325232652956, -82.36104056871763 35.71616023262963, -82.3612575687918 35.71591423260209, -82.36168156892704 35.715495232560755, -82.36183756897888 35.715327232542776, -82.36194256901572 35.71520223252824, -82.36204856905624 35.71505423250908, -82.36227456916156 35.71461723244368, -82.36242456923738 35.71428823239233, -82.36258956931255 35.71398023234677, -82.36274356936742 35.7137912323243, -82.36288756941236 35.71365523231155, -82.36311056947558 35.71348623230019, -82.36337656954765 35.71330523229097, -82.36358456960554 35.71315423228178, -82.36374256965067 35.71303223227324, -82.36387256969591 35.712879232255574, -82.36400456974698 35.712691232231094, -82.36412056980822 35.712420232187995, -82.36419556988315 35.71201723211383, -82.36423956994811 35.71164623204303, -82.36427356999005 35.711412231999084, -82.36431357003184 35.71118623195719, -82.36438557008142 35.71094323191525, -82.36445857011982 35.71077423188854, -82.36457557017424 35.710548231854624, -82.36475857024722 35.710273231817744, -82.36499757032921 35.71000023178691, -82.36529657041812 35.70974623176619, -82.36559957049825 35.709553231758306, -82.36592757057905 35.709382231757424, -82.36642857069481 35.70917123176627, -82.36728057088638 35.708845231788054, -82.36852057116528 35.70837123181979, -82.36924057134101 35.70800723182023, -82.37005457158358 35.70731223176306, -82.37168957216268 35.70532523152815, -82.372567572433 35.704520231455255, -82.37331457266275 35.70383623139339, -82.37386757288196 35.70301423128354, -82.37435257307375 35.702295231187506, -82.37484657322806 35.70182823114361, -82.37545757338238 35.70148523113698, -82.37614657352951 35.701272231164815, -82.37776357381554 35.701154231307775, -82.37830957392266 35.701046231342225, -82.37897557408283 35.70072523134575, -82.37906057411071 35.700636231336496, -82.37948357424858 35.700199231291364, -82.37972357435656 35.699759231226686, -82.37986557447111 35.69917223112215, -82.3798585745149 35.698882231062505, -82.3797905749126 35.69624623051983, -82.37978457494786 35.69601223047166, -82.3799035750045 35.695774230435575, -82.38014457507062 35.69560523042614, -82.38148357534196 35.695285230499266, -82.38188257543659 35.695101230503155, -82.38217757552978 35.69481523047546, -82.38235057560665 35.69450423043011, -82.38276457584593 35.693403230249096, -82.38327957608354 35.692421230102774, -82.38350857622947 35.69172422998479, -82.38357957646136 35.690305229703796, -82.38358957647709 35.69021422968631, -82.38372357667636 35.68907222946807, -82.38372557669376 35.68896222944591, -82.38371857671859 35.68879422941116, -82.38369857674891 35.68857722936495, -82.38366157676577 35.68842922933107, -82.38359157677601 35.688288229295146, -82.38353657680084 35.68806922924502, -82.38351857683419 35.687835229195635, -82.38358157687719 35.687625229159416, -82.38360157689111 35.687557229147664, -82.3836055768939 35.68754322914522, -82.38367757694395 35.68729722910269, -82.38370257696063 35.687216229088826, -82.38384057705571 35.68675022900834, -82.38462457730228 35.68599722893628, -82.38488857739989 35.685649228892835, -82.38533857774817 35.68388322858044, -82.38561557790116 35.68319222846857, -82.38568257793332 35.683056228447896, -82.38578857798069 35.682864228419774, -82.38593757804502 35.68260822838313, -82.38611657811401 35.68235422835001, -82.38622657814612 35.68226422834311, -82.38634457817774 35.6821862283394, -82.38642857819693 35.682152228341174, -82.38651957821644 35.68212322834467, -82.38658457822835 35.68211622834991, -82.38659957823104 35.68211522835128, -82.38669757824772 35.68211222836075, -82.38687157827341 35.68213222838282, -82.38698157828664 35.68216422840069, -82.3870925782985 35.6822062284206, -82.38718457830471 35.68226422844189, -82.38727357830761 35.68234122846674, -82.38737857830958 35.682440228497676, -82.38769657830463 35.682812228606046, -82.38793257829687 35.68311422869179, -82.38881257825024 35.68435522903479, -82.38922057819951 35.685118229231925, -82.38946457815204 35.68568522937227, -82.38962157810485 35.68615722948445, -82.38971257804769 35.68662322958851, -82.38979557795462 35.687312229737074, -82.38978157786828 35.68785422984569, -82.38972057781547 35.68812922989538, -82.38964657766452 35.689024230069556, -82.38968157757759 35.68962223019475, -82.389805577535 35.69002923029015, -82.39045057744075 35.69132623062026, -82.39057257741253 35.6916382306963, -82.39067357734143 35.692204230821744, -82.39064657727556 35.6926002308994, -82.39052757716614 35.6931792310048, -82.3900945768505 35.694752231279764, -82.39003357677974 35.69514323135293, -82.39006157672556 35.69552223143281, -82.39017057670593 35.6957652314934, -82.3903375766987 35.6959902315564, -82.39063857671135 35.69623023163624, -82.39089657673347 35.696363231689865, -82.39129957678192 35.69648123175543, -82.39169957683959 35.69653623180787, -82.39260357697982 35.6965972319136, -82.39298857704257 35.696604231954744, -82.39486757734802 35.69664123215615, -82.39532157741657 35.69668423221173, -82.39566457746167 35.69675923226239, -82.39609457750856 35.69691623233867, -82.39645657754063 35.6970962324126, -82.39778057764052 35.697866232705735, -82.39829157768776 35.69810723280742, -82.39837157769662 35.69813523282142, -82.39850557771425 35.6981652328413, -82.3986565777365 35.6981822328604, -82.39872857774816 35.698184232868215, -82.39871657772858 35.698298232890096, -82.39870757772084 35.69833823289732, -82.39870557771283 35.69838723290707, -82.39871457770835 35.69842623291592, -82.39873357770657 35.69845823292435)))",5533,37,021,002900,370210029003,1115,1115,6,1097,1089,1,2,3,0,2,18,900,4,896,885,877,1,2,3,0,2,15,554,478,76
census_2010_blockgroups_view.fid--2dc29038_13ec899ba8f_-25f2,"MULTIPOLYGON (((-82.54614661614345 35.607952229698064, -82.54616061617129 35.60778622966564, -82.54620661625553 35.60728922956925, -82.54620761625725 35.60727922956736, -82.54620961626125 35.60725522956266, -82.54622661628412 35.60712522953792, -82.54632161629887 35.60713222954912, -82.54644761631894 35.60713722956313, -82.54688261638802 35.607157229611865, -82.5471126164252 35.6071642296369, -82.54733461646093 35.60717122966117, -82.54741561647391 35.60717422967013, -82.54766061651318 35.607183229697156, -82.54774261652642 35.60718622970618, -82.54785661654456 35.607191229718865, -82.5479616165618 35.60719222972987, -82.54827561661304 35.607198229763355, -82.54861961666995 35.60719922979896, -82.54883961670619 35.60720122982194, -82.5488386167057 35.60720322982226, -82.54896861672756 35.607201229835205, -82.5489866167305 35.60720222983724, -82.54906561674325 35.60720422984575, -82.549304616782 35.60721022987156, -82.54938461679481 35.60721322988037, -82.54947961681049 35.60721422989036, -82.54976761685742 35.60721922992097, -82.5498636168731 35.6072212299312, -82.55004761690365 35.60722122995016, -82.55015361692027 35.60722722996225, -82.55065861699929 35.60725923002067, -82.5510226170569 35.60727723006169, -82.55131361710288 35.6072922300947, -82.55140961711804 35.60729723010556, -82.55170061716362 35.60731523013918, -82.55179761717885 35.607321230150404, -82.55186361718917 35.60732523015792, -82.55206261722039 35.60733723018079, -82.55212961723079 35.60734123018854, -82.55244761728127 35.60735623022421, -82.55340461743286 35.607404230332406, -82.55350661744893 35.60740923034389, -82.55372461748563 35.607406230365704, -82.5538056174672 35.60761323041615, -82.55399661742402 35.60809923053467, -82.55404561741109 35.60823623056761, -82.55412261739154 35.6084462306183, -82.55422961735763 35.60878123069745, -82.5543426173221 35.609133230780685, -82.55454561725448 35.60979123093552, -82.55465061722 35.61012823101484, -82.55476361718262 35.61049223110059, -82.55481261716677 35.610648231137404, -82.55493461712673 35.611039231229476, -82.55506861708365 35.61146323132954, -82.55511661705987 35.61166923137647, -82.55513261704868 35.61175923139643, -82.55514561702941 35.61189823142603, -82.55515561700135 35.61209123146635, -82.55515761697947 35.612235231495895, -82.55516061695715 35.612383231526344, -82.55515661692708 35.6125742315648, -82.55514261689305 35.612780231605306, -82.55513361687265 35.612902231629164, -82.55511261682443 35.61319223168606, -82.55510461681104 35.61327123170133, -82.55509961680326 35.61331623170999, -82.55509361679023 35.61339423172523, -82.55520361680662 35.613406231739, -82.55560561686879 35.61343623178646, -82.55561761687079 35.61343623178765, -82.55582961690462 35.61344523181127, -82.55610761694777 35.613464231843714, -82.5564626170038 35.61348323188401, -82.55670061704079 35.613500231911985, -82.55681461705754 35.61351423192653, -82.55687661706398 35.613539231937956, -82.55691461706205 35.61359223195265, -82.55694061705417 35.61367123197146, -82.55698061703717 35.613825232006896, -82.55698361703676 35.613831232008394, -82.55700961703315 35.61388223202148, -82.55708161703713 35.61393423203947, -82.55716761704737 35.61396023205354, -82.5572606170598 35.613980232067206, -82.55745661709119 35.61398723208882, -82.55770461713139 35.61399423211573, -82.55795661717178 35.61400323214346, -82.55844861724826 35.614037232200886, -82.5584496172484 35.61403723220105, -82.55849961725484 35.61404923220861, -82.55855361725693 35.614094232223344, -82.55861661725032 35.6142052322524, -82.55844261720738 35.61429623225304, -82.5584176172003 35.61431523225434, -82.55788161704591 35.614739232285544, -82.55770361699446 35.6148812322962, -82.55721461685422 35.615264232323874, -82.55709661682415 35.615332232325606, -82.5569666167938 35.61538923232386, -82.55673461674553 35.615452232312826, -82.55660161672269 35.615457232300166, -82.55648961670411 35.61545723228869, -82.55560761657195 35.61536423217903, -82.55505661648813 35.61531423211231, -82.5548646164591 35.61529623208885, -82.55483061643258 35.61543123211285, -82.55481961642394 35.61547523212069, -82.55476961638301 35.61568723215874, -82.55468761632207 35.61599423221275, -82.5546806163178 35.616014232216145, -82.55467661631533 35.61602623221817, -82.55461861628051 35.61618923224539, -82.55453861627284 35.616153232229856, -82.5544846162675 35.61612923221937, -82.55443861626311 35.616108232210365, -82.55429861624819 35.616054232185, -82.55421861623961 35.61602423217069, -82.55426261625459 35.61597423216506, -82.55430561627294 35.61590123215455, -82.55433961629895 35.615769232131214, -82.55434361633725 35.61552523208195, -82.55433861634978 35.61543823206375, -82.55433161637498 35.6152672320282, -82.55431061638734 35.615164232005114, -82.55423761639021 35.61506723197785, -82.55415761638861 35.61499123195415, -82.55405361638296 35.6149162319282, -82.55392361637755 35.61481123189338, -82.55370061637245 35.61460423182835, -82.55330361635953 35.614260231717516, -82.5531396163549 35.61411323167074, -82.55268061634234 35.613700231539525, -82.55237961633435 35.61342823145322, -82.55221261633093 35.613270231403895, -82.55214761632982 35.61320723138439, -82.55199361632754 35.61305623133788, -82.55160661633401 35.61259723120461, -82.55153261633556 35.61250723117869, -82.55131361634074 35.61223823110143, -82.55130361634104 35.61222523109784, -82.55123761634134 35.612152231076095, -82.5509866163473 35.611843230987446, -82.5509716163475 35.61182623098249, -82.55069461635169 35.61150023088768, -82.55042461635753 35.61117123079289, -82.55016161636135 35.61086323070314, -82.55015961636138 35.61086123070255, -82.54989361636709 35.61053723060928, -82.54974161637027 35.610353230556214, -82.54961061637178 35.610202230512, -82.54953261637364 35.610106230484426, -82.54932561637841 35.60985223041147, -82.54896761639331 35.60936923027641, -82.54868161640353 35.60899523017087, -82.54851461641108 35.608766230107065, -82.54829261642104 35.608462230022425, -82.54818361642594 35.608313229980844, -82.5480936164296 35.608192229946994, -82.54796761641104 35.608177229930995, -82.54790461640243 35.6081652299221, -82.54749761634623 35.60809122986521, -82.5473416163244 35.608065229843824, -82.54715361629796 35.608034229818244, -82.54704261628207 35.60801722980333, -82.54695261626836 35.60800922979246, -82.54680961624638 35.60799822977558, -82.5463476161747 35.6079652297213, -82.54614661614345 35.607952229698064)))",4592,37,021,000400,370210004003,636,636,21,626,513,96,6,4,0,7,10,543,13,530,535,443,80,3,3,0,6,8,371,333,38
census_2010_blockgroups_view.fid--2dc29038_13ec899ba8f_-25f1,"MULTIPOLYGON (((-82.45378261028127 35.546576207723376, -82.45378461028501 35.54655420771904, -82.45379261029632 35.546489207706685, -82.45379561030005 35.54646820770268, -82.45377161030908 35.54638420768317, -82.45374461031963 35.54628620766045, -82.4537956103513 35.54613520763503, -82.45382361036853 35.546053207621206, -82.45388461037527 35.54607520763195, -82.45402361039056 35.546125207656424, -82.45407061039546 35.546144207665144, -82.45413161040166 35.546169207676435, -82.45425761041467 35.546220207699776, -82.45429761041888 35.54623620770717, -82.45449861043716 35.54633320774751, -82.45489461046843 35.54655620783357, -82.45517261048875 35.54672320789603, -82.4554646105129 35.54688020795792, -82.45577561054108 35.54703220802082, -82.4560196105662 35.547131208065935, -82.4562486105917 35.54721220810601, -82.45649361062083 35.54728620814625, -82.45664361063957 35.54732620816975, -82.45672661064988 35.547348208182775, -82.45680261066018 35.54736320819357, -82.45696161068146 35.54739620821661, -82.45728161072597 35.54745120826067, -82.45836961088146 35.547611208405, -82.458478610897 35.54762720841944, -82.46190161138497 35.54813920887523, -82.46219961142681 35.54818820891573, -82.46253661147412 35.5482432089616, -82.46294961152996 35.54832520902065, -82.4630716115455 35.54835520903931, -82.46347661159723 35.548455209101235, -82.46382761164028 35.54855320915723, -82.46459561172968 35.5487982092859, -82.46512961179205 35.54896820937537, -82.46527361180877 35.54901420939945, -82.46540261182379 35.54905520942111, -82.46652761195506 35.549413209609455, -82.46697661200648 35.54956220968586, -82.46772961209436 35.54980120981183, -82.46806161213304 35.54990720986744, -82.46851661218749 35.550043209941904, -82.4687766122181 35.55012420998501, -82.46888261223116 35.55015321000178, -82.46930061228268 35.55026821006815, -82.46977661234051 35.55040521014485, -82.47062161244267 35.550650210281525, -82.47247561267947 35.5511072105649, -82.47299761274611 35.55123621064476, -82.47311961276175 35.551266210663435, -82.47337961279504 35.551329210702825, -82.47418061289724 35.55152721082539, -82.47425361290577 35.55155021083763, -82.47455961294138 35.55164821088892, -82.47470061295846 35.55168921091173, -82.47477961296828 35.551710210924156, -82.47488961298126 35.55174421094237, -82.47491161298422 35.55174921094568, -82.47492061298534 35.551751210946996, -82.47506261300238 35.55179321097007, -82.47528861302982 35.551858211006575, -82.47531761303357 35.55186521101095, -82.47532161303351 35.551870211012364, -82.47534161303543 35.55187921101626, -82.47547761304882 35.551938211042234, -82.47560661306142 35.55199521106708, -82.47562561306316 35.552004211070845, -82.47599161309681 35.552180211144226, -82.47612061310855 35.552242211170054, -82.47637861313228 35.55236621122174, -82.4764416131388 35.55239121123335, -82.47650661314559 35.55241721124527, -82.4769906131961 35.552610211334375, -82.47701361319636 35.55263321134132, -82.47740961323272 35.55282321142062, -82.47752061324297 35.552876211442765, -82.4777356132652 35.55296321148254, -82.47776961326878 35.55297621148875, -82.47828961332453 35.553174211582395, -82.47837261333181 35.553216211599505, -82.47861461335815 35.553305211642446, -82.47874361337183 35.553355211665824, -82.47885661338411 35.553397211685976, -82.47905261340647 35.55346321171951, -82.47910461341242 35.5534802117283, -82.47912461341483 35.55348621173159, -82.47923261342702 35.553523211750225, -82.47926361343058 35.5535332117554, -82.47931661343645 35.55355221176473, -82.47953461346134 35.55362521180195, -82.47963961347321 35.5536612118201, -82.47989261349976 35.553761211866416, -82.48018061353048 35.553871211918405, -82.4803966135535 35.55395421195744, -82.4805176135656 35.554006211980465, -82.4805946135729 35.55404121199545, -82.48088461360072 35.55417321205211, -82.48117761362597 35.55432421211291, -82.48129761363616 35.554387212138, -82.48136861364182 35.55442721215346, -82.48153061365429 35.55452021218905, -82.48178661367427 35.55466621224498, -82.48201461369011 35.55480921229743, -82.48217361370098 35.55490921233416, -82.4821866137019 35.554917212337074, -82.4822276137047 35.55494321234662, -82.48224161370561 35.554952212349946, -82.4824716137213 35.55509821240317, -82.48261161373097 35.555186212435444, -82.48282661374583 35.55532121248499, -82.4829036137512 35.55536921250264, -82.48347861379074 35.555731212635344, -82.48372461380745 35.55588721269232, -82.48409461383253 35.55612321277838, -82.48411161383378 35.556133212782115, -82.48416261383734 35.55616521279387, -82.48418061383855 35.556176212797965, -82.48419461383972 35.55618421280105, -82.4842366138425 35.55621121281083, -82.4842516138436 35.556220212814225, -82.48427061384483 35.55623221281859, -82.48432761384879 35.55626821283182, -82.48434761385026 35.55628021283623, -82.48436961385171 35.55629421284136, -82.48443861385668 35.55633621285699, -82.48446161385822 35.55635121286245, -82.48448461385988 35.5563652128676, -82.48451861386224 35.5563862128754, -82.48455461386469 35.556409212883736, -82.48457861386639 35.5564242128893, -82.48469261387412 35.556496212915604, -82.48498561389438 35.55668021298311, -82.48503661389792 35.556712212994846, -82.48515061390543 35.55678621302163, -82.48537561392025 35.556932213074404, -82.48556161393006 35.5570692131214, -82.48562261393248 35.557119213137874, -82.4857506139372 35.557226213172726, -82.48590461393889 35.55738121322011, -82.48600061393887 35.55748421325087, -82.48613861393683 35.557646213298, -82.48625861393074 35.55781521334475, -82.48632261392581 35.55791621337186, -82.48642561391566 35.558093213418374, -82.48651861390138 35.558286213467234, -82.48661861388233 35.558517213524404, -82.48666161387438 35.55861521354877, -82.48678261385392 35.55887921361489, -82.48686961384367 35.55903921365641, -82.48693661383687 35.559155213686886, -82.48694461383627 35.55916821369029, -82.48705361382905 35.559332213734834, -82.48716561382537 35.55947721377582, -82.48717161382525 35.559484213777864, -82.48726261382481 35.5595852138078, -82.48729761382451 35.55962421381926, -82.48737061382423 35.559705213843294, -82.48740761382497 35.55974021385418, -82.4874466138257 35.55977721386572, -82.4874706138263 35.5597992138727, -82.48754561382827 35.55986721389421, -82.48757061382885 35.559890213901426, -82.48762261383071 35.55993421391571, -82.48778061383888 35.56005121395576, -82.48796961384961 35.560185214002416, -82.48798561385064 35.56019521400607, -82.4880856138579 35.5602562140288, -82.48832861387753 35.56039021408099, -82.48848161389176 35.56046221411134, -82.4887026139141 35.56055521415296, -82.48933561397887 35.56081621427112, -82.4893916139847 35.560838214281276, -82.48987361403586 35.5610252143689, -82.49011661406169 35.5611192144129, -82.49047461409974 35.561257214477735, -82.49084561413798 35.5614082145466, -82.49108761416274 35.56150821459175, -82.49132961418833 35.561602214635705, -82.49142561419843 35.56164021465336, -82.49165061422154 35.561732214695205, -82.49205461426396 35.56189121476905, -82.49229661428937 35.561987214813364, -82.4924906143098 35.562063214848806, -82.49306261436986 35.562289214953466, -82.49307361437103 35.56229321495543, -82.49326861439154 35.56237021499111, -82.49321961437926 35.562397214991634, -82.49307261434171 35.56248221499379, -82.49302461432933 35.5625112149947, -82.49299161432101 35.56253021499525, -82.49286361428994 35.56259421499511, -82.49273661425887 35.56265921499523, -82.49246861419549 35.562782214992744, -82.49241961418399 35.56280421499218, -82.49237061417332 35.562821214990656, -82.49220061413544 35.56288421498595, -82.4919556140816 35.5629702149783, -82.49165761401821 35.56306121496617, -82.4913336139521 35.56314221494933, -82.4910246138907 35.56320821493104, -82.49062661381514 35.563270214902715, -82.4896566136349 35.563397214828974, -82.4894596135981 35.563424214814134, -82.48920761355038 35.56346321479618, -82.48896861350394 35.5635072147806, -82.48876761346425 35.56354921476856, -82.48855061341968 35.56360521475759, -82.48818261334219 35.563712214741514, -82.48794961329118 35.56379321473405, -82.48773461324292 35.56387521472862, -82.48735061315404 35.5640392147226, -82.48715561310664 35.56413721472253, -82.48681861302259 35.564320214725086, -82.48647161293123 35.56454021473415, -82.48618461285172 35.564748214747, -82.48605361281412 35.564851214754434, -82.48587861276208 35.565001214766944, -82.48577661273087 35.56509421477536, -82.48569661270606 35.565169214782415, -82.48544361262324 35.5654352148105, -82.48530061257274 35.56560921483125, -82.485182612528 35.5657722148522, -82.48498161244603 35.566089214896, -82.48487061239724 35.56628621492467, -82.48476861235052 35.566480214953636, -82.48469061231312 35.56663921497798, -82.48461561227472 35.56680821500466, -82.48454261223489 35.566988215033774, -82.48444261217273 35.56728421508364, -82.4843526121066 35.567617215142064, -82.48425861202745 35.5680302152165, -82.48422561200164 35.56816221523987, -82.48417761196264 35.56836421527606, -82.48413461193425 35.568502215299695, -82.48408961190795 35.568624215319915, -82.48403161187697 35.56876321534222, -82.48392361182432 35.568989215377044, -82.48380161177025 35.569209215409245, -82.48371761173524 35.56934621542846, -82.48329761156793 35.56998121551447, -82.48318161151748 35.570183215543565, -82.48306061146221 35.57041221557772, -82.48303861145124 35.570460215585236, -82.48297361141834 35.57060421560784, -82.48271161126969 35.571287215719806, -82.48263861122814 35.571479215751346, -82.48250361115781 35.571790215800746, -82.48243361112512 35.57192721582138, -82.48234361108591 35.57208521584431, -82.48218561102496 35.57231121587398, -82.48210761099686 35.57240921588596, -82.48183361090672 35.572700215916946, -82.48163761084811 35.57287021593131, -82.48145661079636 35.573011215941484, -82.4811966107257 35.57319021595113, -82.48103961068462 35.573288215954896, -82.48028661048703 35.57376121597363, -82.48028361048603 35.573764215974, -82.48001461041453 35.57393921598198, -82.48000061041073 35.573949215982516, -82.47981561036022 35.574078215989694, -82.47968961032446 35.574174215996315, -82.47953961027875 35.57431021600851, -82.47942861024198 35.574429216021336, -82.47932461020403 35.57456421603809, -82.47930461019621 35.57459321604196, -82.47923361016761 35.57470221605683, -82.47918261014401 35.57480121607173, -82.47915261012696 35.57487921608457, -82.4789066100871 35.574873216058, -82.47791160991939 35.574892215959544, -82.47788560991494 35.574893215957054, -82.47419160929167 35.57496621559223, -82.47295160908241 35.57499121546988, -82.47353960940231 35.57354621523653, -82.4753046103619 35.56921321453689, -82.47589361068177 35.56776921430381, -82.47525561061205 35.56753521419061, -82.47438461048915 35.567396214072915, -82.47424761046975 35.56737521405454, -82.47327161035724 35.56705521388921, -82.47267961031831 35.56667121375026, -82.47210361025243 35.566479213652045, -82.46994560996502 35.5660242133377, -82.46967160992843 35.565967213297995, -82.46842360976606 35.56567921311115, -82.46730360973817 35.564655212787834, -82.46702960977103 35.564147212656536, -82.46695060978068 35.56399921261822, -82.4664546097847 35.563439212453396, -82.46594260977386 35.56295921230318, -82.46504660970922 35.56241521210056, -82.46408660965362 35.561743211865306, -82.46338260963553 35.561103211662754, -82.46283860960459 35.56071921152884, -82.46206360952026 35.56043321139104, -82.46192660950518 35.56038321136681, -82.46111060940217 35.56017521124067, -82.460758609366 35.56003121117524, -82.46008660929661 35.559759211050896, -82.4585346091283 35.559183210774265, -82.45842160911236 35.559165210758984, -82.45791060903967 35.5590872106906, -82.45739860896484 35.559023210625, -82.45685460890175 35.55884721053333, -82.45634260888845 35.55838321038639, -82.45600660889191 35.55799921027388, -82.45541460888255 35.557423210095884, -82.4547106088251 35.55703920994549, -82.45397460874753 35.55675120981131, -82.45389160873702 35.55673020979848, -82.4533986086744 35.55660720972288, -82.45269460857499 35.55649520962766, -82.45215060849468 35.55643220955899, -82.45221160854221 35.55618920951584, -82.45234260864224 35.55568020942588, -82.45239760868502 35.55546120938701, -82.45246060873265 35.555219209344315, -82.45294860893763 35.55441220923043, -82.4530296089777 35.55423920920355, -82.45330260911201 35.5536602091139, -82.4535776092286 35.55319820904827, -82.45391160933126 35.55289020901999, -82.45426560944928 35.55250420897789, -82.45434460948317 35.55236920895855, -82.45446260962436 35.55157820880992, -82.45442260966186 35.551291208747536, -82.45436360971787 35.55086420865464, -82.45430560977364 35.550439208562274, -82.45426460980836 35.55016920850316, -82.45447360993715 35.54955720840027, -82.45446660994446 35.54950220838835, -82.45443760997468 35.549274208339064, -82.45438861002846 35.5488722082523, -82.45439761010374 35.54839220815563, -82.45433561016253 35.54794320805802, -82.45418861019719 35.54756020796505, -82.454143610208 35.54744120793628, -82.45389661026802 35.546785207777575, -82.45388461026884 35.54676720777264, -82.4538486102707 35.54671620775858, -82.45383761027146 35.54669920775396, -82.45383061027154 35.54669120775168, -82.45381161027208 35.54666720774479, -82.45380561027233 35.546659207742586, -82.45380061027412 35.546642207738586, -82.45378661027947 35.54659220772699, -82.45378261028127 35.546576207723376)))",4781,37,021,003203,370210032033,1292,1292,158,1265,1133,25,4,21,1,81,27,1043,101,942,1028,937,17,4,13,1,56,15,699,598,101
census_2010_blockgroups_view.fid--2dc29038_13ec899ba8f_-25f0,"MULTIPOLYGON (((-82.42612159512754 35.61519121882455, -82.42578459515576 35.61464721867929, -82.4256105951719 35.61435621860222, -82.4254335951856 35.61407721852729, -82.42529159519533 35.61386221846895, -82.42517659519855 35.61371821842792, -82.42500959519462 35.61356421837939, -82.42473459517906 35.61337021831169, -82.42472059517812 35.61336121830838, -82.42437259515384 35.61314521822867, -82.42415859513609 35.613031218183444, -82.42394959511337 35.61295421814629, -82.42354059505976 35.61286221808548, -82.42528059536484 35.612752218242285, -82.42629559554939 35.612645218325, -82.42690159566072 35.61257421837299, -82.42858259596927 35.61237821850617, -82.42891359603011 35.612339218532334, -82.42919859608322 35.61230121855398, -82.4292975961016 35.612288218561524, -82.42953959614525 35.6122652185817, -82.42994159622 35.612212218612314, -82.43029359628471 35.612170218639996, -82.4305985963426 35.6121222186617, -82.43097559641248 35.6120742186908, -82.43104859642627 35.612063218695994, -82.43143259649862 35.61200621872396, -82.43166559654013 35.61198721874408, -82.43178959656238 35.61197621875458, -82.43188459657922 35.61196921876303, -82.43214659661395 35.61202521880132, -82.43215659661513 35.61202821880293, -82.43227559662856 35.61206921882351, -82.4323045966318 35.61207921882858, -82.43233459663412 35.61209621883513, -82.43250559664757 35.612192218872245, -82.43251359664818 35.61219721887403, -82.4325575966501 35.61223221888571, -82.43269759665611 35.612343218922625, -82.43299159666633 35.61259221900353, -82.43335659667909 35.61290121910396, -82.43430859671923 35.61366221935662, -82.4345015967316 35.613789219402314, -82.43464459674205 35.61387521943448, -82.4347945967557 35.61394721946458, -82.43505759678077 35.61406721951599, -82.43511959678737 35.6140912195273, -82.4352685968032 35.61414821955419, -82.43561659684231 35.61426821961444, -82.43594259687731 35.614391219672946, -82.43612459689822 35.6144512197039, -82.43631759692028 35.61451521973675, -82.43645959693474 35.61457421976337, -82.43673359696697 35.614659219808864, -82.43697759699567 35.61473521984938, -82.43717259702133 35.61477821987827, -82.43737959704956 35.6148172199075, -82.43750259706748 35.614833219923376, -82.43757459707956 35.61483221993065, -82.4376605970938 35.614832219939444, -82.43786259712907 35.61482021995782, -82.438021597159 35.614797219969525, -82.43821159719445 35.6147712199838, -82.43849259725282 35.61469421999705, -82.43864859728504 35.614653220004755, -82.43875959731052 35.61460722000688, -82.43888659734068 35.61454822000794, -82.43909659739415 35.61442722000491, -82.43910859739702 35.61442122000496, -82.43934959746245 35.61425621999625, -82.43964659754415 35.6140452199839, -82.44031359773255 35.613540219949876, -82.44054959779898 35.61336321993822, -82.44066359782921 35.61329021993513, -82.44072859784458 35.61326021993573, -82.4408355978661 35.61323521994168, -82.44106459791037 35.61319421995685, -82.4414645979793 35.61317721999454, -82.4416345980083 35.61317122001083, -82.44190459806387 35.61310122002447, -82.4422885981571 35.61290922002488, -82.44257559824567 35.61264322000038, -82.4426945982992 35.61242421996812, -82.44275659836026 35.61209521990761, -82.44279359842453 35.611718219834785, -82.4428045984426 35.61161321981461, -82.4428885985246 35.611172219733575, -82.44292859855963 35.610988219700275, -82.44295259858056 35.61087821968037, -82.44300359861101 35.61073521965663, -82.44303659863043 35.61064521964168, -82.44321759871379 35.610299219589976, -82.44338859878144 35.61004421955568, -82.44341859879307 35.610001219550064, -82.44349559883644 35.609803219517765, -82.44445459896842 35.609977219651775, -82.44477359901393 35.610024219694175, -82.44494859903523 35.610074219722364, -82.44503959904308 35.61012121974132, -82.44511859904652 35.61018321976207, -82.44518659904813 35.610246219781864, -82.44522359904704 35.61029321979518, -82.44524359904626 35.61031921980253, -82.44536359903789 35.61050221985209, -82.44542959903625 35.61058421987552, -82.44548859903634 35.610646219894214, -82.4455435990382 35.61069321990944, -82.44562059904297 35.610745219927885, -82.44576959905612 35.61082021995853, -82.44602359908309 35.61091822000463, -82.44619259909982 35.61099122003679, -82.44633959910911 35.61108822007163, -82.44639359910957 35.61114322008842, -82.44643659910791 35.61120022010441, -82.44647559910437 35.61126522012161, -82.44649859910001 35.61131822013476, -82.44651159909228 35.611382220149096, -82.44652459906851 35.61155022018465, -82.44647259899126 35.611995220269684, -82.44647359897193 35.61212122029548, -82.44649159895546 35.61224722032292, -82.44651559894103 35.612366220349614, -82.44655359892772 35.6124932203793, -82.44660059891534 35.612624220410765, -82.44665359890931 35.612720220435726, -82.44672359890798 35.612804220459985, -82.4468035989122 35.61286222048007, -82.4468525989169 35.612884220489555, -82.44686959891854 35.612892220493, -82.44694659892696 35.612920220506574, -82.44704459894078 35.61293622051991, -82.44714659895668 35.61294222053162, -82.44728759898034 35.61294022054573, -82.44770359905208 35.61292222058488, -82.44825659914564 35.61290922063911, -82.44857259919812 35.61290822067147, -82.44896159926212 35.61291122071216, -82.44954359935764 35.61291722077325, -82.44977859939512 35.61292622079925, -82.44997359942532 35.61294022082215, -82.45022559946102 35.61297922085601, -82.45049359949553 35.613043220896564, -82.45076859952569 35.613143220945204, -82.45087859953537 35.61319822096773, -82.4510225995481 35.61327022099718, -82.45120159956114 35.613378221037514, -82.45124659956431 35.61340622104792, -82.45130059956611 35.61345222106276, -82.45138259958094 35.61344422106966, -82.45154659960842 35.613442221086046, -82.45170159963612 35.61342922109937, -82.45182959966161 35.61340122110684, -82.45195659969167 35.613343221108146, -82.45197959969765 35.61332822110749, -82.45206959972117 35.61327322110561, -82.45219759975745 35.61317522109878, -82.45234159980079 35.613049221087984, -82.45254959986657 35.6128462210681, -82.45259359988329 35.61278522106031, -82.45264159990944 35.61266722104118, -82.4526695999317 35.61255322102091, -82.45268759995143 35.61244422100061, -82.45273960007441 35.61170322085533, -82.45276260010523 35.61152822082209, -82.4527856001211 35.61145022080863, -82.45282260014044 35.61136422079491, -82.45285160015304 35.61131422078776, -82.4529116001748 35.611237220778285, -82.45301460020887 35.61112722076652, -82.45317360025852 35.61097622075215, -82.4535236003679 35.610643220720476, -82.45357860038507 35.61059122071559, -82.45375160043795 35.610434220701464, -82.45390460048125 35.61031722069342, -82.45403760051693 35.61022922068917, -82.4541716005507 35.61015422068779, -82.45440160060537 35.61004722068968, -82.45475060068628 35.60989722069514, -82.45480760069938 35.60987322069604, -82.45496960073763 35.60979922069765, -82.45511660077416 35.60972022069674, -82.4551816007913 35.609679220695085, -82.45543560085859 35.609516220688135, -82.45561560090546 35.609405220684096, -82.45575360093964 35.60933222068346, -82.45587460096833 35.60927622068447, -82.45590260097464 35.60926522068507, -82.45604060100538 35.60921422068894, -82.45627160105596 35.60913422069643, -82.45655660111834 35.609036220705846, -82.45695860120473 35.608908220721176, -82.45716560125041 35.60883422072747, -82.45731760128497 35.60877322073071, -82.45743960131462 35.60871222073083, -82.45766460137452 35.608565220724124, -82.45781060141093 35.608486220723144, -82.45796360144553 35.608426220726635, -82.45820460149879 35.608340220733886, -82.45821260150049 35.608337220734136, -82.45873660161263 35.608173220754736, -82.45901060166949 35.608099220767855, -82.45905460167856 35.60808722076993, -82.4591686017018 35.608059220775985, -82.4591876017056 35.60805522077716, -82.45923260171412 35.6080482207803, -82.4593306017328 35.60803222078715, -82.45947460175874 35.60801922079938, -82.45956660177326 35.6080232208096, -82.45974560179941 35.60804622083268, -82.45978360180494 35.608051220837645, -82.45996860183021 35.608086220863775, -82.46013960185225 35.60812722088973, -82.46031960187436 35.60817722091841, -82.460505601898 35.6082232209469, -82.46064260191737 35.60824522096541, -82.46076360193588 35.60825522097998, -82.46087160195351 35.60825622099124, -82.46098660197383 35.60824822100145, -82.46107160199001 35.60823522100753, -82.46126460202915 35.60818822101785, -82.46130360203706 35.608179221020016, -82.46176160213346 35.60804622104013, -82.46183860214977 35.60802322104339, -82.46188060215837 35.60801222104546, -82.46209360220175 35.60796022105679, -82.46224560223153 35.607930221066354, -82.46227060223633 35.607926221068105, -82.46236860225486 35.60791122107516, -82.4629486023607 35.607848221122, -82.4632586024167 35.60781822114776, -82.46355060246921 35.60779122117234, -82.46368260249173 35.607787221185085, -82.46382260251396 35.6077932212007, -82.46394560253236 35.60780622121601, -82.46438060259305 35.60788022127579, -82.46455160261746 35.60790522129853, -82.46481860265914 35.60792222132938, -82.46497260268448 35.607923221345494, -82.46522360272881 35.60790522136762, -82.46545260277193 35.60787222138448, -82.46565760281204 35.60783222139742, -82.46591960286442 35.60777422141261, -82.46659060299801 35.60762922145217, -82.46679360303919 35.607580221463074, -82.46687460305569 35.60756022146733, -82.4670256030861 35.60752522147577, -82.46711660310521 35.60749922147982, -82.46719760312202 35.60747722148368, -82.46725360313376 35.60746122148624, -82.46742260316881 35.60741522149424, -82.46747960318055 35.60740022149702, -82.46756660319872 35.6073762215011, -82.46764060321463 35.607352221503895, -82.46793260327685 35.607263221515765, -82.46812460331712 35.6072082215244, -82.46820660333421 35.60718522152809, -82.46828860335009 35.60717022153346, -82.46843660337885 35.60714322154324, -82.46867560342058 35.60712922156498, -82.46906760348111 35.60715822161119, -82.46974460358048 35.607241221697784, -82.47036660367165 35.60731822177739, -82.47086060374582 35.60736822183833, -82.47101160377024 35.607372221854725, -82.47105460377786 35.607369221858505, -82.47112660379086 35.60736222186453, -82.47126460381865 35.607330221872196, -82.47136660384167 35.60729022187452, -82.47149160387148 35.60723122187539, -82.47164260391165 35.607133221870995, -82.47173860393991 35.6070532218646, -82.47183060397094 35.60695122185336, -82.47200560403552 35.60672022182441, -82.47209460406683 35.606613221811756, -82.47218060409521 35.6065212218019, -82.47228760412472 35.60644522179741, -82.47243860416147 35.606369221797586, -82.47265860421162 35.6062802218021, -82.4733656043669 35.60603322182457, -82.4735036043998 35.605968221825556, -82.47362560443277 35.60588522182122, -82.47365260444084 35.605862221819365, -82.4737496044688 35.605785221813626, -82.47385760450338 35.60567722180276, -82.47437260467566 35.605113221741036, -82.4745506047328 35.60493422172298, -82.4745776047406 35.60491222172129, -82.47469460477134 35.60483922171849, -82.47468360473535 35.6050602217623, -82.4746806047135 35.60519922179025, -82.47468260470114 35.60528122180712, -82.47468760468469 35.6053932218304, -82.47470560467177 35.60549622185317, -82.47472760466326 35.60557522187157, -82.4747576046578 35.60564322188843, -82.4748146046528 35.6057362219132, -82.47498160465213 35.60592022196779, -82.47503760465106 35.60598722198719, -82.47517760464376 35.60618522204186, -82.47532560463384 35.606408222102395, -82.47547660462405 35.606634222163926, -82.47556260461546 35.606782222202895, -82.47559960461207 35.60684422221926, -82.47563960460235 35.60695022224491, -82.47565160459972 35.60698022225232, -82.47568060458498 35.60710722228106, -82.47569860456755 35.60723922230978, -82.475711604552 35.607354222334486, -82.47571560453001 35.607501222364846, -82.47571660452566 35.60753022237078, -82.47571060450495 35.607658222396246, -82.47570860450004 35.607687222401914, -82.47570660449288 35.607732222410874, -82.47567960445363 35.60795722245391, -82.4756796044533 35.607959222454305, -82.4756746044402 35.608039222469955, -82.47569260440692 35.608274222519626, -82.47569360439502 35.60835222253563, -82.4756786043814 35.60842422254875, -82.4756476043668 35.608486222558106, -82.47559960434987 35.60854422256502, -82.47554260433208 35.60859822257011, -82.47546560431203 35.60864522257168, -82.47543660430408 35.60866622257303, -82.47538660429001 35.608703222575414, -82.47529560426202 35.608787222583175, -82.47526560424856 35.60884222259124, -82.47526060424413 35.608865222595405, -82.47525360422956 35.60895222261235, -82.47527060422131 35.609024222628776, -82.47527860421887 35.60904822263445, -82.47530160421283 35.60911222264989, -82.47545360418687 35.609444222732996, -82.4754966041756 35.60956322276161, -82.47551960416999 35.60962422277638, -82.47554060416206 35.609698222793575, -82.47554860415644 35.60974322280361, -82.4755876041203 35.61001922286372, -82.47561060409022 35.61023922291082, -82.47561760407366 35.610354222934944, -82.47565160404623 35.61056822298189, -82.47568260403871 35.61065022300176, -82.47573560403089 35.61075822302919, -82.47574360403003 35.61077222303283, -82.47602460400553 35.611233223155544, -82.47617760399291 35.61147922322134, -82.4762276039853 35.61158222324739, -82.47627060396765 35.61174322328455, -82.4763466039171 35.612152223375574, -82.4764326038772 35.612503223455725, -82.47650660385382 35.612734223510394, -82.47669660380663 35.61324422363364, -82.47673960379342 35.61337622366488, -82.47684860375935 35.61371422374489, -82.47690260374286 35.61387922378395, -82.4771076036854 35.61447122392547, -82.47713260367938 35.61453722394147, -82.47719860367464 35.61463922396901, -82.47724060367385 35.614689223983426, -82.47719860365703 35.614753223992196, -82.47717460364709 35.61479222399763, -82.47715060363548 35.61484122400509, -82.47709660360839 35.61495922402354, -82.4770656035923 35.615030224034776, -82.47691560351613 35.61536222408693, -82.47690960351349 35.61537322408852, -82.47684160348201 35.61550422410815, -82.4767606034443 35.615661224131784, -82.47659060336385 35.61600022418319, -82.47653660333663 35.61611822420163, -82.47644760328828 35.616336224236804, -82.47642860327599 35.616395224246894, -82.4763656032333 35.61660422428291, -82.47629860320009 35.61674822430523, -82.47627060318565 35.616811224315214, -82.4762556031793 35.61683622431878, -82.47623260316858 35.61688122432556, -82.47610360311504 35.617089224354594, -82.4760526030936 35.61717322436638, -82.47597760306498 35.61727822438004, -82.47575460297895 35.617596224421796, -82.4756816029504 35.617703224436, -82.475543602898 35.61789422446064, -82.47532960281607 35.61819522449984, -82.47520760276781 35.6183772245243, -82.47515060274308 35.61847622453862, -82.47514860274225 35.61847922453893, -82.47509860271734 35.618587224555824, -82.47505760269372 35.6186962245738, -82.47501060266676 35.618820224594145, -82.4749316026208 35.61903322462934, -82.47489460260083 35.61912322464386, -82.47485860258449 35.61919022465377, -82.47483260257214 35.619242224661654, -82.47478960255538 35.61930422466984, -82.4747776025508 35.619321224672035, -82.47468160251933 35.61942222468267, -82.47454660247932 35.61953622469201, -82.47444960245313 35.61960222469545, -82.47438760243696 35.61964022469685, -82.47430360241464 35.61969422469915, -82.47397960233447 35.6198662247008, -82.47386960230472 35.6199402247045, -82.47375260227055 35.62003622471193, -82.47355560220957 35.62021922472897, -82.47338660215573 35.62038722474571, -82.47329560212846 35.6204662247524, -82.47319860210072 35.62054122475766, -82.47312960208369 35.620578224758084, -82.47311860208079 35.62058522475841, -82.47302760206021 35.62062022475612, -82.47294360204256 35.620644224752375, -82.47261760198184 35.62068822472776, -82.47236060193424 35.62072022470786, -82.4721676018975 35.620751224694295, -82.47201160186671 35.62078322468482, -82.47187860183827 35.62082422467944, -82.47179060181831 35.62085922467751, -82.47170660179741 35.62090422467805, -82.47163960177858 35.62095422468126, -82.4715826017615 35.62100422468552, -82.47157960176052 35.62100722468589, -82.47153260174295 35.6210702246938, -82.47149360172475 35.62114622470527, -82.47136660164938 35.62149822476382, -82.47135660164278 35.62153022476926, -82.47131960161879 35.62164622478899, -82.47130460160335 35.62173022480459, -82.47130360158945 35.621819224822545, -82.47132060158067 35.621894224839586, -82.4713536015727 35.62198122486065, -82.47141360156625 35.62208722488839, -82.47152060155955 35.6222452249315, -82.47154860155437 35.62230922494747, -82.4715646015493 35.62235922495922, -82.47156660154086 35.62241622497105, -82.47155860153026 35.6224762249824, -82.47153560151628 35.62254222499351, -82.47148960149416 35.62263622500787, -82.47117160135376 35.62320422509067, -82.47109760132174 35.6233322251091, -82.47099860128071 35.623491225131225, -82.47084960122365 35.62370122515859, -82.47064960115726 35.62391622518171, -82.47055560112598 35.6240182251928, -82.47050360110758 35.62408122520024, -82.47045460108896 35.62414922520901, -82.47038860106046 35.62426322522543, -82.4703436010351 35.62437922524434, -82.47032460102413 35.62443022525284, -82.47020960093185 35.62490422533737, -82.4701416008807 35.62516222538285, -82.47005360081025 35.62552422544743, -82.47007360077109 35.62579922550534, -82.47009760076907 35.62583822551574, -82.47020760076035 35.62601322556264, -82.47085960079261 35.6265042257296, -82.47133460078904 35.62703722588689, -82.47165760078038 35.62744022600208, -82.47189960077209 35.62775322609066, -82.4719906007705 35.62786122612201, -82.47205460077018 35.62793222614301, -82.4720826007702 35.62796222615197, -82.47217260077194 35.628047226178516, -82.47246860078246 35.628297226259846, -82.47255760078441 35.62838022628588, -82.47264660078477 35.62847322631397, -82.47270860078117 35.62856322633867, -82.47272960077746 35.628609226350136, -82.47275760077305 35.628668226365015, -82.47278860076163 35.62877522639004, -82.47282360072312 35.629062226451914, -82.47283260070016 35.6292212264852, -82.47283460069676 35.629245226490276, -82.47283660067805 35.62936822651549, -82.47283160065795 35.62949322654044, -82.4728186006362 35.629620226564924, -82.47275260056904 35.62998422663218, -82.47264060046709 35.63052422673047, -82.47258360042593 35.63072922676625, -82.4725156003905 35.63088622679124, -82.47246160036586 35.63098722680617, -82.47242960035337 35.63103422681245, -82.47228560029595 35.631251226841705, -82.47207660021488 35.631551226881264, -82.47205260020603 35.63158322688533, -82.47199960018584 35.63165722689493, -82.47198060017921 35.631680226897615, -82.47195560017 35.63171222690151, -82.4719776001536 35.63184222693027, -82.4720046001564 35.63185322693527, -82.47203860014154 35.63198622696585, -82.47221360014333 35.632162227019606, -82.47222360014419 35.63216722702166, -82.4723076001521 35.63220622703823, -82.47246960015366 35.63237022708827, -82.47250960014856 35.632446227107856, -82.47257060011756 35.632712227168255, -82.47261060011738 35.63275622718128, -82.47283960013702 35.63287522722906, -82.47296060013637 35.63300922726874, -82.47300160012307 35.6331392272994, -82.47284860004757 35.633464227349776, -82.47284660004627 35.633470227350784, -82.47283359998968 35.633822227421014, -82.47287359997458 35.633963227453826, -82.47284659996296 35.634009227460346, -82.4728875999633 35.634051227473186, -82.47290059995503 35.6341192274883, -82.47289459986902 35.634669227599524, -82.47280659981188 35.63494522764666, -82.4727535997772 35.63511222767512, -82.47273959975895 35.63521522769465, -82.47272659974031 35.63532222771502, -82.47273959972553 35.635432227738725, -82.4726525995924 35.63620022788605, -82.47268659957238 35.63636622792323, -82.47275359955648 35.63654122796574, -82.47296959955482 35.63678422803738, -82.47307659954903 35.636936228079314, -82.47316459953106 35.637147228131326, -82.47321859950637 35.63736522818118, -82.47327259950156 35.637454228204895, -82.47340759951236 35.637529228233994, -82.4735695995304 35.63758622826233, -82.47386559957376 35.63762322830027, -82.47401259956739 35.6378222283559, -82.47411659951638 35.638264228456435, -82.47414159950407 35.63837022848058, -82.47416259950032 35.63841722849232, -82.47418159949687 35.638460228502986, -82.47421559946011 35.63873422856224, -82.47426959945041 35.63885522859243, -82.47426959943684 35.63894322861032, -82.47429659943792 35.6389652286176, -82.47433659939894 35.63926022868166, -82.47436359940001 35.639282228689, -82.47438459937631 35.639458228726916, -82.47439759935618 35.63960222875754, -82.47442459935735 35.63962422876478, -82.4744415993515 35.63968022877798, -82.47445159934817 35.63971222878547, -82.47446559932685 35.639865228818046, -82.47437059929071 35.639997228835036, -82.47431759927773 35.64002422883508, -82.47431059927305 35.640047228839094, -82.4741895992412 35.640123228842036, -82.47417659923383 35.64015722884765, -82.47412259922164 35.64017822884637, -82.4741085992141 35.64021222885179, -82.47409959921208 35.64021522885155, -82.47405459920189 35.64023322885052, -82.47397359917466 35.64032222886035, -82.47391559915938 35.64035922886182, -82.47349859904992 35.64062022887198, -82.47347659904409 35.640634228872614, -82.47326759897865 35.64083322889157, -82.4728775988655 35.64114722891522, -82.47282359885344 35.64116722891375, -82.47238659872129 35.641554228947555, -82.47237059871685 35.64156522894804, -82.47197759860617 35.641860228967595, -82.47192959859274 35.6418952289698, -82.47180759855826 35.64198722897589, -82.47179459855244 35.642011228979456, -82.4717665985396 35.64206422898732, -82.47179759851379 35.64226422903124, -82.47188159844468 35.64280222914927, -82.47190059843813 35.64286522916405, -82.47195959841775 35.6430602292098, -82.47197959841073 35.6431272292255, -82.4720415983894 35.64333122927335, -82.47205059838633 35.64336122928043, -82.47205459838078 35.64340122928893, -82.47206359836962 35.64348322930655, -82.47209059837074 35.64350522931376, -82.47208359836117 35.64355922932407, -82.47217859833114 35.64385522939408, -82.47246759826058 35.64462222957975, -82.47253559824411 35.64480222962339, -82.47269059821886 35.645131229706294, -82.4731825981885 35.645856229904396, -82.4735395981373 35.64657023008632, -82.47367459813513 35.64672923013257, -82.47403759814273 35.64706923023904, -82.474064598147 35.64707123024229, -82.47410559814891 35.64710223025279, -82.47441559819326 35.647148230294036, -82.47446959819871 35.647170230304084, -82.4747185982096 35.64736723036986, -82.47479959820716 35.647470230399115, -82.474825598201 35.647537230415374, -82.47483959819817 35.64757123042377, -82.47486659817726 35.647735230459915, -82.47486659814588 35.64793823050117, -82.47494059807337 35.64848723062049, -82.47504259804451 35.6487832306912, -82.4750505980413 35.64881223069789, -82.47514359800037 35.64917723078174, -82.47521759796794 35.64946623084807, -82.47526459795377 35.649608230881825, -82.47530559789607 35.65002623097109, -82.47534559788903 35.65011423099309, -82.47548559789854 35.65020323102563, -82.47553459790164 35.65023523103717, -82.47557459790832 35.6502352310413, -82.47567559791582 35.650295231063865, -82.47579459791866 35.65040423109824, -82.47591759792193 35.650515231133575, -82.47603959790656 35.650745231192865, -82.47606159789747 35.650828231212024, -82.47609359788497 35.65094323123869, -82.47615459784579 35.65126223130985, -82.47616759780877 35.65151523136267, -82.47612059773655 35.65193223144266, -82.47601359767367 35.652224231491076, -82.47592859764828 35.65229723149711, -82.47569759757877 35.65249923151441, -82.47550659753519 35.65257623151035, -82.47542759751714 35.65260823150882, -82.47530659747557 35.6527472315246, -82.47526659744703 35.65288923154933, -82.47523259738337 35.653264231622124, -82.47521159735962 35.65339523164657, -82.47517959732218 35.653603231685594, -82.47517259727152 35.65392323174999, -82.47514559724517 35.65406523177605, -82.47494359714442 35.65450023184371, -82.47491059707593 35.65490723192315, -82.47487059704908 35.655038231945696, -82.47484359701212 35.65524823198559, -82.47481659700104 35.65529123199151, -82.47474259691579 35.65576323207993, -82.47469559687664 35.65596623211641, -82.47468959687139 35.65599323212125, -82.47465559685868 35.656039232127064, -82.47464559684985 35.65608523213548, -82.4746015968064 35.65631923217847, -82.4747025967177 35.657001232327595, -82.47474659672054 35.65703023233804, -82.47477059672225 35.65704523234358, -82.4748455967178 35.65715423237349, -82.47487659671616 35.657198232385625, -82.47489159671537 35.657219232391434, -82.47512759667028 35.65776423252658, -82.47518159664855 35.657962232572366, -82.47519559662895 35.65810423260273, -82.47516159657313 35.6584282326651, -82.47502759649981 35.65875923271863, -82.47500559649059 35.65879523272368, -82.474885596439 35.65900023275304, -82.47484559642704 35.65903423275583, -82.47467059635414 35.659318232795584, -82.4744955962987 35.65948923281233, -82.47436759624848 35.65967623283716, -82.47428659620121 35.65989523287337, -82.47430059620004 35.65991823287948, -82.47427359619215 35.65994023288123, -82.47425959616946 35.66007123290643, -82.47423359616161 35.66009423290837, -82.4742195961492 35.660160232920404, -82.47402459606484 35.660496232968654, -82.47398459604153 35.660604232986486, -82.47382259598042 35.6608252330147, -82.4737825959611 35.66090723302732, -82.47370159593684 35.66097723303321, -82.47363359591667 35.66103523303796, -82.47362759589973 35.6611382330583, -82.47331859576339 35.66168823313842, -82.47326459574614 35.661742233143784, -82.47324459573254 35.661808233155185, -82.47310959566592 35.66209423319944, -82.47295459555534 35.662643233295086, -82.47290159548606 35.6630342333692, -82.47284559544262 35.66325523340834, -82.47282759542803 35.663330233421746, -82.47280059538271 35.66359423347264, -82.47286159529568 35.66422223360664, -82.47282859521724 35.66469423369925, -82.47277459517605 35.66490223373599, -82.47276359516978 35.66493123374082, -82.47268059512301 35.66514423377552, -82.47266659510446 35.66524923379544, -82.47260659502307 35.665711233883286, -82.47253859498628 35.66587623390979, -82.47241759494256 35.66602923392844, -82.47234859490744 35.66618223395249, -82.47234359490469 35.66619423395438, -82.47229059484673 35.666512234013595, -82.47216759476727 35.666894234078605, -82.47179959452905 35.66803923427359, -82.47167759444953 35.66842223433896, -82.47160259443963 35.66840623432793, -82.47139659441972 35.668314234288026, -82.47120559441025 35.66817023423907, -82.47105959441146 35.66800623419065, -82.47098459441668 35.66789223415976, -82.47083959443239 35.6676352340926, -82.47071759445267 35.66737323402672, -82.47050859449118 35.66690023390894, -82.4704305945019 35.66674723386979, -82.47042459450216 35.666739233867524, -82.4703375945061 35.666620233834365, -82.4702115945033 35.66650323379756, -82.47004759449236 35.66639823375939, -82.46987359447455 35.66632723372695, -82.46972659445525 35.666294233705116, -82.46953159442658 35.66627023368014, -82.46935559439694 35.66627323366268, -82.46919459436803 35.66628723364891, -82.46886459430667 35.66633023362364, -82.46858159425292 35.666374233603456, -82.4683845942139 35.66641523359153, -82.46817559417052 35.66647223358154, -82.46771959407012 35.66663223356712, -82.46721959395238 35.666857233561345, -82.46652359378649 35.66718323355597, -82.4662255937214 35.66728423354582, -82.46596659366905 35.667345233531556, -82.4656915936187 35.66737623350953, -82.46546159358054 35.66737623348582, -82.46521159354336 35.667348233454376, -82.46487659349982 35.66727123340415, -82.46461059346855 35.667188233359866, -82.46427859343196 35.6670682333013, -82.46380859338036 35.666898233218284, -82.46305059329906 35.66661123308178, -82.46286259328016 35.666532233046354, -82.46266659326291 35.66643323300601, -82.46251759325234 35.666342232972184, -82.46229959324107 35.66618123291696, -82.46216759323897 35.66605323287736, -82.46195959324453 35.66579423280329, -82.46188459325194 35.665666232769496, -82.46185259325712 35.6655982327524, -82.46183059326077 35.66555123274054, -82.46178559327264 35.66542623271049, -82.46176259327842 35.66536423269552, -82.46102859353178 35.66294023212697, -82.46089559354523 35.66271023206646, -82.46074759355197 35.66250823201014, -82.46056659355382 35.6623022319496, -82.46039159355007 35.662139231898486, -82.46017859354085 35.66197023184217, -82.45992959352786 35.661787231779265, -82.45966159351114 35.66160823171528, -82.45936959349433 35.661404231643665, -82.45917659348628 35.661249231592265, -82.45901059348398 35.66108623154207, -82.45887459348813 35.66091323149285, -82.45875359349647 35.66073023144311, -82.4586205935113 35.660491231380846, -82.45847359352337 35.66025623131795, -82.45831859352899 35.660053231260704, -82.45829959352852 35.66003623125526, -82.4581525935244 35.659905231213436, -82.45793859351238 35.65975323116051, -82.45741659347152 35.65945823104676, -82.45721259345855 35.659323230998325, -82.45709159345603 35.65921023096284, -82.45700059346423 35.659059230922765, -82.45694059348725 35.65884623087326, -82.45691959352338 35.658590230819065, -82.45691159365556 35.65772723064276, -82.4568785936853 35.65749923059302, -82.4568025937077 35.65727323053919, -82.4566855937243 35.657040230479744, -82.45657259372965 35.656884230436354, -82.45640459373296 35.656683230378185, -82.45621159372692 35.65651523032419, -82.45600659371551 35.65636923027339, -82.45545659367711 35.65602823014736, -82.4552195936656 35.65584823008636, -82.45494159365548 35.65561623001054, -82.45474959365717 35.6553992299466, -82.45454159366786 35.6551072298658, -82.45439859368075 35.654870229802945, -82.45423959369252 35.6546242297365, -82.45407159369623 35.654420229677704, -82.45383859368494 35.654243229617734, -82.45362959366504 35.654147229576694, -82.45337259363025 35.654097229540014, -82.4530385935751 35.65409622950541, -82.45247059346582 35.65419422946682, -82.45206759337958 35.65431922945076, -82.45176859330428 35.65448622945388, -82.4515515932378 35.65468322947163, -82.45138559317583 35.65490622949986, -82.45126359311725 35.65515422953775, -82.45115459306142 35.65539822957606, -82.4510175930041 35.6556222296075, -82.45084159294579 35.65581022962758, -82.45059059288198 35.655954229631035, -82.45030059281953 35.65604722962006, -82.4496715926865 35.656233229593134, -82.44943159263339 35.65631922958589, -82.4491845925729 35.65644522958599, -82.44893959250338 35.656632229598806, -82.44877259244421 35.656836229623075, -82.44862359235998 35.657221229686044, -82.44862259230953 35.65754622975197, -82.4487075922721 35.65787922982851, -82.44885859224622 35.65820822991095, -82.44904859222393 35.65855623000125, -82.44925359221412 35.65883923007994, -82.44949759220692 35.65914723016774, -82.44976959220062 35.659479230263166, -82.44999659218891 35.65979823035147, -82.4501975921737 35.66011223043603, -82.45038859214861 35.660478230530074, -82.45052359212201 35.66079523060846, -82.45062559208777 35.66112623068629, -82.45068759205438 35.66140823075004, -82.45072959201805 35.66168823081124, -82.45075559196911 35.66203223088389, -82.45076259193898 35.662234230925705, -82.45076459193098 35.662288230936916, -82.4507575918811 35.662603231000254, -82.4506995918138 35.662976231070154, -82.45059459175464 35.663246231114165, -82.45044059169345 35.66347623114502, -82.45021559161906 35.66371623117068, -82.44999459155565 35.66388923118311, -82.4493465913748 35.66436423121289, -82.44911359130721 35.664551231226945, -82.4488985912386 35.66476423124805, -82.44874059117949 35.66497723127515, -82.44857759110639 35.665275231318915, -82.44829659095635 35.66594323142574, -82.4480415908148 35.66658523153006, -82.44791859075521 35.666838231568775, -82.44781059070732 35.66703223159706, -82.44768759066109 35.66719923161836, -82.4475295906109 35.667354231633645, -82.44736559056294 35.66748823164393, -82.44724159053021 35.66756723164729, -82.44720759052133 35.66758823164797, -82.44700259047382 35.66767523164459, -82.44684859044139 35.66772023163788, -82.44667959040876 35.667750231626556, -82.44643259036542 35.66776523160414, -82.4462035903293 35.667753231578125, -82.44600959030063 35.66773123155364, -82.44569959025976 35.66766323150788, -82.44527859020643 35.667557231442885, -82.44518559019494 35.667531231428015, -82.44412359006354 35.66724323126, -82.44384659002554 35.66719223122117, -82.44359958998785 35.66717123119139, -82.44339458995138 35.6671872311735, -82.44320458991395 35.66722523116163, -82.44309158989014 35.66725823115673, -82.44290758984738 35.66733723115384, -82.44274658980422 35.66744423115906, -82.44262458976563 35.66756223117042, -82.44244558969731 35.66781223120278, -82.44236058965244 35.66801123123448, -82.44232558961612 35.668208231270924, -82.44230058957658 35.66843723131486, -82.44229758954027 35.66866823136157, -82.44228058950071 35.668906231408194, -82.44223458945227 35.66916923145697, -82.44217158939793 35.66945323150816, -82.44210158934565 35.66971623155451, -82.44203858929399 35.669982231602035, -82.44200058925148 35.67021623164568, -82.44201358921912 35.67043923169242, -82.44207058920091 35.670618231734665, -82.44220358919733 35.670783231781876, -82.44235858920773 35.670882231817984, -82.44241358921363 35.6709032318279, -82.44259358923256 35.670973231860785, -82.4432285893094 35.671157231963605, -82.44340158932442 35.67124523199931, -82.4435145893277 35.67134523203129, -82.44362158932279 35.67149123207199, -82.44365958930626 35.67163923210602, -82.44364158927607 35.67181423213975, -82.44358558924283 35.6719692321655, -82.44348158919189 35.672187232199086, -82.44319558905023 35.67279523229323, -82.44306158898164 35.67309523234043, -82.44294958891186 35.67342623239614, -82.44291058887674 35.67361123242977, -82.44287458883608 35.6738352324716, -82.44284458878931 35.67410523252343, -82.44282658874847 35.67435023257134, -82.44279758871144 35.67455823261067, -82.44273358866769 35.67477223264757, -82.44264058862507 35.6749472326736, -82.44253658858483 35.67509623269317, -82.44235758852918 35.67526423270889, -82.44219558848205 35.67539523271883, -82.44200858843078 35.675526232726156, -82.44182558838166 35.67564723273188, -82.44142158827731 35.67588923273949, -82.44137958826711 35.6759102327394, -82.44122658822933 35.67599023273989, -82.44105858819015 35.67606323273742, -82.4409275881618 35.67610623273274, -82.44077058812968 35.676145232724444, -82.44061958810059 35.67617223271435, -82.44041258806433 35.67618423269542, -82.44024058803743 35.67617423267572, -82.44009358801642 35.67615223265607, -82.43991858799356 35.67611223262993, -82.43976558797675 35.676057232602886, -82.43959958796087 35.675982232570554, -82.43939458794506 35.675865232525666, -82.43921458793005 35.67576923248766, -82.43883858790316 35.675540232402255, -82.43826058785912 35.67520623227473, -82.43806658784239 35.675106232234484, -82.4378675878241 35.67501123219459, -82.43767958780552 35.674930232158694, -82.43751558778762 35.674870232129685, -82.43732058776334 35.67481823209894, -82.43710458773425 35.67477523206799, -82.43695058771242 35.674751232047186, -82.43672558767672 35.67474123202199, -82.4365015876366 35.67476023200276, -82.43636158760845 35.67479223199481, -82.43620358757255 35.67485523199132, -82.43604058753156 35.674945231992815, -82.43594058750163 35.675031232000016, -82.43583258746476 35.67515423201391, -82.43575358743055 35.675290232033404, -82.43567858738747 35.6754882320659, -82.43549458724624 35.67620323219229, -82.43543158721039 35.67636723221915, -82.4353335871702 35.67652223224057, -82.43525658714472 35.67660423224929, -82.43512558710894 35.67669523225426, -82.43496058706931 35.676774232253365, -82.43482258704056 35.67681223224685, -82.4346465870082 35.67683323223299, -82.4344295869739 35.67682223220836, -82.43420258694233 35.676783232177016, -82.43385158689514 35.67671223212643, -82.43361058686192 35.676669232092856, -82.43335958682403 35.67664523206202, -82.43308658677827 35.676648232034545, -82.43278758672437 35.67667623200942, -82.43261058668841 35.6767192319999, -82.43235358663252 35.676805231990905, -82.43196758654472 35.67695923198237, -82.4316065864579 35.6771332319805, -82.4312905863755 35.67732723198744, -82.43093358627155 35.67761623200936, -82.43069358619465 35.67785623203343, -82.43049858612885 35.67807223205723, -82.43017058600628 35.67851323211308, -82.43010558598361 35.678589232121816, -82.43001958595356 35.67869123213371, -82.42989958591714 35.67879823214305, -82.42978858588701 35.67887423214702, -82.42972758587115 35.678911232148266, -82.42967158585785 35.678937232147746, -82.42953858582909 35.678980232142855, -82.42937758579771 35.679011232132545, -82.42922058577102 35.67901523211714, -82.42902758574418 35.67898223209059, -82.4288955857288 35.67894023206836, -82.42868458570868 35.67884423202718, -82.42849358569181 35.678749231988135, -82.42828958567533 35.6786372319443, -82.42806458565502 35.67852723189876, -82.42782658562955 35.67843723185592, -82.42769358561043 35.67841823183831, -82.42750158558032 35.67840723181632, -82.42733458555193 35.67841223180013, -82.42714158551615 35.678436231785106, -82.42667458542562 35.67852123175419, -82.42653458539935 35.67854123174379, -82.42639758537581 35.67854623173073, -82.42623058535055 35.67853123171047, -82.42608958533198 35.67850023168961, -82.42595158531826 35.67844123166336, -82.42589058531406 35.67840223164917, -82.42583258531046 35.67836423163547, -82.42574958530838 35.6782882316115, -82.42567758531773 35.67815123157618, -82.42561258533097 35.67799623153803, -82.42556258536172 35.677744231481576, -82.425555585366 35.67770923147374, -82.42548858542841 35.67723423137027, -82.42543558546056 35.67697023131115, -82.42541258549157 35.67674523126308, -82.42533458553136 35.6764052311859, -82.42527058554394 35.67625523114884, -82.42518058555292 35.67610123110821, -82.42508658555464 35.67598923107577, -82.42496358555188 35.67587523103989, -82.42483958554514 35.67578623100901, -82.42473958553711 35.67573123098756, -82.42472058553567 35.67572023098337, -82.42448358551468 35.675602230934956, -82.42423058548837 35.675501230888365, -82.42404058546701 35.67543623085555, -82.4240165854642 35.675428230851395, -82.42377558543643 35.67535023081072, -82.42349558540022 35.675284230768405, -82.42322158536226 35.67523623073044, -82.42299558533021 35.675201230700026, -82.42269158528512 35.67516723066169, -82.42243558524349 35.67516223063433, -82.42220458520408 35.675169230611935, -82.42198158516378 35.67519123059339, -82.4217885851258 35.67523023058141, -82.42161558508904 35.67528223057416, -82.42140958504271 35.67536123056895, -82.42125658500554 35.675437230568676, -82.42105558495207 35.675567230574416, -82.42086458489715 35.67571723058513, -82.4206875848422 35.675883230600675, -82.42049958478025 35.676082230621724, -82.42033758471966 35.67630023064936, -82.42025758468503 35.67643823066916, -82.42017558463257 35.676689230711744, -82.4201475845838 35.676974230766696, -82.4201845844934 35.67759723089717, -82.42018258446787 35.677760230930105, -82.42013358443695 35.67790723095492, -82.42005158439932 35.678062230977964, -82.41995658436535 35.678180230992155, -82.41984858433345 35.67827023099936, -82.41969858429707 35.678345230999184, -82.41955358426554 35.678393230993905, -82.41939658423476 35.678424230984, -82.41927058421277 35.678431230972414, -82.41926258421165 35.67843023097143, -82.41907258418182 35.67841923094961, -82.41891058415801 35.67840023092906, -82.4187785841404 35.67837223090969, -82.41854958410786 35.678337230879, -82.41804058404088 35.67822523080374, -82.41775558400033 35.67818223076558, -82.41754958396682 35.67817823074359, -82.41741758394308 35.678190230732426, -82.41732158392415 35.678210230726584, -82.41720658389615 35.67826823072649, -82.41709358386638 35.67833923072923, -82.41701558384077 35.678421230737904, -82.41695558381723 35.67850823074941, -82.41690658378673 35.67865323077385, -82.41689058375776 35.67882323080669, -82.41690958373553 35.678987230841955, -82.41709358368313 35.67952223096976, -82.41718258366289 35.67974823102483, -82.41728058363172 35.68005423109711, -82.41738858360631 35.68033323116501, -82.4174455835867 35.680521231209106, -82.41747558356103 35.68071923125243, -82.4174605835415 35.68082923127324, -82.41739258350735 35.68097623129612, -82.41733758348603 35.6810552313065, -82.41727958346578 35.68112423131458, -82.41706058340472 35.68128423132451, -82.4168245833448 35.68141823132733, -82.41667558330425 35.68152023133275, -82.41655058326711 35.68162723134163, -82.41645158323543 35.68172523135128, -82.41632858317453 35.6819872313919, -82.41618558303597 35.68272823152779, -82.41600958295406 35.68306923157889, -82.4153135827158 35.683862231668314, -82.41468558244131 35.684962231827164, -82.41426558230216 35.68541123187511, -82.4133655820412 35.68613323192902, -82.4128885819236 35.68638223193042, -82.41237558183411 35.686411231883405, -82.41158058173404 35.686207231759965, -82.41123258168179 35.68617223171689, -82.4108025815913 35.68629623169775, -82.41008658137261 35.686942231755275, -82.4093895811245 35.687798231857315, -82.40919558102411 35.68823823192673, -82.40913158095039 35.688645232002784, -82.40939758071332 35.69045923239895, -82.40942258062944 35.691027232517044, -82.40936558055421 35.691451232597316, -82.40927258048463 35.69180123265883, -82.40926358047761 35.691836232665, -82.40872858019664 35.69307723286203, -82.40841757989647 35.69468123315596, -82.40805857975953 35.69518023322034, -82.40755857962185 35.695534233240735, -82.40631457933469 35.69605723321871, -82.40535357909873 35.69655223322016, -82.40520757905692 35.6966662332282, -82.40519257906404 35.69660423321409, -82.40514757908502 35.696420233172084, -82.40513257909201 35.69635923315807, -82.40508857911257 35.6961802331172, -82.405083579145 35.695965233073046, -82.40506957924087 35.69533223294292, -82.40500857931741 35.69477323282295, -82.40496657937186 35.69437723273819, -82.40500657939542 35.69426823272014, -82.40504657942759 35.694103232690736, -82.40498657947384 35.693741232610975, -82.40491957948844 35.69357523257027, -82.40479757950213 35.69335623251316, -82.4046845795234 35.693098232449124, -82.40446857956458 35.692602232325996, -82.40419857956927 35.69228323223335, -82.40393657955829 35.69207423216379, -82.40370757955242 35.69186723209813, -82.40349157955262 35.691635232028645, -82.40340457955864 35.69150323199289, -82.4030005795521 35.69111423187214, -82.40285257955837 35.690915231816405, -82.40264357958182 35.690541231718825, -82.40230657959076 35.69012323159913, -82.40219257960247 35.6899262315473, -82.40219057960377 35.6899152315449, -82.40217857961548 35.6898272315258, -82.40211157962132 35.6897182314967, -82.4014855796039 35.68916123131892, -82.40132357960921 35.688954231260155, -82.40128357960596 35.688932231251556, -82.40087257969829 35.687897230998814, -82.40085257976646 35.687436230903046, -82.40087957980482 35.6872172308613, -82.40098157987472 35.68687523080235, -82.40104857990445 35.686755230784804, -82.40106157992025 35.686667230768286, -82.40116957997648 35.68642023072927, -82.40121658001088 35.68624823069914, -82.40124358002981 35.686155230683006, -82.40125758005243 35.68602423065792, -82.40131158008337 35.68588223063463, -82.40129758008318 35.685868230630305, -82.40132458011277 35.68570623060015, -82.401493580226 35.685156230505854, -82.40154058028313 35.68483823044601, -82.40152758028624 35.68480423043779, -82.40155458033827 35.68449723037817, -82.40156158041525 35.68400823027948, -82.40153458042109 35.68394123026313, -82.40153458046035 35.6836882302117, -82.40156858054763 35.68316123010809, -82.40148058059093 35.68278723002303, -82.40125258063165 35.68228122989668, -82.40116458072771 35.68156722974253, -82.40116558074851 35.68143422971553, -82.40119158075593 35.68141422971418, -82.40126658081776 35.68109522965713, -82.40129258082901 35.681050229650594, -82.40131958087413 35.68078822960021, -82.40128658089758 35.68060122955872, -82.40125958094089 35.68029322949334, -82.40128058107402 35.67945622932548, -82.40139458121469 35.67867022917748, -82.40155058130014 35.67828522911534, -82.40155058130671 35.67824322910681, -82.40161758133328 35.67814322909337, -82.40168358136589 35.67800322907176, -82.40168558136676 35.67800022907131, -82.40171858141616 35.67771622901701, -82.40169158144946 35.67747222896468, -82.40169158149969 35.67714822889884, -82.40173958153294 35.67698522887062, -82.40182058163833 35.67639122875822, -82.40180058167094 35.67615922870907, -82.40175958168288 35.67603822868026, -82.40170558168221 35.67598522866385, -82.40163858168987 35.67586422863233, -82.40157158171108 35.67565522858302, -82.40161858175638 35.67541322853863, -82.40159158177597 35.67525822850438, -82.4015105817693 35.67521422848708, -82.40111358175564 35.6748782283779, -82.40099258175586 35.67474722833881, -82.40091158176287 35.67461522830365, -82.40088558180122 35.67434022824499, -82.40095858187037 35.67397222817771, -82.40102758192528 35.673691228127815, -82.40106658195616 35.67353322809971, -82.40112758198346 35.67342222808341, -82.40119558202872 35.673203228045914, -82.40127658210517 35.672796227971574, -82.4013905821734 35.67247722791848, -82.40155258225188 35.67214422786752, -82.40164058230222 35.67191322782966, -82.40166758231021 35.67189022782784, -82.4017075823441 35.67171422779613, -82.40173458235179 35.67169322779468, -82.40176158238887 35.671483227754734, -82.40174158251327 35.67065822758502, -82.40171458251223 35.67063622757782, -82.40169458255467 35.67034122751575, -82.40169458257517 35.67020822748871, -82.40172158259824 35.670088227467126, -82.40174858260632 35.67006522746528, -82.40176258261867 35.670000227453514, -82.40184358264302 35.669929227447454, -82.4020655826935 35.66984122745244, -82.40211958272454 35.66969822742893, -82.4021195827452 35.669565227401925, -82.40206558276691 35.66936722735608, -82.40192458278612 35.669092227285645, -82.40182958281282 35.66881822722021, -82.4018895828771 35.66846722715502, -82.40189058287739 35.66846622715495, -82.40193058290623 35.66832322713, -82.40199858292773 35.66825722712363, -82.4022275829775 35.66818022713158, -82.40232158300236 35.66812022712907, -82.4024025830497 35.66790122709296, -82.40244258306164 35.66786722709015, -82.4024765830876 35.66773522706685, -82.40251758309942 35.667703227064514, -82.40254458311753 35.66761522704943, -82.4025845831308 35.66757222704481, -82.40266558317686 35.6673612270103, -82.40278658322046 35.667209226991915, -82.40284758325801 35.667032226962235, -82.40283358326396 35.666978226949766, -82.40292858330463 35.6668172269269, -82.40292858335036 35.66652222686694, -82.40290158334756 35.66651122686194, -82.40286758337604 35.66629122681365, -82.40284158337525 35.66626822680638, -82.40280058339555 35.66609322676654, -82.40277358339277 35.66608222676155, -82.40273358343741 35.66575122669017, -82.40275658347811 35.665513226644116, -82.40276758349579 35.665410226624424, -82.40288858353279 35.66530122661464, -82.40290158354149 35.66525822660729, -82.402955583559 35.665203226601626, -82.40311758360626 35.66507122659158, -82.4033805836728 35.66492322658857, -82.40362258373 35.664812226590996, -82.40377058376976 35.66471422658627, -82.40394558382243 35.6645612265733, -82.40415458390247 35.664267226535124, -82.40419558391419 35.66423522653285, -82.40439758401924 35.663773226459725, -82.40447858405123 35.66365322644372, -82.40460658409295 35.663520226429874, -82.40463358409744 35.663520226432716, -82.40464658410271 35.66350022642995, -82.40482158414525 35.66341222643015, -82.40502458420025 35.66327422642297, -82.40513158424541 35.66309722639802, -82.40516558428833 35.66285622635262, -82.40511158432011 35.66259322629359, -82.40499058434945 35.66227422621619, -82.40495858438632 35.66200222615768, -82.40495758438828 35.66198822615472, -82.40497058442112 35.661790226115826, -82.40492358447122 35.66141622603503, -82.40481558449073 35.66117422597469, -82.40453358449344 35.660855225880766, -82.4044995845098 35.660713225848404, -82.404513584531 35.66059122582506, -82.40463458457816 35.66041622580198, -82.40468858459538 35.660362225796526, -82.40483658466255 35.66008722575589, -82.40483658466763 35.660054225749306, -82.4049105846937 35.659965225738745, -82.40493758471256 35.65987222572264, -82.40507258477722 35.65959822568088, -82.40509958478533 35.65957522567899, -82.40528158487828 35.65916922561521, -82.40530858488636 35.659146225613334, -82.40530858489284 35.65910422560485, -82.40534858491665 35.65899322558638, -82.40537558492433 35.65897222558488, -82.40538958493853 35.658895225570696, -82.4054425849561 35.65883822556457, -82.40544358496298 35.65879522555598, -82.4054775849741 35.65876022555237, -82.40551058498433 35.65872922554943, -82.4055985850234 35.65857122552642, -82.40565158504066 35.658516225520664, -82.40565158504756 35.658471225511555, -82.40574658509739 35.658251225476654, -82.4057195851082 35.65815222545369, -82.40569258510548 35.658141225448716, -82.40559158513116 35.6578672253826, -82.40555158513136 35.65782322536956, -82.40552458514384 35.65771322534446, -82.40545658515133 35.657592225312854, -82.40545658515967 35.65753822530192, -82.40543058515895 35.65751522529449, -82.4053895851915 35.65726122523864, -82.40536258519045 35.65723922523138, -82.40532958522749 35.65696422517207, -82.40530258522614 35.65694422516524, -82.40526158525167 35.65673522511857, -82.40518858533497 35.65611922498584, -82.40517458537178 35.655866224933014, -82.405208585403 35.655701224903, -82.40528958544493 35.65551622487372, -82.4053425854626 35.65545922486763, -82.40538358549153 35.655316224842736, -82.40541058549911 35.65529622484154, -82.40543758553792 35.65507422479918, -82.40541758555996 35.65491022476371, -82.40539058555876 35.654888224756526, -82.4053765855666 35.65482322474187, -82.40535058560174 35.65456822468735, -82.40532358559906 35.65455722468236, -82.40527658563536 35.6542722246196, -82.40527658569292 35.65390022454403, -82.4053635857661 35.65352022447578, -82.40539758582621 35.65316822440771, -82.40541158589127 35.652762224326615, -82.40540958589322 35.65274822432361, -82.40537158592902 35.65247622426435, -82.4053445859279 35.65245422425712, -82.40529058594127 35.652310224222305, -82.4052305859854 35.65196022414499, -82.40518258606434 35.65139922402609, -82.40514958616271 35.650728223886304, -82.40516358617349 35.6506732238766, -82.40490058636111 35.649179223545836, -82.40444958636179 35.64869222340041, -82.40391058636241 35.64811122322679, -82.40126958638751 35.645122222347226, -82.40126558647763 35.644535222227525, -82.40125858661699 35.64362722204233, -82.4012565866576 35.64336222198823, -82.40125458670263 35.64306922192851, -82.40124958682287 35.64228622176897, -82.40126058693806 35.641553221621095, -82.40125058694598 35.64149122160743, -82.40123858695624 35.64141222159021, -82.40118758695706 35.64135222157268, -82.40116558695492 35.64134222156845, -82.40105258694467 35.64128822154582, -82.40105758694615 35.64128322154535, -82.40106858695033 35.641268221543406, -82.40107358695175 35.64126422154308, -82.40098558694655 35.641204221521825, -82.40081258693162 35.641115221485904, -82.4006085869141 35.64101022144359, -82.40029958688065 35.64089622138855, -82.40000558685871 35.64072322132311, -82.39992258685233 35.64067522130487, -82.39978758683853 35.640620221279754, -82.39973758683476 35.6405912212687, -82.39978258685208 35.640527221260335, -82.39980158686157 35.64048622125392, -82.39980458686745 35.640451221247105, -82.3998025868753 35.64039822123616, -82.39972258691374 35.64006422116004, -82.39963558695747 35.63968822107474, -82.39950458702351 35.63912122094595, -82.39943858706248 35.63879822087356, -82.39942458707733 35.638687220849555, -82.39942158709313 35.638582220827935, -82.39942858710756 35.63849622081117, -82.3995235871923 35.63805022073032, -82.39957558724507 35.63776422067754, -82.39959458727313 35.63760322064683, -82.39963658734538 35.637181220565374, -82.39964158737158 35.6370172205326, -82.39963258738706 35.636907220509315, -82.39961058742489 35.636639220452594, -82.39961458744564 35.63650922042657, -82.39962758746177 35.63641822040939, -82.39964758747638 35.63634522039666, -82.39968858749994 35.63623722037896, -82.39974058752354 35.63613922036435, -82.39982158755606 35.636016220347685, -82.39990258758574 35.635911220334705, -82.40043758777541 35.63525722025701, -82.40066358785344 35.63499422022682, -82.40084958791364 35.634804220207435, -82.40090758793221 35.63474622020161, -82.40096158794917 35.63469422019661, -82.40240658839876 35.6333332200689, -82.40277958851351 35.63299022003765, -82.40295258856437 35.63284622002624, -82.4031495886171 35.63271622002006, -82.4032595886446 35.63265622001922, -82.40336958867087 35.63260422002003, -82.40377458876384 35.63243622002755, -82.40430058888303 35.63222822003955, -82.40442958891359 35.632169220040836, -82.40458958894826 35.63211622004648, -82.40485558900934 35.63200522005135, -82.40514158907354 35.63189622005869, -82.40526558910202 35.631845220061095, -82.405322589115 35.63182222006231, -82.40604458927821 35.63153922007915, -82.4062485893227 35.6314702200862, -82.4064285893604 35.63141922009433, -82.40658258939169 35.631381220102504, -82.406732589421 35.63135222011203, -82.40692758945809 35.63132122012586, -82.40700558947296 35.631308220131196, -82.40723258951465 35.63128222014935, -82.40748158955759 35.63127122017275, -82.40790258962816 35.631265220214935, -82.40821658967944 35.63126922024805, -82.4090375898136 35.63128122033505, -82.40938158986847 35.631294220373135, -82.40962758990564 35.631317220403176, -82.40987058994094 35.63134922043469, -82.4112165901261 35.63159322062295, -82.41169659019164 35.63168322069067, -82.41177559020238 35.631698220701836, -82.41197459022867 35.63174122073115, -82.41205359023886 35.63176022074309, -82.41214659025066 35.63178322075736, -82.41235459027618 35.631841220790555, -82.41329359038735 35.632127220945435, -82.4134975904132 35.632179220977044, -82.41369159043909 35.63221922100509, -82.41374359044592 35.63223022101271, -82.41490359060916 35.632417221170236, -82.41530759066583 35.63248322122528, -82.41591759074892 35.632599221311644, -82.41598059075753 35.632611221320566, -82.41628759079839 35.63267522136517, -82.41659459084025 35.63273322140866, -82.41679959086984 35.63276122143544, -82.41704959090718 35.63278822146664, -82.41759659098997 35.63283822153323, -82.41776159101444 35.63285622155379, -82.41813159106931 35.632898221600456, -82.41837759110415 35.63293622163358, -82.41857059113056 35.632972221660765, -82.41872159114976 35.63300922168385, -82.41890859117197 35.63306622171463, -82.41919559120431 35.63316422176416, -82.41923859120914 35.63317922177162, -82.41953059124388 35.63326722181955, -82.41976359127503 35.633315221853344, -82.4199055912959 35.63333222187141, -82.42007159132287 35.6333352218891, -82.4203195913683 35.633307221909, -82.42169159162876 35.633092222006624, -82.42170759163186 35.633089222007655, -82.4224535917726 35.63297822206188, -82.42254759179151 35.63295622206716, -82.42270359182389 35.6329142220747, -82.42279459184402 35.632881222077295, -82.42288959186713 35.63283322207739, -82.42309259191619 35.63273322207799, -82.42385859210616 35.632325222073945, -82.42418159218609 35.6321542220724, -82.42456059228005 35.631952222070396, -82.42463159229759 35.63191522207019, -82.4248725923563 35.631793222070165, -82.4252225924436 35.631603222067675, -82.4253045924655 35.63154922206508, -82.42545559250972 35.631425222055476, -82.4255335925347 35.631347222047594, -82.42560559255918 35.63126522203837, -82.42561959256493 35.6312432220354, -82.4257825926295 35.63100022200274, -82.42585059265899 35.63088222198572, -82.42620259281547 35.63024722189294, -82.42636259288206 35.62998722185659, -82.42657559297115 35.629639221807835, -82.4267125930282 35.629417221776826, -82.42778859343548 35.62793422158614, -82.42813759356733 35.62745522152472, -82.4284625936818 35.6270622214784, -82.42924359393596 35.62625422139457, -82.42938259398107 35.62611122137984, -82.42971559409641 35.62572122133481, -82.42985059415261 35.62550222130417, -82.42994959419917 35.62530722127477, -82.43004359425065 35.625074221237064, -82.43011259428977 35.62489522120778, -82.43023959437318 35.6244912211388, -82.43033759443536 35.62419422108847, -82.4304995945374 35.62370722100617, -82.43098459483703 35.62228722076747, -82.4310775948964 35.62200222071916, -82.43113359493553 35.62180922068567, -82.43115159495656 35.62169222066375, -82.43114859497258 35.621585220641705, -82.43114159497809 35.621542220632264, -82.43113059498705 35.6214722206169, -82.43109659500016 35.62135122058881, -82.43103359500915 35.62122522055664, -82.43091859501573 35.62105922051109, -82.43065859501701 35.620772220426026, -82.43042259501725 35.62051722034988, -82.43000859501794 35.62006922021617, -82.42971859501927 35.61974922012128, -82.42948559502047 35.619492220045096, -82.42901959502237 35.61898021989303, -82.42893159502275 35.61888321986421, -82.42826059502431 35.61815321964679, -82.42797259502387 35.6178472195549, -82.42786859502459 35.61773121952066, -82.42782059502497 35.617677219504735, -82.42761859502649 35.61745121943799, -82.42757359502691 35.61740021942303, -82.42741959502992 35.617215219369584, -82.42725859503607 35.617003219309886, -82.42719359504004 35.61690721928372, -82.42709859504642 35.61676421924482, -82.4270015950528 35.616619219205376, -82.42682559506822 35.61633021912852, -82.42673759507603 35.61618521909001, -82.42627659511459 35.61544121889129, -82.42612159512754 35.61519121882455)))",6530,37,021,003001,370210030012,2863,2863,57,2806,2719,37,8,26,0,16,57,2399,46,2353,2363,2286,31,7,25,0,14,36,1119,1003,116
census_2010_blockgroups_view.fid--2dc29038_13ec899ba8f_-25ef,"MULTIPOLYGON (((-82.77260965869823 35.57627424647095, -82.77272165871832 35.576265246480574, -82.77305865877807 35.57624224651041, -82.77315965879575 35.57623624651951, -82.77317165879796 35.57623524652055, -82.77321865880643 35.57623124652452, -82.77333865882743 35.576224246535425, -82.77360565887471 35.576207246559264, -82.77437165901041 35.57615524662704, -82.77466365906447 35.57612024664978, -82.77571565920321 35.5763602468065, -82.776906659324 35.57686724703187, -82.77752665938426 35.57714924715291, -82.77779765939296 35.577387247229275, -82.77789865940092 35.57744524725141, -82.77811965942415 35.57753424729223, -82.77818965942917 35.57757724730824, -82.77850365945673 35.57773924737334, -82.77866165947017 35.57782324740665, -82.77876665948092 35.57786724742642, -82.77886765948855 35.57792724744903, -82.7790636595069 35.578021247488266, -82.77917565951736 35.57807424751053, -82.77931165953125 35.57813224753631, -82.77940965953795 35.578195247559165, -82.77940365951525 35.57833624758732, -82.7793256594678 35.5785612476253, -82.77932365944243 35.5787242476583, -82.77929665942852 35.57878524766806, -82.77915265936953 35.579013247699784, -82.77901365930357 35.57929224774252, -82.77872165918829 35.57972624780118, -82.77867465916783 35.579808247813084, -82.77845665906128 35.5802662478843, -82.77831965901248 35.58043524790478, -82.77821265895749 35.580677247943214, -82.77802465889089 35.58090724797087, -82.7779476588495 35.5810932480009, -82.7778586588199 35.58118924801147, -82.77773165876131 35.58143324804822, -82.77764465872322 35.58158624807052, -82.77724765854845 35.582294248174364, -82.77764065855052 35.58270824829909, -82.77823165853292 35.58346524851412, -82.77883265858007 35.58381124864626, -82.77942765862863 35.58414224877473, -82.78047865874053 35.584555248966645, -82.78042365833689 35.58712624948575, -82.78066965836184 35.58723124953239, -82.78070565836539 35.58724724953939, -82.78070665833728 35.58743124957701, -82.78094265832293 35.58778124967261, -82.78117965832585 35.58802024974559, -82.78139665832073 35.588289249822765, -82.78166165831966 35.58858424991009, -82.78204365822137 35.589640250164805, -82.78206565821493 35.5897062501805, -82.7824496582279 35.59003925028774, -82.78286965824182 35.59040525040545, -82.78366165827605 35.591043250616806, -82.78402465827456 35.591447250736444, -82.78476265836863 35.5916372508508, -82.78518665842249 35.591747250916676, -82.78591565846959 35.59223325109054, -82.78629065850367 35.5924182511667, -82.78826865871284 35.59320625153009, -82.7895586588591 35.593656251754055, -82.78974565887906 35.59372925178809, -82.79076965898834 35.59413125197501, -82.79297465921714 35.595038252385926, -82.79320165923413 35.59517425243693, -82.79356465926126 35.59539225251859, -82.79401765929849 35.595642252616024, -82.79525765945007 35.59600325281671, -82.79748165981047 35.596074253058894, -82.79879165984264 35.59728925344111, -82.79923565977704 35.59819925367231, -82.80007465963527 35.60003525413303, -82.8007056595675 35.601163254428, -82.80112965955645 35.6016962545802, -82.80143565954849 35.60208125469015, -82.8017516594455 35.60309525492954, -82.80192065928318 35.60433625520023, -82.80206865922253 35.60489225532885, -82.80230565921886 35.60517425541075, -82.80261165916731 35.60584225557844, -82.80253465907053 35.606389255682274, -82.80243665894636 35.607091255815554, -82.80307765890997 35.608025256071855, -82.80335465871002 35.60962825642753, -82.80341365865978 35.61001925651338, -82.8035136585756 35.61067625665779, -82.80407865862942 35.61094025676958, -82.80464765868352 35.61120625688211, -82.80503865867226 35.61170525702407, -82.8057906586507 35.61266325729669, -82.80702365859435 35.61437025777152, -82.80739565861397 35.61464725786618, -82.80771365863053 35.6148852579474, -82.80830465865131 35.61539225811143, -82.80833965864485 35.61547225813132, -82.80694165848848 35.61497025788567, -82.80625065842415 35.614638257747096, -82.8060956584096 35.61456425771609, -82.80557665837239 35.614242257597176, -82.8054226584124 35.61381425749401, -82.80501465838773 35.61353125739447, -82.80462465830286 35.61366025738086, -82.80430265820692 35.61393425740384, -82.8039866580763 35.61444125747494, -82.80356465795529 35.61477025749892, -82.80304465782774 35.61503525749976, -82.80234365765877 35.61537325749691, -82.80223265766739 35.61519625744944, -82.8020826576609 35.615075257409444, -82.80162965751616 35.6155252574549, -82.80179765744741 35.61615525760071, -82.80182165743773 35.616244257621325, -82.80341865772748 35.61609425775428, -82.80397365781447 35.61613125781871, -82.8037946577437 35.61639725785471, -82.80370665771571 35.61648425786341, -82.8035596576742 35.61659425787081, -82.80311465756353 35.616831257873606, -82.80267765746608 35.61699025786139, -82.8020786573265 35.61724725785248, -82.8012166571324 35.61757425783087, -82.80083365705582 35.617656257808456, -82.80061865701845 35.617666257788436, -82.80042265697308 35.6177482577851, -82.80026865692693 35.61788125779643, -82.80011265686602 35.61810825782681, -82.80002865683264 35.61823425784394, -82.79987665678617 35.61837125785636, -82.79969365674211 35.61845925785559, -82.79947965669179 35.618554257853084, -82.79901365659688 35.61866525782798, -82.79803765638637 35.618974257791066, -82.79775565631893 35.61910725778931, -82.79767865629418 35.619184257797194, -82.79757265625442 35.61932825781572, -82.7973586561431 35.61982025789426, -82.79722865607961 35.62009125793631, -82.79699965599396 35.62040025797584, -82.79682465591539 35.62072125802349, -82.79654965578389 35.621278258109015, -82.79638165566855 35.62184625820778, -82.79629065562874 35.62200625823112, -82.79604665555452 35.62222425825068, -82.79562665548626 35.622212258205145, -82.79422265521248 35.62246825811356, -82.79382665512408 35.62261325810255, -82.7933916550339 35.62272725808129, -82.79254565487622 35.62283425801652, -82.79242265485338 35.6228492580069, -82.79203165478009 35.62290125797748, -82.79154665468623 35.622985257944904, -82.79127765462302 35.62310425794167, -82.79118165459943 35.623153257941794, -82.79108665457606 35.62320225794209, -82.7908056545067 35.623348257943064, -82.79041565440355 35.62359525795355, -82.79003865431031 35.62379225795513, -82.78983065426374 35.623869257949536, -82.78953365421171 35.623885257922375, -82.78910965414346 35.623869257875675, -82.78895465411503 35.62388525786309, -82.7886586540471 35.624006257857395, -82.78855865403041 35.624006257847135, -82.78816165398193 35.6238902577828, -82.7879256539451 35.623873257755186, -82.78758265387913 35.62393025773167, -82.78753865387026 35.62394025772917, -82.78742065384621 35.6239682577228, -82.78698365377159 35.62397925768026, -82.78670765371888 35.624022257660755, -82.78647165366854 35.62409325765104, -82.7863126536219 35.62422425766155, -82.78563765339678 35.624955257741526, -82.78476265321324 35.6251992577017, -82.78432765307784 35.62560725774036, -82.78410665299641 35.625897257776955, -82.78393865294377 35.62605725779242, -82.78361065283549 35.62640525782982, -82.78349565278704 35.626595257856856, -82.78336665268635 35.62711025794875, -82.78332765263818 35.62738125800008, -82.78328965260599 35.62754925803046, -82.78321365255813 35.62777825806941, -82.783137652519 35.627950258096725, -82.78307665249939 35.62801125810294, -82.78297765247649 35.62805325810142, -82.78279365243759 35.628106258093354, -82.78264865239227 35.62824325810648, -82.78250365233929 35.62843025812971, -82.78240565230169 35.62856825814792, -82.7823746522898 35.62861225815367, -82.78194365214695 35.62907325820359, -82.78187665210437 35.62927725823839, -82.78176165206058 35.62943725825922, -82.78166765200169 35.62971825830702, -82.78165365196644 35.62993225834928, -82.78163365194297 35.63006325837395, -82.7815666519073 35.6302222583995, -82.78126965178858 35.6306722584609, -82.78120265175187 35.63083825848792, -82.78120965172013 35.631052258532335, -82.7811886517006 35.63115625855142, -82.78112865167046 35.63128725857204, -82.78097365161891 35.63145425859018, -82.78085265157348 35.631618258611326, -82.7808116515371 35.63181025864631, -82.78074465150974 35.63191525866085, -82.78058965146097 35.63206425867538, -82.78041465141925 35.632145258674, -82.78021265137711 35.6322002586645, -82.78003765133604 35.63227725866231, -82.7798966512965 35.63238125866914, -82.77974865124719 35.632541258686565, -82.77966765121168 35.63268425870746, -82.77962765117968 35.63284925873703, -82.77962665115076 35.63303625877509, -82.77966065114299 35.63312325879635, -82.7797346511351 35.63325525883088, -82.77976765112469 35.63335825885532, -82.77976865109848 35.633530258890474, -82.77966065104171 35.63378225893084, -82.77950565094469 35.63424425900924, -82.77949265090203 35.63450725906161, -82.77949165090008 35.634519259063985, -82.77946465087261 35.63466825909166, -82.77940365084923 35.63475425910291, -82.77928265081273 35.63486025911215, -82.77919565079145 35.63490425911218, -82.7787646507042 35.63500325908827, -82.77858965066149 35.63509125908826, -82.77848865062953 35.63518925909792, -82.77836065057002 35.63543725913542, -82.77834365055631 35.63550825914816, -82.77822565045979 35.63600725923798, -82.77818565043604 35.63611825925654, -82.77810465040996 35.636200259264896, -82.77785565035146 35.6363102592619, -82.77776765032758 35.63637025926509, -82.77757265025438 35.63663425929901, -82.7773306501497 35.637052259359486, -82.77692564996391 35.637820259474786, -82.77679164991626 35.63798425949453, -82.77658264984585 35.63821525952019, -82.7761316497401 35.63841325951444, -82.775976649693 35.63855125952673, -82.77543864951534 35.63912225958805, -82.77532964947807 35.639246259602224, -82.77483164930646 35.63982125966854, -82.77469664926869 35.639920259674916, -82.7744746492165 35.640018259672104, -82.77443464920796 35.64003025967043, -82.77423964916996 35.64006625965782, -82.77399464912344 35.64010225964006, -82.77397064911891 35.64010625963841, -82.77360664903469 35.64025825963207, -82.77351864900722 35.640341259640024, -82.7735016489984 35.640380259646264, -82.77347164898225 35.640452259657856, -82.77345764892829 35.640788259725056, -82.77324964886427 35.640978259742504, -82.77308164881994 35.64108425974691, -82.77306164881004 35.64112725975361, -82.77305464877482 35.64134825979804, -82.77301364875703 35.64141925980832, -82.77293264873263 35.641490259814475, -82.77281164870317 35.64155025981429, -82.77266364866152 35.641660259821634, -82.77261664864449 35.64172025982899, -82.77260964864166 35.64173125983058, -82.77257564862583 35.64179725984052, -82.77255164854556 35.64229225993912, -82.77254164851254 35.642496259979765, -82.77252964850156 35.642554259990334, -82.77252164849429 35.64259325999746, -82.77246764846323 35.64273626002117, -82.77234664841731 35.642903260042814, -82.77224564838541 35.64300126005248, -82.77207764834209 35.64310026005541, -82.77203264832937 35.643134260057764, -82.77194264830355 35.6432042600628, -82.77183764826974 35.64331026007373, -82.77183464826877 35.643313260073974, -82.77169364821818 35.64348926009548, -82.7716126481808 35.64364426011878, -82.7716256481543 35.64383026015806, -82.77157164813079 35.64392426017178, -82.77152464811806 35.64395626017345, -82.77144464810044 35.64398426017101, -82.7713096480745 35.6440062601616, -82.77120864805347 35.64403326015671, -82.7711676480379 35.64409026016416, -82.7711606480242 35.64417126018001, -82.77113464800468 35.64427026019751, -82.77095964792983 35.64456626024002, -82.77087164786022 35.644923260303855, -82.77082464783038 35.64506626032823, -82.77070364777273 35.64530926036547, -82.77066664775306 35.645397260379646, -82.77062264772893 35.64550626039736, -82.77056164769087 35.645687260428005, -82.77050764764384 35.6459342604729, -82.77037964758095 35.64620426051494, -82.77027164752245 35.6464672605575, -82.77019064747334 35.64669826059636, -82.77015064743955 35.64687426062816, -82.77012964740052 35.64710526067317, -82.77019664736855 35.64738526073722, -82.77019764733505 35.64760426078203, -82.77017664730334 35.647787260817175, -82.77000164720226 35.648254260894575, -82.76997464716756 35.6484502609318, -82.76994064708306 35.648962261032814, -82.76994064701123 35.64942926112819, -82.76992664699452 35.64952226114571, -82.76986664697343 35.649594261154235, -82.76970464693734 35.64965326114971, -82.7696846469263 35.64970326115781, -82.76967764686982 35.6500622612304, -82.76971064676476 35.65078026138034, -82.76968964667479 35.65134226149289, -82.76967964666291 35.65140826150528, -82.76965664663388 35.65157226153643, -82.76937364650126 35.65212626162053, -82.76917564637782 35.65271326171998, -82.76911064633711 35.65290726175298, -82.76902264626428 35.65328526182107, -82.76900864621959 35.65356026187575, -82.76903564618588 35.65380826192918, -82.76903564616292 35.653957261959576, -82.76885364608442 35.65427026200477, -82.76872564604362 35.65439626201743, -82.76855064600001 35.65448926201842, -82.76842264596252 35.654594262026734, -82.76834864593326 35.654704262041584, -82.76826764588765 35.65491226207579, -82.76826564588133 35.654951262083465, -82.76825464585419 35.655115262115835, -82.76826164583181 35.65526826214783, -82.7682746458302 35.65529326215419, -82.76834164582213 35.655418262186586, -82.76838864580198 35.655600262228596, -82.76841564577701 35.65579126227036, -82.76840964575554 35.6559242622969, -82.76840864575041 35.65595626230333, -82.76828464567915 35.65628426235758, -82.76823964565277 35.65640726237802, -82.76814764560733 35.656602262408384, -82.76796364551613 35.65699526246973, -82.76780264542916 35.65738526253282, -82.76779464537887 35.6577032625969, -82.7677276453323 35.65793326263701, -82.76763364529273 35.65808826265896, -82.76755264525109 35.658270262687815, -82.76733664516841 35.65857326272748, -82.76726964514044 35.65868226274292, -82.76718864509651 35.65887926277478, -82.76713464507151 35.65898326279047, -82.76698664502142 35.65914826280896, -82.7668846449845 35.6592772628248, -82.7667846449479 35.65940626284092, -82.76654864486603 35.65968226287305, -82.76591564462939 35.66053226298153, -82.76581464459885 35.66062126298942, -82.76554464455214 35.66063226296395, -82.76543964453275 35.66064426295563, -82.76541764452857 35.66064726295395, -82.76530264449721 35.660726262958256, -82.76520164446629 35.660817262966496, -82.76506664440907 35.661042262998585, -82.76484464432009 35.661379263044566, -82.76468964424531 35.66169726309363, -82.76463464420468 35.66190126312956, -82.76462864417898 35.66206126316167, -82.76466264414829 35.662297263213325, -82.76474964411372 35.66261626328735, -82.76483664407428 35.662966263367736, -82.76485064403089 35.66326326342977, -82.76491064401532 35.66342926346978, -82.7649176440082 35.66348326348154, -82.76477564393203 35.66382326353638, -82.7647146438763 35.66411926359051, -82.76466064385114 35.66422426360639, -82.76458664382855 35.66429026361234, -82.76447864380299 35.664339263611225, -82.76438464377638 35.664410263616034, -82.76429064373438 35.6645812636413, -82.76429064372324 35.66465326365603, -82.76437764370984 35.66483426370184, -82.76440464369053 35.66498926373636, -82.76439764367329 35.665093263756816, -82.76433764362879 35.6653172637964, -82.76435064359522 35.66554926384503, -82.76443764355581 35.6658992639254, -82.76444464354229 35.66599426394552, -82.76443764353117 35.666059263958076, -82.7643706434954 35.666218263983644, -82.7641006433792 35.66668026405027, -82.76398864332735 35.66689526408266, -82.76398664332618 35.666900264083495, -82.76376364319516 35.667509264184865, -82.76359564312293 35.66779626422628, -82.76340664305174 35.668053264259306, -82.76320464298551 35.66826426428163, -82.76314364295848 35.6683732642976, -82.76315064295038 35.668433264310636, -82.76317764294552 35.66849426432579, -82.76330564295013 35.6686032643612, -82.76345364293662 35.66885126442702, -82.76344664292372 35.66892726444186, -82.76338564289627 35.66903926445842, -82.76337864288514 35.66910426447094, -82.76341264287139 35.66923026450021, -82.76345264286354 35.66932426452347, -82.76341264284252 35.66941726453832, -82.76336164282061 35.66950426455085, -82.76324964277276 35.669693264577994, -82.7631096427124 35.669933264612574, -82.76300164267325 35.67007026462942, -82.76282564262632 35.67018426463461, -82.76282564262617 35.6701852646349, -82.76267264259108 35.670247264631776, -82.76262164257977 35.670265264630224, -82.76260064257441 35.670277264630556, -82.76257764256925 35.67028626463003, -82.76240664252002 35.67042026463986, -82.7623416425011 35.67047226464379, -82.76224064247442 35.67053626464648, -82.76218664245354 35.6706132646566, -82.76205864239454 35.67085726469331, -82.76189664234357 35.67101226470828, -82.76188264233909 35.67102626470971, -82.76168464228351 35.67117226471924, -82.76166764227867 35.67118526472013, -82.76131064219443 35.67134526471614, -82.76103464214944 35.67133826468634, -82.7608356421131 35.67135826467002, -82.76065664208038 35.67137726465558, -82.75966764187791 35.6716192646034, -82.75935764182871 35.6716022645682, -82.75918864178878 35.671678264566296, -82.75908164175402 35.67178826457778, -82.75881864168898 35.67192526457876, -82.75869764164135 35.67210326460272, -82.75863664162212 35.67216226460855, -82.758468641578 35.67226626461244, -82.75844564157265 35.672276264612115, -82.75823964152359 35.67237126461038, -82.75811164148776 35.672465264616385, -82.75804364146371 35.67254726462621, -82.75799664143976 35.672652264642764, -82.75791564138476 35.672921264689414, -82.75783464135023 35.673057264708824, -82.75771364130541 35.67321726472906, -82.75761864128687 35.67323426472272, -82.75747164126342 35.67322726470625, -82.7572826412394 35.673178264676864, -82.75718864122452 35.67317326466617, -82.75714264121127 35.673209264668806, -82.7570866411948 35.67325526467248, -82.75701264116456 35.67337126468859, -82.75656164108935 35.67337126464225, -82.75619164101315 35.67346426462319, -82.75584864092977 35.67363426462275, -82.75551164084386 35.67382626462734, -82.75486464067393 35.67422826464294, -82.75463964061107 35.67439226465333, -82.75416364047747 35.674743264676145, -82.75386664039674 35.67494526468686, -82.75346964029241 35.67519226469654, -82.75326064024203 35.67529226469551, -82.75293064017019 35.675401264683806, -82.75251964010255 35.675395264640464, -82.75232464006204 35.67544626463085, -82.75222364003538 35.67551026463354, -82.75214264000572 35.675615264646694, -82.75200763996685 35.675721264654484, -82.75187363993521 35.675781264652876, -82.75157063988463 35.6757812646218, -82.7512206398288 35.67576426458242, -82.75109863980501 35.67578626457439, -82.7507276397221 35.675922264564086, -82.75001463957442 35.67610826452886, -82.74984563953323 35.67619226452859, -82.7496016394685 35.6763482645354, -82.74932563938752 35.67657426455318, -82.74900963928658 35.67688726458462, -82.74881963922878 35.67705626459963, -82.7486186391663 35.67724426461738, -82.74825363906113 35.67753126463843, -82.74821963905943 35.67750526462969, -82.74806363904817 35.677409264594054, -82.7479196390352 35.677337264564606, -82.74790963903436 35.677332264562494, -82.74777563902104 35.67727326453674, -82.74767663900809 35.67725026452188, -82.74755263898834 35.677244264507884, -82.74746263897138 35.6772562645011, -82.74733363894353 35.67729726449625, -82.74708963888895 35.67738726448958, -82.7468796388399 35.67747826448663, -82.74678063881771 35.67751526448399, -82.74654363876373 35.67760826447859, -82.7464466387436 35.67763426447399, -82.74640463873578 35.677639264470635, -82.74634863872508 35.67764826446678, -82.74627863871463 35.67764026445797, -82.7462116387088 35.677605264443926, -82.74618963870688 35.67759426443944, -82.74574963868403 35.67726626432727, -82.745720638682 35.67724726432044, -82.74554963867004 35.67714026428108, -82.74528663865192 35.67697326421995, -82.74510263863826 35.676862264178446, -82.74508963863786 35.676851264174864, -82.74499363863336 35.676776264149716, -82.74489863863246 35.67667926412015, -82.74485163863677 35.67660026409916, -82.74483963863817 35.67657826409346, -82.74472163865386 35.676349264034585, -82.74465363866618 35.67619526399621, -82.74450763868452 35.6759182639247, -82.74444163869188 35.67579926389364, -82.74434863871848 35.67552626382834, -82.74433663873026 35.67543726380899, -82.74431963874943 35.67529426377804, -82.74429363876497 35.67516526374904, -82.74427863878005 35.67505126372423, -82.74425663879532 35.67492826369688, -82.74424663879748 35.67490326369078, -82.74420763880515 35.67481126366797, -82.74420263880626 35.674799263664994, -82.74416163881182 35.67471826364428, -82.74411863882831 35.67456526360861, -82.7441006388297 35.67453626360092, -82.74405063883448 35.67445126357837, -82.74404163883531 35.67443626357445, -82.74397063883924 35.67433426354634, -82.7438796388439 35.674205263510686, -82.74380563885063 35.67408126347778, -82.74377463885786 35.67400126345823, -82.7437566388595 35.67397126345024, -82.74370763886375 35.67389026342866, -82.74368763886672 35.6738492634183, -82.74366863886988 35.673808263407984, -82.74363363887828 35.67371626338561, -82.74363163888043 35.67370026338213, -82.74359263892154 35.673391263315075, -82.7435946389323 35.67332326330144, -82.74358563894593 35.673225263280465, -82.7435686389551 35.67314726326284, -82.743521638957 35.67308426324514, -82.74351163895746 35.673070263241236, -82.74332663894883 35.67292626319293, -82.74318563893807 35.672843263161454, -82.74301463891999 35.67277526313007, -82.74287263890399 35.672725263105235, -82.74272063888687 35.672672263078816, -82.74244663885665 35.6725712630301, -82.74216563882737 35.672457262977936, -82.74188663880197 35.67232026292144, -82.74172063878484 35.67225126289029, -82.7413306387395 35.672123262824115, -82.74121863872558 35.672092262806295, -82.74110163871252 35.672050262785696, -82.74095163869869 35.671977262755384, -82.74086663869471 35.67191126273324, -82.74080863869277 35.671861262717016, -82.74071463868962 35.67178026269086, -82.74061363868398 35.67170726266557, -82.74050763867618 35.67164326264165, -82.74015663863861 35.67150726257788, -82.74002263862424 35.67145526255352, -82.73999963862153 35.671448262549696, -82.73968163858169 35.67136226249952, -82.73951163855793 35.67133226247596, -82.73939863854211 35.67131226246028, -82.73934663853395 35.67130926245435, -82.73929463852575 35.67130626244834, -82.73923463851621 35.67130326244158, -82.73914263850297 35.671289262429255, -82.73909263849575 35.67128226242275, -82.73880763845514 35.67123726238426, -82.73861363842737 35.67120726235825, -82.73811363835598 35.67112926229099, -82.7380326383438 35.67112026228084, -82.73795363833216 35.671110262270744, -82.73780963831061 35.671094262252694, -82.73766763828836 35.67108526223621, -82.73766263830855 35.67094826220781, -82.73764863836917 35.67054026212313, -82.73764463838943 35.67040426209489, -82.73763463843562 35.67009426203062, -82.73759963856223 35.66923526185178, -82.73757263863573 35.66872926174571, -82.7375616386851 35.668397261676915, -82.73755463870853 35.66823726164353, -82.73753563873274 35.66805926160521, -82.73750263875655 35.66786926156311, -82.73746863877436 35.667717261528544, -82.73743163878574 35.66760326150152, -82.73739163879512 35.66749926147621, -82.73727263881119 35.66726626141641, -82.7371456388194 35.66707526136443, -82.73704663882206 35.666951261328954, -82.7369496388225 35.666843261296904, -82.73684063882129 35.66673326126328, -82.73673463881815 35.66663826123306, -82.7364316388065 35.6663862611505, -82.73608363879076 35.666111261058695, -82.73581863878061 35.665890260986394, -82.73557663877247 35.66568126091892, -82.73547763877006 35.66559026089019, -82.73535063876709 35.66547226085309, -82.73533663876653 35.66546026084915, -82.73518963876506 35.66531026080351, -82.7350966387643 35.66521526077461, -82.73505863876392 35.66517626076273, -82.73502763876417 35.665141260752385, -82.73483463876538 35.664924260688295, -82.73482763876547 35.66491626068592, -82.73476363876648 35.66484026066388, -82.73460663876897 35.664654260609794, -82.73451463877277 35.66453026057502, -82.73433963877994 35.66429426050891, -82.73422063878644 35.664123260461835, -82.7341036387951 35.663940260412446, -82.73390163881366 35.663601260322594, -82.73386663881841 35.66353226030491, -82.73381063882671 35.66341826027592, -82.73369463884478 35.66317526021445, -82.73356163886851 35.662877260139986, -82.73338163890814 35.66242526002929, -82.73330663892791 35.66221625997895, -82.73313463896838 35.661767259869684, -82.73312363897053 35.6617412598632, -82.73305763898563 35.66157225982194, -82.73292063901617 35.66122525973711, -82.7327756390361 35.66093925966385, -82.73269163904261 35.66080625962807, -82.732592639048 35.66066425958898, -82.73247863904876 35.66053525955095, -82.73234063904583 35.660405259510284, -82.7322186390426 35.6602942594751, -82.73193663902254 35.6601192594104, -82.73190563901967 35.660104259404164, -82.73180863901105 35.660055259384215, -82.73173763900458 35.66002025936978, -82.73169963900122 35.660001259362026, -82.73148663897857 35.65991725932306, -82.73134863896266 35.659871259299514, -82.73131063895804 35.65986025929338, -82.73103063892452 35.659774259247044, -82.73088863890766 35.659730259223515, -82.73068063888229 35.65966925918967, -82.73030463883661 35.659559259128706, -82.72958963874846 35.65935725901408, -82.728942638669 35.659172258909905, -82.72842663860575 35.659024258826754, -82.72825763858496 35.65897625879964, -82.72819463857726 35.65895825878945, -82.72765963851123 35.658807258703774, -82.72755963849946 35.65877525868696, -82.72741463848224 35.65873025866291, -82.72726363846559 35.65867525863615, -82.72716663845476 35.658640258619094, -82.72708563844591 35.65861025860463, -82.72707463844465 35.6586062586027, -82.72697663843788 35.658544258579965, -82.72685863842622 35.65849225855729, -82.72681563842177 35.65847425854918, -82.72678063841826 35.65845925854253, -82.72669963841017 35.658424258527056, -82.72661463840265 35.658381258509515, -82.72652963839629 35.65833025849048, -82.72646963839179 35.65829425847695, -82.7263226383824 35.65819625844186, -82.72615763837581 35.65806025839715, -82.72595563837051 35.657876258338874, -82.72587663836953 35.65779725831465, -82.72567663836668 35.65759925825373, -82.7255936383659 35.65751425822791, -82.72534663836352 35.657262258151114, -82.72526463836263 35.657179258125794, -82.72504363836042 35.656954258057226, -82.72483363835828 35.6567412579922, -82.72450763835322 35.6564212578934, -82.72436463834813 35.656299257853874, -82.7242106383427 35.65616825781137, -82.72411963833767 35.656102257788504, -82.72393063832729 35.65596525774118, -82.7238606383225 35.65592025772478, -82.72366663830914 35.65579725767982, -82.7233576382835 35.65562925761383, -82.72302263824994 35.655484257549865, -82.72298063824574 35.655466257541825, -82.72272763821805 35.65537225749678, -82.72267163821178 35.65535225748688, -82.72261963820536 35.6553372574785, -82.72237563817542 35.65526725743916, -82.72229263816479 35.655247257426595, -82.72218263815036 35.655221257409984, -82.7221446381454 35.65521225740423, -82.72177563809436 35.655144257352475, -82.72166563807907 35.65512425733711, -82.72133163802957 35.65508425729473, -82.72102763798134 35.65506825726025, -82.7208166379462 35.655068257238554, -82.72058763790662 35.6550772572169, -82.72054163789846 35.655080257212774, -82.72012963782464 35.65511325717719, -82.71973863775438 35.65514625714383, -82.71943263769901 35.6551742571181, -82.71929363767384 35.655187257106476, -82.71784263741078 35.655324256985494, -82.71711563727786 35.65540025692639, -82.71678963721762 35.655438256900645, -82.71644163715312 35.655480256873474, -82.71595763706239 35.65554525683708, -82.71590463705236 35.65555225683311, -82.71585463704305 35.65555925682933, -82.71574863702286 35.65557525682174, -82.71569663701278 35.65558425681824, -82.7156956370134 35.655579256817155, -82.71589663710364 35.65521125676268, -82.71606563717144 35.6549542567276, -82.71630563726308 35.654619256683894, -82.71643763731088 35.654452256663454, -82.71645163731611 35.65443325666099, -82.7167276374192 35.65406325661386, -82.71689163748192 35.653833256583745, -82.71709063756087 35.6535362565436, -82.71730263764742 35.65320425649766, -82.71750463773164 35.652876256451414, -82.71767463781231 35.65253625639951, -82.71799063795112 35.651977256317934, -82.71809463799315 35.65181725629592, -82.71822763804195 35.65164425627435, -82.718339638082 35.65150625625769, -82.71845763812594 35.6513482562376, -82.718552638166 35.65119125621529, -82.71863663820527 35.651027256190446, -82.71867263822357 35.65094725617782, -82.71870663824032 35.65087525616664, -82.71878263830423 35.650543256106715, -82.71882163833406 35.65039125607969, -82.71885563836939 35.65019925604403, -82.71890663839974 35.6500572560203, -82.71898863844254 35.64986825599016, -82.71907663847958 35.64972325596957, -82.7191266384977 35.649659255961645, -82.7191746385153 35.64959725595391, -82.71927763855706 35.649437255931865, -82.71937563859453 35.64930025591397, -82.71942263861504 35.64921825590207, -82.71948963864344 35.649106255886124, -82.71961563869299 35.64892125586136, -82.71983163876659 35.64867725583368, -82.72002663883002 35.64847625581271, -82.72048563897377 35.64804025577088, -82.72055063899393 35.6479792557651, -82.72075963906057 35.647773255744596, -82.72086363909426 35.64766725573355, -82.7209846391332 35.64754525572113, -82.72115063918335 35.6473992557084, -82.72118563919369 35.64737025570604, -82.7213736392466 35.64723025569676, -82.72158163930904 35.64705025568144, -82.72202163945028 35.6466092556366, -82.72210963947845 35.64652225562794, -82.72226963953091 35.646354255610056, -82.72229363953923 35.6463262556068, -82.72236663956481 35.646239255596534, -82.72249563962595 35.64598225555734, -82.7225246396523 35.64584225553179, -82.72258863974972 35.64527925542349, -82.72267563985035 35.64472025531838, -82.72271163988111 35.64455925528922, -82.72273263990438 35.64443125526524, -82.7227836399316 35.64430925524559, -82.72285163995802 35.644211255232584, -82.72295963999196 35.644108255222676, -82.72299864000253 35.64408125522117, -82.72313164003879 35.64399025521626, -82.72357864015551 35.643716255206236, -82.7237376401952 35.643630255205004, -82.72386464022365 35.64358325520848, -82.72399464024814 35.64356525521809, -82.72418864027938 35.64357225523937, -82.72440364031311 35.64358625526434, -82.72461664035063 35.64357325528354, -82.72470664037334 35.64352325528259, -82.724742640385 35.64348625527876, -82.72475064038757 35.64347825527792, -82.7248076404179 35.64334325525623, -82.72484164045017 35.643170255224426, -82.72485564048567 35.64295525518204, -82.72480864052812 35.64262825511051, -82.72434464058567 35.64175225488417, -82.72395164072618 35.64041425457089, -82.72412664095388 35.639124254325615, -82.72398364104824 35.63835725415451, -82.72354264134081 35.63597925362416, -82.72322264130332 35.63587625357035, -82.72304464127853 35.63584425354556, -82.72291564125683 35.63584525353255, -82.72276364122523 35.63588625352532, -82.72261464118753 35.635970253527184, -82.72238364112226 35.636143253538755, -82.72205564102717 35.63640625355874, -82.72197864100518 35.63646525356293, -82.7215366408789 35.63680725358729, -82.72134464082652 35.6369392535945, -82.72101864074088 35.63714225360248, -82.72081764068818 35.637267253607334, -82.72055964061975 35.637432253614556, -82.71973264039944 35.637967253638806, -82.71955564035505 35.63806425364043, -82.71934364030324 35.638171253640486, -82.71933264030064 35.6381762536404, -82.7191476402575 35.63825625363774, -82.71893464020685 35.63835425363588, -82.71876864016977 35.63841525363127, -82.71855264012795 35.63845325361687, -82.71830364008586 35.63845625359193, -82.71804464004892 35.63841625355719, -82.71780464001714 35.638362253521564, -82.71758963999197 35.63829325348544, -82.71726563995675 35.63817125342728, -82.71724163995351 35.63816625342379, -82.71711263993583 35.63814125340547, -82.7169606399104 35.6381422533901, -82.71675763987513 35.63815125337108, -82.71661063985081 35.638150253355754, -82.71642563982407 35.6381232533313, -82.71620863980081 35.63803925329192, -82.71593363977631 35.63790125323556, -82.71556963974741 35.63769425315605, -82.71535063973036 35.63756825310785, -82.7152576397225 35.637518253088075, -82.71431263964358 35.637008252887085, -82.71399863961726 35.63683825282019, -82.71369063959179 35.63667125275451, -82.71313963954456 35.63638125263877, -82.71280763951599 35.63620725256925, -82.712572639495 35.63608925252106, -82.71241263947846 35.63602325249119, -82.71224063945625 35.63598125246498, -82.71200663942044 35.63596025243677, -82.71174863937594 35.6359702524123, -82.71158963934604 35.63599225240048, -82.71149763932672 35.63601825239632, -82.71136963929337 35.63609625239907, -82.71076863912053 35.636568252433705, -82.71059763907475 35.63668025243896, -82.71053863906167 35.63670125243724, -82.7104376390391 35.63673825243437, -82.71024263900074 35.63677625242209, -82.71001263896375 35.63676825239688, -82.70977263893293 35.636708252360066, -82.7096266389161 35.63665925233507, -82.7095966389136 35.636643252328675, -82.70941663889835 35.63654725229063, -82.70930463889589 35.63644225225779, -82.70928963889556 35.63642825225332, -82.70917363890037 35.63627125220942, -82.70915463890191 35.636240252201155, -82.70906463890941 35.63609425216215, -82.70897863893164 35.63585725210505, -82.70893863896333 35.6356082520501, -82.70888363899415 35.63534825199145, -82.70879963902324 35.63506825192572, -82.70867663904913 35.63476725185166, -82.70854963906412 35.63453225179069, -82.70851063906875 35.63446025177205, -82.70824863907599 35.63412925167762, -82.70817663907556 35.63405425165498, -82.7081316390751 35.634008251641, -82.7080856390748 35.633960251626476, -82.70799163907206 35.63387625159971, -82.70794463907079 35.633834251586315, -82.7078676390684 35.63376625156451, -82.70761763906441 35.63352125148885, -82.70727863905365 35.633224251393514, -82.70723863905253 35.633188251382094, -82.7065426390325 35.63256425118341, -82.70640363902511 35.63246225114836, -82.70627263901531 35.632384251119, -82.70612863899825 35.63233925109509, -82.70596563897321 35.63232525107548, -82.70564363891923 35.63232725104278, -82.7054286388794 35.63235325102609, -82.70528663885072 35.63238625101819, -82.70516663882388 35.63243025101495, -82.70500763877956 35.63254625102225, -82.70479663871711 35.63272325103662, -82.70478763871436 35.632731251037406, -82.70458463864868 35.632938251058775, -82.70423363854258 35.63324725108577, -82.70406963849777 35.63336125109221, -82.70363763856056 35.632485250869244, -82.70336763865942 35.63155125065104, -82.70329063868752 35.631285250588846, -82.7032196387054 35.63109225054225, -82.70310563872755 35.63082525047607, -82.70292763875517 35.63045325038196, -82.70286963876761 35.63030925034661, -82.7028496387743 35.63024425033138, -82.70285563879555 35.63011225030505, -82.7028696388056 35.63006225029625, -82.70289563881809 35.630009250288126, -82.70293163883215 35.629957250281215, -82.70298863885087 35.62989725027488, -82.70388063911912 35.62912025020791, -82.70417863922327 35.628766250166215, -82.70456263937568 35.62819225008858, -82.70461863940818 35.62804125006354, -82.70464463944259 35.62784625002646, -82.70453763948595 35.627448249934325, -82.70432463953904 35.62687324979516, -82.70425363957655 35.626552249722444, -82.70420863960061 35.62634724967605, -82.70411863962671 35.626080249612286, -82.70383863965566 35.625589249483454, -82.70344163967657 35.625023249327285, -82.70335363968945 35.624844249281786, -82.70334863969953 35.62477324926675, -82.7033336397298 35.62456024922177, -82.70332963973992 35.624490249207106, -82.70340263976519 35.62440524919723, -82.70362363984107 35.62415124916815, -82.70369763986636 35.624067249158614, -82.70374663988335 35.62401024915203, -82.70383063990748 35.62394424914714, -82.70426264003086 35.62361024912341, -82.70440764007205 35.623499249115575, -82.70495264021943 35.623132249096656, -82.70658864066131 35.62203224904017, -82.70692764075265 35.621805249028625, -82.70712164080916 35.621648249016516, -82.7073076408634 35.62149724900478, -82.70776664100593 35.621068248964455, -82.70819764113946 35.62066724892681, -82.70862464126647 35.62030424889659, -82.70901164136532 35.62008124889086, -82.70920364141172 35.61998724889135, -82.70941964146017 35.61990624889695, -82.70969964152098 35.619814248906906, -82.70996164157555 35.6197432489194, -82.71080064174988 35.61951924895972, -82.71095664178227 35.61947724896719, -82.71151264189787 35.619328248993746, -82.71183664197007 35.619210249002926, -82.71198864200373 35.61915624900752, -82.71223064206092 35.61904624900992, -82.71266164217518 35.6187702489979, -82.71283864222454 35.618641248989626, -82.71294564225813 35.61853924897983, -82.71322764235289 35.61822824894531, -82.71346864243776 35.61793824891092, -82.71369464251738 35.61766524887837, -82.71395064260062 35.61740124885084, -82.71419064267306 35.61719024883238, -82.71427064269672 35.61712324882692, -82.71444964274944 35.61697424881489, -82.71512164294148 35.61645424877774, -82.71524964297822 35.61635424877048, -82.71563564308823 35.6160572487495, -82.71576464312497 35.6159582487425, -82.71584464314795 35.615895248737914, -82.71608664321688 35.615709248724784, -82.71616764323998 35.615647248720464, -82.71670364339306 35.61523224869078, -82.71804364377529 35.614199248617496, -82.71831164385223 35.613989248602095, -82.71884764400546 35.61357424857251, -82.71900164404909 35.613457248564345, -82.71902864405688 35.61343624856287, -82.71927364412645 35.613249248549785, -82.71984464428819 35.61281624852005, -82.72036764442699 35.61248024850516, -82.7206036444871 35.612345248501825, -82.7210696446057 35.61207924849535, -82.72181064479332 35.61166224848628, -82.72202164484754 35.611538248482624, -82.72206264485806 35.61151424848193, -82.72238864494035 35.61133224847821, -82.72268964501455 35.611176248477285, -82.72301864509848 35.61098724847246, -82.72389564531568 35.610525248468115, -82.72429564541086 35.610339248471206, -82.7246826455048 35.61014824847195, -82.72493664556593 35.610026248473034, -82.72504564559208 35.60997424847364, -82.72534564566263 35.60984024847707, -82.72592864580264 35.6095622484801, -82.72632464589768 35.60937324848214, -82.72667164598398 35.60918824847998, -82.7268096460196 35.609105248477285, -82.7269366460526 35.60902924847476, -82.72720364612832 35.608826248460716, -82.72750264621673 35.60857524844021, -82.72792664635104 35.60816124839922, -82.72899964669408 35.60709324829135, -82.72940264682278 35.60669324825106, -82.72971864691924 35.60640824822532, -82.7299706469946 35.60619124820688, -82.73003264701305 35.60613824820246, -82.73015864705056 35.60603124819353, -82.73051964715725 35.60572824816874, -82.73149564744386 35.60492224810436, -82.73194264757488 35.6045542480751, -82.73188264757317 35.60450024805792, -82.73180564757585 35.60439924802948, -82.73175964758023 35.604321248008844, -82.7317296475834 35.60426824799489, -82.73167864759466 35.604139247963396, -82.73152464767291 35.603463247809685, -82.73148764769182 35.60330024777263, -82.73145464770566 35.603174247743574, -82.73140664772612 35.60298924770093, -82.73137064774158 35.60284924766866, -82.73125664778576 35.60243824757311, -82.73124864778887 35.602409247566435, -82.73120064780423 35.60225724753049, -82.73119464780576 35.60224024752641, -82.73117964781085 35.60219124751486, -82.73117464781248 35.60217524751113, -82.73115464781885 35.602112247496144, -82.73114164782352 35.60206724748564, -82.73104964785821 35.601742247409945, -82.73101964786976 35.601634247384816, -82.73095764789282 35.60141724733419, -82.73095464789394 35.60140624733172, -82.73092764791332 35.6012512472973, -82.73093364793074 35.601144247276096, -82.7309626479519 35.60103824725738, -82.73108264801216 35.6007762472163, -82.73117664805916 35.60057224718434, -82.73123064808676 35.60045124716515, -82.7313066481244 35.60028824713973, -82.73138064816803 35.60008524710584, -82.73138764817165 35.600069247103285, -82.73137964818777 35.59995524707921, -82.73176964828416 35.599751247077606, -82.73202364834258 35.59964624708222, -82.73223664839077 35.599564247087315, -82.73236864842428 35.59948924708554, -82.73270364851794 35.59924324706971, -82.73321564863714 35.59902224707707, -82.73350464870657 35.598884247078566, -82.73371364876034 35.59876124707487, -82.73401264884521 35.59853324705898, -82.73428064891797 35.598350247049105, -82.73430464892367 35.59833924704937, -82.73435164895429 35.59819124702402, -82.73444964900987 35.59793524698184, -82.7344766490255 35.59786324696985, -82.73462964911185 35.597466246904624, -82.7346376491215 35.597413246894554, -82.73465264913804 35.597321246877364, -82.73469864916264 35.59721124685962, -82.734789649202 35.597054246836954, -82.73507964930359 35.59670724679584, -82.73523264934784 35.596585246786695, -82.73537264938315 35.59650724678507, -82.73543064939892 35.59646724678287, -82.73551464942936 35.5963602467697, -82.73558364946678 35.59619224674245, -82.73561364949343 35.596051246716776, -82.73576664954467 35.595883246698214, -82.73585764957863 35.59576124668258, -82.73597964964522 35.59546024663373, -82.73616164970329 35.59527924661549, -82.73636864976595 35.59509624659935, -82.73672864987492 35.59477724657111, -82.73709164997507 35.594519246555734, -82.73724565003381 35.594304246527635, -82.73742765008774 35.59415024651484, -82.73772365015735 35.59401824651826, -82.7378576502042 35.593859246499576, -82.7380256502795 35.59355124645398, -82.73805265030929 35.593386246423044, -82.73803265038018 35.59290324632245, -82.7379106504231 35.5924912462259, -82.73789065045185 35.59228224618126, -82.73777565048002 35.591974246106616, -82.73748665052116 35.591392245958254, -82.73692665045859 35.59119224586005, -82.73646165040645 35.59102724577876, -82.73527765027917 35.59057024556424, -82.73525865027713 35.59056324556091, -82.73469765021329 35.59037024546399, -82.73458465027227 35.5898632453491, -82.7342476504497 35.58834224500417, -82.73413565050885 35.58783524488932, -82.73426065053759 35.5877842448917, -82.73488865065522 35.58769924493876, -82.73592865082865 35.5876992450453, -82.7372836511719 35.5869342450281, -82.73802965141375 35.58616924494851, -82.7388536517076 35.585150244824966, -82.73938365192639 35.584300244705915, -82.73968765214825 35.58318524450963, -82.73989465229849 35.582431244376956, -82.74093465269368 35.58098624418869, -82.74168065300069 35.57979624402233, -82.74313265343818 35.578522243911216, -82.74534065389416 35.57794924402043, -82.74547365392932 35.577864244016695, -82.746273654107 35.57757624403986, -82.7467056542109 35.57736824404174, -82.74737765435725 35.577144244064854, -82.74836965455209 35.57695224412726, -82.74873765462826 35.57685624414536, -82.74879565463866 35.57685124415029, -82.74984165489225 35.57633524415215, -82.75074865507682 35.576117244200525, -82.75423165580871 35.57513224435622, -82.7575466566013 35.57356824437658, -82.75965465715738 35.572234244320256, -82.76111665754273 35.57131124428156, -82.76471565855924 35.568596244096035, -82.76591465891623 35.56757224400981, -82.76597865893595 35.56751324400437, -82.76631365887589 35.56826924419297, -82.76730365886297 35.56943024453121, -82.76817465885165 35.57045124482865, -82.7694846588502 35.57188524525536, -82.77009665861254 35.57410024577012, -82.77050165846632 35.57549424609596, -82.77052065846685 35.57551124610141, -82.77124965848613 35.576178246312146, -82.77239065865925 35.57629024645182, -82.77260965869823 35.57627424647095)))",6354,37,021,002603,370210026031,2074,2074,95,2044,1969,21,13,2,0,39,30,1616,46,1570,1599,1551,16,12,2,0,18,17,951,836,115
census_2010_blockgroups_view.fid--2dc29038_13ec899ba8f_-25ee,"MULTIPOLYGON (((-82.51134461827154 35.55662321567882, -82.51143761828726 35.556621215687926, -82.51259561848248 35.55660021580258, -82.51316861857879 35.556591215859626, -82.51391461870499 35.55657521593297, -82.51484061886097 35.55655921602474, -82.51512461890844 35.556556216053316, -82.51634761911463 35.556534216174434, -82.51712361924524 35.556521216251454, -82.51759961932544 35.55651321629871, -82.51760561930597 35.55664621632641, -82.51760861929847 35.55669821633723, -82.51761261928708 35.556776216353576, -82.51762561924794 35.55704521640961, -82.51763261922844 35.55717921643757, -82.5175486192135 35.55718621643038, -82.51738361918193 35.55721321641892, -82.51724861915602 35.557236216409756, -82.51694161909757 35.55728521638819, -82.51663961904018 35.557333216366985, -82.51639261899312 35.55737321634968, -82.51625261896743 35.55738921633858, -82.51625061896696 35.55739021633861, -82.5161386189453 35.55741021633119, -82.51604361892525 35.55743821632707, -82.51595261890398 35.557478216325926, -82.51586761888143 35.55753321632834, -82.51586261887998 35.55753721632869, -82.51583461887128 35.55756321633109, -82.51575861884814 35.557632216337325, -82.51568061882439 35.55770221634356, -82.51566861882087 35.55771221634433, -82.51541361873936 35.55796721637006, -82.51532861871199 35.55805321637882, -82.51527661869552 35.558105216384, -82.5152416186838 35.55814321638815, -82.51515561865463 35.55824021639908, -82.51498861859926 35.55842021641848, -82.51498761859885 35.55842221641888, -82.51492061857186 35.558525216432905, -82.51490561856632 35.55854521643542, -82.51489761856297 35.55855821643735, -82.51486861854998 35.558611216445065, -82.5148576185447 35.55863421644857, -82.51483161853265 35.55868421645617, -82.51482361852867 35.55870121645878, -82.51476161849595 35.55884721648211, -82.51473961848218 35.55891321649331, -82.51470961846643 35.55898321650441, -82.51514561849794 35.55924821660312, -82.51522861850471 35.559294216620955, -82.51563161853704 35.55951821670793, -82.51600061856522 35.559732216789335, -82.51655061861207 35.56002121690459, -82.5166136186145 35.56007321692168, -82.516639618611 35.56012421693469, -82.51665661860316 35.560193216950545, -82.51665961859074 35.5602772169679, -82.51665761858825 35.56029121697055, -82.5166386185625 35.560438216998456, -82.51661061849728 35.560832217075735, -82.51661061848759 35.56089521708859, -82.51660861842414 35.56130521717179, -82.51661661839786 35.561485217209274, -82.51662061839617 35.561500217212654, -82.51664761838468 35.56160421723663, -82.51667761837994 35.56166721725254, -82.51672861837746 35.56173821727222, -82.51681361838031 35.56181121729582, -82.51693361838623 35.561902217326626, -82.51704461838798 35.56201021736001, -82.51712761838368 35.562128217392505, -82.5172036183727 35.56228121743141, -82.51725761836065 35.56241721746462, -82.51728161834845 35.56252321748865, -82.51728161833242 35.56262721750987, -82.51723461827264 35.56296521757379, -82.51722561825642 35.56306121759232, -82.51722661825274 35.56308621759758, -82.51722961824625 35.56313121760698, -82.51724061824044 35.56318121761831, -82.51726761823828 35.563224217629845, -82.51731461823793 35.56327721764543, -82.51760461824617 35.563536217727915, -82.51768661824696 35.56361921775324, -82.5177626182422 35.56373221778403, -82.5177796182412 35.563757217790894, -82.51784561823224 35.5638862178239, -82.51794061822193 35.564056217868206, -82.51801961821135 35.56421021790764, -82.51809961820582 35.564332217940674, -82.51817861819639 35.56447821797851, -82.51820761819114 35.564544217994914, -82.51822461818162 35.564624218012945, -82.51823661816915 35.56471821803326, -82.5182536181617 35.564785218048705, -82.51827261813543 35.56497621808949, -82.51830661811657 35.5651352181253, -82.51834761810068 35.56528321815959, -82.51838161809152 35.56537921818259, -82.51842961807914 35.56551121821444, -82.51817261803454 35.565524218190674, -82.51783461797682 35.565535218158175, -82.51773461796078 35.56553121814711, -82.51771461795823 35.565526218144015, -82.51676361779049 35.565592218059834, -82.5165026177418 35.5656272180401, -82.51647561773665 35.56563121803815, -82.51561661757229 35.565774217979, -82.5153776175263 35.56581521796281, -82.51533061751734 35.565823217959625, -82.51511261747537 35.56586121794499, -82.5149126174366 35.56589721793169, -82.51446061735045 35.56597021790014, -82.51424361730886 35.56600621788522, -82.51328561712502 35.56616921781996, -82.51316161710041 35.56619521781255, -82.51318561708779 35.56630321783699, -82.51350961694735 35.56756521812693, -82.51355261691897 35.56779621817836, -82.51358461689117 35.56801121822533, -82.51359361688284 35.5680752182394, -82.51360061687338 35.56814421825409, -82.51361261685807 35.568256218278094, -82.51361261684174 35.56836221829961, -82.51360661682976 35.5684342183137, -82.51358961681153 35.56853421833231, -82.51358661680963 35.56854321833384, -82.51355861678466 35.56867521835778, -82.51350261673976 35.56890721839921, -82.51349961673662 35.568924218402344, -82.51348761672091 35.56901321841923, -82.51348661670588 35.56911021843892, -82.51350261669293 35.56921121846105, -82.51355961667824 35.569368218498845, -82.51361261667206 35.56946521852409, -82.51372861666721 35.569622218567886, -82.51373461666726 35.56962821856973, -82.51388461666998 35.56977221861439, -82.51391961667039 35.56980721862516, -82.51395561667069 35.569844218636355, -82.51397261667087 35.56986121864156, -82.51406161667035 35.56996021867085, -82.51409761667043 35.56999921868252, -82.51424361666842 35.57016921873208, -82.51426561666804 35.57019521873962, -82.514319616672 35.570227218751675, -82.5143816166794 35.57024621876193, -82.5144406166884 35.57025121876902, -82.5145136167016 35.57024421877508, -82.51463961672678 35.570216218782356, -82.51470861673981 35.57020621878741, -82.51475861674778 35.57020821879292, -82.51480961675517 35.5702152187996, -82.51486161675976 35.57024121881023, -82.51487861676048 35.57025521881482, -82.51490261676109 35.57027721882172, -82.51493461675912 35.57032421883456, -82.51498861674885 35.5704492188656, -82.51503361673844 35.570565218893776, -82.51506561673271 35.57063721891173, -82.51519061671019 35.570918218981724, -82.5153136166996 35.57111921903524, -82.5153556166981 35.571174219050775, -82.5153616166979 35.57118221905295, -82.51543561669756 35.57126421907724, -82.51549761669905 35.57132121909525, -82.51567461670575 35.57146821914336, -82.51573461670804 35.57151821915968, -82.5158896167176 35.57162321919698, -82.51605861673033 35.57172221923449, -82.51626561674914 35.57182321927626, -82.51629061675135 35.571836219281444, -82.51640261675799 35.57191321930862, -82.51644561675728 35.57196421932341, -82.51648861675478 35.57202721934066, -82.51650861674963 35.57208221935389, -82.51652461674257 35.572145219368316, -82.51652561669998 35.572423219425026, -82.51652761666566 35.57264821947098, -82.51658961650044 35.573788219709286, -82.51659861649163 35.57385521972383, -82.51661061648154 35.57393421974109, -82.51664261646322 35.57408721977554, -82.51669261644645 35.57425021981385, -82.51672261644141 35.57431521983014, -82.51675661643552 35.574390219848915, -82.5168366164294 35.574516219882774, -82.51694361642713 35.57464621992022, -82.51703961642723 35.57474921995104, -82.51708261642729 35.57479521996484, -82.51819861644425 35.57588722030164, -82.51821761644453 35.57590622030744, -82.51859161645207 35.57626022041787, -82.5187586164556 35.57641722046692, -82.51895461645957 35.576602220524734, -82.5192496164624 35.57690222061602, -82.519411616464 35.57706622066605, -82.51947961646468 35.57713522068712, -82.51968561646648 35.57734522075093, -82.51969061646649 35.57735022075247, -82.51970161646676 35.577360220755665, -82.51975861646841 35.57741122077184, -82.51964861643961 35.577480220774596, -82.51961461643035 35.577503220775874, -82.51946361638933 35.57760722078144, -82.51924061631506 35.57784922080781, -82.51912561627645 35.57797622082181, -82.51908661628076 35.57790622080359, -82.51907361628213 35.57788322079755, -82.51884561630158 35.57751122069847, -82.5186676163099 35.5772652206301, -82.5185046163176 35.57704022056756, -82.51815561632563 35.57661222044468, -82.51774661632577 35.57617022031277, -82.5174666163209 35.57590022022911, -82.5169326163059 35.57542222007698, -82.51630361628844 35.574858219897585, -82.51555361626671 35.57419121968489, -82.51351661620765 35.572380219107146, -82.5133056162015 35.5721922190473, -82.51282261618779 35.57176121890999, -82.5125596161808 35.57152321883456, -82.51245261617784 35.571427218804004, -82.51224161617233 35.57123621874349, -82.51213361616898 35.57114121871307, -82.51202661616553 35.571048218683146, -82.51174661615605 35.57080821860553, -82.51090961612806 35.57008821837314, -82.51085861612641 35.570044218358895, -82.51062461611642 35.56985721829687, -82.51046861610962 35.56973321825561, -82.51013361609155 35.56948921817157, -82.51006561608801 35.569439218154415, -82.50967561606447 35.569172218060004, -82.50925361603575 35.56890421796219, -82.50872561599478 35.56860121784631, -82.50857261598237 35.56851721781343, -82.50839361596772 35.56841921777517, -82.50802661593448 35.56824021770103, -82.50789061592205 35.568174217673686, -82.50781161591463 35.568137217658055, -82.50747661588154 35.56799121759394, -82.5073386158678 35.567932217567716, -82.50722761585635 35.567887217547224, -82.50689461582135 35.567755217486166, -82.50678461580996 35.56771121746584, -82.50650061578686 35.56755521740496, -82.50578561571234 35.567269217273356, -82.50572261570579 35.56724421726184, -82.50456561558423 35.56678721704999, -82.50381361550563 35.56648821691189, -82.50347761546904 35.56636421685221, -82.50307361542676 35.56620321677791, -82.50248261536518 35.56596721666928, -82.50229061534513 35.565890216633846, -82.50161361527356 35.56562621651064, -82.50140361525185 35.56554121647175, -82.50135661524703 35.565522216463094, -82.50120561523075 35.5654652164359, -82.50117361522737 35.56545221643005, -82.50069661517803 35.56525921634179, -82.50048961515664 35.565175216303366, -82.5002626151332 35.56508321626136, -82.50021761512865 35.56506421625291, -82.50008261511455 35.565010216228075, -82.5000386151101 35.56499221621981, -82.49999461510555 35.56497421621171, -82.4998656150922 35.56492221618786, -82.4998226150877 35.56490521618, -82.49978161508349 35.56488821617232, -82.49965861507079 35.56483821614949, -82.49961861506661 35.56482221614216, -82.49950261505464 35.564775216120644, -82.49936261504001 35.564719216094936, -82.49924661502898 35.56466621607225, -82.49915961502069 35.564626216055096, -82.49914261501915 35.56461821605181, -82.49904461500867 35.56458021603395, -82.49909461502943 35.56449921602259, -82.49915261505305 35.56440821601007, -82.49924661509208 35.564256215988806, -82.49929761511284 35.56417621597775, -82.49979961532014 35.56336921586523, -82.50019961548482 35.56273021577634, -82.50045961559093 35.5623202157197, -82.5005776156407 35.56212421569189, -82.50112561586508 35.56125621557163, -82.50131261594252 35.560954215529414, -82.50162561607185 35.560450215459056, -82.50181861614995 35.5601502154179, -82.50186961616998 35.560075215407814, -82.50189261617894 35.56004221540349, -82.50194461620124 35.55995321539081, -82.50202061623001 35.55984821537723, -82.50207461625014 35.55977521536788, -82.50216961628604 35.55964421535102, -82.50229361633 35.559492215332874, -82.50243861638018 35.55932221531318, -82.50252861641091 35.55921921530145, -82.50270361646793 35.559037215282444, -82.50280761650025 35.55893921527317, -82.5031526166063 35.55862121524387, -82.50353661671637 35.55831921522188, -82.5037436167736 35.558170215212876, -82.50375461677655 35.55816321521258, -82.5040596168572 35.55796721520403, -82.50423661690294 35.5578612152007, -82.5043706169374 35.557781215198176, -82.50471761702273 35.55760021519697, -82.50508961711134 35.557425215199544, -82.50532761716617 35.55732521520368, -82.50533861716879 35.557320215203795, -82.50568261724518 35.55719421521347, -82.50593061729933 35.55710921522164, -82.50632961738349 35.556992215238864, -82.50655061742873 35.556936215250175, -82.5069356175056 35.55685121527242, -82.50722161756083 35.55680021529141, -82.5074796176093 35.556763215310355, -82.50800261770509 35.556704215352106, -82.50828061775408 35.55668521537675, -82.5086716178212 35.55667021541388, -82.50894361786706 35.55666521544076, -82.51017261807402 35.5566442155628, -82.51040661811358 35.55663921558572, -82.5111096182319 35.556627215655446, -82.51134461827154 35.55662321567882)))",5703,37,021,002000,370210020002,1493,1493,103,1433,1235,143,6,3,1,45,60,1183,64,1119,1159,1016,104,6,2,1,30,24,704,654,50
census_2010_blockgroups_view.fid--2dc29038_13ec899ba8f_-25ed,"MULTIPOLYGON (((-82.72842663860575 35.659024258826754, -82.728942638669 35.659172258909905, -82.72958963874846 35.65935725901408, -82.73030463883661 35.659559259128706, -82.73068063888229 35.65966925918967, -82.73088863890766 35.659730259223515, -82.73103063892452 35.659774259247044, -82.73131063895804 35.65986025929338, -82.73134863896266 35.659871259299514, -82.73148663897857 35.65991725932306, -82.73169963900122 35.660001259362026, -82.73173763900458 35.66002025936978, -82.73180863901105 35.660055259384215, -82.73190563901967 35.660104259404164, -82.73193663902254 35.6601192594104, -82.7322186390426 35.6602942594751, -82.73234063904583 35.660405259510284, -82.73247863904876 35.66053525955095, -82.732592639048 35.66066425958898, -82.73269163904261 35.66080625962807, -82.7327756390361 35.66093925966385, -82.73292063901617 35.66122525973711, -82.73305763898563 35.66157225982194, -82.73312363897053 35.6617412598632, -82.73313463896838 35.661767259869684, -82.73330663892791 35.66221625997895, -82.73338163890814 35.66242526002929, -82.73356163886851 35.662877260139986, -82.73369463884478 35.66317526021445, -82.73381063882671 35.66341826027592, -82.73386663881841 35.66353226030491, -82.73390163881366 35.663601260322594, -82.7341036387951 35.663940260412446, -82.73422063878644 35.664123260461835, -82.73433963877994 35.66429426050891, -82.73451463877277 35.66453026057502, -82.73460663876897 35.664654260609794, -82.73476363876648 35.66484026066388, -82.73482763876547 35.66491626068592, -82.73483463876538 35.664924260688295, -82.73502763876417 35.665141260752385, -82.73505863876392 35.66517626076273, -82.7350966387643 35.66521526077461, -82.73518963876506 35.66531026080351, -82.73533663876653 35.66546026084915, -82.73535063876709 35.66547226085309, -82.73547763877006 35.66559026089019, -82.73557663877247 35.66568126091892, -82.73581863878061 35.665890260986394, -82.73608363879076 35.666111261058695, -82.7364316388065 35.6663862611505, -82.73673463881815 35.66663826123306, -82.73684063882129 35.66673326126328, -82.7369496388225 35.666843261296904, -82.73704663882206 35.666951261328954, -82.7371456388194 35.66707526136443, -82.73727263881119 35.66726626141641, -82.73739163879512 35.66749926147621, -82.73743163878574 35.66760326150152, -82.73746863877436 35.667717261528544, -82.73750263875655 35.66786926156311, -82.73753563873274 35.66805926160521, -82.73755463870853 35.66823726164353, -82.7375616386851 35.668397261676915, -82.73757263863573 35.66872926174571, -82.73759963856223 35.66923526185178, -82.73763463843562 35.67009426203062, -82.73764463838943 35.67040426209489, -82.73764863836917 35.67054026212313, -82.73766263830855 35.67094826220781, -82.73766763828836 35.67108526223621, -82.73766763827057 35.671200262259745, -82.73763463822971 35.671429262303064, -82.73760263819763 35.67160326233529, -82.73760163819632 35.67161026233662, -82.73746163809543 35.67211326242485, -82.73734463801846 35.67248626248893, -82.73714863788982 35.673108262595726, -82.73712263787212 35.67319426261068, -82.73706363783322 35.673383262643135, -82.73701563778958 35.67361426268538, -82.7369936377547 35.67381626272435, -82.73697563766324 35.674390262839594, -82.7369746376302 35.67460326288296, -82.73697463761498 35.674702262903146, -82.73696463749876 35.67544426305354, -82.73696263743075 35.67588326314292, -82.73695463736405 35.67630726322864, -82.73695363726722 35.676934263356465, -82.73694863723556 35.67713426339676, -82.73692963720364 35.677320263432755, -82.7369006371802 35.67744126345453, -82.73686463715568 35.67756126347527, -82.73686263715486 35.67756426347567, -82.73650463695256 35.678488263627486, -82.73635663687165 35.678853263686754, -82.73634763686643 35.67887726369074, -82.73624663682236 35.679053263716234, -82.73612563677572 35.67922526373894, -82.73595963671619 35.67943126376393, -82.73573663663812 35.67969626379512, -82.7356516366079 35.6798002638076, -82.73540463651919 35.6801082638451, -82.73522863645663 35.68032326387086, -82.73492063634627 35.680705263917176, -82.73473363627642 35.680956263949184, -82.73471763626989 35.68098126395265, -82.73462263622856 35.68114626397653, -82.7345886362104 35.681227263989584, -82.73453763618258 35.68135226400993, -82.73452663617444 35.68139326401713, -82.73448763614299 35.68155426404603, -82.73445963610675 35.681759264084945, -82.7344566360814 35.68192026411749, -82.73445663607589 35.6819562641248, -82.73447263605684 35.682097264155246, -82.73449163604427 35.68219926417798, -82.73454363602579 35.682375264219296, -82.73461663601098 35.68255026426244, -82.73472963600067 35.68273926431267, -82.73475663599949 35.68277626432299, -82.73484063599611 35.68288926435466, -82.73496163599509 35.683026264395004, -82.7351056359985 35.68316026443714, -82.73528363600563 35.683306264485175, -82.73588863603426 35.68377526464305, -82.73611763604637 35.683944264701005, -82.73637563605811 35.684147264768924, -82.73645063606027 35.68421426479034, -82.73665963606629 35.68440126484994, -82.73680963606064 35.684600264905974, -82.7369136360492 35.684787264954814, -82.7369316360474 35.68481826496293, -82.7369866360353 35.68495626499685, -82.73699163603399 35.6849702650002, -82.73719863598143 35.68553426513655, -82.73726863596414 35.685722265182065, -82.73738163593548 35.68603026525652, -82.73745963591281 35.68626126531165, -82.73753463589556 35.68645426535873, -82.73761763587335 35.686688265415, -82.73765763585442 35.68685426545299, -82.7376686358493 35.686899265463296, -82.73769363582898 35.68705826549832, -82.73770263580363 35.68723226553477, -82.73768663575723 35.68751526559093, -82.73764263567578 35.687995265684364, -82.73764663565136 35.688158265718016, -82.73766763562769 35.688334265756026, -82.73771563559929 35.688570265809176, -82.73783263553503 35.689113265931994, -82.737980635454 35.68979826608696, -82.73811263537893 35.69042726622892, -82.73817063533957 35.69074526629974, -82.73819863532158 35.69089226633263, -82.73824563528585 35.69117426639496, -82.73825563526881 35.691295266420695, -82.73828863525104 35.69144626645486, -82.73831063523997 35.691542266476745, -82.73830963520318 35.691779266524996, -82.73828863517979 35.69190826654916, -82.73826463515198 35.692062266578176, -82.73825563513385 35.69217026659924, -82.7382036350941 35.69237126663492, -82.73814863506102 35.69252626666091, -82.73814463505849 35.692538266662964, -82.73807263502346 35.692687266685944, -82.73795863495847 35.69298526673505, -82.73791463492978 35.69312326675872, -82.73784463485335 35.69354326683721, -82.73780963479206 35.69390226690689, -82.73780763478975 35.693915266909315, -82.73777563473796 35.694216266967516, -82.73776563471617 35.69434626699302, -82.73777063470956 35.694394267003254, -82.73777563470313 35.694441267013396, -82.73778963468575 35.694569267040926, -82.73779263468441 35.69458126704373, -82.73780663467967 35.69462726705453, -82.73781563467621 35.69465926706202, -82.73782163467446 35.694677267066275, -82.73785263466786 35.69475326708496, -82.73786563466514 35.694785267092826, -82.73788963465925 35.694849267108395, -82.73790863465595 35.69489126711888, -82.73793063465214 35.69493926713097, -82.73799563463399 35.695127267175984, -82.73800963462197 35.695220267196355, -82.73801363461908 35.69524326720149, -82.73801763460555 35.6953352672207, -82.73801963460069 35.6953692672278, -82.73801263458249 35.695479267249574, -82.73800263457173 35.69553826726055, -82.7379966345652 35.69557426726734, -82.737929634522 35.695781267302664, -82.7378036344568 35.69606726734811, -82.73778363444707 35.69610926735462, -82.73769663440396 35.6962942673834, -82.73765563438386 35.69638026739671, -82.73759863435414 35.69651126741769, -82.73754563432618 35.69663526743749, -82.73749963429877 35.69676226745868, -82.73745963426539 35.69693526748991, -82.73743863423782 35.69709126751961, -82.73744163422153 35.69720026754218, -82.73744363421226 35.69726226755493, -82.73745163420028 35.69734826757337, -82.73746763418923 35.697437267593145, -82.73747063418726 35.69745326759675, -82.73747963418128 35.697502267607696, -82.73748263417914 35.69751926761143, -82.73748763417603 35.69754426761707, -82.73750763416537 35.69763526763768, -82.73756963413202 35.69791826770185, -82.73758163412367 35.6979852677167, -82.73758363412281 35.69799326771856, -82.73759163410703 35.69810426774199, -82.73760163408613 35.69825026777285, -82.73759963407433 35.69832426778773, -82.73759963406681 35.69837326779773, -82.73756163399717 35.69878326787746, -82.73756663397963 35.69890226790227, -82.73758063397239 35.69896426791641, -82.73758663397072 35.69898126792045, -82.73760563396573 35.69903426793324, -82.73764863396275 35.699100267951124, -82.73770863396327 35.69916126796974, -82.73778563396844 35.69921126798782, -82.73790163398088 35.699256268008995, -82.73799663399426 35.69927226802194, -82.73810363401232 35.699271268032774, -82.73820963403341 35.699249268039146, -82.73844563408234 35.69918726805072, -82.7386596341267 35.69913126806127, -82.73880163415328 35.699112268072, -82.73894763417631 35.699121268088845, -82.73905363418926 35.699152268106054, -82.73913263419533 35.69919826812353, -82.7391616341975 35.699215268130025, -82.73929063420209 35.69932526816567, -82.73939863419959 35.699458268203955, -82.73952463419069 35.69965226825647, -82.73962763418605 35.699793268295856, -82.73965963417402 35.69990626832221, -82.73967263416192 35.69999826834229, -82.7396766341588 35.70002326834785, -82.73967063413771 35.70015326837377, -82.73963363411035 35.70029026839788, -82.73954063404832 35.70059126844975, -82.73953463404379 35.70061426845388, -82.73951763402319 35.70072926847555, -82.73953863399421 35.700939268520614, -82.73958863398548 35.7010502685484, -82.73964763398052 35.70114626857403, -82.73972463397726 35.70125026860313, -82.73976863397891 35.70128726861521, -82.73982463398104 35.70133426863059, -82.7399236339877 35.70139826865377, -82.74003663400025 35.70143926867374, -82.74021063402095 35.70149326870261, -82.7403096340364 35.70150026871427, -82.74039363404935 35.70150726872436, -82.74055963407753 35.70150426874074, -82.74082463412513 35.7014822687635, -82.74115463418808 35.70143126878705, -82.74139263423228 35.70140226880551, -82.741577634264 35.701397268823506, -82.74177863429571 35.701409268846625, -82.7420176343303 35.701443268878094, -82.74207863433877 35.70145426888661, -82.742298634369 35.70149626891776, -82.74251363439943 35.70153226894724, -82.74266563442409 35.70153626896363, -82.74266963442483 35.70153626896409, -82.7428226344531 35.701518268976116, -82.7428266344538 35.7015182689765, -82.743098634506 35.7014742689955, -82.74319163452245 35.70146826900384, -82.74327663453636 35.701470269012965, -82.74329463453884 35.70147326901548, -82.74335963454752 35.701487269024945, -82.7434476345575 35.701518269040314, -82.74350763456239 35.70155126905325, -82.74352363456364 35.70156026905668, -82.74358563456363 35.70162726907675, -82.74364163456069 35.70170726909885, -82.74365063456024 35.70172026910242, -82.74365863455331 35.70177326911405, -82.74367463454008 35.70187626913668, -82.7436826345059 35.70210626918446, -82.7436746344851 35.70223226920932, -82.74367563448389 35.70224126921124, -82.743694634469 35.70235826923709, -82.74372463445108 35.70250626927042, -82.74381363443237 35.70272426932405, -82.74390763441836 35.70291626937293, -82.74402263439426 35.70319726944204, -82.74413763437444 35.70344926950528, -82.74418463436709 35.703548269530316, -82.74425563435638 35.703694269567386, -82.74434663433867 35.703907269620224, -82.74436763433077 35.70398126963749, -82.74440263431929 35.70409326966391, -82.74440463429875 35.704228269691704, -82.74440663428457 35.70432226971111, -82.74436863423637 35.70459326976249, -82.74436663419449 35.7048622698172, -82.74440363418299 35.704977269844456, -82.7444336341734 35.705071269866735, -82.74455163418017 35.705155269896025, -82.74456063418101 35.70515926989772, -82.74466363419106 35.70520626991796, -82.74468563419316 35.705216269922225, -82.7448876342233 35.70523926994766, -82.74499663424686 35.70520426995176, -82.74509263426752 35.705174269955535, -82.74510363427082 35.705165269954726, -82.74529363432832 35.70499826994021, -82.74538463435908 35.70489726992896, -82.74551263440213 35.70475726991352, -82.74566463444722 35.70462926990302, -82.74589863449735 35.70455726991235, -82.74626463455837 35.70455826995013, -82.74643063458326 35.704576269970836, -82.74651063459532 35.70458526998095, -82.7468196346449 35.70459827001532, -82.74692863466248 35.70460227002731, -82.74700263467507 35.704600270034554, -82.74729463472441 35.70459627006375, -82.74755263477299 35.7045612700831, -82.74773563480724 35.70453727009696, -82.74786663483178 35.70452027010696, -82.7480796348756 35.70446627011782, -82.74810263488159 35.70445227011733, -82.74821963491138 35.70438627011585, -82.7483286349492 35.704259270101105, -82.74833563497475 35.70410127006964, -82.74828963499947 35.70389127002203, -82.74810363501456 35.70359226994188, -82.74806663502429 35.703489269917114, -82.74803763503222 35.7034062698971, -82.74803563506363 35.70320126985516, -82.74808463508248 35.70313226984606, -82.74812963509967 35.70306926983783, -82.7482266351244 35.70301426983659, -82.74833963515302 35.70295126983525, -82.74860463520015 35.70293226985865, -82.7486666352079 35.70294926986847, -82.74877263522089 35.7029792698855, -82.7489116352244 35.70310726992589, -82.74901363516378 35.70361027003906, -82.74903063515687 35.703673270053734, -82.74914563511155 35.704091270150755, -82.74933663505264 35.70467927029039, -82.74954963500542 35.70521527042167, -82.74960263499975 35.705309270446314, -82.74974563498469 35.70556127051248, -82.74995063498741 35.705765270575135, -82.75012763500239 35.705860270612696, -82.7505216350352 35.70607327069671, -82.75065263504418 35.7061572707273, -82.75082263505554 35.70626727076723, -82.7510616350717 35.70642127082325, -82.75127563510057 35.70646527085417, -82.75151563514872 35.706413270868175, -82.75166263519236 35.70628927085803, -82.75168963520038 35.706267270856245, -82.751823635246 35.706116270839196, -82.7519506353132 35.705818270791454, -82.75203663537913 35.70548427073207, -82.75216963545431 35.70514127067578, -82.752245635501 35.70492127063865, -82.75238563555153 35.70474527061712, -82.75277663567198 35.70438827058438, -82.75316063578626 35.70406327055752, -82.75320263579962 35.70402227055348, -82.75348363588719 35.70375927052869, -82.75375463596716 35.70353427051055, -82.75390463601349 35.70339627049779, -82.75393363601249 35.70343427050852, -82.75395363601184 35.703460270515954, -82.75404063601572 35.70352927053887, -82.75407863601741 35.70355927054898, -82.75398963599436 35.70361227055061, -82.75369263591422 35.70381027056056, -82.75329563579389 35.7041602705912, -82.7532236357671 35.70425527060318, -82.75314663573826 35.70435927061649, -82.7528296355929 35.704958270706214, -82.7526336354908 35.705407270777705, -82.75222963528724 35.70628827091602, -82.75210763523737 35.706479270942495, -82.75158863507163 35.70699127099364, -82.75150763504747 35.70706027099939, -82.75145463503145 35.7071062710034, -82.7512656349992 35.70711127098498, -82.75092163497294 35.7069092709084, -82.75061863494534 35.70676027084686, -82.75051263493366 35.70672127082801, -82.75045763492771 35.70670027081807, -82.75029263490978 35.706638270788474, -82.75023763490363 35.70661827077876, -82.75021463490101 35.70661027077476, -82.75019163489786 35.70660627077158, -82.7500656348799 35.706586270754556, -82.75003063487483 35.70658127074995, -82.7500056348712 35.7065772707465, -82.74999363480195 35.707013270834324, -82.75038163478132 35.70756627098706, -82.75113963478202 35.708381271231254, -82.7515366347362 35.70910727142018, -82.75165263461531 35.7100152716175, -82.75161863451028 35.710658271745196, -82.7514456344458 35.71088927177466, -82.75119263437817 35.71105327178211, -82.7502446341034 35.711807271838595, -82.74985063398914 35.71212127186217, -82.74942963388762 35.71232327186014, -82.74928863385557 35.71237827185696, -82.74906563380132 35.71248827185648, -82.74890463376687 35.71253727184993, -82.7486886337257 35.712570271834466, -82.7484596336865 35.71257627181219, -82.7483546336712 35.71256227179852, -82.74815663364178 35.71253827177322, -82.74791363360218 35.71253227174706, -82.74783063358933 35.71252527173714, -82.7477476335766 35.71251827172716, -82.74768263356802 35.71250327171739, -82.7473556335252 35.712427271668346, -82.74710663349025 35.71238427163391, -82.74691163346124 35.712361271609204, -82.74661863340646 35.71239927158685, -82.74637363335924 35.71244027157011, -82.74610763330006 35.712535271562096, -82.74592963325401 35.712641271565474, -82.74584263321533 35.71279727158833, -82.74582363313871 35.71327327168355, -82.74580663311286 35.713422271712226, -82.74558963297613 35.714072271822644, -82.74546363292488 35.714268271849676, -82.74528163286804 35.714439271865864, -82.74498763279395 35.71460127186872, -82.74493663278089 35.714630271869375, -82.74470463273744 35.71466127185186, -82.74449863270496 35.71464827182799, -82.74432063267881 35.71462527180509, -82.74401063264125 35.71453327175447, -82.74344763257866 35.714330271655136, -82.74321163255242 35.714245271613585, -82.74180263239172 35.71376227137018, -82.74141063233724 35.71369127131539, -82.74118963230639 35.71365227128469, -82.74098463228235 35.7135862712502, -82.74069263225618 35.71344027119046, -82.740359632234 35.71322327111186, -82.740129632223 35.71304627105213, -82.7400366322169 35.71298527103015, -82.73950663213371 35.71295127096874, -82.73925163209945 35.71289727093149, -82.73889463205785 35.71278027087093, -82.73853263202132 35.71262627080233, -82.7382326320043 35.71241227072782, -82.73791463200983 35.71203227061759, -82.73770663200106 35.71186427056191, -82.73757163198707 35.71180927053681, -82.73737263195403 35.71180827051611, -82.73720763191612 35.71187527051288, -82.73698863184536 35.71209627053545, -82.73689563179813 35.712301270567735, -82.73682363175432 35.712507270602366, -82.73660463161488 35.7131732707158, -82.736532631578 35.71333427074125, -82.73643663152812 35.7135532707761, -82.73628863147331 35.713748270800615, -82.73609663142125 35.71387727080726, -82.73578463135671 35.713958270791736, -82.73548363130286 35.713981270765494, -82.73496663122292 35.713940270704036, -82.73468763118078 35.71391127066943, -82.73455363116058 35.71389727065277, -82.73450563115338 35.71389227064678, -82.73414963109454 35.713888270609374, -82.73401563107237 35.71388727059547, -82.73374263102382 35.713906270571215, -82.73346463096573 35.71398227055826, -82.73325463091501 35.7140832705572, -82.73314863087938 35.71419927056998, -82.73310163084804 35.71435127059618, -82.73312063081892 35.71456027064079, -82.73326663079945 35.714844270713755, -82.7333606307989 35.714949270744825, -82.73349563081074 35.71501827077277, -82.73395263087097 35.71512227084098, -82.73412263089322 35.715162270866685, -82.73454963094582 35.7152832709352, -82.7350826310216 35.71536827100732, -82.73540663107 35.7154052710482, -82.7358696311463 35.71541127109699, -82.73619963120301 35.71540127112891, -82.73647863124496 35.71543127116367, -82.73665163125979 35.71552227120004, -82.73673963125826 35.71562727123054, -82.73678063123708 35.71580827127168, -82.7367706311874 35.716119271334094, -82.73668863114308 35.716317271366066, -82.73657163110117 35.7164622713836, -82.73537063077036 35.71730527143223, -82.73514463071461 35.71742227143292, -82.73489363066045 35.717501271423224, -82.73453063059246 35.71754927139569, -82.73410263051483 35.71758927135988, -82.7337896304568 35.717626271335284, -82.73350363039842 35.71769527131992, -82.73347863039243 35.71770727131985, -82.73301863027989 35.71793827131967, -82.73279763021705 35.7181062713313, -82.7326186301511 35.71833927136041, -82.73250963009505 35.718584271399195, -82.7322806298989 35.71960627158425, -82.7322576298799 35.71970427160187, -82.73221962984685 35.71987727163322, -82.73216262982034 35.71998727164985, -82.73211762979888 35.72007727166361, -82.7320676297752 35.72017627167866, -82.73190562970355 35.72046527172094, -82.73175262963528 35.7207412717615, -82.731664629592 35.72092627179027, -82.73154862948103 35.721519271899325, -82.73147262943944 35.72170527192956, -82.73142562941364 35.721822271948525, -82.73129162934701 35.722108271993136, -82.73129162934684 35.72210927199337, -82.73128162934198 35.722130271996605, -82.73125662933442 35.72215227199855, -82.73112962929511 35.72226927200932, -82.73108862928218 35.722308272013066, -82.7310036292566 35.72238227201939, -82.73091762923977 35.72239827201391, -82.73078262921858 35.72238927199816, -82.73055262919813 35.7222732719509, -82.73051162919435 35.7222532719426, -82.73008662913942 35.72215027187781, -82.72974362911825 35.7219162717948, -82.72959662914323 35.721596271714375, -82.72957362916954 35.72140127167226, -82.72962062921427 35.72116227162833, -82.72967762923405 35.7210962716207, -82.72991362931438 35.720831271590896, -82.72999662935146 35.72068127156879, -82.72999662936168 35.72061527155538, -82.72999662937556 35.720525271537, -82.72989362938385 35.72036027149268, -82.72969762937292 35.720219271443774, -82.72947262935487 35.72009327139497, -82.72916662932602 35.71994927133412, -82.72885462930945 35.71971927125508, -82.72871262930187 35.71961527121929, -82.72848862929011 35.719449271162375, -82.72833562929647 35.71924327110467, -82.72757462935382 35.71805027078297, -82.72720862933794 35.71775727068554, -82.72675962930617 35.71747827058247, -82.7264306292913 35.71721927049585, -82.7261186292458 35.71717627045495, -82.72585962919781 35.717207270434635, -82.72562462914325 35.717306270430676, -82.72549462910888 35.717388270434085, -82.72547362910325 35.71740227043472, -82.72533162905928 35.71753327044688, -82.72522262902999 35.717605270450335, -82.72514162901426 35.71761927044498, -82.72490862896889 35.71766127042954, -82.72440162888287 35.71767027037927, -82.7240776288304 35.717660270343885, -82.72406762882882 35.717659270342715, -82.72383062879037 35.71765227031689, -82.7236516287661 35.71761627029111, -82.72345962874346 35.71755527025899, -82.7228856286926 35.71726427014053, -82.72225262865786 35.7168052699819, -82.7217906286519 35.71634526984052, -82.72137162864625 35.715929269712525, -82.72089362861482 35.71561626959956, -82.72073762859856 35.71555326957068, -82.72054562856886 35.71553826954789, -82.72035562853051 35.715581269537076, -82.7202126284947 35.7156582695381, -82.72004062844344 35.715804269550226, -82.71951162826912 35.71636126960952, -82.71923462818467 35.716608269631394, -82.71888862810295 35.71676326962747, -82.71844962801646 35.71684926959992, -82.7170996277772 35.716939269479504, -82.71653862767775 35.71697726942957, -82.716135627604 35.71701926939668, -82.71566562750657 35.71714226937346, -82.7153416274341 35.717261269364386, -82.71488562733903 35.71738326934243, -82.71458262728278 35.717420269318836, -82.7144906272667 35.717425269310404, -82.71432462723746 35.7174352692954, -82.7141936272143 35.71744326928352, -82.71403262718134 35.71748326927522, -82.7138886271457 35.71755826927566, -82.71379862711238 35.71767626929048, -82.71373662707228 35.71786926932343, -82.71369262703519 35.71806126935816, -82.71346562692898 35.71850326942501, -82.71321262682453 35.71890626948119, -82.71298862670922 35.71941026956098, -82.71295862670438 35.719409269557715, -82.71292862669952 35.7194082695544, -82.71285462668439 35.71942626955049, -82.71280062666762 35.71947626955506, -82.71271362663022 35.719624269576414, -82.7125186265375 35.72001326963568, -82.71228362642509 35.72048726970826, -82.71206262633387 35.72083826975706, -82.71162562617054 35.721423269831504, -82.71151762613452 35.721539269844094, -82.71128262605606 35.72179326987174, -82.71108462599423 35.7219792698893, -82.71089462593454 35.72216026990672, -82.71054062580963 35.72258626995724, -82.71051462580036 35.72261826996108, -82.71033862574046 35.722815269983165, -82.71011062568812 35.72290826997875, -82.70993962566126 35.72289726995888, -82.70978862564593 35.7228332699303, -82.70963062563928 35.7227062698882, -82.70958762564058 35.7226512698725, -82.70943862564482 35.72246326981878, -82.7092966256737 35.72212326973486, -82.7091316256858 35.72186626966544, -82.70893062569682 35.72157826958609, -82.70876162568969 35.72144226954092, -82.70857762566969 35.72137326950793, -82.70834362564526 35.7212782694645, -82.70818962563712 35.721165269425605, -82.70811062564727 35.7210142693867, -82.70807362568854 35.72070726932022, -82.70804862571049 35.720538269283175, -82.70802762572967 35.72039126925101, -82.70791362575795 35.7200852691769, -82.70779462576861 35.71988826912445, -82.70775562577218 35.71982326910715, -82.70764862579654 35.71955026904049, -82.70751762589492 35.718772268868356, -82.70748562591793 35.71858926882765, -82.70746662593267 35.718473268802, -82.707420625976 35.71814326873002, -82.7073866259855 35.718045268706526, -82.70733862599928 35.71790426867282, -82.70731762600028 35.71787526866474, -82.70719962600579 35.71771226861932, -82.70694162598964 35.71753826855732, -82.7069396259894 35.71753726855688, -82.70665162595871 35.71742526850448, -82.7063956259364 35.71729326845117, -82.7060156259121 35.71704026836049, -82.70565962590233 35.716719268258394, -82.70564162590186 35.71670326825335, -82.70533262590456 35.71635226814992, -82.70531862590435 35.71633826814564, -82.70509062590034 35.71611826807733, -82.70492262589715 35.715957268027175, -82.70468362589503 35.71571326795285, -82.7044516259016 35.715420267869256, -82.70430562590569 35.71523626781671, -82.70425862590804 35.7151702677984, -82.7045286259466 35.71521226783472, -82.70455262595033 35.71521426783756, -82.70506162602612 35.71527326790197, -82.70543262609026 35.71525826793706, -82.70544162609218 35.715256267937505, -82.70573362614967 35.71519926795594, -82.70577362615758 35.71519126795843, -82.70645462630611 35.71496526798234, -82.7066226263427 35.714910267988344, -82.7068356263915 35.71482426799271, -82.70698062643267 35.71471426798524, -82.70708062646608 35.71460626797349, -82.70719462652067 35.71437626793828, -82.70732962659832 35.714019267879316, -82.70747162667631 35.7136682678223, -82.70760762673085 35.71346226779429, -82.70779062678652 35.71329926777976, -82.70781762679367 35.7132822677791, -82.70812362687242 35.713103267774116, -82.7084766269618 35.71290626777016, -82.70857062698562 35.712853267769006, -82.70885862706028 35.71268126776354, -82.70891362707641 35.71263626775998, -82.70906862712124 35.7125132677509, -82.70924062717873 35.71232726773055, -82.70945962725447 35.71207326770125, -82.70973362732973 35.71188226769054, -82.7101066274219 35.711688267689276, -82.71010862742257 35.71168626768905, -82.71057962753322 35.71147926769526, -82.7106156275416 35.71146326769568, -82.71074462757326 35.711398267695714, -82.71106762765199 35.71123726769608, -82.7112366276949 35.71114226769406, -82.7113986277357 35.71105326769254, -82.71145762775076 35.71101926769171, -82.71151562776522 35.71098826769127, -82.71163962779583 35.710924267690984, -82.71170162781078 35.71089426769119, -82.7118756278533 35.710807267691315, -82.71190162785975 35.71079326769118, -82.71216262792447 35.71065626769009, -82.71234362797713 35.71051126767903, -82.71243662800984 35.71039926766576, -82.71254462804741 35.71027326765118, -82.71257362806 35.71022326764396, -82.71266162809778 35.71007326762243, -82.7129496282392 35.70946926752883, -82.71304862828774 35.70926226749669, -82.71328362839093 35.7088482674364, -82.71349362846257 35.70861126740966, -82.71375562853288 35.708439267401516, -82.71406662860299 35.70832126740938, -82.71430162864746 35.70828726742656, -82.71440562866465 35.70828826743753, -82.71459562869619 35.70828926745726, -82.71491962874246 35.70833926750075, -82.71575262886161 35.70846826761267, -82.71598862889924 35.70847926763915, -82.71614262892949 35.70845026764912, -82.71630362896465 35.70839626765465, -82.71649462900915 35.708314267657535, -82.71660762903652 35.70825926765795, -82.71670962906101 35.70821126765858, -82.71708362915611 35.7079992676538, -82.71748062925167 35.707809267655826, -82.71764662929546 35.707705267651626, -82.71783562935141 35.707547267638866, -82.71798862940948 35.70733626761153, -82.7181396294729 35.70708926757663, -82.71841062959341 35.70660226750519, -82.71848962962778 35.706465267485335, -82.71867962970984 35.706139267438346, -82.71888962980692 35.70573726737785, -82.71891562982054 35.70567726736835, -82.71900762986895 35.70546326733409, -82.71912062994362 35.70510226727208, -82.71914862996424 35.7049992672539, -82.71926263004823 35.70457826717978, -82.71927463005612 35.70454026717322, -82.71959763027313 35.70348426699093, -82.71978663039533 35.7028972668906, -82.71986063044118 35.70268026685394, -82.71991663047635 35.702513266825626, -82.71993863049018 35.70244726681446, -82.72000563053186 35.70225026678113, -82.72002163054148 35.702205266773596, -82.72002763054553 35.7021852667701, -82.72012963061674 35.70183426670899, -82.72016963064426 35.70169926668554, -82.72018663066443 35.70158726666445, -82.72019463068587 35.70145726663875, -82.72016763070854 35.70128126660009, -82.7201156307191 35.70115626656924, -82.71989963073445 35.700823266479084, -82.71987663073628 35.70078726646942, -82.71976563074968 35.700580266415734, -82.71972663075529 35.70050226639585, -82.71966863076364 35.70038526636597, -82.71965063076621 35.700349266356774, -82.71950363079061 35.700032266276985, -82.71949963079138 35.7000232662748, -82.71945663080128 35.69991226624769, -82.71945063080251 35.69989826624421, -82.71943563080599 35.69985926623466, -82.71943063080714 35.699846266231525, -82.71940663081259 35.69978526621668, -82.71940463081314 35.699779266215195, -82.71934163083013 35.69960126617239, -82.71932063083604 35.69954026615783, -82.71931763083698 35.69953126615562, -82.71923863086467 35.69926626609348, -82.71919663088377 35.69909726605471, -82.71919163088637 35.69907526604973, -82.71915363091183 35.69886926600374, -82.71912663093805 35.6986702659604, -82.71910563096903 35.698447265912705, -82.719090631005 35.698198265860405, -82.71908363103611 35.697989265817014, -82.71907163106104 35.69781426578005, -82.71904863108458 35.69763726574159, -82.71898863114838 35.69715926563797, -82.71898063115631 35.697099265624864, -82.71895763118016 35.69692026558597, -82.71895063118808 35.696861265573226, -82.71893863119374 35.696811265561756, -82.71891363120719 35.696697265535946, -82.71889163120822 35.69666726552754, -82.71886163120949 35.69662626551611, -82.71882863121074 35.696582265503736, -82.71877463120796 35.6965422654901, -82.71873663120596 35.69651426548043, -82.71854363118655 35.696431265443714, -82.7184386311735 35.69640226542695, -82.71832163115894 35.69637026540839, -82.71830763115507 35.696380265409, -82.71820163113166 35.69641726540563, -82.71807563110262 35.696469265403316, -82.71804263109489 35.6964832654028, -82.71748363096165 35.696742265398164, -82.71734863093134 35.696793265394696, -82.71727063091346 35.696824265393055, -82.71721563090124 35.69684426539145, -82.71718463089435 35.69685526539051, -82.7170956308778 35.69686626538363, -82.7170376308672 35.69687226537892, -82.71701963086377 35.69687526537766, -82.71689163084515 35.69685726536081, -82.71686663084193 35.69685126535703, -82.7168106308342 35.69684026534906, -82.71672063082197 35.69682226533615, -82.71645663078989 35.69674526529327, -82.71635263077937 35.69670126527358, -82.71627763077153 35.69667026525955, -82.71610363075516 35.69658826522497, -82.71585663074349 35.6963972651606, -82.71579963074845 35.69630326513559, -82.71576263075148 35.6962442651198, -82.71570163077472 35.69602726506927, -82.71569363078241 35.69596926505659, -82.71566263079251 35.69587026503317, -82.71560163080122 35.695748265001995, -82.71552563080671 35.69563026497013, -82.71541863080893 35.695500264932626, -82.71526663080763 35.695344264885186, -82.71496063080204 35.695050264793736, -82.71470963079956 35.69479526471592, -82.71448763080075 35.69454726464253, -82.71430463080516 35.69432126457765, -82.71423663080965 35.6942182645496, -82.71409163081427 35.69403226449683, -82.71403063081762 35.69394426447253, -82.71389263081696 35.6937992644288, -82.71375563081128 35.69368826439212, -82.71369463080764 35.69364626437725, -82.71351863079421 35.693543264338125, -82.713287630774 35.69342426429014, -82.71277863073242 35.69314326418054, -82.712702630724 35.6931162641672, -82.71261863071413 35.69308926415307, -82.71250463069866 35.6930662641366, -82.71228363066174 35.693066264113945, -82.71210763062994 35.69308226409908, -82.71177963057 35.69311626407242, -82.71170063055591 35.693122264065416, -82.71143163050758 35.693144264042274, -82.71106763044536 35.69315426400694, -82.71075763039427 35.69315026397427, -82.7105696303643 35.69314126395311, -82.71038963033655 35.69312626393154, -82.71021563031081 35.69310526390945, -82.71006163028937 35.69307726388784, -82.70974463024233 35.693039263847595, -82.70974363024224 35.69303926384743, -82.70908263013966 35.69298926376935, -82.7085686300606 35.69294626370772, -82.70832563002466 35.69291626367662, -82.7082306300106 35.69290526366465, -82.70809862999198 35.692883263646614, -82.70791762996764 35.692845263620185, -82.70785962996061 35.69282826361079, -82.70782862995682 35.692819263605756, -82.70780562995425 35.692811263601826, -82.70770462994298 35.692775263584075, -82.70765562993985 35.69274226357228, -82.70760962993694 35.692711263561215, -82.70756562993519 35.692675263549425, -82.70750562993693 35.692599263527704, -82.70741662994814 35.692430263484106, -82.70733962997038 35.69220326342994, -82.70728862999489 35.69198926338099, -82.70728363000516 35.691917263365795, -82.70728763001976 35.69182726334783, -82.70728863002255 35.69181026334448, -82.70731763003991 35.69172926333092, -82.70732163004226 35.69171826332908, -82.70737363006893 35.69160126331054, -82.70745763010089 35.69148526329555, -82.70784063023892 35.69100526323699, -82.70801663030626 35.69075926320491, -82.70815063035583 35.690583263182745, -82.70827463039994 35.690431263164456, -82.7083676304343 35.69030926314918, -82.70841163045179 35.69024326314023, -82.70845563047148 35.6901632631284, -82.70848663048763 35.69009226311716, -82.708519630511 35.689976263096796, -82.70858263056304 35.68970726304841, -82.70864863059566 35.68956726302669, -82.70873163062991 35.6894352630083, -82.708771630645 35.68938026300116, -82.70883063066694 35.68930226299128, -82.70929263084281 35.688662262908174, -82.70934263086043 35.68860226290111, -82.70936363086776 35.688577262898185, -82.70938763087612 35.688549262894874, -82.70942363088969 35.688500262888596, -82.70944363089687 35.68847526288559, -82.70947363090825 35.68843326288006, -82.70956763094345 35.68830726286401, -82.70959963095517 35.688266262858924, -82.70961163095967 35.68825026285689, -82.7096706309855 35.68814626284175, -82.70976963103368 35.68794126281014, -82.70988663110197 35.68762526275765, -82.70991863113727 35.687431262721425, -82.7099116311603 35.68727426268868, -82.70989263117147 35.687181262667714, -82.70988463117403 35.687156262661844, -82.70981663119751 35.686930262608705, -82.7098066312104 35.686836262588564, -82.70980863122513 35.68674326256977, -82.70983363124536 35.686639262551125, -82.70986263126143 35.68656626253917, -82.71043163147823 35.68577626243652, -82.71047363149721 35.685699262425125, -82.71049863151246 35.685627262413, -82.71049963152295 35.68556026239941, -82.71048063153341 35.68547226237945, -82.71039263154427 35.68530626233658, -82.71026663155412 35.68510626228288, -82.71013263155821 35.68493526223422, -82.70998763155875 35.68477526218663, -82.70990763156112 35.6846732621577, -82.70984363156789 35.68456026212806, -82.70978563158084 35.68441326209204, -82.70974763159306 35.68429326206373, -82.70973163160092 35.68422526204815, -82.70973063161446 35.68413626202993, -82.7097586316293 35.68407026201933, -82.70976863163439 35.68404826201589, -82.70979263164162 35.684027262014034, -82.7098136316482 35.68400726201218, -82.7099766316984 35.68385826199851, -82.71014063174431 35.68373826199082, -82.71032063179295 35.68361726198466, -82.7104976318396 35.683506261980185, -82.7106136318712 35.68342726197596, -82.71068763189449 35.68335626196912, -82.71071863190437 35.68332526196598, -82.71073363190908 35.683311261964626, -82.71077763192908 35.68322926195245, -82.71078363193291 35.68321126194939, -82.71080063194204 35.683170261942834, -82.7108236319552 35.683109261932685, -82.7108426319657 35.68306226192506, -82.7108826319937 35.682924261901114, -82.71090163200638 35.68286226189031, -82.71092063201989 35.68279526187866, -82.71092763202414 35.68277526187528, -82.7109546320452 35.6826682618562, -82.71097763206046 35.68259426184345, -82.71099463207163 35.682540261834205, -82.71099963207432 35.68252826183229, -82.7110356320934 35.68244326181866, -82.7110836321187 35.682331261800755, -82.7111386321431 35.68223226178613, -82.71115663215184 35.68219526178048, -82.7111976321714 35.68211326176791, -82.71124663219483 35.68201426175286, -82.7113146322232 35.6819032617371, -82.71139163225338 35.68179126172221, -82.71146463227973 35.68169926171091, -82.71152263229932 35.681635261703875, -82.71174863236837 35.681432261685664, -82.71183163239522 35.68134826167697, -82.7118976324176 35.681274261668676, -82.71203663246683 35.68110526164848, -82.7121536325125 35.68093626162601, -82.71222263254123 35.68082426161027, -82.71233163259184 35.68061426157862, -82.71245663266419 35.68028026152339, -82.71247863267868 35.6802102615113, -82.71252963271138 35.68005326148451, -82.71267463279555 35.67966426142012, -82.71270063281163 35.67958826140723, -82.7127636328493 35.6794122613778, -82.71278063285993 35.67936226136934, -82.71280863287612 35.67928726135691, -82.71304563301798 35.67862426124605, -82.71308063303879 35.678527261229895, -82.71331963317364 35.67791126112876, -82.71350563327123 35.6774802610599, -82.71357663329879 35.6773782610464, -82.71366063332698 35.67728626103626, -82.71397463342247 35.67700626101138, -82.71412363346975 35.67686126099713, -82.7141606334813 35.67682626099374, -82.71432463353749 35.67663926097249, -82.71443263357848 35.676490260953145, -82.7145066336136 35.67634326093081, -82.71452563362479 35.67629126092212, -82.714538633636 35.67623226091147, -82.71456363365992 35.67610426088782, -82.71455963367053 35.67603126087254, -82.71454463368325 35.67593226085082, -82.71448563369505 35.67579226081619, -82.71440263370236 35.675655260779735, -82.71391363374588 35.674844260564065, -82.71387263375246 35.674757260542144, -82.71384263376119 35.6746682605209, -82.7138096337777 35.67452526048834, -82.7136686338614 35.67383026033205, -82.71366463386556 35.673799260325346, -82.71365363387741 35.673710260305995, -82.71365563389698 35.67358526028078, -82.71368063391799 35.6734762602611, -82.71373063394199 35.67337526024566, -82.71380363397016 35.67327126023187, -82.7138746339945 35.67319026022267, -82.71391663400897 35.67314226021725, -82.71396363402472 35.6730902602114, -82.71399363403614 35.67304926020611, -82.71403163405029 35.672998260199655, -82.71403363405156 35.67299226019861, -82.71406063406502 35.67293426018956, -82.71408463407707 35.67288226018138, -82.71411263409853 35.67277326016207, -82.71413263412445 35.67262726013434, -82.71413963416362 35.67238026008464, -82.71413563419046 35.6722022600479, -82.71411763421551 35.672020260008935, -82.71409563423511 35.67186925997585, -82.71405163424966 35.6717272599424, -82.71396863426268 35.67155325989835, -82.71388863427082 35.67141425986176, -82.71382963427683 35.67131125983469, -82.71378363428478 35.67121025980942, -82.71376563429871 35.67110025978513, -82.71377063431635 35.670991259763404, -82.71380663433904 35.67088325974509, -82.71385763436074 35.67079725973278, -82.71393963439216 35.670682259717715, -82.71422063449025 35.67035025967881, -82.7146256346366 35.669839259616204, -82.7147676346942 35.669619259585915, -82.71482263472143 35.66950225956767, -82.71494863479286 35.66917525951395, -82.7150266348301 35.669018259489874, -82.71508563485484 35.66892125947614, -82.71539363497325 35.66848725941922, -82.71551663502396 35.668291259391886, -82.71557363504996 35.66818425937596, -82.71561263507276 35.66807825935829, -82.71564963510004 35.66794125933421, -82.71568663514776 35.66767225928308, -82.71569863520614 35.66730625920967, -82.71570063521217 35.6672692592023, -82.7157136352403 35.667101259169364, -82.71575963527867 35.66690225913351, -82.7158046353063 35.66677125911142, -82.71604363544459 35.666133259005825, -82.71617963552308 35.66577125894589, -82.71618663552978 35.665735258939264, -82.71625563556769 35.665564258911495, -82.71625863556895 35.6655592589108, -82.71638963564394 35.66521425885382, -82.71641863566222 35.66512725883911, -82.71659263576204 35.66466825876329, -82.71663063578575 35.66455525874417, -82.71672663583664 35.664329258707866, -82.71673663584164 35.66430725870449, -82.71680863587375 35.664177258685285, -82.71687863590206 35.66406925867042, -82.71703863596191 35.66385425864303, -82.71714763599745 35.663741258631205, -82.71724063602642 35.66365425862297, -82.71735363605896 35.66356525861644, -82.71758463612156 35.663409258608354, -82.71774163616224 35.66331525860529, -82.7180706362479 35.66311525859829, -82.7189356364705 35.66260725858342, -82.71924963655279 35.66241325857609, -82.71934763657757 35.66235825857491, -82.71986863671293 35.66204425856435, -82.71987763671531 35.66203825856403, -82.720041636757 35.66194525856195, -82.72015563678723 35.66187225855876, -82.72038463684672 35.661734258554084, -82.72068263692479 35.66155025854713, -82.7210046370082 35.66135725854079, -82.72121263706278 35.661228258535864, -82.72140463711227 35.66111525853248, -82.72143763712096 35.6610942585316, -82.72179963721452 35.66087925852495, -82.72199463726504 35.660762258521046, -82.7221916373164 35.660642258516795, -82.7226096374254 35.66038725850771, -82.72274063745913 35.660310258505454, -82.72282063747942 35.66026525850446, -82.72293863750899 35.66020125850347, -82.7230146375295 35.66015025850093, -82.72318163757127 35.66006025849972, -82.72331863760647 35.65998025849742, -82.72342263763214 35.6599262584971, -82.72356763766618 35.6598622584989, -82.72367563769248 35.659808258499055, -82.72370263769878 35.65979625849934, -82.72414663780953 35.65955825849634, -82.72457063791714 35.65931925849113, -82.72473463795792 35.659232258490164, -82.72513763805942 35.659009258486044, -82.72533463810896 35.65890125848425, -82.7254566381381 35.65884425848515, -82.72562063817546 35.658779258488686, -82.72563963817942 35.65877425848966, -82.72578963821134 35.65872925849587, -82.72583263822037 35.65871725849782, -82.72599463825358 35.658677258506316, -82.72624863830397 35.658625258521745, -82.72640263833443 35.65859425853121, -82.72647963835053 35.65857325853492, -82.72649163835298 35.658570258535484, -82.72661363837844 35.658537258541315, -82.72670763840087 35.65849325854198, -82.72673163840659 35.65848225854217, -82.72678063841826 35.65845925854253, -82.72681563842177 35.65847425854918, -82.72685863842622 35.65849225855729, -82.72697663843788 35.658544258579965, -82.72707463844465 35.6586062586027, -82.72708563844591 35.65861025860463, -82.72716663845476 35.658640258619094, -82.72726363846559 35.65867525863615, -82.72741463848224 35.65873025866291, -82.72755963849946 35.65877525868696, -82.72765963851123 35.658807258703774, -82.72819463857726 35.65895825878945, -82.72825763858496 35.65897625879964, -82.72842663860575 35.659024258826754)))",6348,37,021,002604,370210026042,1293,1293,69,1273,1234,11,2,1,1,24,20,1018,44,974,1007,981,7,1,1,1,16,11,574,514,60
census_2010_blockgroups_view.fid--2dc29038_13ec899ba8f_-25ec,"MULTIPOLYGON (((-82.6785236447356 35.56511023455693, -82.67855664474119 35.565110234560365, -82.67865764475795 35.565110234570646, -82.6786916447635 35.565111234574324, -82.67878564478005 35.56510523458278, -82.67907164483037 35.56508723460841, -82.67916664484692 35.565082234617115, -82.67937464488337 35.56507023463597, -82.67949664490509 35.56506123464664, -82.68048664507995 35.564995234734624, -82.68081764513836 35.56497423476433, -82.68087364514842 35.56496923476901, -82.68104164517811 35.564958234783965, -82.68109864518799 35.56495523478917, -82.68135764523383 35.564937234812135, -82.68213664537166 35.56488423488107, -82.68239664541751 35.56486723490426, -82.68242264537946 35.565143234963166, -82.68244164533024 35.5654842350347, -82.68245264528613 35.56578423509692, -82.68245464525802 35.56596923513489, -82.682450645242 35.56606923515487, -82.68243864518237 35.5664452352302, -82.68241364513948 35.566697235279086, -82.68235364506457 35.56712023535912, -82.68234564504245 35.56725523538588, -82.6823496450264 35.5673642354085, -82.68237364501307 35.56747723543396, -82.68242764499888 35.56762823547031, -82.68254964497808 35.56789623553745, -82.68264164496968 35.568050235578276, -82.68276164495907 35.56824923563106, -82.68296164494394 35.56856523571604, -82.68310164493991 35.56874323576664, -82.68330064494172 35.5689472358286, -82.68359964495431 35.569189235908546, -82.68364864495729 35.569223235920546, -82.68403564498023 35.569493236015255, -82.68465164502162 35.569891236159535, -82.68447364496842 35.57004523617272, -82.68427964490985 35.57021623618765, -82.68412464484514 35.570469236223325, -82.68413164482328 35.5706192362546, -82.6841426447891 35.57085423630362, -82.68417164469778 35.57148023643422, -82.68433364464373 35.57200823655845, -82.68446064454754 35.57277223672724, -82.68472764447175 35.57355523691422, -82.68479064445398 35.5737392369582, -82.68482464441492 35.574030237021, -82.68474364424871 35.57502523721547, -82.68476364413054 35.57581623737879, -82.68482464413488 35.57585423739281, -82.68484164412828 35.57591523740697, -82.68485864412195 35.575975237420955, -82.68485764409215 35.57616823746025, -82.68493264408117 35.57632123749909, -82.68506664402324 35.57684323761929, -82.68523464398442 35.57727823772511, -82.68527564395836 35.57749223777298, -82.6852756438714 35.57805823788832, -82.68545064373014 35.57916823813256, -82.68549064372492 35.579245238152396, -82.68556464373144 35.5792832381677, -82.68585364376847 35.57935523821196, -82.68602864378583 35.57943223824564, -82.68619664378933 35.57959123829531, -82.6862576437581 35.579860238356375, -82.68643864373519 35.58020623844546, -82.68656064369203 35.58061923854214, -82.68656664366686 35.5807892385774, -82.686418643601 35.58105823861707, -82.6863956435778 35.581184238640404, -82.68637164355258 35.5813222386661, -82.68644564350257 35.581728238756455, -82.68643264347502 35.58189323878877, -82.68637164343788 35.582069238818335, -82.686385643359 35.58259723892747, -82.68641864334181 35.582745238961046, -82.68664764333018 35.58306923905058, -82.68668164332136 35.58316323907318, -82.68668164329615 35.58332723910667, -82.68649964322606 35.58358623914075, -82.68631864317692 35.58371023914752, -82.68607564311084 35.583877239156635, -82.6859686430609 35.58408623918826, -82.68588764300274 35.58437723923926, -82.68577964295856 35.58454723926284, -82.68563164290936 35.58470723928033, -82.68558464289573 35.58474523928323, -82.68528264280657 35.58499823930384, -82.68474464260898 35.58570123939203, -82.68466364257259 35.58585023941407, -82.68461664253695 35.58603123944615, -82.68460964249955 35.58626723949358, -82.68449564242988 35.58659723954913, -82.68409864225579 35.58730023965172, -82.68390364214892 35.58778423973043, -82.68372164207636 35.588059239767844, -82.6836846420641 35.58809923977224, -82.68361464203991 35.5881802397816, -82.68303564187342 35.588636239815116, -82.68262564177066 35.58886123981894, -82.68220864165174 35.58918323984183, -82.68095964129516 35.59015023991094, -82.6805436411763 35.59047323993408, -82.67993864108539 35.59040923985903, -82.67993564108491 35.59040923985872, -82.67932764102551 35.59013723974097, -82.67873564098107 35.58978523960846, -82.67833164094927 35.58955423951994, -82.67828764094583 35.589529239510334, -82.67812764093883 35.589401239467875, -82.67780764090769 35.58925723940566, -82.67689564075098 35.58928923931878, -82.67566364051143 35.58951323923802, -82.67478364034531 35.58964123917384, -82.67388764018634 35.589705239095025, -82.67377964015486 35.5897932391019, -82.67287963989067 35.59053723916122, -82.67161563949094 35.59176923928272, -82.67047963912718 35.592905239397766, -82.67010263901462 35.59322923942514, -82.66876763861349 35.59439323952545, -82.66753563824605 35.59544923961442, -82.66668763799179 35.59618523967742, -82.66532763762757 35.597081239720595, -82.66451963742178 35.59754523973228, -82.66440163739155 35.597614239734234, -82.66415963732969 35.59775423973785, -82.66268763698136 35.598426239723885, -82.66153563668877 35.59908223973942, -82.66073563650392 35.59941823972577, -82.65991563638687 35.599292239616005, -82.65927763629561 35.599195239530765, -82.65827663616076 35.598989239386064, -82.65780163618491 35.59831823920065, -82.65732263620913 35.59764223901371, -82.65718663625478 35.59719823890927, -82.65709863627745 35.596955238850725, -82.65708763629031 35.596860238830246, -82.65708663630423 35.59676823881137, -82.65709963632207 35.596666238791954, -82.65712663634274 35.59656123877328, -82.65714163636295 35.596446238751376, -82.65714863638273 35.59632523872745, -82.65715763639294 35.59626823871676, -82.65716763640373 35.596209238705804, -82.65721463643212 35.59607523868331, -82.65732563649054 35.59581523864167, -82.65738063651543 35.59571323862653, -82.65745963654443 35.59561023861364, -82.6575406365702 35.59553023860567, -82.65761763659238 35.59546923860109, -82.6576946366159 35.59539923859471, -82.65786763667278 35.59521723857542, -82.65791363671224 35.59501023853791, -82.65795963673777 35.59489423851901, -82.65804463677651 35.59473423849511, -82.65824963685485 35.59444623845748, -82.65840763694324 35.594042238391324, -82.65844363696098 35.5939662383795, -82.65850463698585 35.593870238366186, -82.65862663704108 35.59364323833246, -82.65870363707141 35.59352923831714, -82.65882963712356 35.5933262382887, -82.65886763714374 35.59323623827424, -82.65890063716384 35.593141238258305, -82.65891963717762 35.593072238246165, -82.65893163718661 35.59302623823802, -82.65894863719586 35.59298523823142, -82.65896863720725 35.59293223822268, -82.65900663722546 35.59285523821087, -82.6590696372587 35.59270723818709, -82.65908363726884 35.59265623817816, -82.65908863727726 35.5926072381687, -82.65908563728401 35.59256023815883, -82.6590856372845 35.59255623815802, -82.65907663728676 35.59253223815219, -82.65903263728693 35.59248323813768, -82.65908263731465 35.59235723811718, -82.6591986373721 35.592109238078464, -82.65942563747474 35.59168723801577, -82.65960663755395 35.5913682379693, -82.65963663756771 35.59131123796078, -82.65964863757308 35.591289237957554, -82.65966063757901 35.591263237953484, -82.6596726375849 35.59123823794957, -82.65973463761304 35.59112223793239, -82.65975963762442 35.59107523792532, -82.65986063767323 35.59086723789326, -82.65999363773669 35.5905982378521, -82.66014263781285 35.59026423779928, -82.66015063781784 35.59024023779526, -82.66020463784876 35.59009723777161, -82.66022963786436 35.59002323775913, -82.66026563788695 35.589915237740804, -82.66030663791253 35.589793237720166, -82.66036363795226 35.58959623768584, -82.66036463795372 35.589588237684275, -82.66038063797353 35.589476237663106, -82.66038663798207 35.58942723765374, -82.66039663799519 35.58935323763968, -82.66040063800692 35.58928123762539, -82.66040463801488 35.58923323761606, -82.66040663801957 35.58920523761058, -82.66040363802519 35.5891652376021, -82.66039763803815 35.58907423758289, -82.66037263805032 35.58896823755874, -82.66037163805052 35.58896623755823, -82.66036463805203 35.58894823755385, -82.66034763805617 35.58890323754291, -82.66033663805864 35.58887523753611, -82.66021163806764 35.58868123748375, -82.66014363807243 35.58857623745538, -82.66000563808406 35.588351237395386, -82.65980463810257 35.5880132373059, -82.65967263811491 35.587790237246914, -82.65966763811512 35.58778323724494, -82.6596486381169 35.58775123723645, -82.65957163812604 35.587608237199426, -82.65948463813746 35.587440237156265, -82.6594756381387 35.5874222371517, -82.65943263814627 35.58732623712779, -82.65937163815903 35.58717723709106, -82.65932263817254 35.587036237057326, -82.6592566381986 35.586795237001425, -82.65924263820585 35.58673323698734, -82.65914763825548 35.58630723689081, -82.65912963826543 35.586223236871874, -82.65908463829132 35.58600623682303, -82.65905863831667 35.585813236781036, -82.65904763832711 35.58573323676354, -82.65904663832848 35.58572323676145, -82.6590266383606 35.585492236712334, -82.65901963836542 35.58545323670361, -82.65900663837697 35.58536423668412, -82.65900263838091 35.58533423667759, -82.65898163838885 35.58526023666039, -82.65896263839589 35.585193236644805, -82.6589116384077 35.58506123661265, -82.65884463841674 35.58493023657909, -82.65882463841942 35.58489123656909, -82.65866263843745 35.58459823649273, -82.65859963844694 35.58446823645985, -82.65854863845811 35.5843402364285, -82.65849763847223 35.58419323639338, -82.658456638487 35.5840532363606, -82.65841163851562 35.583818236308105, -82.65840463853303 35.58369723628269, -82.65840463854411 35.58362523626803, -82.65840763858237 35.58337923621822, -82.65839963859892 35.58326323619371, -82.6583786386107 35.583163236171174, -82.65835463862072 35.5830722361502, -82.6583376386279 35.58300723613523, -82.65827063864413 35.582829236092095, -82.65820463866031 35.582652236049164, -82.65813263868198 35.58243323599718, -82.65809063869453 35.582306235967, -82.65804863871982 35.58209623591988, -82.65801663875781 35.58181423585919, -82.65797863880498 35.581466235784376, -82.65797163881099 35.581419235774085, -82.65795163882933 35.58127823574325, -82.65794563883546 35.58123223573325, -82.65793663884365 35.581169235719535, -82.65788263888842 35.580819235642664, -82.65784263892236 35.58055523558476, -82.65782063892989 35.58048223556764, -82.65778763893717 35.58039923554737, -82.65770563894444 35.580263235511175, -82.65766363894815 35.58019323549263, -82.65754363895356 35.58002823544665, -82.65731463895861 35.5797472353659, -82.65730763895877 35.57973923536359, -82.65712863896115 35.579529235302445, -82.65710363896167 35.57949923529371, -82.65703963896301 35.579421235271326, -82.65697363896426 35.57934123524826, -82.65689963896581 35.57925123522231, -82.65681563896617 35.579158235194726, -82.65676463896455 35.57911323518033, -82.65674663896404 35.579097235175254, -82.6566786389587 35.57905823516028, -82.65657763894744 35.579022235142574, -82.65644363893163 35.57898023512031, -82.65640963892808 35.578966235113946, -82.65631063895498 35.57868423504636, -82.65618163896725 35.57846423498831, -82.65597963906401 35.57761623479472, -82.65597663908792 35.57745723476202, -82.65597263911978 35.57724523471842, -82.65601463918303 35.576879234648146, -82.65596763927212 35.57624823451476, -82.6559196392923 35.576065234472516, -82.65579963930162 35.57587423442131, -82.65584063935638 35.57556223436195, -82.65587863941475 35.575223234296786, -82.65587163942074 35.575177234286734, -82.65586363943045 35.575105234271135, -82.65581063944035 35.57498323424086, -82.65579463944015 35.57496723423596, -82.65572663943824 35.57490623421653, -82.65553563942332 35.57479623417459, -82.65530463940348 35.57467523412618, -82.65506463938512 35.57453523407304, -82.65421963931715 35.57406223389006, -82.653951639293 35.57392923383548, -82.65370063926527 35.57383823379117, -82.65352063924115 35.57380023376498, -82.65339163922386 35.573773233746245, -82.6533806392223 35.573771233744765, -82.65309063918102 35.57372623370584, -82.65295763916238 35.5737032336875, -82.65281763914281 35.57367923366824, -82.65252163910127 35.573629233627685, -82.65235163907937 35.573587233601685, -82.65231063907413 35.57357723359549, -82.6519846390406 35.57344223353457, -82.65174263901879 35.57332223348526, -82.6515296390039 35.5731882334362, -82.65134763899844 35.57302723338466, -82.65117263899978 35.57282923332633, -82.65115163899998 35.57280523331932, -82.65102263900688 35.57262023326836, -82.65089963901397 35.572441233219294, -82.65086563901586 35.57239223320587, -82.65078063902443 35.572244233166984, -82.65077263902586 35.57222623316249, -82.6507016390387 35.5720652331224, -82.65054363907608 35.571651233021775, -82.65051763907896 35.57160423300955, -82.6504816390835 35.57153623299205, -82.65045863908637 35.57149223298069, -82.65033863909083 35.57133323293602, -82.6503046390921 35.57128823292337, -82.65028863909201 35.57127123291824, -82.65018063909142 35.571158232884144, -82.6501636390914 35.571140232878726, -82.64976363908463 35.57075123275844, -82.64968263908492 35.57066123273186, -82.64958763908528 35.57055623270068, -82.64953763908895 35.57047823267962, -82.64950063909151 35.57042123266425, -82.64943563909867 35.5703042326338, -82.64942563910105 35.570278232627444, -82.64929463913559 35.56991123253917, -82.64918363914776 35.569712232487326, -82.64913063914584 35.56966723247263, -82.64907263914347 35.56961923245695, -82.64892763912688 35.56957023243208, -82.64892363913566 35.56950923241928, -82.6488626391441 35.56938823238833, -82.64838563914243 35.568882232236355, -82.64804763912066 35.56865823215612, -82.64796663911531 35.56860523213699, -82.64796163911498 35.56860223213585, -82.64743763909536 35.56816223199238, -82.64687263910432 35.56749223179799, -82.64654363909183 35.56721723170825, -82.64623363906993 35.56702423163712, -82.6460996390873 35.5667662315708, -82.64573663909783 35.566304231439446, -82.64572963910416 35.56625523142879, -82.64546063908237 35.566106231370824, -82.64501063906532 35.56573023124807, -82.6449096390615 35.56564523122038, -82.64412963905424 35.56484823097801, -82.64399763904193 35.564785230951685, -82.64392163903489 35.56474923093656, -82.64376063901571 35.56469923090983, -82.64355863899138 35.56463923087689, -82.64339063898464 35.564501230831546, -82.64315963899138 35.56420723074802, -82.6429406389976 35.56392923066889, -82.64242863899176 35.56341323051123, -82.64231463902178 35.563094230434594, -82.64231563906998 35.56278123037088, -82.6423286390949 35.56263323034209, -82.64230163909978 35.56257223032692, -82.64188563909381 35.56216023020027, -82.64171063910959 35.56186823012281, -82.64165663912335 35.56172023008718, -82.641632639139 35.56159223005864, -82.6414826392378 35.56078622987906, -82.64145763926929 35.56055422982924, -82.64144563928355 35.56044822980638, -82.64143463929686 35.560349229785125, -82.64141163932646 35.56013222973851, -82.64140063934074 35.56002722971601, -82.64138763935635 35.55991122969107, -82.6413756393719 35.55979722966659, -82.64133363938335 35.559677229637806, -82.64132163938658 35.55964322962963, -82.64131663938716 35.5596342296273, -82.64406663984143 35.55965322991306, -82.64418363985737 35.5596762299298, -82.6443276398833 35.55966322994192, -82.64483963997756 35.559604229982334, -82.64510764002785 35.55956623000208, -82.64563164012851 35.5594782300379, -82.64613964022911 35.559373230068566, -82.64664164033123 35.559252230095396, -82.64702264041031 35.55914923011342, -82.64734964047966 35.55905223012719, -82.64770364055602 35.55893823014029, -82.64819764066497 35.558763230155215, -82.6482936406866 35.5587262301575, -82.64837164070438 35.558695230159245, -82.64848364072975 35.558651230161715, -82.64912964087877 35.55838023017273, -82.65131564138647 35.55744123020545, -82.65199864154411 35.55715423021706, -82.65223064159645 35.55706423022244, -82.6526986416998 35.55689823023661, -82.653031641771 35.55679523024977, -82.65296164171349 35.55709423030348, -82.6529516417053 35.55713623031107, -82.65293264168929 35.55722023032618, -82.6529336416715 35.55733723035014, -82.65293964166186 35.55740623036484, -82.65294364165754 35.557439230371926, -82.65294664163866 35.5575652303979, -82.65293564162086 35.557669230417936, -82.65289664160213 35.557749230430275, -82.65280864157157 35.55785323044245, -82.65275864155534 35.55790423044776, -82.65263064151331 35.558039230462136, -82.65244564145316 35.55823123048226, -82.65243164144867 35.55824523048364, -82.65225264138859 35.55844223050545, -82.6518586412552 35.55888423055517, -82.65166864119065 35.559099230579456, -82.65154964115088 35.55922923059379, -82.65143864111374 35.55935123060725, -82.65118864103177 35.55961423063526, -82.65106764099203 35.559742230648894, -82.65114664100206 35.55976223066105, -82.65135164102814 35.5598142306927, -82.65138464103265 35.55982123069753, -82.65146564104329 35.55983923070945, -82.65169464107404 35.559887230742724, -82.65213064113573 35.55995723080168, -82.65234564116687 35.559987230829826, -82.65236064116928 35.55998823083155, -82.65272864122421 35.560029230877696, -82.65288364124874 35.560037230895134, -82.65301364127004 35.5600392309089, -82.65314564129262 35.560035230921606, -82.65327964131673 35.56002323093292, -82.65349964135912 35.55998523094773, -82.65365464138996 35.55995223095688, -82.65408864147749 35.559852230981, -82.65459764158125 35.55972823100792, -82.65489264163975 35.55966623102552, -82.65502164166483 35.559643231034094, -82.65503864166791 35.55964123103534, -82.65525764170746 35.55962123105374, -82.65544364173834 35.55962123107275, -82.6556056417638 35.55963123109142, -82.65594364181403 35.55967023113402, -82.6559796418192 35.559675231138726, -82.65609064183542 35.559690231153134, -82.6561276418408 35.559695231157946, -82.65642564188516 35.55972923119547, -82.65675664193436 35.559767231237124, -82.65686564195047 35.55978023125099, -82.65708864198476 35.559798231277504, -82.65725064201033 35.55980723129593, -82.65732364202216 35.559809231303795, -82.65744864204234 35.55981323131745, -82.65762464207164 35.559813231335475, -82.65778264209926 35.55980423134978, -82.65790964212137 35.559798231361675, -82.65825764218431 35.559765231390514, -82.65841664221294 35.55975123140405, -82.65851464223059 35.55974223141224, -82.65863764225246 35.55973323142302, -82.65873264226857 35.559731231432394, -82.6588106422811 35.55973423144093, -82.65882764228374 35.559735231442836, -82.65890964229565 35.55974623145352, -82.6589906423064 35.55976423146546, -82.65903664231237 35.55977523147248, -82.65918864232862 35.559834231500034, -82.65922364233194 35.55985023150692, -82.65929864233877 35.55988723152218, -82.65944964235246 35.55996123155268, -82.65957664236365 35.56002623157896, -82.66002364240272 35.56025623167166, -82.66032864242982 35.56041023173425, -82.6604096424372 35.56044923175051, -82.66069064246334 35.560584231806864, -82.66080064247423 35.56063223182792, -82.66080364247439 35.56063423182858, -82.66099964249686 35.56070023186215, -82.66114664251626 35.56073323188394, -82.66117264251973 35.56073923188783, -82.66126564253265 35.560755231900615, -82.661331642542 35.56076623190964, -82.66148664256546 35.56078123192852, -82.66173664260307 35.56080723195945, -82.66215264266685 35.560842232009286, -82.66237564270108 35.56086123203598, -82.66311064281372 35.560924232124165, -82.66345264286689 35.56094823216411, -82.66346464286877 35.560949232165555, -82.6637136429089 35.56095723219269, -82.66373464291271 35.560955232194424, -82.66381264292694 35.56094723220079, -82.66395064295418 35.560919232209216, -82.6640106429672 35.56089923221131, -82.66406664298073 35.56087223221157, -82.66416864300776 35.56080623220851, -82.66425964303411 35.56073323220302, -82.66431664305574 35.5606542321927, -82.66442164309777 35.56049423217087, -82.66450164312538 35.56040123216011, -82.66458064315 35.56032623215292, -82.66466364317212 35.56027223215047, -82.66476164319535 35.56022723215135, -82.66486464321778 35.56019223215477, -82.66493864323279 35.56017523215889, -82.6650376432514 35.560161232166166, -82.66604964343195 35.560081232253594, -82.66620664345906 35.56007523226845, -82.6663186434774 35.56007723228033, -82.66639764348879 35.56008823229067, -82.66643864349452 35.560095232296284, -82.66653164350636 35.56011923231072, -82.66661764351575 35.560151232326135, -82.66670564352381 35.56019423234384, -82.66680064352961 35.56025923236682, -82.66689064353419 35.56032723238984, -82.66699464353535 35.56043223242191, -82.66725364353607 35.56070823250471, -82.66749164353679 35.56096123258067, -82.66750464353684 35.560975232584894, -82.66765964353644 35.56114623263564, -82.66785564353725 35.561353232697925, -82.6682306435378 35.56175623281841, -82.66825364353723 35.561784232826504, -82.66849264353407 35.56206423290809, -82.66859864353086 35.562200232946665, -82.6687976435179 35.562500233028224, -82.6689516435053 35.56274923309469, -82.66908164349339 35.56296723315246, -82.66911664349023 35.56302623316814, -82.66939264346419 35.56349523329199, -82.66946864345695 35.56362423332602, -82.66959764344467 35.5638442333841, -82.66971264343414 35.56403723343526, -82.67001464340721 35.56454023356872, -82.67006464340427 35.56461323358867, -82.67015264339932 35.564741233623835, -82.67020064339931 35.56479323363931, -82.67025364340043 35.56484323365491, -82.67030764340433 35.56487623366717, -82.67035464340917 35.56489623367613, -82.67037764341183 35.56490323367992, -82.67045864342104 35.564931233693926, -82.67063664344768 35.56495123371619, -82.67073064346374 35.564948233725254, -82.67086164348738 35.56493623373622, -82.67100364351563 35.564906233744615, -82.67101464351768 35.5649042337454, -82.67121064355742 35.56485823375609, -82.67137764359121 35.564819233765235, -82.67187864369251 35.56470223379275, -82.67204564372628 35.5646632338019, -82.67229864377755 35.56460323381562, -82.67306064393144 35.56442723385781, -82.67331464398276 35.56436823387181, -82.6739356441088 35.56422023390531, -82.67412664414745 35.56417523391575, -82.67423064416846 35.564151233921486, -82.67435964419391 35.56412523392942, -82.67468364425692 35.564066233950555, -82.67488564429237 35.564054233968875, -82.67504464431774 35.56406123398662, -82.67520264434107 35.56408023400667, -82.67539264436594 35.56412423403511, -82.6756086443915 35.564192234071086, -82.67580264441159 35.56427123410706, -82.67596064442797 35.56433623413653, -82.67639664447405 35.5645082342162, -82.67643864447851 35.564525234223986, -82.67656664449179 35.56457723424775, -82.67660964449615 35.564595234255826, -82.67670664450635 35.564634234273676, -82.67699964453672 35.564754234328156, -82.67709764454688 35.564794234346344, -82.67736464457518 35.56489923439515, -82.67737064457586 35.56490123439615, -82.67763464460732 35.564982234439675, -82.67793364464625 35.56505323448482, -82.67818064468155 35.56509123451794, -82.6782296446892 35.5650942345235, -82.678465644726 35.56511023455098, -82.6785236447356 35.56511023455693)))",6544,37,021,002505,370210025051,2465,2465,144,2410,2305,30,9,4,0,62,55,1935,91,1844,1909,1832,24,9,4,0,40,26,1022,958,64
census_2010_blockgroups_view.fid--2dc29038_13ec899ba8f_-25eb,"MULTIPOLYGON (((-82.76727066284438 35.54341423921928, -82.76724466282558 35.543509239236045, -82.76761966279646 35.54410723939633, -82.76768066279178 35.54420423942234, -82.76778566278371 35.54437123946722, -82.76867166275368 35.54553123979455, -82.76944566276315 35.546312240033124, -82.76950866276388 35.54637624005261, -82.76971566271564 35.54691624018397, -82.76979066269142 35.54715624024059, -82.77015366257581 35.54830624051245, -82.77032166256429 35.54856424058224, -82.77081966252989 35.54933024078948, -82.77089866252825 35.54942724081741, -82.77098966252355 35.54955724085323, -82.77103966252601 35.549595240866054, -82.77109866251124 35.54975624090495, -82.77113066249187 35.54991724094108, -82.77111466246119 35.55010024097681, -82.77109066244489 35.55018024099074, -82.7710706624289 35.550263241005524, -82.77119666242726 35.55041124104862, -82.77152366244057 35.55068024113703, -82.77154866244287 35.55069224114202, -82.77175366246219 35.5507892411828, -82.77191466246495 35.55094624123123, -82.77196566246147 35.55102424125237, -82.7719976624542 35.55110624127243, -82.77204566246262 35.55110424127693, -82.77209966246578 35.55114224129018, -82.77212666246129 35.55120124130495, -82.77210466245144 35.55124124131091, -82.77213166244647 35.551303241326295, -82.77218566244946 35.55134224133986, -82.77221166244803 35.551380241350216, -82.77229366244329 35.551500241383074, -82.77242566245363 35.55157624141213, -82.7725386624325 35.55183724147695, -82.7726276624046 35.552116241543, -82.77265966238531 35.55227724157913, -82.77268566238364 35.55231624158975, -82.77275466238416 35.55238824161148, -82.7730276623987 35.55259024168067, -82.77309666239823 35.552668241703614, -82.77350066244612 35.5527952417709, -82.77352566244531 35.552828241780134, -82.77373166244797 35.55303524184351, -82.77383766245987 35.55307224186189, -82.77396466247244 35.55312824188632, -82.77402266246375 35.553248241916734, -82.77430566249352 35.55336224196892, -82.7743066624906 35.55338224197314, -82.7749716625834 35.55350024206525, -82.77509566260471 35.55349624207715, -82.77542966264622 35.553589242130265, -82.77545666265392 35.553568242128755, -82.77610366270908 35.55391224226514, -82.77636566272311 35.55410624233149, -82.77668666272831 35.55442124242869, -82.77698166271718 35.55481524253921, -82.77711866271274 35.55499324258959, -82.77729866273444 35.55504724261906, -82.77749266270828 35.55542924271679, -82.77757066271562 35.55546624273235, -82.777653662708 35.55560624276941, -82.77771066269 35.55578624281195, -82.7776376626652 35.555868242821276, -82.77731266259678 35.555961242806966, -82.77694566249981 35.55619424281694, -82.77664866242392 35.5563662428217, -82.77655266239236 35.55646824283271, -82.77650866238146 35.556491242832884, -82.77640366235421 35.55655524283515, -82.77604966226482 35.556753242839335, -82.77596066224412 35.55679124283803, -82.77581366220016 35.55691824284887, -82.77567466213313 35.55720424289299, -82.7756596620995 35.55740724293289, -82.77558966206884 35.55753124295106, -82.77561466206703 35.55757024296157, -82.77554466203362 35.557712242983385, -82.77541366199202 35.557841242996304, -82.77537566198241 35.5578622429967, -82.77527866195346 35.55794524300371, -82.77491566184463 35.55826124303101, -82.77484166182577 35.55830324303203, -82.7746496617516 35.55857824306854, -82.77437366166197 35.55886324309849, -82.7742976615898 35.559251243169825, -82.77404366148517 35.55965724322671, -82.77377566141969 35.559793243227034, -82.77361666136817 35.55995624324399, -82.77335966127531 35.56028224328427, -82.77318966118281 35.56070124335238, -82.77300766106535 35.56126924344965, -82.77294166099173 35.56167824352635, -82.77271066089091 35.562084243585595, -82.77265166082864 35.562426243649334, -82.77166866050824 35.56344724375703, -82.77089366029493 35.563995243789556, -82.77086466028553 35.5640252437927, -82.77054166019285 35.56427824381124, -82.77020966009707 35.56454224383118, -82.7700646600498 35.56469224384696, -82.76995966001469 35.56480724385972, -82.76976965997213 35.5648782438547, -82.76969565992887 35.56508024388834, -82.76956365987567 35.56528324391625, -82.76940265983141 35.565397243923016, -82.76908165974581 35.56560624393284, -82.76845765959757 35.56589424392776, -82.76834765957882 35.56589724391707, -82.76823765954647 35.5659882439244, -82.76806265949716 35.5661192439332, -82.76775565941611 35.56631424394159, -82.76731965931731 35.566484243931605, -82.76715665927607 35.56657624393374, -82.76677465918833 35.56673324392669, -82.76671365917386 35.56676124392613, -82.76666665913751 35.566947243959284, -82.76654765910308 35.56704224396654, -82.7661216589759 35.567408243997576, -82.76597865893595 35.56751324400437, -82.76591465891623 35.56757224400981, -82.76471565855924 35.568596244096035, -82.76111665754273 35.57131124428156, -82.75965465715738 35.572234244320256, -82.7575466566013 35.57356824437658, -82.75423165580871 35.57513224435622, -82.75074865507682 35.576117244200525, -82.74984165489225 35.57633524415215, -82.74879565463866 35.57685124415029, -82.74873765462826 35.57685624414536, -82.74836965455209 35.57695224412726, -82.74737765435725 35.577144244064854, -82.7467056542109 35.57736824404174, -82.746273654107 35.57757624403986, -82.74547365392932 35.577864244016695, -82.74534065389416 35.57794924402043, -82.74313265343818 35.578522243911216, -82.74168065300069 35.57979624402233, -82.74093465269368 35.58098624418869, -82.73989465229849 35.582431244376956, -82.73968765214825 35.58318524450963, -82.73938365192639 35.584300244705915, -82.7388536517076 35.585150244824966, -82.73802965141375 35.58616924494851, -82.7372836511719 35.5869342450281, -82.73592865082865 35.5876992450453, -82.73488865065522 35.58769924493876, -82.73426065053759 35.5877842448917, -82.73413565050885 35.58783524488932, -82.73321365029761 35.588210244871306, -82.73184764997839 35.58880624485294, -82.73138264986822 35.58901924484875, -82.72943364940608 35.589913244831415, -82.72670464882054 35.59076424472538, -82.72407564829078 35.591361244577676, -82.72279964804626 35.59156824448915, -82.7219786478889 35.591702244432334, -82.7200946474467 35.59253724440951, -82.71999064742778 35.592547244400905, -82.71998664743145 35.59251924439482, -82.71994964743406 35.59246224437943, -82.71965264741432 35.5922682443094, -82.71944864740908 35.59208124425035, -82.71935964740027 35.592042244233234, -82.71899564734639 35.59199824418697, -82.71845264727212 35.59189224410971, -82.71830764725493 35.59184724408563, -82.71823964725469 35.59177524406402, -82.71819764726825 35.591641244032346, -82.71820064730726 35.591390243981536, -82.71808364735723 35.59093824387732, -82.71806664737917 35.590777243842744, -82.718104647411 35.59061124381275, -82.71823164747867 35.59030824376397, -82.71827364750052 35.59021124374852, -82.71829864752391 35.59008624372556, -82.71827264753401 35.589992243703726, -82.71816964753972 35.58984324366278, -82.71802464754143 35.58967524361366, -82.71789864753868 35.58955624357653, -82.71775264752542 35.589484243546835, -82.71742264749011 35.589356243486925, -82.7171776474554 35.58931624345365, -82.71692064741548 35.58929724342349, -82.71643564733917 35.589268243367854, -82.71602364727596 35.589233243318446, -82.71569864722701 35.589199243278195, -82.71542164718436 35.58917624324518, -82.7152146471496 35.58917824322435, -82.71501064710387 35.58925424321895, -82.71478264704788 35.5893712432195, -82.71465264701533 35.589442243220596, -82.71447264697014 35.58954124322229, -82.71421864690376 35.58969824322831, -82.71404964684747 35.589881243248286, -82.71398664681078 35.59005224327674, -82.71394764673124 35.59052724336957, -82.71387164668141 35.59076924341112, -82.71376964662497 35.59102624345309, -82.71366964655914 35.591346243508134, -82.71356464650623 35.59157624354425, -82.71348764647674 35.5916852435586, -82.71295464630154 35.592247243618566, -82.71278464625154 35.59238824362997, -82.71255964619614 35.59250524363066, -82.71228464613849 35.59258224361825, -82.7120656461009 35.59258924359719, -82.71176664605895 35.59253824355616, -82.7115076460273 35.592463243514324, -82.71084164595842 35.59218924339015, -82.71047164591035 35.59210124333429, -82.71027964588036 35.592088243312, -82.71014164585876 35.59207924329601, -82.70971764579737 35.592019243240294, -82.70859864566694 35.59165424305121, -82.7084536456559 35.59156924301894, -82.7083236456514 35.59145724298277, -82.70822464565457 35.591329242946564, -82.70817264567205 35.591159242906535, -82.7081916456961 35.59102324288074, -82.7083526457918 35.590575242805905, -82.70838464582609 35.5903862427707, -82.7083766458554 35.590187242729286, -82.70836264586627 35.5901012427103, -82.70835764586991 35.59007224270386, -82.70832064588103 35.58995924267701, -82.70824764588521 35.58985324264787, -82.70813364588084 35.58975824261687, -82.70798664587008 35.589668242583414, -82.70771964585055 35.589506242523086, -82.70750964583758 35.58936324247232, -82.70736764583118 35.58925024243472, -82.70726964583426 35.58912424239898, -82.70720364584413 35.58898824236446, -82.70716564585685 35.588864242335305, -82.707134645878 35.588693242297275, -82.70708164592044 35.588359242223724, -82.70706464593133 35.58827024220386, -82.70695864600383 35.58768324207325, -82.70692164602302 35.58751824203578, -82.7068696460454 35.5873162419893, -82.70681964606467 35.58713624194748, -82.70680064607178 35.58706924193192, -82.70671464610494 35.58676024186006, -82.70668864612246 35.586618241828475, -82.70668164614374 35.58647224179793, -82.70670264617128 35.58631524176811, -82.7067336462044 35.58613324173416, -82.70682364629086 35.58566824164852, -82.70684964632872 35.58545024160675, -82.70686964637088 35.58519724155718, -82.70688664640419 35.584998241518385, -82.70694564647998 35.584569241436945, -82.70695264648832 35.58452224142803, -82.70701464655657 35.58414524135753, -82.70710164666562 35.58352924124086, -82.70712464669211 35.58338224121324, -82.70714864671803 35.58323924118659, -82.707219646783 35.58289324112327, -82.70725364680591 35.582781241103895, -82.7073016468295 35.58267924108801, -82.70735464685082 35.582598241076944, -82.70744764688487 35.582477241061795, -82.70760164693337 35.58232824104723, -82.70774264697566 35.582206241036765, -82.70801464705039 35.58201424102545, -82.7081666470893 35.58192624102309, -82.70836364713514 35.58184124102594, -82.7085906471834 35.58177324103534, -82.70884864723413 35.581722241051466, -82.70914764729119 35.58167524107251, -82.70983964741909 35.581593241126676, -82.71010964746876 35.58156224114799, -82.71023064749383 35.58153024115393, -82.71034264752018 35.58148024115519, -82.7104466475519 35.58138624114669, -82.71051564758208 35.581265241129024, -82.71058264761713 35.58110924110413, -82.71060964763545 35.58101924108851, -82.71063064764965 35.58094924107638, -82.71063864766087 35.580885241064216, -82.71063964766307 35.580872241061655, -82.71064464766998 35.58083224105398, -82.7106466476722 35.580820241051754, -82.7106516476795 35.58077824104365, -82.7106396477051 35.58059824100571, -82.71059364773997 35.58032124094459, -82.71057964774762 35.580256240929884, -82.71054164776973 35.580071240888266, -82.71033764786034 35.57925924070174, -82.7103066478747 35.57913224067268, -82.71016064793224 35.57859924054901, -82.71001064799157 35.57805024042172, -82.70993164802138 35.577770240356536, -82.70987364804989 35.57752124029975, -82.70981864807794 35.577279240244835, -82.70977964811719 35.57698124017999, -82.7097676481304 35.57688224015863, -82.70967664826678 35.57589523994798, -82.7096266483418 35.57535223983221, -82.70961964835362 35.57526723981409, -82.70960864836229 35.57519923979914, -82.70959964837603 35.57510023977799, -82.70956864839003 35.574975239749364, -82.70952564839808 35.57487623972479, -82.70948564840091 35.574814239708004, -82.70945964840288 35.57477323969698, -82.70938264840338 35.57468623967133, -82.70919064839768 35.57451523961679, -82.7091236483966 35.57444923959649, -82.70907864839869 35.57438723957928, -82.70904864840492 35.57431423956132, -82.70903864841247 35.57425423954803, -82.70903264842367 35.57417423953106, -82.70903964843801 35.57408823951426, -82.70906364845547 35.574001239498934, -82.70910964847668 35.57391223948553, -82.70918364850368 35.57381723947373, -82.70926364852741 35.57374923946811, -82.70935964855258 35.57368923946574, -82.70948164858058 35.57363923946802, -82.7096046486064 35.573604239473454, -82.70965364861668 35.573591239475796, -82.70999664868583 35.57351223949487, -82.71014864871887 35.57346223950028, -82.71017464872497 35.57345023950053, -82.71024564874119 35.57342223950206, -82.71025464874364 35.57341623950169, -82.71028064875026 35.57340123950133, -82.71033264876394 35.573368239499914, -82.71033564876454 35.573367239500065, -82.71037164877518 35.57333723949756, -82.71041164878665 35.573306239495345, -82.71043564879497 35.57327823949211, -82.71046264880393 35.57324823948876, -82.71046464880514 35.573243239487994, -82.71049264881701 35.5731962394813, -82.7104946488182 35.573190239480226, -82.71050564882484 35.573159239475096, -82.71051364882939 35.573138239471575, -82.71051764883937 35.57307723945957, -82.71051364884104 35.57306223945609, -82.71050664884466 35.57303123944906, -82.7105036488463 35.57301723944585, -82.71045964885143 35.57293623942489, -82.71030764885958 35.57271823936487, -82.7102756488613 35.57267223935215, -82.71019464886663 35.57254923931881, -82.71013264887466 35.572430239288195, -82.71007064888742 35.57227923925098, -82.70991064894277 35.571745239125725, -82.70989264894808 35.57169123911286, -82.7097766489828 35.571339239029214, -82.70999864900789 35.571416239067695, -82.71020464903397 35.57147023909983, -82.7111956491591 35.571730239254336, -82.71150964920214 35.57179023929871, -82.71161964921714 35.571812239314504, -82.71178064924393 35.57181223933095, -82.71186864926291 35.57178423933428, -82.71193564928177 35.571734239330965, -82.71213764933887 35.5715812393205, -82.71225864936751 35.57152623932162, -82.71235264938822 35.57149323932453, -82.71260164942798 35.571504239352315, -82.7127686494493 35.571546239378, -82.71277664945036 35.57154823937917, -82.71339464951028 35.57182823949961, -82.71365764952716 35.57200423956248, -82.71403364953497 35.572361239673775, -82.71417564953255 35.57253123972295, -82.71452564955462 35.57276723980691, -82.71496064957319 35.573118239923126, -82.71520464958347 35.5733162399885, -82.71558864960522 35.57359124008394, -82.71569564961396 35.573650240106865, -82.71579264962195 35.5737032401277, -82.71608364964563 35.57386524019053, -82.71618064965347 35.573919240211474, -82.71657764968565 35.574140240297154, -82.71672264969895 35.57421124032654, -82.71680364970628 35.57425124034294, -82.71701464972551 35.57435524038577, -82.71736464976614 35.574470240445095, -82.71767364981004 35.57451924048678, -82.71793664983959 35.57461224053266, -82.71866964989853 35.5750242406918, -82.71873964990328 35.57506924070817, -82.7193336499433 35.57545324084729, -82.71937564994609 35.57548024085718, -82.71956564996424 35.5755682408945, -82.7201096500161 35.575821241001805, -82.7202666500285 35.57591024103615, -82.72049265004622 35.57604024108578, -82.72064765008392 35.575963241085915, -82.72076165011977 35.57585324107519, -82.72090965018404 35.57559524103769, -82.72096865022885 35.57536724099727, -82.72096965022943 35.575364240996784, -82.72101065024718 35.57529324098651, -82.72121165029759 35.57518324098465, -82.72179665043222 35.574941240995244, -82.72235465055559 35.574743241012015, -82.72316865074517 35.57439124102356, -82.72332665077921 35.57434124102963, -82.72345165080586 35.57430324103462, -82.72407765096888 35.57392024102067, -82.72414365098622 35.57387924101911, -82.72433865104146 35.57373124100886, -82.72439665106256 35.573656240999526, -82.72447365108995 35.57356124098802, -82.72472865120507 35.573088240917606, -82.72496065132715 35.57254424083048, -82.72502465136058 35.57239624080688, -82.72506465140604 35.57214324075932, -82.72556565160936 35.571362240651354, -82.72706865221915 35.56902024032763, -82.72757065242246 35.568240240219986, -82.72821665265333 35.567437240122395, -82.7284246527274 35.567180240091254, -82.72884065290135 35.56649823999471, -82.7292446530588 35.56591023991617, -82.72959365318113 35.5654922398667, -82.72971465323498 35.565272239834236, -82.72978865329779 35.5649432397747, -82.72986365332412 35.564853239764, -82.73001665337723 35.564673239743, -82.73007065340383 35.56455823972503, -82.73024465351044 35.56405223963968, -82.73030565353751 35.56394223962348, -82.73031165353908 35.56393823962323, -82.73133965398152 35.5621702393679, -82.73143665402303 35.56200523934418, -82.73152065407982 35.56172623929592, -82.73158765409683 35.56168823929502, -82.73158965409736 35.56168623929481, -82.73161165410279 35.561675239294786, -82.73176865412795 35.5616812393121, -82.73182265413993 35.561662239313755, -82.73189865415655 35.56163623931621, -82.73189865416504 35.56158123930501, -82.73189865418385 35.561458239279936, -82.73189465418966 35.56141623927097, -82.73189165419745 35.561362239259594, -82.73188565420982 35.56127523924127, -82.73182665424659 35.560971239173234, -82.73167465429529 35.5604882390592, -82.73154665433121 35.56011523896993, -82.73141165437907 35.55965623886251, -82.73120165445448 35.55893623869413, -82.7311746544644 35.55884223867223, -82.7307756545892 35.55759523837707, -82.73072365460779 35.557417238335404, -82.73065665464111 35.557127238269445, -82.73064065464425 35.55708923826003, -82.73059565466552 35.556901238217094, -82.73056165469549 35.55666923816625, -82.73054265477158 35.55615223805884, -82.73054465481975 35.55584023799545, -82.73053465484416 35.55567023795974, -82.73049465486817 35.55547023791483, -82.73043865487942 35.55533623788177, -82.73037265488819 35.55520723784874, -82.73018365490313 35.55490423776761, -82.73007465490687 35.55476123772729, -82.72996565491208 35.554609237685085, -82.72972265492386 35.55426823759071, -82.72912565495407 35.55342223735702, -82.72893465496165 35.55316523728508, -82.72939065507566 35.55291723728117, -82.73004365523872 35.5525632372758, -82.73039165532681 35.552366237271215, -82.73041565533266 35.55235423727124, -82.73050365535428 35.552309237271125, -82.73064865538731 35.552251237274085, -82.73076265541104 35.55222023727944, -82.7307756554137 35.552217237280196, -82.73092565544208 35.55219523729108, -82.73129265550655 35.55217323732409, -82.73144565553463 35.5521562373363, -82.73158865556312 35.55212523734462, -82.73162465557094 35.552114237346075, -82.73171465558983 35.55208823735003, -82.73186165562258 35.55203423735398, -82.7322876557226 35.55184523735914, -82.73255865578722 35.55171823736096, -82.7326646558124 35.55166923736181, -82.73277365584036 35.551605237359894, -82.7328526558616 35.55155223735714, -82.73292765588641 35.551472237348506, -82.73298665590882 35.55139023733785, -82.73299965591357 35.55137323733569, -82.73306665594343 35.55125123731771, -82.73320165601314 35.55094323726865, -82.73323965603466 35.55084423725238, -82.7336276561181 35.550721237267034, -82.73412365622251 35.550579237288886, -82.73438165627623 35.55050923730102, -82.73472265634602 35.55042423731852, -82.73475265635234 35.55041623731994, -82.735111656425 35.550332237339546, -82.73538165647905 35.5502732373552, -82.73587165657585 35.550174237385164, -82.73651665670018 35.55006423742876, -82.73715165682 35.54997223747497, -82.73894265715165 35.549755237614065, -82.73931365722088 35.549707237642245, -82.73959065727334 35.549666237662244, -82.7399536573436 35.54960223768631, -82.74009765737233 35.54957123769477, -82.7404756574493 35.54948023771485, -82.74084965752876 35.54936823773029, -82.74107365757786 35.54929123773749, -82.74131665763282 35.549197237743236, -82.74153765768415 35.54910223774648, -82.74176165773771 35.54899623774777, -82.74209565782033 35.548820237746106, -82.74232065787837 35.54868623774172, -82.74253765793615 35.548545237735205, -82.74259465795186 35.548504237732665, -82.743043658085 35.54812423770108, -82.74374865829405 35.547526237651276, -82.74382665831719 35.54746023764581, -82.74569865890388 35.54566723747164, -82.74690865928548 35.54449223735577, -82.74749565947036 35.54392423729998, -82.74775265954682 35.54370423728145, -82.7481926596695 35.543382237260744, -82.7485506597613 35.543172237254545, -82.74888565983521 35.54305423726477, -82.74912365988763 35.5429712372722, -82.7517376604105 35.5424012374234, -82.75279766062197 35.54217423748552, -82.75308866067677 35.54213323750697, -82.75673566136635 35.54159923777114, -82.75680966137435 35.54162723778444, -82.75792266158382 35.54147123786651, -82.75943166187024 35.54124323797434, -82.7608806621426 35.54104123808137, -82.7613326622276 35.54097823811477, -82.7621696623849 35.54086223817673, -82.76255866245675 35.540816238207185, -82.7629476625275 35.5407782382392, -82.76333166259654 35.54074523827175, -82.76371766266479 35.5407192383059, -82.76438066278014 35.54068823836741, -82.76463566282331 35.540683238392475, -82.7654076629522 35.540682238471284, -82.76580766301768 35.54069023851385, -82.76599066304685 35.54069923853433, -82.76599966304471 35.540722238539956, -82.76603166303282 35.54083523856631, -82.76612166299975 35.54114923863959, -82.76654266304854 35.54128923871115, -82.7667866630766 35.54137123875293, -82.76696766309762 35.54143123878368, -82.76710366308801 35.5416422388406, -82.76717166308303 35.54174823886919, -82.76756766305458 35.54236523903562, -82.76743966296446 35.542814239114136, -82.76743066295762 35.54284923912033, -82.76733466288911 35.54319223918049, -82.76732066287934 35.54324023918895, -82.76730966287232 35.54327423919473, -82.76728066285142 35.543379239213145, -82.76727066284438 35.54341423921928)))",6576,37,021,002504,370210025042,1901,1901,54,1863,1808,24,7,9,1,14,38,1401,29,1372,1385,1352,14,5,6,1,7,16,805,738,67
census_2010_blockgroups_view.fid--2dc29038_13ec899ba8f_-25ea,"MULTIPOLYGON (((-82.51866862437394 35.524808209959076, -82.51864562436047 35.524871209969575, -82.51858062432049 35.52506121000153, -82.51855862430703 35.525125210012305, -82.5184866242636 35.525330210046604, -82.51827362413376 35.525946210149975, -82.51820262409038 35.526152210184634, -82.51818962408268 35.526188210190625, -82.51815162405947 35.52629821020913, -82.5181396240518 35.5263352102154, -82.51811362403633 35.52640821022763, -82.51803662398963 35.52662921026464, -82.51801162397413 35.52670321027719, -82.51795362393905 35.526869210304916, -82.51794962393635 35.52688221030715, -82.51788762389147 35.52710721034655, -82.517836623845 35.52735521039177, -82.51783462384068 35.52738121039683, -82.51782362381182 35.52755721043153, -82.51781362378814 35.527700210459585, -82.51781062377678 35.52777121047379, -82.51779862371511 35.52816021055168, -82.51779562367527 35.528416210603424, -82.5177936236419 35.528631210646935, -82.51779262363641 35.52866621065394, -82.51779262363148 35.52869821066042, -82.51779462362065 35.52877121067552, -82.5177966236155 35.5288062106828, -82.5178006235974 35.528928210708024, -82.51780262359387 35.52895421071353, -82.51782362356029 35.529195210764684, -82.51785362353455 35.529395210808495, -82.51785662353247 35.52941221081229, -82.51788462351725 35.529541210841316, -82.51789262351231 35.52958221085055, -82.51791062350274 35.52966421086904, -82.51792162349795 35.52970721087895, -82.51793362349345 35.52974921088872, -82.51803362345306 35.53012021097445, -82.51833362333156 35.53123521123208, -82.51843462329118 35.531607211318054, -82.51846562327889 35.5317202113442, -82.51855862324213 35.532060211422966, -82.51858962322981 35.53217421144926, -82.51860362322378 35.53222821146172, -82.51864862320595 35.53239321149994, -82.51865062320549 35.532398211501125, -82.51866362319997 35.53244821151265, -82.51866862319773 35.532468211517184, -82.51872962317115 35.532707211572074, -82.51882062313402 35.53304721165061, -82.51930562293833 35.53484421206584, -82.51946762287311 35.535444212204524, -82.51959562281816 35.535940212318586, -82.51992462267664 35.537216212611966, -82.51997662265218 35.53743121266102, -82.52006562261064 35.53779821274489, -82.52009362259484 35.53793121277474, -82.52012462257656 35.53808321280881, -82.52015662255702 35.53824521284504, -82.52034362244319 35.53918821305607, -82.52040662240515 35.539503213126636, -82.52042962239054 35.5396232131534, -82.52050162234718 35.539983213234045, -82.52052562233276 35.54010321326091, -82.52056262231255 35.54027421329948, -82.52057062230813 35.540312213307985, -82.52071462223559 35.54093921345033, -82.52076262221155 35.54114821349776, -82.52081862218432 35.54138521355175, -82.52082262218153 35.54140821355683, -82.52091262213159 35.541830213652005, -82.521000622091 35.542189213733955, -82.52106562206184 35.54244921379354, -82.52108262205417 35.54251721380915, -82.52109062205122 35.54254521381566, -82.52115262202861 35.54275921386549, -82.52117562202106 35.542833213882965, -82.52120662201138 35.542929213905644, -82.52127462198939 35.54314621395677, -82.52136362196153 35.5434232140223, -82.521482621926 35.54378321410774, -82.52148562192447 35.5437962141107, -82.52155262190203 35.54401421416192, -82.52158862189037 35.54412921418896, -82.52164962187145 35.544318214233705, -82.5216986218551 35.544477214271026, -82.5217356218433 35.54459421429864, -82.5217876218262 35.54476121433793, -82.52185062179755 35.545016214396284, -82.52185962179396 35.54504921440393, -82.52190862176394 35.54529721445939, -82.5219486217314 35.54555221451544, -82.52195262169322 35.54580521456734, -82.52193962165427 35.54604421461455, -82.52189862161569 35.546251214652486, -82.52187962160285 35.54631421466334, -82.52180262154886 35.54658221470994, -82.52174862151693 35.54673221473498, -82.52172062150045 35.54680921474781, -82.52166962146968 35.54695421477197, -82.52163662145092 35.54704021478611, -82.52160762143433 35.54711721479877, -82.52156762141205 35.5472192148154, -82.52145062134501 35.54752921486644, -82.52141162132267 35.547632214883464, -82.5213286212751 35.54785221491965, -82.52128462124938 35.54797221493959, -82.52094762105123 35.548898215093324, -82.52090762102968 35.548995215109024, -82.52080762097431 35.54924721514996, -82.52077762095598 35.54933421516455, -82.5202836208452 35.549522215152116, -82.52026362084037 35.54953221515211, -82.51993362075702 35.54971821515606, -82.51950762063446 35.550056215181144, -82.51898162046932 35.55056321523025, -82.51858562034482 35.55094621526749, -82.5182916202504 35.5512432152977, -82.51828262024732 35.551253215298836, -82.51824062023412 35.5512942153028, -82.51808862018589 35.55144421531774, -82.5179156201266 35.55164321534045, -82.51776662006665 35.55187221537177, -82.51768662001929 35.55209421540867, -82.51763961998229 35.55228421544254, -82.51761761996428 35.552377215459224, -82.51759961991185 35.55269921552289, -82.51757061984416 35.55310821560304, -82.51755061978658 35.55346121567279, -82.51754661977341 35.553542215688935, -82.51752161967276 35.55417021581408, -82.51751561962918 35.55444721586981, -82.51752161961826 35.55452421588607, -82.51756261954435 35.55504921599715, -82.51757961943959 35.55574921614119, -82.51759761933494 35.55644921628546, -82.51759961932544 35.55651321629871, -82.51712361924524 35.556521216251454, -82.51634761911463 35.556534216174434, -82.51512461890844 35.556556216053316, -82.51484061886097 35.55655921602474, -82.51391461870499 35.55657521593297, -82.51316861857879 35.556591215859626, -82.51259561848248 35.55660021580258, -82.51143761828726 35.556621215687926, -82.51134461827154 35.55662321567882, -82.5111096182319 35.556627215655446, -82.51040661811358 35.55663921558572, -82.51017261807402 35.5566442155628, -82.50894361786706 35.55666521544076, -82.5086716178212 35.55667021541388, -82.50828061775408 35.55668521537675, -82.50800261770509 35.556704215352106, -82.5074796176093 35.556763215310355, -82.50722161756083 35.55680021529141, -82.5069356175056 35.55685121527242, -82.50655061742873 35.556936215250175, -82.50632961738349 35.556992215238864, -82.50593061729933 35.55710921522164, -82.50568261724518 35.55719421521347, -82.50533861716879 35.557320215203795, -82.50532761716617 35.55732521520368, -82.50508961711134 35.557425215199544, -82.50471761702273 35.55760021519697, -82.5043706169374 35.557781215198176, -82.50423661690294 35.5578612152007, -82.5040596168572 35.55796721520403, -82.50375461677655 35.55816321521258, -82.5037436167736 35.558170215212876, -82.50353661671637 35.55831921522188, -82.5031526166063 35.55862121524387, -82.50280761650025 35.55893921527317, -82.50270361646793 35.559037215282444, -82.50252861641091 35.55921921530145, -82.50243861638018 35.55932221531318, -82.50229361633 35.559492215332874, -82.50216961628604 35.55964421535102, -82.50207461625014 35.55977521536788, -82.50202061623001 35.55984821537723, -82.50194461620124 35.55995321539081, -82.50189261617894 35.56004221540349, -82.50186961616998 35.560075215407814, -82.50181861614995 35.5601502154179, -82.50162561607185 35.560450215459056, -82.50131261594252 35.560954215529414, -82.50112561586508 35.56125621557163, -82.5005776156407 35.56212421569189, -82.50045961559093 35.5623202157197, -82.50019961548482 35.56273021577634, -82.49979961532014 35.56336921586523, -82.49929761511284 35.56417621597775, -82.49924661509208 35.564256215988806, -82.49915261505305 35.56440821601007, -82.49909461502943 35.56449921602259, -82.49904461500867 35.56458021603395, -82.49896061499989 35.564547216018624, -82.49870961497352 35.564448215972654, -82.49862661496473 35.56441621595765, -82.49834061493463 35.56430321590532, -82.49825961492603 35.56427221589067, -82.49747661483995 35.56398721575228, -82.49746361483854 35.563983215750106, -82.49719061480965 35.563877215700536, -82.49705761479574 35.56382421567613, -82.4966586147537 35.563667215603125, -82.49652661473989 35.563615215578984, -82.49614961470029 35.56346621551, -82.49613361469856 35.56346021550716, -82.4951866145965 35.56310321533717, -82.49500961457647 35.563043215306855, -82.49462661453299 35.56291321524108, -82.49458961452981 35.5628942152334, -82.49435561450528 35.562801215190476, -82.49353961441993 35.56247721504077, -82.49326861439154 35.56237021499111, -82.49336361441672 35.56230821498829, -82.49356161446912 35.562181214982786, -82.4936456144926 35.562119214978814, -82.49373761451793 35.56205321497479, -82.49399061459128 35.56184921495935, -82.49407561461743 35.56177121495222, -82.49448661473747 35.561433214925714, -82.4948056148484 35.56105621488177, -82.49495861490882 35.56082821485118, -82.49517461499381 35.56050821480829, -82.49552461520287 35.55952621464451, -82.4956136152702 35.55918421458406, -82.49567161535984 35.55866421448433, -82.49576161546507 35.5580772143741, -82.49579361552124 35.557746214310136, -82.49592661564407 35.55709121419053, -82.4960016157597 35.556420214061816, -82.49609461587387 35.555778213940805, -82.49609961587944 35.55574721393495, -82.49618561600005 35.55505621380327, -82.49631561613377 35.55432621366817, -82.49637161618388 35.55406121362004, -82.49641161621969 35.553871213585474, -82.49667461635143 35.55329821349601, -82.49696561647498 35.55280821342623, -82.49729061658807 35.552423213381296, -82.49731661659693 35.552393213377904, -82.49763061672438 35.55190321331044, -82.49791561686564 35.55129121321528, -82.49798761695048 35.550817213126265, -82.49802061704303 35.55025121301456, -82.49794961720345 35.549131212779436, -82.49795361731293 35.54842321263588, -82.49792861739854 35.54783921251453, -82.49798861748121 35.547366212424585, -82.49821861758043 35.54696921236744, -82.49826761760134 35.54688621235557, -82.49865261773328 35.54644221230477, -82.49924761793318 35.54578321223182, -82.49943161800508 35.54551421219601, -82.49956561808442 35.54514221213412, -82.49956961815316 35.544699212044485, -82.49937061821211 35.5441012119024, -82.49902061825111 35.543470211738175, -82.49868861827007 35.54298921160625, -82.49843261831498 35.54242121146447, -82.4983226183614 35.5420002113675, -82.49830161843327 35.54151021126571, -82.49843561851245 35.54113921120403, -82.49868361861562 35.54073521114735, -82.49894261869026 35.54052921113203, -82.49905161872161 35.540442211125566, -82.49946361884251 35.54010021109823, -82.50008361899583 35.539771211095015, -82.5005776191291 35.539436211077636, -82.50095361924673 35.53907621104303, -82.50131561937502 35.53863221098988, -82.50195561958384 35.537963210919465, -82.50257261974829 35.537558210900436, -82.50329361992887 35.53716021089352, -82.50331161993391 35.53714721089274, -82.50378762005934 35.53684421087993, -82.50416462017557 35.53649421084747, -82.50445262030719 35.53594821076601, -82.50470162050975 35.53489821057799, -82.50474562054534 35.534714210545154, -82.50498362064431 35.53432621049059, -82.50505862067541 35.53420521047372, -82.50544462080337 35.53378821042851, -82.50606062096892 35.53337521040771, -82.5064816210734 35.533149210405035, -82.5066016211031 35.53308521040432, -82.50703762121526 35.532825210396176, -82.50716462124801 35.532749210393696, -82.50769362138007 35.532460210389274, -82.50790762143546 35.5323302103848, -82.50830162153716 35.53209321037703, -82.50881562168107 35.53171121035206, -82.50909562179685 35.531259210288916, -82.50928562188989 35.530858210226846, -82.50938062197852 35.53038421014015, -82.50948262206188 35.52995121006259, -82.50949762207372 35.52989021005166, -82.50977862218821 35.52944820999063, -82.51005962228159 35.5291432099574, -82.51019762232754 35.52899320994107, -82.51066762245677 35.52865820992118, -82.51067762245985 35.52864920992037, -82.51179562277477 35.52780520986349, -82.51215262291647 35.52726720979071, -82.51229862298737 35.526963209743776, -82.512438623055 35.5266742096994, -82.51266562315627 35.52625920963823, -82.51271662317902 35.526166209624556, -82.51298262326337 35.52590420959862, -82.51300362326944 35.52588720959728, -82.51330662335326 35.52566820958387, -82.51381262348288 35.525370209575165, -82.51427762358806 35.52518720958558, -82.51433662359794 35.5251862095915, -82.51484362368195 35.525186209643486, -82.51532762376233 35.525185209692985, -82.5156156238098 35.52518720972288, -82.5160546238818 35.52519220976898, -82.5167346239974 35.525173209834946, -82.51746862413249 35.52508520989234, -82.51791862422093 35.5249952099201, -82.5181316242627 35.52495320993346, -82.51866862437394 35.524808209959076)))",5521,37,021,002102,370210021021,2340,2340,141,2281,1872,286,10,47,0,66,59,1815,92,1723,1791,1501,212,10,28,0,40,24,1093,997,96
census_2010_blockgroups_view.fid--2dc29038_13ec899ba8f_-25e9,"MULTIPOLYGON (((-82.50739058490677 35.76820425832436, -82.5073945849105 35.76818525832089, -82.50740258491699 35.76815125831482, -82.50740958492115 35.76813225831166, -82.50741758492498 35.768116258309206, -82.50742358492813 35.76810225830698, -82.50748158495126 35.76801525829525, -82.5074995849583 35.76798925829181, -82.50759158498718 35.76790225828363, -82.50770958501676 35.767838258282794, -82.50777558503006 35.76782325828659, -82.50785958504696 35.76780425829131, -82.50789358505232 35.767805258295084, -82.5079885850678 35.76780725830528, -82.50803458507534 35.76780825831021, -82.50820458509665 35.767853258336935, -82.50826058510162 35.76788125834844, -82.5083285851075 35.76791625836253, -82.50834358510792 35.76792925836677, -82.50842758511091 35.76800025838988, -82.50869358511153 35.7682802584743, -82.50906358511247 35.7686702585919, -82.50922858511377 35.76883825864318, -82.50938858511383 35.76900925869447, -82.50947058511285 35.76910325872199, -82.50951658511033 35.76916825874011, -82.50956158510606 35.769244258760125, -82.5096355850908 35.769421258803845, -82.50971558507457 35.76961125885072, -82.50979458506116 35.769782258893656, -82.5098295850519 35.76987925891705, -82.51002958508585 35.76987425893672, -82.51026358512277 35.769887258963514, -82.51032758513273 35.7698912589709, -82.51061658517509 35.76992825900829, -82.5109155852162 35.769983259050356, -82.51127058526275 35.770063259103324, -82.51154358529723 35.77013325914568, -82.51196558535035 35.770243259211576, -82.51266858544201 35.770405259317144, -82.51267058544238 35.77040525931734, -82.51300258548886 35.770461259363, -82.51326358552741 35.77049225939627, -82.51359558557901 35.770515259435214, -82.51384458561918 35.77052325946252, -82.51483458578657 35.770505259561084, -82.5155585859087 35.77049325963338, -82.51581158595177 35.77048725965823, -82.51657358608054 35.77047325973403, -82.51682858612358 35.77046925975961, -82.51704558616048 35.77046425978094, -82.5172195861899 35.77046125979828, -82.51756158624866 35.77044825983094, -82.517697586273 35.77043725984279, -82.51778658628889 35.77043025985048, -82.51791458631236 35.77041625986084, -82.51796958631773 35.77044025987145, -82.51808858632926 35.77049325989452, -82.51813558633323 35.77051825990442, -82.5181905863379 35.770547259916036, -82.51835858635182 35.77063725995169, -82.51854958636426 35.77076125999665, -82.5186095863674 35.77080526001174, -82.51871358637293 35.77088126003797, -82.51890858637998 35.77104426009133, -82.5189675863816 35.7710972601082, -82.51903358638357 35.77115526012677, -82.5191725863877 35.77127726016597, -82.51919458638841 35.77129626017212, -82.51942658639325 35.77151326024027, -82.51959758639339 35.771695260294955, -82.51971158638774 35.77185326033889, -82.51972658638644 35.77187826034555, -82.51982758637729 35.772045260389945, -82.51986258637223 35.77211526040781, -82.51992058636408 35.77222926043704, -82.5200345863372 35.77252426050884, -82.52007758633077 35.772611260530994, -82.52007858633087 35.772612260531254, -82.52015358632764 35.77271326055962, -82.52026258632932 35.77281926059244, -82.52073158634602 35.77321326072104, -82.52113458636013 35.77355326083188, -82.52128558636203 35.773703260878, -82.5213925863633 35.773809260910575, -82.52157058636224 35.774006260969145, -82.52164858635949 35.77410726099766, -82.52172158637042 35.774115261006905, -82.52193958639799 35.77417126104085, -82.5219455863986 35.77417326104181, -82.52208858641764 35.77420426106286, -82.52222458643702 35.77422526108122, -82.52254158648502 35.774255261120025, -82.52283058653038 35.774272261153264, -82.52290958654272 35.774277261162496, -82.5231125865759 35.774281261184235, -82.52312958657895 35.77428026118576, -82.52331258661142 35.774266261201795, -82.52351458665206 35.7742212612135, -82.52368358668704 35.77417726122203, -82.52372158669475 35.77416826122408, -82.52429558681453 35.77401126125139, -82.52469658689478 35.77392426127505, -82.52528158701082 35.773803261310746, -82.52533558702135 35.773793261314296, -82.52541858703754 35.77377826131984, -82.52550158705063 35.77378226132927, -82.52557358706035 35.77379726133971, -82.52568158707193 35.77383826135917, -82.52584758708707 35.77391826139262, -82.52586958708886 35.77393026139732, -82.52592258709298 35.77396026140886, -82.52596258709607 35.773983261417726, -82.52606258710232 35.77405026144168, -82.52607558710288 35.77406026144505, -82.52612458710499 35.774099261458, -82.52613558710563 35.77410726146076, -82.52616858710715 35.77413226146931, -82.52618058710783 35.774141261472394, -82.52619458710844 35.77415226147602, -82.52621458710928 35.77416826148137, -82.5262345871096 35.77418726148725, -82.52624858710993 35.77420026149136, -82.52629758711107 35.77424526150565, -82.52638658711284 35.77432926153186, -82.52645158711644 35.77437526154797, -82.52650658711957 35.774414261561645, -82.52657258712328 35.77446126157808, -82.52658658712446 35.774468261580886, -82.52670158713399 35.774530261605335, -82.5267965871418 35.77458126162557, -82.52684858714898 35.77459126163292, -82.52694458716185 35.77461126164692, -82.52710858718397 35.774644261670566, -82.5271405871889 35.77464626167424, -82.52733858722051 35.77465526169656, -82.52759058725646 35.77469326173025, -82.52770258727118 35.774718261746884, -82.52799558730483 35.774815261796924, -82.52850658735724 35.775025261892424, -82.52902458741593 35.77520126198171, -82.5293755874317 35.77547526207375, -82.5297875874409 35.77585726219409, -82.53003258743783 35.77613926227668, -82.53029958743235 35.77646026236964, -82.53073058741747 35.7770172625275, -82.53074058741707 35.777030262531255, -82.53089758741862 35.777188262579585, -82.53107358742511 35.77733526262771, -82.5312575874382 35.77744726266953, -82.5314905874591 35.777562262717, -82.53178058748138 35.77772926278093, -82.53238958751227 35.77818226293603, -82.5324925875223 35.77822826295593, -82.53261158753608 35.778266262976, -82.53285358757005 35.77830726300935, -82.53322058762438 35.77835026305599, -82.53337358764591 35.77837526307683, -82.53344958765675 35.778387263087126, -82.5336785876938 35.778393263112, -82.53397958774441 35.77839026314248, -82.53420458778133 35.77839326316631, -82.53434358779873 35.77843026318816, -82.53444358780713 35.778483263209296, -82.53447158780865 35.77850326321617, -82.53453158781191 35.77854626323119, -82.53460158780834 35.778644263258336, -82.53461558779733 35.77873026327731, -82.53466558775973 35.779025263342525, -82.53471758773313 35.77925226339412, -82.53483758770774 35.77954426346596, -82.53484858770561 35.779569263472226, -82.5349475876907 35.77977126352351, -82.53495958768842 35.77979926353045, -82.5349815876845 35.77984826354272, -82.53504358767299 35.77998826357764, -82.53504658767206 35.77999726357978, -82.53506358766683 35.780049263592105, -82.5351335876784 35.78004926359943, -82.53533258770682 35.78007926362603, -82.53573758776277 35.780153263682905, -82.53580258777174 35.780165263692, -82.53593558778854 35.78019926371267, -82.5360425877998 35.780241263732265, -82.53616158780994 35.78030326375714, -82.53634658781789 35.78045026380619, -82.53648858781885 35.78059626385057, -82.53661858781132 35.78078326390205, -82.5366685877997 35.78091226393353, -82.53668458778085 35.78105026396328, -82.53668658775631 35.781210263996044, -82.53666258771558 35.78144626404159, -82.5366765876923 35.78161126407671, -82.53670358768356 35.78169626409678, -82.53672558767666 35.78176426411289, -82.53679258766999 35.781879264143186, -82.53691358766599 35.78203426418731, -82.53706558766748 35.782187264234075, -82.53711458766864 35.78223226424835, -82.53722158767118 35.782330264279324, -82.53739658767763 35.78247626432711, -82.53747858768057 35.78254526434963, -82.53764058768871 35.782666264391, -82.53801458771619 35.782889264474996, -82.53835558774863 35.78304526454202, -82.53861358777326 35.78316326459264, -82.53870158778446 35.78318526460616, -82.5386325877231 35.78350626466448, -82.53866458770811 35.78363726469442, -82.53880158768999 35.78390026476213, -82.53912158764784 35.784513264919944, -82.539276587588 35.78506426504821, -82.53932158754633 35.78538026511718, -82.53929058746196 35.78589026521784, -82.53925558742735 35.786075265251874, -82.53911758728793 35.78682426539022, -82.53906158723177 35.787125265445695, -82.53902858712378 35.787784265576484, -82.53899658701515 35.7884492657086, -82.538976586977 35.78867326575212, -82.53894658694436 35.78885126578536, -82.53890558690877 35.78903626581877, -82.5387865868315 35.789405265881584, -82.53872458679494 35.78957426590961, -82.53864958674427 35.78982026595194, -82.53864658672431 35.78994526597714, -82.53866058671386 35.79002726599528, -82.5386935867033 35.790130266019624, -82.53877058669788 35.790247266051416, -82.53899758669283 35.790523266131025, -82.5390255866921 35.79055726614086, -82.5391135866845 35.79070026617908, -82.53914858667234 35.790816266206306, -82.53915058665638 35.79092126622788, -82.53913058663733 35.79102226624644, -82.53908658661379 35.791126266263014, -82.53904358659592 35.79119526627263, -82.53897358657012 35.791286266284, -82.53894158655955 35.791320266287606, -82.53889258654348 35.791371266292934, -82.53884458652769 35.791421266298194, -82.53868058647353 35.79159426631645, -82.53866958646998 35.791605266317575, -82.53860958644906 35.79167526632562, -82.53853158642372 35.791755266333816, -82.53849258641083 35.79179626633819, -82.53821358636593 35.79178626630736, -82.5380385863381 35.79177826628763, -82.5379005863215 35.791737266264995, -82.53763258629776 35.79160326621006, -82.53655258618586 35.791167266009836, -82.53628058614208 35.791158265979895, -82.53524258548843 35.7942502665024, -82.53494458536281 35.794739266571185, -82.53492658535602 35.79476326657422, -82.53156358462634 35.79585826644996, -82.53146858460013 35.79592526645381, -82.53131658455818 35.79603226645989, -82.530499584314 35.796728266517256, -82.52869858390171 35.79745226647865, -82.52859758387685 35.797504266478896, -82.52832858381629 35.79760626647183, -82.52820358378825 35.79765226646829, -82.52819258378572 35.79765726646818, -82.52780858371374 35.79770926643907, -82.52767758368898 35.797728266429466, -82.52750558365776 35.79774526641522, -82.52716858367889 35.79724926627934, -82.52629958340646 35.798071266356985, -82.5255015832015 35.79853526636907, -82.5250925831434 35.7984712663138, -82.52447458304499 35.798443266244284, -82.52419758300746 35.798388266204434, -82.52410158299442 35.79836926619066, -82.52388758296136 35.798353266165286, -82.52330558292024 35.797995266032366, -82.52239858286232 35.7973982658171, -82.5203575822736 35.799000265932484, -82.520306582259 35.799039265935185, -82.52033058225769 35.79907326594454, -82.51919858192696 35.799989266014165, -82.51901558187048 35.80015626602928, -82.51884458182683 35.80025426603152, -82.51870558179125 35.80033426603349, -82.51837158170802 35.800512266035206, -82.51814058164675 35.800659266041265, -82.51797458159994 35.800782266049154, -82.51792258158537 35.80082026605158, -82.51789558157773 35.800840266052816, -82.51756558148288 35.801097266071096, -82.51729658140258 35.801326266089895, -82.51704258131952 35.801588266117015, -82.51679458123401 35.80187226614923, -82.51658458116304 35.80210426617481, -82.5164145811131 35.802243266185535, -82.51622158106316 35.80235826618894, -82.51525258082663 35.80284226618746, -82.514975580759 35.80298126618706, -82.51469558069168 35.80311426618526, -82.51450658064827 35.803191266181436, -82.51437658062342 35.803212266172245, -82.51421558059414 35.8032282661589, -82.51399758055932 35.80321926613456, -82.5137795805258 35.80320126610836, -82.51366958050873 35.80319326609539, -82.51293158039059 35.80316426601325, -82.5125475803283 35.80315426597152, -82.51247258031579 35.80315426596377, -82.51203658024266 35.80315826591954, -82.51191658022695 35.80313126590167, -82.51083558005855 35.80305826577509, -82.51001157991169 35.8031212657028, -82.5092275797723 35.803179265633645, -82.50806457955883 35.80330826553976, -82.50782257953107 35.803228265498475, -82.50773257952048 35.803200265483476, -82.50732457947333 35.803067265414306, -82.50654857938386 35.8028132652824, -82.50653357938232 35.802807265279625, -82.50650757938295 35.802775265270434, -82.5064625793755 35.802775265265744, -82.50630557936823 35.80265426522493, -82.50612457938537 35.80235026514434, -82.50570457936477 35.80203426503659, -82.50534557933753 35.80182626495717, -82.50510457931924 35.80168626490381, -82.50506257931593 35.80166226489453, -82.5042465792113 35.80146326476976, -82.50372957913571 35.801396264702696, -82.50325757906677 35.80133526464151, -82.50200757885797 35.80134126451365, -82.50136357870973 35.801606264501, -82.50069757856676 35.80181326447437, -82.50054757853468 35.80185926446823, -82.50032657850342 35.80182426443824, -82.4993545783499 35.80177226432728, -82.49860257826539 35.80151226419664, -82.49830057822864 35.80142526414774, -82.49729557822745 35.80036026382715, -82.49648657813314 35.80010226369103, -82.49562057801994 35.799904263561245, -82.49488957791894 35.79977326345904, -82.49440957784007 35.79976726340823, -82.49388557774142 35.7998412633692, -82.49328357763449 35.79988526331595, -82.49240857740703 35.80041226333279, -82.49205457731996 35.80059326333302, -82.4908565770477 35.80106326330491, -82.49065857700266 35.80114126330033, -82.48983157677081 35.801747263338235, -82.48914057659427 35.802144263347635, -82.4890125765611 35.802220263349895, -82.4886975764807 35.80240026335398, -82.48795157646452 35.80170826313603, -82.48801257649426 35.80158226311673, -82.48811257654032 35.801393263088514, -82.48811757654188 35.80138826308804, -82.48820457657831 35.80124726306834, -82.48840057665353 35.80097326303285, -82.48863157674384 35.800640262988985, -82.48900757688878 35.80011026291996, -82.48909657692278 35.79998726290406, -82.4893345770155 35.79964526285911, -82.48954157709427 35.7993602628225, -82.48996357725677 35.79876726274535, -82.49013457732609 35.798504262709514, -82.49046657747108 35.797927262626374, -82.49100357772036 35.79689926247263, -82.49117857780458 35.79654526241864, -82.49130957787368 35.79624126237035, -82.491354577905 35.79608826234383, -82.4913955779328 35.795953262320566, -82.49156757806392 35.79529426220423, -82.49164757813097 35.79494926214227, -82.491711578197 35.79459326207639, -82.49171357820023 35.79457426207283, -82.4917195782122 35.79450426205913, -82.49173757824413 35.794318262023204, -82.49173757824788 35.79429426201831, -82.49174057825927 35.79422426200432, -82.49174357827796 35.794107261980805, -82.49174657829377 35.79400926196116, -82.49173557833126 35.793756261908555, -82.49173057834847 35.79364026188446, -82.49170357844187 35.79301126175366, -82.4917005784532 35.79293526173788, -82.49165657859288 35.791990261540974, -82.49163257872324 35.79112726136282, -82.49163057873487 35.79105026134697, -82.49163957876318 35.79087826131288, -82.4916625787931 35.790710261281085, -82.49171157882614 35.790550261253614, -82.49172857883505 35.790511261247374, -82.49174957884618 35.79046226123961, -82.49176757885536 35.79042226123336, -82.49181857888004 35.790318261217394, -82.49184257889134 35.790271261210286, -82.49196357893838 35.7900982611876, -82.49199757895025 35.790058261182956, -82.49209357898295 35.7899502611709, -82.49258057912974 35.78952726113516, -82.49266457915495 35.78945526112918, -82.49277857918977 35.78935326112019, -82.49284157920904 35.78929626111507, -82.49295757924438 35.789193261106085, -82.4930265792672 35.789120261098404, -82.49308657928671 35.789059261092234, -82.49311857929715 35.789026261088786, -82.49314457930817 35.78898326108265, -82.49317557932062 35.78893626107626, -82.4932175793427 35.78883926106096, -82.49322757936132 35.78873026103974, -82.4932255793635 35.78871426103631, -82.49321857937228 35.78865026102257, -82.4932095793754 35.78862026101553, -82.49319957937847 35.788590261008366, -82.49318257938398 35.788536260995606, -82.49316557938617 35.78850426098733, -82.49315157938794 35.788477260980365, -82.49313757939007 35.78844926097325, -82.49302957939003 35.78833426093877, -82.49294557938696 35.78826426091577, -82.49283757937626 35.7882172608951, -82.49269557935983 35.788171260870996, -82.49262057934915 35.7881602608611, -82.49255957934035 35.788151260852906, -82.49239557931465 35.78814126083396, -82.49182357922082 35.78813326077323, -82.49150057917059 35.78811126073536, -82.49122057913137 35.78806426069692, -82.49098057910224 35.78799526065812, -82.49073657907472 35.78791126061578, -82.49073057907425 35.78790826061459, -82.49014557901744 35.787648260501264, -82.49006557900962 35.78761326048585, -82.48938057894446 35.78730026035133, -82.4891585789233 35.7871992603079, -82.488374578848 35.78684626015506, -82.48814357882702 35.78673426010839, -82.48789457880852 35.78658726005279, -82.48771157879914 35.786452260006385, -82.48755557879512 35.7863112599616, -82.48742857879483 35.786177259921224, -82.48733157879852 35.786050259885336, -82.48727057880413 35.785949259858484, -82.4871825788144 35.785789259816816, -82.48712557882584 35.785654259783456, -82.48707757883845 35.78552225975159, -82.48704157885832 35.785356259714185, -82.4870125788812 35.785178259674886, -82.48699857889825 35.78505325964806, -82.48692057900323 35.78429525948569, -82.48690557902991 35.78410825944614, -82.48689857904264 35.78401825942705, -82.48689057904805 35.78397525941748, -82.48686257904403 35.78397125941373, -82.48677957903212 35.783959259402806, -82.48675257902808 35.783956259399396, -82.48666557901545 35.783944259387894, -82.48665157901347 35.78394225938608, -82.48647957899023 35.78390825936138, -82.48640957898102 35.78389225935091, -82.48632557897005 35.78387325933839, -82.48601757893276 35.78378425928842, -82.4857715789056 35.78369625924511, -82.48567057889558 35.783652259225704, -82.48557057888567 35.78360925920664, -82.48491957882497 35.78330425907738, -82.48379757872236 35.782765258851775, -82.48317557866564 35.78246625872674, -82.482752578627 35.78226225864152, -82.48257357861071 35.78217625860549, -82.48186657854545 35.78184025846412, -82.48157757851807 35.78170825840735, -82.48129057848759 35.78159725835511, -82.48106857846258 35.78152125831672, -82.48088157844055 35.78146325828563, -82.48072157842013 35.78142325826096, -82.48067757841451 35.781412258254186, -82.48032257836728 35.781337258202264, -82.48017057834586 35.78131225818147, -82.48006657833047 35.78130025816828, -82.47983057829563 35.78127225813818, -82.47961757826211 35.78126025811376, -82.47933057821555 35.78125325808272, -82.47905357816877 35.781258258055146, -82.47903957816642 35.78125825805366, -82.4787835781209 35.781277258031054, -82.47848057806551 35.781310258006485, -82.47815457800303 35.78136325798356, -82.47782257793669 35.781435257963984, -82.47701657777264 35.7816292579202, -82.47660957769043 35.781723257897305, -82.47601857756953 35.78186925786594, -82.47573757751178 35.781940257851375, -82.47530957742279 35.782055257830564, -82.47502557736273 35.78213825781808, -82.47492457734145 35.782167257813576, -82.47487857733158 35.78218125781162, -82.47462357727642 35.782263257802015, -82.47444357723654 35.78232825779661, -82.47430057720453 35.782381257792665, -82.47418357717855 35.7824232577891, -82.47409257715807 35.78245725778657, -82.47383557710032 35.78255425777988, -82.47379257709058 35.78257125777888, -82.47372057707423 35.78259925777714, -82.47294957689901 35.78290225775916, -82.47266057683422 35.7830102577512, -82.4722205767352 35.783177257739716, -82.47186857665882 35.7832922577268, -82.47153657658923 35.78338525771139, -82.4711995765214 35.78346125769201, -82.47084557645292 35.78352325766812, -82.47053957639592 35.78356325764464, -82.47008957631422 35.783608257607305, -82.46933357618133 35.78365525753871, -82.46820057598175 35.783728257436536, -82.46669257571637 35.783824257300274, -82.4664605756755 35.7838392572794, -82.46616157562403 35.783851257250895, -82.46595157558866 35.78385425722981, -82.46569457554695 35.78384825720208, -82.46546857551238 35.78382925717484, -82.46526357548221 35.78380425714862, -82.46507957545735 35.78376725712202, -82.46489157543331 35.783721257093255, -82.46464257540394 35.78364425705187, -82.46450857538944 35.78359425702788, -82.46441257537913 35.78355825701063, -82.4643735753748 35.783544257003726, -82.46419557535928 35.78345425696705, -82.46397157534123 35.78333125691885, -82.46380657533034 35.783225256880264, -82.46378157532911 35.78320625687379, -82.46366857532392 35.783119256844444, -82.46354057531913 35.783013256809596, -82.46344157531638 35.78292525678147, -82.46326557531576 35.78274125672584, -82.46294257532692 35.78232525660786, -82.46275657533448 35.78207825653836, -82.4626725753379 35.781966256506976, -82.46220757536237 35.78131325632608, -82.46200257537038 35.781042256249705, -82.461763575383 35.78070625615667, -82.46149457539497 35.78034225605492, -82.46126557540696 35.780021255965856, -82.46111657541302 35.779823255910195, -82.46075057543153 35.7793132557686, -82.46053857543822 35.779044255692014, -82.46034957543954 35.77883425562971, -82.46016657543699 35.77865525557438, -82.46000257543068 35.77852025553002, -82.45993357542704 35.77847025551269, -82.45982557542109 35.77839325548587, -82.45961457540619 35.77826425543787, -82.4593975753877 35.77815125539248, -82.45918757536778 35.7780552553512, -82.458857575331 35.7779392552935, -82.4586315753042 35.77787025525618, -82.45854457529293 35.77785025524304, -82.45866057531317 35.77784325525364, -82.45870657532211 35.77783525525683, -82.45918957541491 35.77775425529018, -82.45928757543375 35.777738255297095, -82.45935057544568 35.777728255301554, -82.45923657544002 35.777643255272444, -82.45919757543805 35.77761425526256, -82.45890857542119 35.777414255191985, -82.45889057542068 35.77739825518689, -82.45878357541707 35.777307255157325, -82.45879657542245 35.77728625515437, -82.45879857542296 35.777285255154354, -82.45881557542924 35.77726325515168, -82.45882657543586 35.7772322551465, -82.45882957543805 35.77722125514456, -82.45883957544316 35.77719925514112, -82.45890657549246 35.7769542550982, -82.45905857560258 35.776408255002906, -82.4590825756302 35.77625625497443, -82.45908557563703 35.77621525496638, -82.45909057564619 35.77616225495614, -82.45908657565526 35.776099254942864, -82.45906757566895 35.775991254918935, -82.45905757567137 35.77596525491268, -82.4590225756795 35.77587525489064, -82.45894857568788 35.775742254856, -82.45877957570686 35.7754402547771, -82.45870757571294 35.775324254746025, -82.45863957571548 35.775235254720904, -82.45855457571635 35.77513925469258, -82.45853957571599 35.775125254688206, -82.45839557571361 35.774987254645275, -82.45836357571373 35.77495225463487, -82.45819357570609 35.77481925459031, -82.45796757570257 35.774601254522494, -82.45790557570265 35.77453425450249, -82.45785657570278 35.77448125448662, -82.45774157570547 35.77434125444631, -82.45755457571224 35.77409825437754, -82.45744957571875 35.7739442543354, -82.45739357572435 35.77384825431004, -82.45733657573356 35.773728254279774, -82.45728757574643 35.773593254247224, -82.45716357578948 35.77318425415122, -82.45709257581875 35.77292025409021, -82.45708757582214 35.7728932540842, -82.4570175758754 35.77247625399214, -82.45699757588152 35.772415253977684, -82.4569595758846 35.772355253961514, -82.45691457588373 35.772312253948066, -82.45689357588334 35.7722922539419, -82.4568305758824 35.772231253922946, -82.45678657588357 35.7721772539074, -82.4567665758877 35.7721292538956, -82.45672857590297 35.77199025386338, -82.4566575759679 35.771497253755754, -82.45664757598487 35.771377253730364, -82.45663657600701 35.77122325369785, -82.45663857602861 35.77108625367022, -82.45664757604631 35.77098225364994, -82.45666957606588 35.770880253631546, -82.45670257608688 35.77078025361455, -82.45675557611618 35.770648253593166, -82.45691357619764 35.77029325353732, -82.45701757625731 35.770020253492476, -82.45708257629849 35.76982525345953, -82.4571215763257 35.76969125343635, -82.45715157635266 35.76955025341076, -82.4571645763755 35.76941725338503, -82.45716857640309 35.769244253350195, -82.45715557652177 35.768467253190835, -82.45714557661553 35.76785325306489, -82.4571525766462 35.76766425302716, -82.45716957667479 35.76749825299514, -82.45717057667964 35.767468252989175, -82.45717357669223 35.767390252973634, -82.45716957670689 35.767292252953204, -82.45714357672593 35.76714125291991, -82.45711757673924 35.76702825289416, -82.45697657679015 35.76655025278242, -82.45694957680648 35.76641625275235, -82.45694857680773 35.76640725275041, -82.4569285768313 35.766234252713126, -82.45691957684947 35.76610825268656, -82.45691957686424 35.76601325266723, -82.45694157689411 35.76584425263516, -82.4570005769622 35.76546925256498, -82.457127577081 35.764841252450275, -82.45716257712951 35.76456625239806, -82.45717457716617 35.76434325235383, -82.45717957719775 35.76414525231415, -82.45717657721367 35.76404025229246, -82.45716257723414 35.76389325226104, -82.45713057724831 35.763768252232325, -82.4570575772607 35.76361025219266, -82.45693457726925 35.76342425214219, -82.45686657727641 35.76330525211087, -82.45685557727896 35.7632772521041, -82.45679457729477 35.76311025206383, -82.4567545773098 35.76297125203143, -82.45672957733343 35.76279225199246, -82.45672557735226 35.76266725196658, -82.45674157737294 35.762551251944586, -82.45677257739472 35.762444251926105, -82.45686057744108 35.762240251893644, -82.45688157745195 35.7621922518861, -82.45697957749634 35.76201125185934, -82.45705057753052 35.76186725183741, -82.45708457754952 35.76178125182343, -82.45708557755033 35.76177725182275, -82.45711257756753 35.761695251808796, -82.45713057758303 35.76161525179443, -82.45713657760939 35.761452251761874, -82.45713057763669 35.76127025172424, -82.45710157767859 35.76096925165996, -82.4570955776804 35.760951251655754, -82.45708857772338 35.76066725159725, -82.45709957774766 35.76052325156911, -82.45713957778365 35.76033425153479, -82.45717057780138 35.76025325152145, -82.45724657784325 35.76006525149106, -82.45737457790864 35.75978125144656, -82.45738957791617 35.75974825144133, -82.4575385779842 35.75947025140019, -82.45767557804251 35.75924125136777, -82.45773757806789 35.759144251354414, -82.45784957811303 35.758973251331206, -82.45793757815782 35.758779251300815, -82.45798157820492 35.75852325125338, -82.4579985782764 35.75808125116517, -82.45801357836675 35.75751625105175, -82.45801257843368 35.7570842509638, -82.45801757844741 35.75700125094744, -82.45804157850941 35.75662825087401, -82.45805457852943 35.756513250851995, -82.45807457854498 35.75643425083797, -82.458109578562 35.75636225082693, -82.45815557858008 35.75629525081804, -82.45850157869705 35.75591225077591, -82.45860957873467 35.75578525076118, -82.45871557878223 35.75559225073285, -82.45877957881373 35.75545825071224, -82.45880457882613 35.75540525070403, -82.45891057888501 35.75513925066088, -82.45898057891921 35.754994250638596, -82.45904757895205 35.75485425061702, -82.45914757900358 35.754629250581594, -82.45919457903723 35.75446325055268, -82.4592525790828 35.754232250511706, -82.45931957912698 35.754019250475274, -82.45950657922768 35.753571250403446, -82.45957257926332 35.75341225037786, -82.4597505793541 35.75301825031614, -82.45985657941131 35.75276325027521, -82.46000957949481 35.75238925021495, -82.46009357955796 35.75207225015914, -82.46015657960525 35.75183525011739, -82.46028457969038 35.75142425004708, -82.46033957971628 35.75131625003072, -82.46049757977306 35.75111925000696, -82.46065757982822 35.75093524998605, -82.46076457986966 35.75078324996621, -82.46084857991205 35.7506002499376, -82.46087957993444 35.75048924991829, -82.46090257995886 35.75035624989358, -82.46096358002059 35.75002424983232, -82.46107758012671 35.74946324972998, -82.46127558029634 35.74858224957127, -82.46137558038181 35.74813924949143, -82.461481580467 35.74770424941394, -82.46157158053553 35.74735924935297, -82.46157458053773 35.747348249351035, -82.46163858059428 35.74705224929749, -82.46168458064176 35.74679624925015, -82.46171058068916 35.74651824919626, -82.46173258074026 35.74621324913647, -82.46176358076808 35.74606724911003, -82.4617885807898 35.74595424908964, -82.46185958083328 35.74575024905545, -82.46188458084808 35.74568124904398, -82.46198258090327 35.745431249003225, -82.46215258098209 35.74510524895444, -82.46227258103379 35.74490024892515, -82.46230258104436 35.74486424892089, -82.46239858107697 35.744757248909046, -82.46253658111962 35.74463024889747, -82.46258158113352 35.74458824889357, -82.46260458114045 35.74456824889185, -82.46272058117543 35.74446724888336, -82.46276758118944 35.744427248879994, -82.4631575813068 35.74408824885133, -82.46325858134125 35.74397424883857, -82.46340358140328 35.74373024880386, -82.46346758143511 35.74359324878258, -82.46352458146276 35.74347624876471, -82.46361958151739 35.74322624872362, -82.46368558155888 35.7430292486904, -82.46370458158778 35.742864248658776, -82.46371158161392 35.7427032486268, -82.46367758166683 35.742326248546604, -82.4636835816906 35.742179248517274, -82.46372558173887 35.74191324846751, -82.46377858178634 35.74166424842233, -82.46385758184061 35.741399248376595, -82.46391858187819 35.74122224834687, -82.46409858197055 35.74082024828365, -82.46419658201954 35.74060924825093, -82.46428758206095 35.740440248225894, -82.46438258210385 35.74026524820013, -82.46473558225715 35.73965524811243, -82.46481058228822 35.73953524809577, -82.46483258229733 35.739500248090884, -82.46484658230119 35.73949024809035, -82.46493858232687 35.7394232480862, -82.4651475823821 35.73929124808088, -82.46518958239402 35.73925924807868, -82.4656575825252 35.73891424805688, -82.46596558260288 35.738743248053886, -82.46621358266269 35.738623248055, -82.46624258266966 35.73860924805515, -82.46644758271803 35.738517248057676, -82.46656658275293 35.73841924804992, -82.46658358276065 35.73838824804542, -82.46665858279401 35.73825324802572, -82.46672158283214 35.738075247995965, -82.46672758283532 35.73806124799379, -82.46682358288174 35.737864247963586, -82.46692358292323 35.73770424794136, -82.46706658296763 35.73757124792908, -82.46728958302602 35.73743324792398, -82.46742258305792 35.737370247924915, -82.46751358307958 35.73732824792575, -82.46774458312953 35.737253247934355, -82.46780158314195 35.737234247936385, -82.46809258319864 35.73718024795545, -82.46846558327125 35.737111247979875, -82.46870258331855 35.73706024799392, -82.46887658335638 35.737002248000046, -82.46906458340185 35.73691024800079, -82.46910858341403 35.736879247998985, -82.46924558345103 35.73678724799441, -82.46932558348232 35.7366712479791, -82.46933058349086 35.73662124796945, -82.46941558350008 35.736653247984734, -82.46942558349966 35.73666624798841, -82.4694735834982 35.736727248005735, -82.46950358349619 35.736772248018035, -82.4695135834955 35.736787248022075, -82.46957658349311 35.73687024804547, -82.46962358349231 35.736925248061496, -82.46962758349235 35.736929248062715, -82.46968058349401 35.73697524807757, -82.46970358349414 35.73699924808488, -82.46976258349446 35.73706024810334, -82.46981858348909 35.73715424812823, -82.4698225834805 35.73721424814085, -82.4698145834663 35.737297248156935, -82.4697765834401 35.73742524817901, -82.46967758338674 35.73766324821722, -82.46962858336013 35.737782248236364, -82.46962558334997 35.73784424824869, -82.46962958334552 35.737877248255835, -82.4696915833516 35.737904248267725, -82.46976258336231 35.73791124827644, -82.46995558339762 35.737890248292075, -82.47013458343125 35.73786524830544, -82.47029558346493 35.73782024831298, -82.47039758349362 35.737744248307976, -82.47049158352658 35.73763224829491, -82.47058058355259 35.73756024828948, -82.47087158361752 35.73745324829772, -82.47143058373776 35.73727624831944, -82.47143358373825 35.7372762483197, -82.47180758381293 35.73719524834181, -82.47215258386959 35.737199248378275, -82.47219758387686 35.73720024838308, -82.47251058391986 35.73725824842719, -82.47283758396453 35.737320248473495, -82.47292858397914 35.73732324848351, -82.47299458399418 35.737297248485056, -82.47304758401194 35.7372392484787, -82.47309658403384 35.73715024846569, -82.473112584042 35.73711524846025, -82.47313958405597 35.737054248450555, -82.47318358408573 35.736909248425576, -82.47326758412126 35.73677024840597, -82.47328158412684 35.736749248403214, -82.4733455841607 35.736599248379285, -82.47338758418051 35.73651724836697, -82.47343958419697 35.73646624836192, -82.47344958419936 35.73646224836215, -82.4733965841958 35.73642824834977, -82.47336358419324 35.736409248342454, -82.47327158418507 35.736363248323606, -82.47319758418482 35.736286248300296, -82.47315758419123 35.73620224827913, -82.47312858420314 35.73609424825414, -82.47309258424843 35.73576424818327, -82.47308958425282 35.73573224817647, -82.47309858426921 35.73563624815786, -82.47309158428124 35.735551248139835, -82.4730445842886 35.73545424811528, -82.472958584284 35.73539124809362, -82.47277558427072 35.73528124805232, -82.4726805842646 35.73521924802989, -82.47263158426237 35.73518124801711, -82.47238858424495 35.73503324796193, -82.47222958423167 35.73494924792842, -82.47197658420745 35.73483424787892, -82.47176458417744 35.73480124785037, -82.4716585841648 35.73476924783287, -82.47156158415503 35.73472824781456, -82.47148558415071 35.73467524779596, -82.47140858414814 35.73460924777456, -82.47136658415106 35.734545247757204, -82.47132058416318 35.734418247726644, -82.47131058416605 35.734389247719655, -82.47128758417365 35.73431524770227, -82.4712715841765 35.734280247693505, -82.47125858417928 35.734248247685635, -82.4711995841807 35.7341762476649, -82.47112258417707 35.73411724764498, -82.47099358416806 35.73403724761532, -82.47079558414578 35.73396924758109, -82.47065158412617 35.73394124756057, -82.47053858410446 35.733960247552716, -82.46996658409006 35.733441247388164, -82.4682515840471 35.73188424689441, -82.46768058403268 35.731366246730154, -82.46837058413209 35.73146424682127, -82.4698555843061 35.73193024706933, -82.4701235843348 35.732032247117736, -82.47022658434584 35.73207124713623, -82.47093558442184 35.73234024726411, -82.47201558454181 35.73272224745332, -82.47249958458133 35.73298524755675, -82.4733975846543 35.733475247749084, -82.47425258477278 35.73362624786801, -82.47516658492265 35.73363824796475, -82.47521958492982 35.73364824797227, -82.47565058498841 35.73373224803384, -82.47716558508449 35.73473324839379, -82.477460585095 35.73498124847472, -82.47888158514499 35.73617924886509, -82.47898358514473 35.73629024889812, -82.47941958514389 35.73676224903915, -82.47961758505767 35.73752924921563, -82.4795785850091 35.737800249266826, -82.47945258485126 35.73868224943325, -82.47918558461924 35.739891249651635, -82.47898458442262 35.74094324984495, -82.47893958437827 35.74118024988855, -82.47889458433329 35.74142224993321, -82.47892558426247 35.741911250035784, -82.47896158425574 35.74199325005624, -82.47900958424682 35.7421022500834, -82.4790695842361 35.74223525011665, -82.47927858426334 35.742283250147935, -82.47939658427876 35.74231025016562, -82.48002158437224 35.74237625024352, -82.48020758440005 35.74239625026678, -82.48024458440574 35.74239925027121, -82.48144658458932 35.74250225041625, -82.48220258471731 35.74248625049099, -82.48277258478493 35.74266025058519, -82.48358858488177 35.74290925072006, -82.4834355848031 35.743252250774084, -82.48297658456666 35.744284250936644, -82.48282458448807 35.74462825099101, -82.48269258442015 35.7449242510376, -82.48229658421592 35.74581625117822, -82.48216558414796 35.74611325122512, -82.48208458410036 35.74633325126152, -82.48184958400743 35.74668025130785, -82.48182258399109 35.746757251320794, -82.4817415839605 35.74686725133486, -82.48174158395537 35.74690025134155, -82.48169058393793 35.74695825134804, -82.48142458384633 35.74726325138263, -82.48141158383581 35.74731725139226, -82.48127658378765 35.74748325141209, -82.48115558375464 35.74756625141652, -82.48107458372598 35.747664251428155, -82.48064958360429 35.747993251451234, -82.48034058349737 35.74835125149212, -82.48018558342233 35.74866925154088, -82.4802125833943 35.74887825158615, -82.480252583387 35.74896825160864, -82.48041558337066 35.749247251682185, -82.4804895833634 35.74937325171549, -82.48056958334446 35.74958125176605, -82.48067158333807 35.74973125180709, -82.48088058331403 35.750109251905634, -82.48102558330329 35.75033325196612, -82.48127558327995 35.750751252076995, -82.48143758324959 35.7511192521686, -82.4815725832339 35.75136525223261, -82.48159258316011 35.751861252335544, -82.4815865831088 35.75218525240085, -82.48158758310308 35.752223252408676, -82.48159958304612 35.75260225248703, -82.48145858296549 35.75297125254754, -82.48141858293069 35.75315225258026, -82.48136458289248 35.753340252613, -82.48116258281988 35.753592252643394, -82.48100758274886 35.75388325268658, -82.4808525826983 35.75404325270316, -82.48074458265337 35.75421725272744, -82.4807445826291 35.754373252759166, -82.48081258259003 35.75469725283207, -82.48083958252805 35.75512525292192, -82.48078558248646 35.75533525295915, -82.48067158243025 35.75557525299619, -82.48055658238121 35.755768253023554, -82.4801795821843 35.7566322531605, -82.48007258213515 35.75683425319049, -82.4799035820729 35.75705425321784, -82.4797355820166 35.757237253237754, -82.47961758198406 35.7573202532425, -82.47966058196575 35.75748425328022, -82.47967658195111 35.75759525330453, -82.47967558191885 35.75780225334645, -82.47970158182888 35.75840925347272, -82.4796925817979 35.758598253510264, -82.47967158176587 35.758782253545476, -82.47965858174678 35.75889125356633, -82.4796005816867 35.75921625362649, -82.47959858168517 35.75922325362765, -82.47957958167088 35.75929525364035, -82.47951658163772 35.75944125366355, -82.47940358157463 35.7597262537099, -82.47936058154643 35.759862253733154, -82.47935258153483 35.759928253745734, -82.47935558152409 35.76000025376066, -82.47937458151371 35.7600872537804, -82.47939958150559 35.760166253799014, -82.47951558148156 35.7604452538678, -82.47952358147575 35.760491253877966, -82.47953558146824 35.76055225389163, -82.47954458143893 35.76075025393285, -82.47955558142885 35.76082725394966, -82.47958058141639 35.76093425397395, -82.47963258139963 35.76109725401248, -82.47976158135204 35.76154125411621, -82.47985958131942 35.761856254190384, -82.47991258130935 35.76197725422051, -82.47997358130199 35.76209025424979, -82.48011158128536 35.76234425431565, -82.48020058127763 35.76248925435439, -82.48027658127313 35.762599254384625, -82.48048358127251 35.762824254451765, -82.48060058127116 35.762958254491096, -82.4806985812649 35.76310325453076, -82.4807625812561 35.7632282545628, -82.48081758124216 35.763377254598815, -82.48085658122508 35.76352825463356, -82.48087758120545 35.76367725466599, -82.48088758115986 35.763981254728925, -82.48089958113788 35.76413525476154, -82.4810185810545 35.764799254908844, -82.48105658103555 35.76496125494575, -82.48118658099055 35.765390255046476, -82.48120258098278 35.76545725506176, -82.48127258095144 35.765733255125205, -82.48131258094025 35.76584825515273, -82.48135758093113 35.76595525517913, -82.48146458091523 35.766171255234084, -82.48151658090475 35.76629425526454, -82.48154858089502 35.76639125528759, -82.48160858087111 35.76660925533808, -82.4816855808489 35.76683425539182, -82.48169858084657 35.76686325539905, -82.48177558083219 35.767038255442635, -82.48194758080308 35.76740925553591, -82.48205258079186 35.76759325558419, -82.48218758077776 35.76782825564595, -82.48232958080452 35.76780825565658, -82.48255858084741 35.76777725567391, -82.48275758088367 35.7677562556901, -82.48290058090981 35.767741255701914, -82.48309458094523 35.76772025571763, -82.48350858102302 35.76766225574858, -82.48358058103652 35.76765225575394, -82.48369758105846 35.76763625576277, -82.48402758112414 35.767566255782654, -82.48420258116144 35.767513255789915, -82.48431858118757 35.767469255792925, -82.48440658120933 35.7674232557926, -82.48447658122906 35.76737125578928, -82.48472258130641 35.767136255766886, -82.4849125813579 35.76700825576043, -82.48507758140026 35.76691225575791, -82.48513158141247 35.766891255759234, -82.48516058141898 35.76688025575997, -82.48525958143689 35.76687125576841, -82.4853885814584 35.76687025578147, -82.485517581482 35.76685625579202, -82.48561958150395 35.766824255795946, -82.48568158152158 35.76677725579285, -82.48570758153059 35.766747255789404, -82.48573958154178 35.76670925578501, -82.48581358157107 35.76659925577022, -82.48589558160204 35.76648825575612, -82.48600358164019 35.76635825574082, -82.48609158166818 35.766272255732375, -82.48620458170043 35.76618525572634, -82.48633858173606 35.766099255722736, -82.48643058176005 35.766043255720746, -82.48658158179913 35.76595325571811, -82.48697958189912 35.76573525571478, -82.48717358194706 35.7656342557143, -82.48751358202595 35.76549025572004, -82.48773958207946 35.765387255722445, -82.48795058213028 35.76528525572346, -82.48810158216867 35.76520025572173, -82.48821358219811 35.76513025571908, -82.48832858223408 35.76502225570904, -82.48845858227895 35.76487225569189, -82.48852358230869 35.76475025567377, -82.48857058233496 35.76463125565436, -82.48860558235961 35.764510255633425, -82.48863858239417 35.76432325559873, -82.488673582418 35.764207255578775, -82.48867858242103 35.76419325557645, -82.48874558244846 35.764088255561994, -82.48889258250077 35.76390825554053, -82.48907558256792 35.76367225551134, -82.48929758264389 35.763421255483145, -82.48930758264733 35.76340925548175, -82.48936058266611 35.763345255474285, -82.48946458270218 35.763224255460365, -82.48952858272229 35.76316325545457, -82.48957358273636 35.76312125545067, -82.48959058274112 35.76310825544971, -82.48971758277808 35.763006255442114, -82.48995158284276 35.76284025543253, -82.49002958286266 35.76279525543136, -82.49017958290061 35.762711255429764, -82.49034958294159 35.76262925543057, -82.49056358299434 35.7625192554303, -82.49079958305104 35.762406255431735, -82.49093558308607 35.762326255429485, -82.49104058311545 35.76224925542465, -82.49113158314397 35.76216325541652, -82.49120358316854 35.762082255407485, -82.49127258319382 35.76199325539649, -82.49135858322227 35.76190225538686, -82.49158758329742 35.761663255361874, -82.491686583326 35.7615852553562, -82.49176558334315 35.761559255359046, -82.4918255833561 35.761540255361375, -82.49196358338146 35.761524255372386, -82.49199158338664 35.761521255374646, -82.4921525834115 35.761533255393694, -82.4922745834294 35.76154825540932, -82.49260258346031 35.76170025547412, -82.49282358348506 35.761777255512676, -82.49311358351655 35.76188425556435, -82.49344958355177 35.762017255626134, -82.49360958357305 35.7620512556495, -82.49370858358697 35.762067255663, -82.49390658361882 35.762074255684894, -82.49410558364596 35.76211225571315, -82.49425758366218 35.76217025574066, -82.49431158366825 35.76218925575008, -82.4944635836882 35.76222325577268, -82.49454058370036 35.76222725578148, -82.49461658371241 35.762231255790155, -82.49468558372509 35.76222325579559, -82.49479158374328 35.76221925580574, -82.49508958379879 35.76218125582878, -82.49522658382564 35.762154255837366, -82.49543258386642 35.76211225585018, -82.49555458388714 35.7621092558621, -82.4958295839282 35.76213925589658, -82.49603258395851 35.76216125592203, -82.49613158397011 35.76219225593856, -82.49622658397705 35.76224925595996, -82.49654758399156 35.76249925604397, -82.49666758400308 35.762553256067314, -82.49676358401607 35.76257225608116, -82.49685458403135 35.76257125609036, -82.49695358404983 35.7625582560979, -82.4970735840754 35.762522256102955, -82.49726558411751 35.76245625610934, -82.49736558413719 35.76243625611559, -82.49748858415764 35.762436256128254, -82.49754358416568 35.7624432561354, -82.49767558418506 35.76246025615245, -82.4977745841985 35.76247925616651, -82.49784858420867 35.762493256177, -82.49793558421645 35.76253625619477, -82.49801158421833 35.762605256216695, -82.49807258421794 35.76267325623676, -82.49813358421727 35.762742256257184, -82.4982475842203 35.76284525628983, -82.49840058423383 35.76292125632114, -82.49849958423954 35.762990256345425, -82.49854558423709 35.763055256363344, -82.49856858423273 35.76310825637654, -82.49857658422157 35.76318825639359, -82.49857058421175 35.7632452564046, -82.49855658419176 35.763359256426384, -82.49855758417165 35.76348925645294, -82.498578584154 35.7636252564828, -82.49862358413883 35.763771256517124, -82.49869758412825 35.763918256554675, -82.49878758412022 35.764066256594056, -82.49889858411535 35.76421625663608, -82.49898358411424 35.76431425666477, -82.49902558411348 35.7643642566793, -82.49903858411346 35.76437825668349, -82.49918358411395 35.76453025672942, -82.49935458411714 35.76469225678001, -82.49954358412263 35.76485925683354, -82.49969358412916 35.76497725687309, -82.50042258416407 35.765532257061224, -82.50091558418508 35.765924257191934, -82.50127358419925 35.766216257288335, -82.50138358420133 35.766320257320814, -82.50147558419987 35.766428257352295, -82.50181058418644 35.76687225747729, -82.50186358418438 35.76694225749699, -82.5019685841834 35.76706125753203, -82.50206858418666 35.76714725755987, -82.5022335841988 35.76724525759684, -82.50242258421801 35.76732425763239, -82.5027005842491 35.76742125768089, -82.50287958427045 35.76747525771031, -82.50296758428087 35.76750225772488, -82.50333858432788 35.76759625778229, -82.50376758438424 35.76769225784614, -82.50379558438782 35.76769925785043, -82.50461658449692 35.76787525797102, -82.50492458453985 35.76792825801367, -82.50524458458635 35.76797125805545, -82.5055375846302 35.76800225809197, -82.5062835847443 35.768066258181975, -82.50648158477365 35.76808925820708, -82.50699558484959 35.768150258272634, -82.50739058490677 35.76820425832436)))",6330,37,021,002900,370210029001,1739,1739,64,1707,1642,21,5,3,0,36,32,1380,32,1348,1360,1322,10,5,2,0,21,20,810,724,86
census_2010_blockgroups_view.fid--2dc29038_13ec899ba8f_-25e8,"MULTIPOLYGON (((-82.51466063304156 35.463935197167736, -82.51482163302946 35.46418819723568, -82.51518463300266 35.46475619738831, -82.51521363300029 35.464803197400926, -82.5162456329175 35.46646019784357, -82.51650863289893 35.466866197953095, -82.51667563288217 35.46715619802918, -82.51681163286051 35.467445198101814, -82.51725263279097 35.46837619833636, -82.51751063274246 35.46897219848409, -82.51828763259739 35.47076019892727, -82.51854663254898 35.47135619907502, -82.51881363249895 35.471972199227665, -82.51900763246262 35.472419199338425, -82.51933663239976 35.47318519952795, -82.51961363234821 35.473821199685645, -82.51963363234483 35.473865199696604, -82.51987163229592 35.474442199838364, -82.52011563225226 35.47499119997508, -82.52084963212144 35.476639200385414, -82.52092963210718 35.4768192004302, -82.52104663208225 35.477108200500986, -82.52108863207656 35.47719120052216, -82.52122863205003 35.47751520060248, -82.52131563203419 35.477713200651685, -82.52139163201018 35.47795220070807, -82.52143463199079 35.478125200747584, -82.52147863196839 35.47831920079158, -82.52149763194241 35.478509200832185, -82.5214996319389 35.47853420083753, -82.52153063189013 35.47888620091226, -82.52156363185932 35.479123200963805, -82.52156563185729 35.47913820096704, -82.52160763180862 35.479501201045174, -82.52162363178788 35.47965420107796, -82.52164363176269 35.47984020111784, -82.52166963173039 35.48007920116915, -82.52143863168999 35.48009320114823, -82.52074863156876 35.480138201086774, -82.52069963156009 35.48014220108251, -82.52051863152826 35.48015420106642, -82.51998163141907 35.48028620103825, -82.51836963109136 35.480682200953574, -82.51783363098224 35.48081520092561, -82.5178286309858 35.480786200919255, -82.51781363099666 35.48069920089998, -82.51780963100036 35.48067120089391, -82.51779463101205 35.480578200873445, -82.51778363102557 35.48047820085204, -82.51775163106727 35.48017120078629, -82.51771863110363 35.47989820072735, -82.51769563112941 35.47970520068574, -82.51768863113678 35.479649200673656, -82.5176796311468 35.479574200657524, -82.51766763115903 35.47948120063732, -82.51766163116669 35.47942520062531, -82.51765763117004 35.47939920061959, -82.51764863118044 35.479321200602875, -82.51764563118375 35.47929620059745, -82.51760163122249 35.47899620053195, -82.51759163123168 35.478925200516436, -82.51748763131687 35.478256200369756, -82.51743763133207 35.478103200333535, -82.51734563136097 35.47781520026554, -82.51730063137447 35.47767820023302, -82.51712263140323 35.47729820013746, -82.51706763141209 35.47718020010787, -82.51686563143156 35.476835200017014, -82.5166716314478 35.47651919993285, -82.51630063148652 35.47586519976183, -82.5162806314881 35.47583319975326, -82.51599163151421 35.475350199625446, -82.51596463151633 35.47530719961401, -82.51588663152317 35.47517819957974, -82.51586163152545 35.47513619956866, -82.51578663153329 35.47500419953409, -82.51560863155174 35.47469119945216, -82.51556063155611 35.4746101994308, -82.5154836315632 35.474481199396706, -82.51545063156624 35.474425199381855, -82.51535163157547 35.47425819933777, -82.51531863157841 35.47420319932321, -82.51529263158068 35.47416019931178, -82.51518763160207 35.47390719924961, -82.51516763160622 35.47385819923757, -82.51508163162954 35.47361319917898, -82.51493463166535 35.473220199084004, -82.51485563168642 35.4729971990306, -82.51478463170548 35.472796198982394, -82.51475963171752 35.47269019895828, -82.51472263171317 35.472679198952235, -82.51461163169928 35.47264919893475, -82.51457463169454 35.4726401989291, -82.51436263167243 35.472555198890134, -82.51372663160616 35.472300198773084, -82.51351563158427 35.472215198734204, -82.5132746315523 35.472163198698915, -82.5132106315437 35.472150198689675, -82.51296063150761 35.472115198656965, -82.5128416314893 35.47210619864296, -82.51257763144561 35.472106198615904, -82.51254063143902 35.47210919861269, -82.51241463141635 35.472121198602224, -82.51229863139312 35.47214719859568, -82.51225563138465 35.47215619859306, -82.51218763137113 35.47217119858912, -82.5121286313589 35.472187198586354, -82.51208663135009 35.47219919858451, -82.51190563131263 35.472248198575905, -82.51181863129425 35.47227419857232, -82.51170063126881 35.47231219856791, -82.5115716312426 35.47234419856117, -82.51155363123918 35.47234719855997, -82.51147863122462 35.47236019855495, -82.51140163121094 35.47236719854845, -82.5112696311895 35.47236419853432, -82.51117763117647 35.472350198522015, -82.51100463115526 35.4723011984944, -82.51096263114998 35.47229019848779, -82.5107346311195 35.472242198454644, -82.5105386310911 35.47221619842934, -82.51030663105573 35.47219619840143, -82.50997263100474 35.4721681983616, -82.50963763095204 35.47215019832356, -82.50901963085366 35.47212419825491, -82.50881263082066 35.472116198232094, -82.5085906307852 35.472107198207546, -82.50848663076911 35.47210019819544, -82.50829863073963 35.47208919817388, -82.50817763072115 35.472079198159484, -82.5080746307052 35.472071198147276, -82.50793363068377 35.47205919813039, -82.50780763066446 35.47204919811549, -82.50765263063984 35.47204219809818, -82.50751063061617 35.472043198083774, -82.5073696305927 35.47204419806955, -82.50724963057219 35.47204819805809, -82.50701063052898 35.472072198038475, -82.50695763051883 35.472081198034836, -82.50676363048102 35.472118198022486, -82.50626863037637 35.47226619800189, -82.50576863026897 35.472427197983386, -82.50537563018423 35.47255519796912, -82.50516063013818 35.472623197960914, -82.5045156299997 35.47283019793692, -82.50445062998564 35.47285219793475, -82.50429862995458 35.47289019792688, -82.50430562997346 35.47277519790419, -82.5043266300293 35.472433197836814, -82.50433463004805 35.47231919781447, -82.50434563008058 35.472118197774684, -82.50437963017862 35.47151519765554, -82.50438863020223 35.471371197627214, -82.50438963021104 35.47131419761566, -82.50450363022995 35.47131419762741, -82.50471563026485 35.471315197649304, -82.50484563028724 35.47130919766146, -82.504959630307 35.47130419767212, -82.50505163032338 35.471296197679926, -82.50510063033197 35.471293197684396, -82.50532863037401 35.47126519770201, -82.50542163039117 35.47125419770932, -82.50555363041498 35.47124119772014, -82.50570563044228 35.47122719773289, -82.50588763047331 35.47122119775032, -82.50595363048392 35.471223197757496, -82.50600263049171 35.471225197762976, -82.50608763050464 35.47123319777324, -82.50620863052276 35.47124519778814, -82.50631963053827 35.471264197803386, -82.50651563056458 35.47130419783158, -82.50682163060567 35.47136719787575, -82.50692663062074 35.47138219788953, -82.50701363063448 35.47138619789928, -82.50707663064556 35.47138219790494, -82.50715463066055 35.47136819791005, -82.50723963067894 35.47134019791308, -82.50732863070016 35.47129819791368, -82.50741463072323 35.4712401979107, -82.50750663075031 35.471163197904445, -82.50759663077959 35.47106919789461, -82.50765863080107 35.4709961978861, -82.50766963080558 35.470978197883504, -82.50781763086385 35.47075819785392, -82.50790163090025 35.470611197832675, -82.50800663094545 35.47042919780643, -82.50802563095334 35.47039819780212, -82.50813863099839 35.470226197778715, -82.50833263107147 35.46995919774435, -82.50840263110095 35.46984219772767, -82.50842963111492 35.46978019771785, -82.50844363112184 35.46975019771315, -82.50847963114374 35.46964619769568, -82.5085026311628 35.46954619767767, -82.5085086311678 35.469520197673035, -82.50852663118269 35.46944219765907, -82.50853263118768 35.469416197654326, -82.50855463120556 35.4693231976377, -82.50856963121612 35.46927019762846, -82.5086426312661 35.469023197585734, -82.50869963130013 35.468862197558835, -82.5087056313047 35.46883919755475, -82.5087496313341 35.468695197529975, -82.50878163135603 35.46858619751113, -82.50878763135978 35.46856819750808, -82.50885863141964 35.468254197451515, -82.50886163142151 35.46824519744998, -82.50888963144142 35.4681451974325, -82.5088996314481 35.46811219742679, -82.50892263145968 35.4680611974188, -82.5089356314662 35.4680331974144, -82.50898963148954 35.46793919740093, -82.50903863150808 35.46787119739206, -82.50907163151858 35.46783819738874, -82.50913563153884 35.46777519738242, -82.5092476315717 35.46768119737481, -82.50936663160611 35.46758519736746, -82.50941263161941 35.46754819736472, -82.5102286318544 35.466896197315734, -82.51025063186093 35.46687719731414, -82.51046663192439 35.46669619729943, -82.51052163194164 35.466643197294275, -82.51061163197198 35.46654219728297, -82.51063863198075 35.46651419728004, -82.51076063203216 35.46631019725106, -82.51080163205435 35.466210197234936, -82.51080763205849 35.46618919723134, -82.51085063208525 35.46606119720961, -82.5109066321266 35.465851197172746, -82.51097163217348 35.465615197131385, -82.51097363217468 35.465610197130545, -82.51101663219514 35.46552219711705, -82.51107263221657 35.46544319710674, -82.51114363223932 35.46537119709933, -82.51120663225794 35.46531819709507, -82.51124763226852 35.46529319709416, -82.51139563230406 35.46522119709469, -82.51153063233453 35.465168197097825, -82.51215763247171 35.46495019711763, -82.51228363249916 35.464907197121825, -82.51256263256161 35.46480119712887, -82.51259463256925 35.464786197129065, -82.51261263257368 35.464776197128906, -82.51266663258662 35.464750197129156, -82.51268563259104 35.46474219712947, -82.51301563266846 35.46459319713297, -82.51317563270585 35.464522197134905, -82.51403263289608 35.46420619715849, -82.51437363297165 35.464081197168014, -82.51443063298568 35.46405119716776, -82.51460263302755 35.463964197167655, -82.51466063304156 35.463935197167736)))",6360,37,021,002205,370210022053,890,890,21,882,808,48,3,8,5,10,8,741,17,724,736,685,34,3,6,1,7,5,426,385,41
census_2010_blockgroups_view.fid--2dc29038_13ec899ba8f_-25e7,"MULTIPOLYGON (((-82.52498961570079 35.58803322347046, -82.5244926156845 35.587603223331875, -82.52397261552747 35.588063223372046, -82.52355561529627 35.589115223543295, -82.52351261517305 35.58986922369228, -82.52336561503249 35.59062322383058, -82.5236286148756 35.591925224122484, -82.5236756148486 35.59215122417328, -82.52373161483372 35.592308224211024, -82.5237746148219 35.592431224240414, -82.52378561473327 35.59301822436106, -82.52357761460796 35.59360822445968, -82.52350561455967 35.59384422450029, -82.52333861444717 35.59439422459501, -82.52331261442964 35.594480224609896, -82.52322461411984 35.59639622499064, -82.52293561362296 35.59931022555393, -82.52208761326037 35.600750225759704, -82.52120361293095 35.601936225910165, -82.52109361279052 35.602729226060205, -82.52066961260918 35.60344922616316, -82.52025361235829 35.60462922636044, -82.52000161207607 35.606189226652035, -82.51945961183125 35.6071942268007, -82.51831761202739 35.604692226174265, -82.51830261203017 35.604658226165796, -82.51825761203952 35.60454922613898, -82.51811661204253 35.60437822608971, -82.51796861203854 35.60424422604734, -82.51794161203799 35.604219226039426, -82.51785161203995 35.604109226007765, -82.51773861202292 35.604098225993866, -82.5175656119965 35.604083225973106, -82.51745461198216 35.60405722595634, -82.5173356119667 35.604029225938426, -82.51716461194822 35.60396522590779, -82.51699461191046 35.60402722590295, -82.51691661185774 35.6042852259474, -82.51680661181285 35.60445822597133, -82.51680061181025 35.604468225972745, -82.51663261176826 35.60456022597418, -82.51659461176088 35.604567225971756, -82.51635861171472 35.60461222595656, -82.51620161168397 35.60464322594682, -82.5161796116837 35.60462122594003, -82.5161326116757 35.60462222593538, -82.51605461166083 35.604635225930096, -82.51569261158927 35.60470922590785, -82.51551961155634 35.60473722589581, -82.51545561154406 35.60474822589148, -82.51521561149262 35.60482322588201, -82.5150306114562 35.60486022587052, -82.51491861143707 35.60486422585981, -82.51483361142586 35.60484522584728, -82.51477661142059 35.604818225835885, -82.51472861141926 35.6047752258222, -82.51468361141943 35.60472522580746, -82.51463961142095 35.60466822579124, -82.51458461142606 35.604576225766905, -82.51451361143569 35.60443722573135, -82.51447561144398 35.60434222570814, -82.51444661145268 35.604255225687425, -82.5144336114634 35.60417122566902, -82.51443561147542 35.60409522565377, -82.51445661149016 35.60402222564103, -82.5144996115126 35.60392322562532, -82.51460261155128 35.60378322560744, -82.51468661158577 35.60364922558879, -82.5147176115984 35.60360122558222, -82.5147646116216 35.60350122556668, -82.51479661164005 35.60341622555273, -82.51480361165318 35.60333822553754, -82.51479661167441 35.60319322550733, -82.51475961170163 35.60297622545941, -82.514732611722 35.602815225423875, -82.51471761173296 35.602728225404626, -82.51471461173522 35.60271022540067, -82.51468161174449 35.60261422537768, -82.51458261175534 35.602437225331514, -82.51449961176027 35.60231622529837, -82.51435761175445 35.602201225260416, -82.5142676117468 35.602154225241556, -82.51421861174245 35.602129225231444, -82.51413361173512 35.60208522521373, -82.51404861172908 35.6020332251944, -82.51397861172389 35.60199122517872, -82.51387061171977 35.601902225149416, -82.51384061171987 35.60186922513967, -82.51381461171995 35.60184022513114, -82.5137716117233 35.601772225112875, -82.51376561172493 35.6017552251088, -82.51374861173001 35.60170422509668, -82.51370561174873 35.601536225058126, -82.51366361177494 35.601321225009976, -82.51359361179274 35.60113022496393, -82.51352761180226 35.60099722493013, -82.51348461181075 35.60089622490511, -82.51344661185034 35.600598224840624, -82.51344361185386 35.60057222483501, -82.51341761187084 35.60043422480426, -82.51337361187444 35.600363224785326, -82.51330661187536 35.600285224762544, -82.51326461187226 35.600260224753185, -82.51319861186751 35.600220224738244, -82.51306561185224 35.600176224715554, -82.5128996118296 35.600144224692, -82.51277561181553 35.60010222467074, -82.51266261180507 35.60004822464816, -82.51257961179947 35.599995224628834, -82.51256461179833 35.59998622462545, -82.51240361179097 35.59986122458348, -82.51225561178668 35.5997292245414, -82.51219361178627 35.599665224521964, -82.51215561178923 35.59960522450585, -82.51213161179513 35.59954122449042, -82.51212061180259 35.59948122447708, -82.51211161183664 35.59925022442915, -82.5121406119187 35.59874922433016, -82.51223961201518 35.59822922423462, -82.51226961205596 35.59799722419049, -82.5122706120583 35.597983224187715, -82.51229361210598 35.597698224132095, -82.51229461212267 35.59759122411044, -82.51228861213846 35.59748222408765, -82.51224961215205 35.597352224057154, -82.51221161216026 35.5972582240342, -82.51218861216542 35.597199224019796, -82.51215361216997 35.597132224002564, -82.51212961217331 35.59708522399051, -82.5120206121845 35.59689522394066, -82.51194661219083 35.596774223908454, -82.51187461219696 35.59665722387722, -82.51166261221907 35.59628522377972, -82.51164261222125 35.59624922377038, -82.5115976122294 35.59614822374522, -82.5115696122368 35.59607022372652, -82.51155361224858 35.595976223705705, -82.51150461231506 35.59549222360221, -82.51146261235075 35.5952152235415, -82.51142561236449 35.59508622351145, -82.51140661236848 35.5950402235002, -82.51136961237619 35.59495022347805, -82.51130861238319 35.594839223449185, -82.5112046123926 35.594666223403294, -82.51105961239999 35.59446222334689, -82.51102961240144 35.594420223335334, -82.51069561241754 35.59395622320655, -82.51062161242066 35.59385622317861, -82.51054861242378 35.59375722315097, -82.51050561242282 35.5937172231384, -82.51045361242068 35.59367522312456, -82.51045061240804 35.593754223140266, -82.51044561240069 35.59379622314837, -82.51040661233823 35.59416022321835, -82.51039461231743 35.59428222324192, -82.51038661230204 35.59437322325965, -82.5103556122752 35.59451422328513, -82.5103416122685 35.59454222328936, -82.51030161224853 35.594629223303016, -82.51015661219257 35.59483622333017, -82.51008661215913 35.594978223351866, -82.51005061213567 35.595091223371185, -82.51001261210322 35.59526122340183, -82.50999061208364 35.59536422342052, -82.5099606120621 35.59547222343946, -82.50994561205239 35.59551922344746, -82.5099256120395 35.595581223458005, -82.5098766120125 35.59570322347773, -82.50985461199953 35.59576422348796, -82.50972561191739 35.596158223554845, -82.50971561191325 35.59617422355706, -82.50967161189054 35.59627422357287, -82.50960161186188 35.59638522358823, -82.50955561184499 35.596445223595694, -82.5094246118044 35.59656722360713, -82.50917161173658 35.59673522361529, -82.50896661168402 35.59685522361858, -82.50889761166664 35.5968942236195, -82.5087786116389 35.59694622361781, -82.5087516116325 35.59695822361744, -82.50861761160311 35.59700522361325, -82.50818161151076 35.59713522359485, -82.50798161146824 35.59719622358675, -82.50773761141724 35.59726422357547, -82.5075516113789 35.59731322356636, -82.50743561135619 35.597335223558915, -82.50734261133893 35.59734722355174, -82.50718761131246 35.59735222353679, -82.5065126112036 35.597332223463376, -82.50622961115957 35.59731322343044, -82.50601861112617 35.59730322340675, -82.50576561108528 35.59729622337931, -82.50570761107612 35.59729322337275, -82.50539661102329 35.597301223342335, -82.50498561098948 35.59707822325472, -82.50498261098923 35.59707722325421, -82.5047876109683 35.59700322321913, -82.50461661095113 35.596930223186696, -82.5045146109433 35.59687122316423, -82.50445761094221 35.59681722314735, -82.50441261094352 35.59676022313113, -82.50436261095206 35.59665122310381, -82.50430061095432 35.5965692230808, -82.50421961095023 35.596509223060266, -82.50390261093816 35.59624622297418, -82.50389661093793 35.59624122297259, -82.50375961093478 35.59611422293264, -82.50368261093217 35.59604822291122, -82.50367861093207 35.59604422291006, -82.50359761094074 35.59590122287268, -82.50352561094842 35.59577422283936, -82.50332361096952 35.59541922274638, -82.50330961097075 35.595396222740284, -82.50323361097712 35.59527322270743, -82.50322961098976 35.59518722268958, -82.50321861102725 35.59493222263655, -82.50321561103979 35.59484722261895, -82.5032076110752 35.5946092225697, -82.50321461110035 35.59445322253871, -82.50325261113672 35.59425822250295, -82.50335961121023 35.59389622244035, -82.50342061124495 35.59373622241404, -82.50350461129665 35.593491222372904, -82.5036116113591 35.59320122232481, -82.50368761139869 35.59302622229708, -82.50375661143117 35.59288922227627, -82.50380961145122 35.59281622226684, -82.50389361147568 35.59274822226167, -82.50412261153365 35.59261822225882, -82.50427561157069 35.592542222259034, -82.50446561161411 35.59246522226292, -82.5046876116626 35.59238922227026, -82.50491361170997 35.5923252222805, -82.50517561176643 35.592240222290094, -82.50535061180602 35.59217222229429, -82.5054506118315 35.59211422229278, -82.50559561187018 35.59201922228833, -82.505677611891 35.59197222228716, -82.50561761189324 35.59189322226496, -82.50557261189229 35.591851222251755, -82.50545061188201 35.591786222226034, -82.50538261187627 35.591750222211736, -82.5051946118596 35.591656222173306, -82.50506861184871 35.59159122214709, -82.50492661183704 35.591514222116885, -82.50458961180945 35.5913302220448, -82.50450261180201 35.591285222026706, -82.5043606117899 35.59121122199702, -82.50427361178237 35.59116622197889, -82.50405961176385 35.59105622193462, -82.5040156117602 35.59103222192524, -82.50393061175323 35.59098622190708, -82.50391261175179 35.590976221903176, -82.50386161174752 35.59094922189245, -82.50384461174609 35.59094022188886, -82.5030736116809 35.590533221726815, -82.50252861163496 35.59024522161225, -82.50240361162545 35.59017222158453, -82.50222961161566 35.590048221541466, -82.50214461161269 35.58997622151802, -82.50200761161076 35.58984122147647, -82.5016676116005 35.58954222138072, -82.50158061159495 35.58948422135998, -82.50147661158393 35.589443221341, -82.50111361153722 35.58935622128598, -82.50082861150103 35.589284221241954, -82.50015461141524 35.589116221138575, -82.49998661139541 35.58906422111075, -82.50010561142761 35.58898322110643, -82.50046461152394 35.58874422109476, -82.50058461155609 35.58866422109084, -82.50087861163506 35.58846822108116, -82.50101561167183 35.588377221076755, -82.50176561187136 35.58788922105453, -82.50196461192422 35.587760221048775, -82.50206661194977 35.58770422104786, -82.50220861198542 35.587625221046416, -82.50226161199875 35.58759622104594, -82.50255161206958 35.58744822104561, -82.50264361209142 35.58740522104634, -82.50279161212649 35.58733722104776, -82.50286561214384 35.587304221048555, -82.5030386121841 35.587229221051096, -82.50308861219541 35.587209221052234, -82.50316461221236 35.58718122105431, -82.50354261229623 35.58704322106509, -82.5037096123318 35.586992221071895, -82.50405961240618 35.586886221086324, -82.5043146124583 35.58682222109949, -82.50483961256207 35.58671422113152, -82.50507061260627 35.58667522114731, -82.50540161266792 35.586631221172354, -82.50541261266999 35.5866302211733, -82.50566361271544 35.58660522119399, -82.50597761277085 35.58658322122179, -82.5061436127997 35.586575221237275, -82.50625161281815 35.586571221247475, -82.50649861285926 35.586570221272716, -82.50664461288316 35.58657222128808, -82.50681161291027 35.58657622130607, -82.50706361295106 35.586582221333195, -82.5071036129574 35.586584221337695, -82.50745461301221 35.5866062213783, -82.50798161309613 35.58662922143713, -82.5082746131425 35.58664322147004, -82.50865161320223 35.58666122151244, -82.50978361338164 35.58671522163974, -82.5101616134414 35.586734221682455, -82.51026861345855 35.58673822169429, -82.51059061350965 35.58675322173042, -82.5106986135268 35.58675822174258, -82.51087661355523 35.58676522176229, -82.51129861362381 35.58677422180747, -82.51160561367367 35.586781221840425, -82.51201461374136 35.586782221882665, -82.51231961379082 35.5867892219154, -82.51256561383006 35.586799221942755, -82.51310161392149 35.586783221994565, -82.5131766139342 35.58678122200194, -82.51340361397386 35.58676822202258, -82.51347061398621 35.586760222027856, -82.51354161399732 35.586764222035924, -82.5137016140253 35.58675522205057, -82.51442661415234 35.586711222116044, -82.51482561422304 35.586681222150986, -82.51514161428044 35.586649222176966, -82.5156916143798 35.58659622222271, -82.51605061444602 35.58655322225084, -82.51679761458499 35.58645522230767, -82.51749861471825 35.58634422235708, -82.51857861493147 35.58612322242307, -82.51887461499071 35.5860572224401, -82.5194146150978 35.58594322247241, -82.52082861537825 35.585645222557055, -82.52106661542561 35.58559422257118, -82.52178361556777 35.5854432226141, -82.52202261561501 35.585393222628454, -82.52210061563075 35.58537522263287, -82.52233761567827 35.58532222264634, -82.52236061568269 35.58531822264796, -82.52241761569385 35.585307222651565, -82.52246361569291 35.58536322266768, -82.52260161568994 35.58553122271601, -82.52264761568874 35.58558822273241, -82.52284961568442 35.585834222803214, -82.52309261568408 35.58609822288186, -82.52324561568403 35.58626322293112, -82.52349061568525 35.58651922300839, -82.52374761568831 35.58677622308708, -82.52452861570086 35.58753622332192, -82.5246806157033 35.587684223367646, -82.52498961570079 35.58803322347046)))",4543,37,021,001801,370210018012,1840,1840,82,1737,1365,325,6,27,0,14,103,1433,48,1385,1400,1137,230,6,18,0,9,33,928,874,54
census_2010_blockgroups_view.fid--2dc29038_13ec899ba8f_-25e6,"MULTIPOLYGON (((-82.57402664760819 35.43299119695073, -82.57401864757514 35.43319919699219, -82.5740126475555 35.43332119701643, -82.57399564749635 35.43369019708977, -82.57399064747672 35.43381319711425, -82.5739846474578 35.43393019713744, -82.57396864740123 35.434283197207634, -82.57396364738243 35.43440119723118, -82.57393864729536 35.4349441973391, -82.57389664714549 35.435880197525286, -82.57386464703418 35.43657419766322, -82.57383964694691 35.437118197771355, -82.57381364685716 35.43767719788245, -82.57373664658822 35.43935419821578, -82.5737116464986 35.43991419832716, -82.57370564647745 35.44004619835345, -82.5736876464136 35.440444198432616, -82.5736826463925 35.44057719845913, -82.57366164633046 35.44096019853491, -82.57364464627948 35.44127519859729, -82.5736396462527 35.441445198631385, -82.5736356462244 35.44162619866773, -82.57364364615977 35.442058198756506, -82.57364764615234 35.442111198767705, -82.57367664610473 35.442454198840416, -82.57368164609943 35.442494198849104, -82.57371464606638 35.44274619890378, -82.57381564596734 35.44350419906837, -82.57384864593631 35.44374319912033, -82.57385064593451 35.44375719912339, -82.57386164592364 35.44384019914141, -82.57389864588792 35.44411419920096, -82.57397164581944 35.44464119931565, -82.57404364574815 35.44518619943391, -82.57409164570142 35.445544199511666, -82.57415064564326 35.445988199608074, -82.57423064556717 35.446573199735326, -82.57424964554895 35.4467131997657, -82.57442664538146 35.448001200045965, -82.57445464534575 35.44826520010252, -82.57446264531819 35.44845420014186, -82.57445964529435 35.4486062001724, -82.57444464526671 35.448771200204526, -82.57442364524013 35.44892220023301, -82.57439464521046 35.44908520026323, -82.57436764518775 35.449204200284676, -82.5741036449921 35.450198200459994, -82.57380264476768 35.451339200661394, -82.57379964476583 35.451349200663074, -82.57379164476004 35.45137820066817, -82.57378964475802 35.45138920067018, -82.57374864472811 35.45154020069677, -82.57372064470665 35.451650200716244, -82.57370064469202 35.45172420072923, -82.57362864463879 35.45199420077686, -82.57360464462064 35.45208720079331, -82.57358964460911 35.45214620080378, -82.57357464459832 35.45220020081325, -82.57353264456685 35.452361200841665, -82.57351864455615 35.452416200851424, -82.57341964448109 35.4527992009193, -82.57341064447412 35.45283520092565, -82.57311564425524 35.453947201121714, -82.57301464417996 35.45433020118937, -82.57294064412514 35.454608201238315, -82.57276164399181 35.455286201358, -82.57272064396108 35.455443201385734, -82.57265064390677 35.455722201435385, -82.57263064389127 35.4558022014496, -82.57262064388041 35.455862201460825, -82.572610643868 35.45593220147396, -82.57260264384821 35.45605320149785, -82.57260764382968 35.45618020152418, -82.57262564381561 35.45629120154859, -82.57263864380626 35.4563662015652, -82.57264564380422 35.45638720157019, -82.57265964379985 35.45643120158056, -82.57257164378542 35.45643020157137, -82.57248564377363 35.45641420155931, -82.57228564374836 35.456362201528286, -82.5721526437288 35.4563462015114, -82.57205064371215 35.45634420150048, -82.57188764368222 35.45636320148774, -82.57186864367867 35.45636620148633, -82.5717136436478 35.45640020147747, -82.57153464361105 35.45644620146851, -82.57135664357551 35.456485201458236, -82.5712496435557 35.45649920145007, -82.57115864353983 35.45650420144178, -82.57106064352419 35.45650020143093, -82.57095464350967 35.45648020141599, -82.57077064348894 35.456416201384144, -82.57056964346785 35.456336201347305, -82.57043064345154 35.456292201324146, -82.57031364343555 35.45627020130768, -82.57021964342125 35.45626120129621, -82.57012364340449 35.456267201287616, -82.57002764338506 35.45629020128245, -82.5699236433615 35.45633120128016, -82.56984064333953 35.456385201282664, -82.56975564331259 35.45646920129101, -82.56971964329928 35.456517201297096, -82.5696546432735 35.4566152013104, -82.56961264325645 35.456681201319505, -82.5694256431744 35.45701520136837, -82.56935064314602 35.457119201381865, -82.56929264312568 35.45718920139019, -82.56924564311012 35.457240201395734, -82.56923164310571 35.45725420139718, -82.56920864309843 35.45727620139924, -82.56915364308144 35.457328201404216, -82.56903464304455 35.457440201414805, -82.5690286430428 35.45744520141523, -82.56849364287532 35.457960201465276, -82.56831564281944 35.458132201482016, -82.56785764267838 35.45855920152205, -82.56776364264915 35.45864820153058, -82.5671576424595 35.45923120158716, -82.56663064229201 35.459755201639794, -82.56655364226746 35.45983220164761, -82.56647964224369 35.45990720165527, -82.56598164208337 35.460416201707865, -82.56561564196794 35.46077420174326, -82.5655786419641 35.46075920173645, -82.56547964193679 35.46083020174072, -82.56424964161009 35.46163320177818, -82.56403664155147 35.46178520178735, -82.56376964147279 35.46201020180577, -82.56352464139637 35.462244201828256, -82.56339964135735 35.46236420183987, -82.56323564130872 35.46250420185155, -82.56306864126529 35.46260720185546, -82.56297164124324 35.46264620185347, -82.56285864121755 35.462692201851254, -82.5626636411743 35.4627632018457, -82.56240464111546 35.462867201840425, -82.56240264111487 35.46286920184062, -82.56216364105788 35.46298220183909, -82.56189964099254 35.46312320184079, -82.56171964094699 35.46322620184327, -82.56159864091478 35.463305201846936, -82.56147764088176 35.46339020185191, -82.5613566408455 35.463496201861076, -82.56120764079772 35.463647201876576, -82.56096064071167 35.46394220191123, -82.56091664069604 35.46399620191774, -82.56074564063421 35.46421520194482, -82.56061864058537 35.46439720196883, -82.56060064057701 35.464432201974155, -82.56055264055483 35.464525201988145, -82.56054864055288 35.464533201989354, -82.56051364053198 35.46463220200587, -82.56048964051148 35.46474020202542, -82.56048364049732 35.464826202042325, -82.5604856404917 35.46486520205039, -82.56049264047543 35.464979202074325, -82.56050964046216 35.46508420209747, -82.56054464044607 35.46522720213015, -82.56060564042544 35.46542820217727, -82.56063464041205 35.46554720220445, -82.56063664040994 35.4655632022079, -82.56064364040334 35.46561420221899, -82.56063964039498 35.46566420222878, -82.56062164038293 35.465723202238934, -82.56058264036731 35.465783202247195, -82.56053564035284 35.46582720225132, -82.56046864033513 35.465870202253164, -82.56036764031136 35.46591620225223, -82.56000464023072 35.46605020224227, -82.55988464020197 35.466107202241595, -82.55981764018375 35.46615420224427, -82.55975564016526 35.46620820224894, -82.55970464014746 35.46626920225618, -82.5596586401276 35.46634920226771, -82.55962464010986 35.46642820228026, -82.5595936400891 35.466530202297854, -82.55955464005744 35.466695202327415, -82.55953264003892 35.466792202344884, -82.55950264001315 35.46692820236949, -82.55946263998374 35.46707720239574, -82.55938963993651 35.46730620243487, -82.55936263992247 35.46736920244497, -82.55935163991666 35.4673952024491, -82.55928763988672 35.46752120246814, -82.55913763982728 35.46774720249881, -82.55887263972858 35.46810520254447, -82.55879063969593 35.46823020256157, -82.55874263967442 35.46831820257451, -82.55873463967086 35.468333202576815, -82.55870763965727 35.46839220258603, -82.5585216395604 35.468824202654886, -82.55828363943203 35.469405202748675, -82.55823263940023 35.46955720277444, -82.55820663938104 35.469655202791714, -82.55819163936557 35.46974020280743, -82.55818663935295 35.46981720282264, -82.55818263933864 35.46990620284035, -82.55818763932344 35.47001120286217, -82.55821463929112 35.470251202913786, -82.5582176392785 35.470337202931574, -82.55822663924754 35.47054920297561, -82.55822063921897 35.47072920301162, -82.55820163919316 35.470877203039805, -82.55818063917154 35.47099620306186, -82.55812663912556 35.47123820310554, -82.55811763910813 35.47134220312581, -82.55811563909047 35.471455203148636, -82.55812663907611 35.47156120317132, -82.55815263906342 35.47167220319657, -82.55816763905655 35.47173320321046, -82.55845463895784 35.472689203434356, -82.55846563895433 35.472724203442645, -82.5584816389487 35.472778203455285, -82.55851263893796 35.472882203479564, -82.55852563893328 35.472926203489905, -82.55855563891384 35.47308620352553, -82.55855363889772 35.47318920354623, -82.55855063889493 35.47320420354898, -82.55854063888071 35.473286203564705, -82.55853263887543 35.47331220356912, -82.55851463886307 35.47337320357975, -82.55846963883788 35.47348920359874, -82.55837963879813 35.47365120362241, -82.55836063878992 35.4736842036272, -82.55831563877027 35.4737642036389, -82.55815163870406 35.47401920367397, -82.55809463867925 35.474119203688495, -82.55805663866043 35.47420120370131, -82.55803463864663 35.474267203712465, -82.55801763863316 35.47433720372493, -82.55800663861629 35.47443520374374, -82.55798763855289 35.47482920382203, -82.55798563854286 35.4748922038346, -82.55795563848466 35.475240203902345, -82.55788163834316 35.47608420406651, -82.55780663821182 35.47686120421693, -82.55777463817206 35.47708620425942, -82.55771763812771 35.47731420429999, -82.55766363809677 35.477458204323746, -82.5576026380673 35.47758420434309, -82.55751063802678 35.477749204367264, -82.5574006379812 35.477928204392455, -82.55732263794646 35.478070204413356, -82.55725563791277 35.47821820443658, -82.55722063788906 35.4783352044568, -82.55720063786859 35.4784472044775, -82.55719863785056 35.47856220450071, -82.55720963783348 35.47868620452705, -82.55723163782241 35.478782204548914, -82.55728663781065 35.47891820458214, -82.55737563780407 35.479058204619776, -82.55750663780083 35.47922120466637, -82.55773863779919 35.47948320474343, -82.55793763780049 35.47969020480598, -82.55807963780374 35.47982220484734, -82.55833563781563 35.48002220491428, -82.5588076378418 35.48036220503179, -82.55897063784937 35.48048920507434, -82.55910863785353 35.48061120511334, -82.55924363785637 35.48073920515319, -82.55927463785643 35.4807722051631, -82.5593516378571 35.480851205187, -82.55943163785602 35.48094520521435, -82.55947463785336 35.481009205231814, -82.55953263783542 35.481189205274404, -82.55935363780038 35.48122420526316, -82.55925963778188 35.48124320525738, -82.55816763756633 35.48146820519126, -82.55763163746242 35.481566205156305, -82.55736363745447 35.481328205080416, -82.55725063745489 35.481203205043414, -82.5572046374552 35.48115120502812, -82.55706263746617 35.48092620496785, -82.55699963748022 35.480766204928756, -82.55687363750373 35.480476204856885, -82.55676263754393 35.48009320476761, -82.55655763755927 35.479771204681064, -82.55638363760912 35.47925720455865, -82.55632263765798 35.478872204474094, -82.55624563771897 35.47839020436817, -82.556296637811 35.47784420426223, -82.55621863784708 35.47752420418919, -82.55620563791373 35.477074204096255, -82.55611063795956 35.47667220400477, -82.55604963801817 35.47622320390711, -82.5558916380338 35.475950203835424, -82.55574363805773 35.4756332037557, -82.55563863807531 35.47540520369861, -82.5553536380869 35.475020203591114, -82.55500363808068 35.474682203486445, -82.55471863809238 35.4742972033789, -82.55459263811345 35.47402320331028, -82.55453663811562 35.47394820328932, -82.55440163812094 35.47376720323867, -82.55427463813201 35.473557203182835, -82.5540846381471 35.473253203101564, -82.5538786381549 35.47297920302476, -82.55375363819537 35.47257920293054, -82.55369163823435 35.47225720285867, -82.55348763830858 35.47155120269412, -82.55323563837254 35.470860202527774, -82.55307763843001 35.47031420240047, -82.5527946384861 35.46964120223463, -82.55252563851262 35.469176202112415, -82.552322638526 35.46886920202917, -82.55206663854247 35.46848420192465, -82.55165363854269 35.468035201791, -82.55125663853828 35.4676342016687, -82.55105063855589 35.467296201578904, -82.55076563857489 35.466863201461635, -82.55057663860998 35.466429201353925, -82.55034563867115 35.465779201198046, -82.5501906387122 35.465343201093454, -82.55003463875299 35.46490720098882, -82.54998763876561 35.4647742009569, -82.54978263877993 35.464458200871675, -82.54913763882531 35.46346320060313, -82.54876963882751 35.46305020048145, -82.54694763883855 35.46100419987862, -82.5467706388349 35.46083619982633, -82.54618263882405 35.46027019965095, -82.5456436387996 35.45984619950955, -82.54551863879385 35.459748199476756, -82.54487863873645 35.459430199346606, -82.54463363871109 35.459331199301374, -82.54452763873756 35.45904319923187, -82.54451463879539 35.4586511991508, -82.54459663887087 35.45824619907687, -82.54475763895124 35.457895199021955, -82.54564263926568 35.4567981988894, -82.54675763962358 35.45566619877325, -82.54726663978578 35.455157198721835, -82.54795263999333 35.45454319866715, -82.54871264022454 35.453855198605005, -82.54942064041938 35.45334819857435, -82.55001364056427 35.45304319857301, -82.550440640665 35.45284719857686, -82.5506266407088 35.45276219857859, -82.55162064094299 35.45230819858798, -82.55305864124713 35.451877198647544, -82.55472764157874 35.45151719874511, -82.55576764176567 35.45142219883234, -82.55626464185657 35.45136619887183, -82.55675264194574 35.45131219891071, -82.55753164210691 35.45110219894777, -82.55845764231915 35.45071819896446, -82.55896764245523 35.45038019894786, -82.55926764254274 35.45013319892833, -82.55956364262923 35.449888198908816, -82.55964064269573 35.44953719884532, -82.55979264282676 35.44884419871979, -82.55972064294998 35.447960198532556, -82.55967164296712 35.44779519849397, -82.55943264305266 35.446976198302885, -82.55916864312007 35.44624919812794, -82.55813164326645 35.44416719759827, -82.55815664327076 35.44416619760065, -82.55823264328376 35.44416319760777, -82.5582556432876 35.44416319761015, -82.55825864328824 35.44416219761027, -82.55838864331025 35.444159197622916, -82.55852164333302 35.44415419763551, -82.55867064336336 35.44411719764322, -82.5587516433809 35.44409019764606, -82.55890564340795 35.44408019765978, -82.55902664342602 35.44409319767477, -82.55918164346338 35.4440171976752, -82.55926964349116 35.4439301976665, -82.55930464352053 35.44377619763875, -82.55933364355214 35.4436011976061, -82.5593886435848 35.44344719758037, -82.55947064362007 35.44330519755992, -82.55957264364953 35.44322319755366, -82.55967364367186 35.44318619755648, -82.55987464370651 35.44317719757526, -82.56013564374786 35.44319019760454, -82.56052364380324 35.44324819765608, -82.56070464382474 35.44330419768599, -82.5608506438445 35.44333319770679, -82.5609456438666 35.44329119770806, -82.56103364388886 35.44324119770683, -82.56112064391317 35.4431761977025, -82.56121564394302 35.4430841976935, -82.5612766439707 35.44296919767637, -82.56134064400798 35.442794197647316, -82.56138264404268 35.44261319761477, -82.5614446440806 35.44243219758435, -82.56143864409982 35.44230019755678, -82.56150764413215 35.44216319753601, -82.56157164417864 35.441928197494725, -82.56166164423634 35.44164819744701, -82.56172364428014 35.441429197408794, -82.56181964431607 35.44129819739199, -82.56196864436407 35.441145197376066, -82.56222564444076 35.440922197357, -82.56230664447165 35.44080819734214, -82.56235064451906 35.44054519729309, -82.56228564454207 35.440324197241516, -82.56220064454646 35.44020319720821, -82.56204164454381 35.44004819716038, -82.56196864454697 35.43994819713251, -82.56187064455352 35.43979919709219, -82.56178464456877 35.43960619704417, -82.56175364458805 35.43944619700843, -82.56172764468779 35.43876519686719, -82.56170564471323 35.438575196826285, -82.56170264471575 35.438555196821945, -82.56171764475015 35.438346196780955, -82.56173264477242 35.43821719675627, -82.56177364481175 35.43800419671706, -82.56181564484551 35.43782819668554, -82.56187764488338 35.43764819665528, -82.56194064490184 35.43759519665099, -82.56199464491785 35.43754919664705, -82.56213664495635 35.437451196641696, -82.56226464498336 35.43741319664705, -82.56241964501153 35.4373971966597, -82.56251364502693 35.43739819666947, -82.56260164504639 35.43736619667197, -82.56278264507885 35.4373501966873, -82.5629846451121 35.43735119670814, -82.56307864513096 35.43733019671351, -82.56344764517817 35.437421196769805, -82.56350864518096 35.43746919678576, -82.56357464518392 35.437521196803104, -82.56366164519414 35.437549196817656, -82.56386164520097 35.4377211968731, -82.56400164521226 35.437799196903306, -82.564154645219 35.43792119694382, -82.56423964522418 35.437979196964356, -82.56426864522595 35.43799919697132, -82.56441564523837 35.43807719700226, -82.56455664525565 35.43811719702481, -82.56462664526003 35.438164197041566, -82.56466064526218 35.4381871970497, -82.5647436452755 35.4381901970588, -82.56485164529849 35.438157197063184, -82.56499364533191 35.43809219706443, -82.56509464534945 35.43808719707377, -82.5652216453686 35.43809919708924, -82.56534864538449 35.43813319710913, -82.56548964539836 35.43819519713615, -82.56560364540547 35.43827219716346, -82.56572364541164 35.438362197194174, -82.56587064542167 35.438456197228284, -82.5659276454265 35.438486197240216, -82.56599764543247 35.4385231972549, -82.56616464545236 35.43857419728231, -82.5662926454693 35.4386021973011, -82.56642664548794 35.43862519731954, -82.56654064550766 35.438620197330195, -82.56662864552628 35.43859319733365, -82.56670264554349 35.43856119733472, -82.56671664554814 35.43854619733315, -82.56678364556947 35.43847919732632, -82.56685864559695 35.43838019731385, -82.5669126456127 35.43833619731047, -82.56696064562475 35.438309197309906, -82.5671826456631 35.43829919733052, -82.5672826456786 35.4383061973422, -82.56745064571135 35.4382741973529, -82.5675096457237 35.43825719735544, -82.5675656457354 35.438241197357925, -82.56766064576034 35.43818119735548, -82.56773264577808 35.43814319735504, -82.56781564579839 35.43810019735479, -82.56794464583565 35.43799619734683, -82.56804664587015 35.43788119733386, -82.56810764590041 35.43774919731331, -82.56811564591858 35.43763919729171, -82.56810164592983 35.43755019727219, -82.56809664593388 35.437518197265206, -82.56809164595754 35.4373581972321, -82.56808164596481 35.437299197219055, -82.56806664597612 35.43720919719924, -82.56804364599627 35.43705219716491, -82.56802164601586 35.43690019713178, -82.56796964603001 35.43675119709611, -82.56793764605005 35.43658519705909, -82.56789464608308 35.43632219700116, -82.5678806460945 35.436232196981344, -82.56784264611153 35.43607919694637, -82.56785664613854 35.43591819691502, -82.56783864615906 35.435764196881905, -82.56786664619227 35.435577196846715, -82.5678686462153 35.43542819681657, -82.56790964624399 35.43528519679172, -82.56797864628227 35.435109196762916, -82.56814364637086 35.43470819669824, -82.56823264640651 35.434571196679435, -82.56834164644734 35.434422196660314, -82.56844964648359 35.43430219664688, -82.5686546465561 35.43405019661661, -82.56877064660297 35.433869196591694, -82.56879264660645 35.43387019659407, -82.56901564669553 35.43352919654756, -82.56917864674847 35.433359196529636, -82.56945764685162 35.43298619648234, -82.56956664689064 35.43284919646553, -82.5696546469236 35.43272919645012, -82.5697166469533 35.43260219643063, -82.56978564699236 35.43242119640088, -82.56984064703002 35.43223419636849, -82.56984264705734 35.43205719633268, -82.5698706470838 35.43191419630641, -82.5700006471355 35.43171719627961, -82.5701236471861 35.43151919625187, -82.57022564723812 35.431289196215566, -82.57025664724888 35.4312521962112, -82.57075664733762 35.431214196254636, -82.57103564738156 35.43122919628623, -82.57196064750143 35.431448196425386, -82.572687647594 35.431631196536976, -82.57367464770944 35.43194619670203, -82.57405064773872 35.43216219678446, -82.57405064770064 35.43241219683534, -82.57402664760819 35.43299119695073)))",6047,37,021,002301,370210023013,895,895,29,883,840,17,1,17,0,8,12,763,20,743,755,727,12,1,10,0,5,8,528,472,56
census_2010_blockgroups_view.fid--2dc29038_13ec899ba8f_-25e5,"MULTIPOLYGON (((-82.46820862213416 35.48494219667669, -82.46822562213697 35.484942196678425, -82.46827862214525 35.484945196684436, -82.46829662214807 35.48494619668649, -82.46833662215452 35.484947196690804, -82.46845862217394 35.48495219670433, -82.46849962218042 35.48495419670897, -82.46861862219934 35.48495919672211, -82.46862162219985 35.48495919672247, -82.46870762221316 35.48496519673249, -82.46884762223482 35.484975196748906, -82.46898362225484 35.48499119676609, -82.46898962225568 35.48499219676692, -82.4691106222722 35.485015196784, -82.46920662228426 35.48504019679893, -82.46922062228596 35.48504419680116, -82.46931962229706 35.48507819681825, -82.46941362230591 35.485122196836826, -82.46948162231136 35.485160196851545, -82.46956962231842 35.48520919687054, -82.46980862233646 35.48534919692351, -82.47011962236155 35.48552119699035, -82.47012862236228 35.48552619699232, -82.47075662243691 35.48571719709553, -82.47118262249224 35.48581619715936, -82.47160262254211 35.48594419722843, -82.47193662257801 35.4860701972883, -82.47195562257997 35.486078197291896, -82.47232562261786 35.48623019736073, -82.47251662263493 35.48632519739965, -82.4727786226586 35.48645419745274, -82.4730266226819 35.4865691975015, -82.47308062268684 35.48659519751235, -82.47338162271875 35.48671219756703, -82.47363462274895 35.486788197608405, -82.4739456227876 35.486872197657405, -82.47433462284152 35.486940197711064, -82.47466462288837 35.486991197755344, -82.4747926229064 35.487011197772496, -82.47522562296889 35.48707119782908, -82.47526262297423 35.487076197833886, -82.4756816230331 35.48714419789072, -82.47589262306275 35.487179197919446, -82.47705262322863 35.48734919807302, -82.47716862324513 35.48736619808838, -82.47751062329475 35.48741219813278, -82.47754662329997 35.48741719813747, -82.47765462331535 35.48743319815183, -82.4776916233206 35.48743919815681, -82.47802062336768 35.487487198200384, -82.47881062348038 35.48760519830544, -82.4790076235066 35.48764619833388, -82.4793346235504 35.487714198381276, -82.4795936235854 35.48776519841818, -82.48018862366577 35.48788319850323, -82.48036962368911 35.487926198530474, -82.48062762372246 35.48798719856939, -82.48065462372601 35.48799319857336, -82.48073862373688 35.488013198586, -82.4807666237405 35.48802019859036, -82.48092762376139 35.48805719861434, -82.48141262382414 35.48817119868729, -82.48148262383327 35.488188198697976, -82.48157262384383 35.48821619871288, -82.48168362385675 35.48825119873131, -82.48201762389598 35.488356198786924, -82.48212962390906 35.48839219880577, -82.48236962393715 35.48846819884577, -82.48309162402168 35.488696198966196, -82.48333262404985 35.48877219900639, -82.48358162407911 35.488850199047754, -82.48377162410145 35.48891019907945, -82.48405962413389 35.48900919912916, -82.48432662416396 35.489101199175224, -82.48457462419188 35.48918719921812, -82.48474062421076 35.4892431992465, -82.4847786242149 35.48925719925323, -82.48505462424866 35.48933519929742, -82.4852466242721 35.4893891993281, -82.48541562429276 35.4894371993552, -82.48584162434496 35.489556199423035, -82.48616762438304 35.48966019947762, -82.48658562443165 35.489794199547774, -82.48695562445486 35.490042199636186, -82.48743562446613 35.49048719977586, -82.48785962451116 35.49065119985264, -82.48795662452842 35.49064319986095, -82.48824762458028 35.49061919988593, -82.48831862459282 35.49061419989223, -82.48834262459876 35.49060119989204, -82.48832762458868 35.49065119990067, -82.48828862457349 35.490708199908234, -82.48821362455001 35.490780199915186, -82.48814362452967 35.490837199919625, -82.48806262450495 35.49091119992634, -82.488001624489 35.49094919992779, -82.48791662446817 35.49099319992801, -82.48785162445054 35.49103819993048, -82.48781962444043 35.49106919993353, -82.48780262443312 35.49109919993788, -82.48779162442416 35.4911451999461, -82.48779062441942 35.49117519995215, -82.48780962440381 35.491297199978874, -82.48783362439045 35.49141020000435, -82.4878766243731 35.491570200041245, -82.48802662433906 35.49195420013468, -82.4880916243297 35.492085200167935, -82.48820062432335 35.49224420021148, -82.48821362432265 35.492263200216705, -82.488310624319 35.49239120025267, -82.48845762431912 35.49254920029988, -82.48860962432252 35.49269120034436, -82.48871362432598 35.492781200373265, -82.48900762434072 35.49300220044841, -82.4892076243567 35.49311420049169, -82.48934962436904 35.493187200521035, -82.48950762437721 35.49330420056105, -82.48965762437982 35.4934492006059, -82.48981862438148 35.49361220065554, -82.48996862438361 35.49376020070108, -82.49007362438181 35.493885200737274, -82.49026262436819 35.494178200816194, -82.49030262436503 35.49424220083329, -82.49035162435672 35.4943492008601, -82.49039162434647 35.49445920088653, -82.49043962433741 35.49457020091409, -82.49048262433654 35.49462220092905, -82.49055062433861 35.49468220094816, -82.49071662434706 35.49480620099049, -82.49085662435608 35.49489820102349, -82.49091462435992 35.49493620103716, -82.49114362437928 35.4950572010852, -82.49142962441023 35.49516420113638, -82.49165062443639 35.49523220117285, -82.49191062446872 35.495302201213775, -82.49221762450823 35.49537620126028, -82.49258362455605 35.49545920131465, -82.49288362459467 35.495531201360116, -82.49306362461772 35.495575201387524, -82.49337062466061 35.495627201429556, -82.49351662468324 35.495637201446556, -82.49375662472592 35.4956182014674, -82.49391562475708 35.495586201477124, -82.49412362479474 35.49556520149416, -82.49430262482637 35.495552201509916, -82.49447062485159 35.49556920153053, -82.4946716248751 35.49563320156426, -82.49478662488372 35.495701201589796, -82.49481362488419 35.49572720159791, -82.49488362488523 35.49579620161914, -82.49500762488336 35.495942201661464, -82.49511662487795 35.49609520170374, -82.49518162486925 35.49622220173631, -82.49519162486816 35.49624020174097, -82.49528562485953 35.49639720178258, -82.4953476248481 35.49653920181776, -82.49552662482857 35.49685920190119, -82.49563262482438 35.49700120194098, -82.49572662481887 35.49713920197862, -82.49577662481116 35.49724320200487, -82.49580262479921 35.497349202029085, -82.49582462478246 35.49748220205845, -82.49588562472674 35.49791120215192, -82.49591862469714 35.49814020220181, -82.49595262467349 35.498331202244145, -82.49599362466273 35.49844520227153, -82.49605062466478 35.49849320228716, -82.4959806246371 35.49859820230133, -82.4959326246091 35.498729202323034, -82.49591762459514 35.49880420233675, -82.4958916245686 35.49894920236354, -82.49586562452053 35.499234202418826, -82.49584762446422 35.49958220248779, -82.495836624425 35.49982620253624, -82.49582362437012 35.50016920260462, -82.49578762428887 35.50066020270086, -82.49576062424478 35.500918202750476, -82.49568962417469 35.50129920282074, -82.49556262407053 35.50184120291785, -82.49554462405537 35.50192020293209, -82.49546462399276 35.50224220298937, -82.49529262387516 35.502823203089825, -82.49524862384118 35.50299720312071, -82.49522162381342 35.503149203148894, -82.49520262378864 35.50329020317561, -82.49519462375446 35.50350420321827, -82.49519262373599 35.50362220324205, -82.4951796237004 35.50384020328502, -82.49516362367264 35.50400420331676, -82.49512662363537 35.504207203354305, -82.49503062355745 35.50461120342653, -82.49490162346196 35.505094203511526, -82.49468462330852 35.505860203645, -82.4944746231524 35.50665120378427, -82.49444662312642 35.506790203809715, -82.49444662312595 35.5067932038103, -82.49443762311708 35.506841203819135, -82.49443062308653 35.50703220385727, -82.49444962305785 35.507240203901524, -82.49449762302993 35.507474203954025, -82.49456462301045 35.50767320400135, -82.49460262299019 35.50784620404046, -82.49461462297056 35.507987204070425, -82.49460262294296 35.50815420410305, -82.49457562290871 35.50834820413975, -82.49455262288781 35.50845920415997, -82.4944896228391 35.50870920420433, -82.49442562277818 35.50903720426441, -82.49441762276636 35.509105204277496, -82.49436562269076 35.50954220436099, -82.49435662268228 35.50958720436925, -82.49410562244357 35.51087220460475, -82.49409662241904 35.51102220463431, -82.49409662241676 35.51103720463735, -82.49411362239636 35.51118820466981, -82.49416362237612 35.511374204712794, -82.49420562236469 35.511494204741446, -82.494255622351 35.511637204775646, -82.49437662232302 35.51195020485172, -82.49444162231039 35.51210220488932, -82.49453762229692 35.5122942049382, -82.49484662225353 35.512910205095196, -82.49517362220409 35.513585205266004, -82.49544762215301 35.51421320542178, -82.49565162212042 35.514646205530745, -82.49568062211566 35.51470820554631, -82.49600462205711 35.5154392057282, -82.49604262205033 35.515524205749394, -82.49606362204635 35.515573205761555, -82.4961056220344 35.51569620579088, -82.49613562202254 35.51580620581634, -82.49615662200972 35.515912205840024, -82.49617762199031 35.51606120587245, -82.49620462193442 35.516454205955114, -82.49620462193099 35.516476205959655, -82.49621362190474 35.51665720599738, -82.49621262184964 35.51701520607005, -82.49619262178426 35.51741920615014, -82.49617562175527 35.51759020618318, -82.49612762170139 35.51788920623907, -82.49607962166719 35.51806020626892, -82.4959086215596 35.51857620635632, -82.49585862152624 35.5187402063845, -82.49581862149311 35.518912206415344, -82.49571962139704 35.51943120651076, -82.4956876213723 35.51955820653331, -82.49567262136256 35.519605206541314, -82.49565362134987 35.51966720655194, -82.49560462132195 35.51979620657315, -82.49555762129994 35.519889206587294, -82.49547562126799 35.52000920660322, -82.49538662123695 35.52011520661564, -82.49509062114001 35.52042720664874, -82.49506162112993 35.520461206652705, -82.49502162111767 35.520498206656114, -82.49479662104568 35.520724206678985, -82.49471762102029 35.520804206687096, -82.49460962098496 35.52091820669918, -82.49445062092661 35.52112620672521, -82.49430862086892 35.52134920675595, -82.49414562079863 35.52163120679656, -82.49410562078101 35.5217022068069, -82.49400362073288 35.521906206837954, -82.49398462072033 35.5219672068484, -82.49398062071785 35.52197920685045, -82.49397962070903 35.522035206861666, -82.49399162070063 35.52210320687678, -82.49401662069795 35.52214720688829, -82.49405162069843 35.52218220689899, -82.49409162070121 35.522207206908135, -82.49413462070619 35.522221206915425, -82.49418262071335 35.522226206921346, -82.49422762072145 35.522222206925164, -82.4942716207302 35.522212206927634, -82.49431562073981 35.52219720692918, -82.49447462077664 35.52212920693164, -82.4945756207973 35.52210320693667, -82.49462562080593 35.522101206941414, -82.49468762081466 35.52211120694978, -82.49473862082017 35.52213020695888, -82.49478062082326 35.522155206968314, -82.49481262082386 35.52218620697784, -82.49484462082208 35.52223220699052, -82.49486762081806 35.522283207003206, -82.49491362079988 35.52245120704214, -82.49493562078827 35.52255020706456, -82.49495062077072 35.52268120709272, -82.49494662075968 35.52274820710592, -82.49492462074438 35.5228242071191, -82.49483662069949 35.5230222071504, -82.49476962066191 35.52319420717843, -82.49475762065394 35.52323320718515, -82.49475462064684 35.52327620719357, -82.49476562064132 35.523324207204475, -82.49479362063964 35.52336520721568, -82.49483062064131 35.52339420722542, -82.49487362064569 35.52341220723349, -82.49492662065262 35.5234242072413, -82.49503062067016 35.523422207251606, -82.49515162069261 35.523406207260734, -82.49525762071563 35.52337120726453, -82.49530462072704 35.52334720726449, -82.49540362075311 35.52328420726184, -82.49546562076834 35.523252207261685, -82.49552562078131 35.523232207263746, -82.4955796207913 35.52322520726782, -82.49564362080132 35.52322920727531, -82.49570162080833 35.523246207284636, -82.49580562081907 35.52328820730389, -82.49604762084013 35.52341220735396, -82.49613462084659 35.523464207373465, -82.49620362084912 35.52352220739229, -82.49627262084906 35.523597207414674, -82.49637762084708 35.52372320745104, -82.49643262084886 35.523771207466524, -82.49649462085367 35.52380620747993, -82.49655662085964 35.523834207491994, -82.49660662086552 35.52385020750037, -82.49665062086974 35.523870207508956, -82.49668662087196 35.52389420751752, -82.49670762087118 35.52392220752536, -82.4967116208672 35.52395220753188, -82.49670662086214 35.5239802075371, -82.49668262085353 35.524010207540684, -82.49664062084246 35.52403720754185, -82.49657862082796 35.524064207541045, -82.49649362080913 35.52409520753858, -82.49641462079242 35.524119207535364, -82.49631262077287 35.52413620752839, -82.49622762075823 35.52413920752028, -82.4961306207437 35.52413020750846, -82.49595262071904 35.524098207483696, -82.49580962069918 35.52407320746393, -82.49560262066866 35.524049207437756, -82.4955106206545 35.52404220742696, -82.49541862063907 35.52404320741767, -82.49536362062857 35.52405220741385, -82.49529562061436 35.5240712074108, -82.49522962059712 35.52411220741233, -82.49518762058372 35.52415420741661, -82.49515162056817 35.524217207425686, -82.49505962051929 35.52443620746083, -82.49501562049946 35.52451720747273, -82.4949856204878 35.52456120747855, -82.49493062046948 35.52462120748519, -82.49488762045512 35.52466820749033, -82.49455362035619 35.524952207513735, -82.49446162033034 35.525021207518414, -82.49438162030897 35.52507420752093, -82.49428162028379 35.525130207522075, -82.49395662020596 35.52528620752043, -82.49387462018707 35.525321207519085, -82.49322562003609 35.52560420751005, -82.49306961999913 35.52567620750868, -82.49299561998336 35.52569920750573, -82.49289961996506 35.5257152074992, -82.49268461992725 35.52572920747992, -82.49254561990314 35.52573620746711, -82.49243861988252 35.52575520745995, -82.49237361986899 35.525773207456936, -82.49214061981492 35.525874207453626, -82.49204461979322 35.52591220745147, -82.49180561974222 35.525986207441974, -82.49172761972409 35.52602020744089, -82.49166161970624 35.52606520744333, -82.4916096196891 35.52612020744911, -82.49156361967184 35.52618320745722, -82.491438619616 35.52641220749091, -82.49137961959481 35.52648620749995, -82.49129561957258 35.526540207502286, -82.49119461954959 35.52658120750025, -82.49109561952942 35.52660620749521, -82.49100861951432 35.526610207487025, -82.49093461950311 35.52660320747807, -82.4908616194946 35.526580207465926, -82.49075661948693 35.52651720744224, -82.49053261947624 35.52634520738436, -82.49052361947577 35.526338207382004, -82.49036861946948 35.52621220734045, -82.49007961946364 35.5259382072551, -82.48990961945884 35.5257862072067, -82.48974661945685 35.525623207156826, -82.48969461945676 35.52556820714033, -82.4896566194541 35.525544207131496, -82.48960661944703 35.52553620712481, -82.48955961943734 35.52554920712259, -82.48953061942879 35.52557320712448, -82.48952461942123 35.52561620713259, -82.48954061941603 35.52566720714463, -82.4895956194139 35.525740207165114, -82.48961161941381 35.52575820717041, -82.48970061941321 35.52585820719987, -82.48979161941112 35.52597020723196, -82.48985861940376 35.526090207263294, -82.48989761939426 35.526194207288455, -82.48991561938173 35.52629520731084, -82.48991461937138 35.52636120732421, -82.48990261936046 35.52641920733467, -82.4899016193589 35.526428207336394, -82.48987461934585 35.52648420734507, -82.48982661932881 35.52654320735214, -82.48974861930516 35.526613207358395, -82.48970361929129 35.52665520736225, -82.48956861924911 35.52678420737468, -82.48952461923524 35.52682720737887, -82.48943461921188 35.52688220738081, -82.48940661920662 35.52688620737873, -82.48935461919675 35.526894207374994, -82.48927061918613 35.526873207362186, -82.48917861917613 35.526838207345634, -82.48905361917149 35.5267342073116, -82.48887861916835 35.52656620725945, -82.48884161916756 35.52653120724862, -82.48875361916437 35.52645720722448, -82.48864361915612 35.526392207199954, -82.48841761913536 35.526283207154634, -82.48776861906083 35.526069207044486, -82.4873306190178 35.52587720696047, -82.4872296190104 35.52581620693769, -82.48715861900735 35.52575920691888, -82.48699061900493 35.5255942068681, -82.48692161900165 35.525541206850164, -82.4868426189948 35.525500206833755, -82.4868306189938 35.525494206831326, -82.48670761897995 35.52545120680994, -82.48650861895489 35.52540020677917, -82.48626561892274 35.52534720674339, -82.48609161889895 35.5253142067189, -82.48593361887643 35.525291206697936, -82.48592961887576 35.525291206697524, -82.48582561885938 35.52528520668566, -82.48565061882793 35.525301206670925, -82.48545861879198 35.52532820665669, -82.48530161876235 35.525352206645515, -82.48520661874446 35.52536620663854, -82.48503461871482 35.52537420662258, -82.48491961869769 35.52536120660805, -82.48483361868739 35.525335206594015, -82.48478761868373 35.52531020658419, -82.48477461868262 35.52530320658145, -82.48471861868268 35.52524220656328, -82.48468161868718 35.52517320654548, -82.48465261869542 35.52508820652517, -82.48461261869728 35.52503320650993, -82.48456361869266 35.52501020650016, -82.48451061868269 35.525018206496384, -82.48447361867191 35.52504820649869, -82.48445661866296 35.52508820650502, -82.48445261864022 35.525232206533886, -82.48445461861576 35.52539320656686, -82.48446761860566 35.52547320658446, -82.48449061859888 35.525542206600875, -82.48459461859092 35.525706206644884, -82.4847226185835 35.525892206695836, -82.48479561857378 35.526034206732184, -82.48479661857334 35.52603820673317, -82.48490861854785 35.526325206802966, -82.48496061854534 35.526397206822956, -82.48503961854911 35.52645820684344, -82.48506761855207 35.526469206848624, -82.48507661855304 35.5264722068501, -82.48510361855583 35.52648320685512, -82.48511361855684 35.52648720685695, -82.48512961855863 35.52649320685988, -82.4851466185603 35.52650020686296, -82.48517861856425 35.526509206868155, -82.48519561856614 35.52651520687105, -82.48522861857022 35.52652420687631, -82.48523061857048 35.526525206876656, -82.48533061858362 35.52654720689146, -82.48536461858798 35.526555206896546, -82.4853006185722 35.52658920689687, -82.48525061855966 35.526617206897505, -82.48510761852575 35.526683206896216, -82.48504261851028 35.52671420689581, -82.48466661832704 35.52750120701721, -82.48439061821108 35.52795920708205, -82.48430961817682 35.52809420710112, -82.48407761810648 35.52830220711962, -82.48361161797371 35.528664207145404, -82.48319661787886 35.52883420713739, -82.48303361784859 35.52885520712495, -82.48222561773463 35.52872620701578, -82.48205261771302 35.52868020698865, -82.48170661766443 35.52862420694175, -82.4805216174987 35.528425206779524, -82.48050461749635 35.52842220677727, -82.4800906174282 35.52841920673413, -82.4797376173526 35.52853120672067, -82.47922261721874 35.528847206732074, -82.47904661716319 35.529019206748906, -82.47851961699645 35.52953620679991, -82.4783446169409 35.52970920681716, -82.47801561683681 35.53003220684908, -82.47754361671427 35.530321206859334, -82.4771146166299 35.53040820683296, -82.47632561647444 35.53056920678467, -82.47518561626522 35.53070220669469, -82.4745536161417 35.53082520665484, -82.4730026157811 35.53150020663283, -82.47293661576762 35.53151720662949, -82.47153461547789 35.531892206561736, -82.47143161545667 35.53191920655667, -82.47124661541889 35.53196520654698, -82.47103461537603 35.53201620653561, -82.47099261536742 35.53202720653352, -82.47007661518066 35.53225520648586, -82.46934661506025 35.532252206410256, -82.46923261504132 35.532252206398596, -82.46883561500627 35.53205320631732, -82.46882661496052 35.53234120637496, -82.46828161479988 35.532799206412065, -82.46797661468881 35.53319320646085, -82.46790761466556 35.53327020646946, -82.46755561454674 35.53366420651338, -82.46711661439805 35.53415920656895, -82.46644461418357 35.53483020663629, -82.46586761393355 35.53583520678134, -82.46574461388049 35.53604820681208, -82.46515761362558 35.537074206960305, -82.4651076136082 35.537133206967155, -82.46458561342494 35.537763207041586, -82.4640756132491 35.538358207110235, -82.46404761322137 35.53850820713783, -82.46392861319455 35.53855420713494, -82.46314861301829 35.538861207117215, -82.4628886129593 35.53896420711145, -82.46260161288741 35.53912320711434, -82.46210961278216 35.53927820709535, -82.46192161274566 35.53931320708314, -82.46051661247145 35.53958320699366, -82.45890461214879 35.53994620690182, -82.45888461214494 35.539950206900635, -82.45787461194358 35.54017220684205, -82.4579736119752 35.54007320683207, -82.45827361207019 35.53977820680289, -82.45837361210185 35.53968020679329, -82.45845061220834 35.53907020667719, -82.45848761225862 35.53878320662269, -82.4586646123234 35.53855220659385, -82.45895261243037 35.53816720654523, -82.45920961252956 35.537798206496596, -82.45937061260116 35.53750620645379, -82.45946661264335 35.53733520642885, -82.45962761272935 35.536949206366906, -82.45970561276235 35.53681820634832, -82.45977061278921 35.536713206333644, -82.45986661281789 35.53663020632665, -82.45996761286247 35.536449206300176, -82.46004261289521 35.536317206281126, -82.45997961289031 35.53628120626732, -82.45965661287237 35.5360502061872, -82.45923961284383 35.535786206090684, -82.45905761284078 35.535610206036196, -82.45895061285093 35.53542920598846, -82.45888361289397 35.53507720591, -82.45888261291068 35.53496720588755, -82.45882261292782 35.53479120584559, -82.45879861292748 35.534767205838286, -82.45872161292705 35.53468720581412, -82.45862061292124 35.53461620578931, -82.45839261289699 35.534528205748, -82.45819061288054 35.53441820570488, -82.45785361285932 35.53419320562458, -82.45770561285853 35.53403920557805, -82.45760561286558 35.53388520553646, -82.45753861288149 35.53370920549382, -82.45748461290988 35.533467205439116, -82.45741661292719 35.53328120539426, -82.45736261292834 35.53321520537531, -82.4573496129347 35.53316020536279, -82.45701961294341 35.532748205245134, -82.45689861295206 35.532561205194696, -82.45685861296076 35.53246220517049, -82.45681861295914 35.53242920515963, -82.45675761297446 35.532264205119866, -82.45673061300545 35.53203320507018, -82.45669061300894 35.531967205052595, -82.45659661300527 35.53189020502731, -82.45647561299349 35.53183620500396, -82.45626061296147 35.53181320497719, -82.45613861295223 35.53174220495017, -82.45597761295087 35.53157720490009, -82.45580961297374 35.531248204815995, -82.45567461298181 35.53105020476193, -82.4553926129757 35.53078620467926, -82.45525861297884 35.53062120463202, -82.45488861298097 35.53020920451024, -82.45486261298451 35.53015820449719, -82.45469961300718 35.52983520441481, -82.45465261303305 35.52961620436546, -82.45458561304564 35.529462204327295, -82.45446461304921 35.52930820428354, -82.45428961304559 35.52914320423205, -82.45415561305808 35.52891820417255, -82.45415461306636 35.52886320416129, -82.45410861306712 35.52880820414539, -82.4541486131025 35.52862120411148, -82.45401361310896 35.52843420405965, -82.4539326131075 35.52835620403542, -82.45365061310281 35.52808320395099, -82.4535966131091 35.52798420392527, -82.4535766131294 35.52783020389191, -82.4534686131538 35.52755520382502, -82.45342861315399 35.52751120381192, -82.45332161314374 35.527462203790954, -82.45330861314334 35.527451203787436, -82.45322661313995 35.52738520376559, -82.45315961314405 35.52728620373858, -82.45293161312999 35.527132203683834, -82.45284361312721 35.527055203659174, -82.4528036131527 35.526846203612656, -82.45274961316409 35.526714203580205, -82.45273661316358 35.5267032035766, -82.452709613171 35.526626203558266, -82.45249361318744 35.52628620346692, -82.45233961320841 35.52598420338972, -82.45216461320474 35.52581920333825, -82.45189561319077 35.52562120327032, -82.45169361318604 35.52543420321165, -82.4516336131878 35.525357203189856, -82.45158661319539 35.525258203164846, -82.4514586132046 35.525060203111515, -82.45133761320392 35.52493420307343, -82.45119461319332 35.52484920304143, -82.45118961319298 35.52484620304031, -82.45088061318239 35.52458220295497, -82.4506586131894 35.52429720287425, -82.4506316131985 35.52420920285358, -82.45056461320428 35.524099202824345, -82.45050561321656 35.523956202789215, -82.45049661321835 35.52393420278386, -82.45049661323871 35.523802202757004, -82.45057061328981 35.52354920271317, -82.4505436133039 35.52342820268581, -82.45031761329228 35.52326020262848, -82.4501676132847 35.523148202590285, -82.45008661328654 35.52304920256189, -82.44994561330375 35.52278520249375, -82.44987861330095 35.52273120247584, -82.44973061331875 35.52245620240477, -82.44967661336227 35.52211520232998, -82.44968261343583 35.52164220223442, -82.44965661344833 35.52153320220958, -82.44956261346408 35.521329202158505, -82.44940061346435 35.5211532021061, -82.44934161345904 35.52112420209417, -82.44911161343836 35.521011202047504, -82.44905761343614 35.520967202033056, -82.44899061344536 35.52083520199934, -82.44892361347826 35.52054920193432, -82.44888261347745 35.52051020192225, -82.44884261347664 35.52047220191036, -82.4485876134589 35.5203132018519, -82.44845261344359 35.52026720182869, -82.44842561344046 35.520258201824035, -82.44805661340817 35.520071201748195, -82.44758561334963 35.51994520167422, -82.44734361331297 35.519923201644914, -82.44711461328693 35.51984620160575, -82.44703661327583 35.51983420159525, -82.44689961325636 35.519813201576945, -82.4465416131967 35.51981620154074, -82.44630861315785 35.51981820151731, -82.44610661313115 35.519774201487586, -82.44581061310228 35.51964320143054, -82.44568961309412 35.51956620140253, -82.44552861308611 35.51944520136141, -82.44532061308801 35.519208201291825, -82.44523961307961 35.51917620127701, -82.44509161307033 35.519077201241714, -82.4450426130727 35.51900920122283, -82.44494361307798 35.51886820118404, -82.4446886130662 35.51867020111759, -82.444526613052 35.518588201084334, -82.44413761300277 35.51848920102428, -82.4440426129939 35.51844520100555, -82.443646612974 35.51814820090456, -82.44348461297496 35.517967200851146, -82.44337761298597 35.51778020080212, -82.44320261298074 35.517626200752865, -82.44314861298365 35.51754920073166, -82.44310161299781 35.5174062006978, -82.44307461303048 35.51716420064582, -82.44302161303357 35.517087200624786, -82.4429136130276 35.517010200598065, -82.44273861300519 35.5169672005713, -82.44272561300477 35.51695620056769, -82.44241661294944 35.51698320054148, -82.44218761290144 35.51704920053142, -82.44206661286958 35.51712620053463, -82.44186461282273 35.51721420053175, -82.44164961278196 35.517247200516394, -82.44163561277985 35.51724620051477, -82.44103161268582 35.517208200445054, -82.44075161263115 35.51726220042719, -82.44069561262003 35.51727420042385, -82.44042661255872 35.5173842004186, -82.44021861250815 35.51748920041871, -82.43985561241092 35.51773120043051, -82.43968061235844 35.51788420044365, -82.43958661233614 35.517928200442896, -82.43951861232323 35.517939200438164, -82.43917461227569 35.51787820039041, -82.43921161228593 35.51785120038871, -82.43931961231871 35.51775420038013, -82.43935661232972 35.517722200377456, -82.4395056123762 35.51758020036391, -82.4397166124472 35.517345200337765, -82.43984461249002 35.51720420032224, -82.44000161254323 35.51702720030245, -82.44012161258122 35.51690920029083, -82.44021361260515 35.51685220028867, -82.44028661262254 35.51681720028902, -82.44034061263521 35.5167932002897, -82.44047061266208 35.51675820029596, -82.44059261268487 35.51674120030501, -82.44077961271832 35.51672520032093, -82.44205361294394 35.516628200432095, -82.44251861302627 35.51659320047274, -82.44264661304845 35.516586200484454, -82.44282461307947 35.516576200500765, -82.44323461315074 35.51655420053829, -82.44327661315796 35.51655220054221, -82.44335761317352 35.51653820054769, -82.44338461317862 35.516534200549614, -82.44344561319215 35.5165112005512, -82.44351461321162 35.516459200547764, -82.4435246132143 35.51645220054736, -82.44354061322024 35.51643120054475, -82.44356661323283 35.51637720053638, -82.44357061324085 35.51632920052713, -82.44357261324458 35.5163072005228, -82.44357461324768 35.516289200519395, -82.44356061326285 35.51617520049476, -82.44345461329996 35.515819200411556, -82.44340761331692 35.51565820037404, -82.44337961332708 35.51556220035157, -82.44334861333506 35.51547720033115, -82.4433256133413 35.515411200315405, -82.4432196133642 35.51514820025104, -82.44313861338185 35.514946200201635, -82.44312361338532 35.514907200192276, -82.44307361339843 35.5147682001588, -82.44304061340691 35.51467720013696, -82.44298061342234 35.514512200097236, -82.44294361343266 35.51440520007171, -82.44291361344173 35.51431420005016, -82.44286561345618 35.514168200015526, -82.44281761347615 35.51398619997362, -82.44278861349454 35.51383519994001, -82.44278261350385 35.51376819992572, -82.44274361356592 35.51332219983111, -82.44273061360221 35.513072199778954, -82.4426996136427 35.51277519971544, -82.44265161374054 35.512086199570504, -82.44263761377081 35.511874199525955, -82.44262961380983 35.51161119947173, -82.44263861382449 35.511525199455214, -82.44265161384371 35.51141419943394, -82.44265361384485 35.5114091994331, -82.44266261385135 35.51137619942731, -82.44268961386983 35.51128519941159, -82.44269161387095 35.51128019941081, -82.44270461387788 35.51124919940585, -82.44275861390744 35.51111419938398, -82.44289561396995 35.51085519934536, -82.44299061401864 35.510640199311474, -82.4430706140654 35.51042219927545, -82.44311961411174 35.510173199229854, -82.44313661412764 35.51008819921425, -82.443140614149 35.509953199187244, -82.44312761417392 35.50977719915018, -82.44307661419512 35.50958419910571, -82.44300961420758 35.50943019906755, -82.44290261421963 35.50923719901735, -82.44279161423013 35.509049198967716, -82.44238661427181 35.50834119878229, -82.44209661430318 35.50782419864749, -82.44199461431757 35.50762119859574, -82.44190961433772 35.50739819854172, -82.4418496143613 35.50718019849121, -82.44181861438234 35.50700919845328, -82.44181761438301 35.507004198452165, -82.44180061441149 35.506800198408996, -82.44181461444592 35.506591198367914, -82.4418466144839 35.506378198327916, -82.44189361452429 35.50616619828972, -82.44197761458337 35.50587119823839, -82.44201061460703 35.505753198217825, -82.44207861465443 35.505517198176776, -82.44210561467695 35.5054001981558, -82.44213361469966 35.50528219813479, -82.44213561470117 35.505274198133236, -82.44218661475607 35.50497219807715, -82.4421926147624 35.50493719807065, -82.44222561480873 35.504671198020006, -82.44225261484033 35.50449419798681, -82.44229061487164 35.50433119795758, -82.44233261489296 35.50423719794283, -82.44243461493369 35.50408219792176, -82.44243661493448 35.50407919792136, -82.44265661500526 35.50385519789843, -82.44266461500807 35.50384519789719, -82.44269061501645 35.50381919789455, -82.44269961501922 35.50381019789366, -82.442841615067 35.50365219787618, -82.4428896150829 35.503600197870554, -82.4432606152098 35.50317319782182, -82.44340061525759 35.50301319780376, -82.44363261533822 35.502738197771656, -82.44382861540588 35.50250819774498, -82.44416261552793 35.50207319769086, -82.4443046155784 35.50189719766974, -82.44436261559889 35.50182619766127, -82.4444926156396 35.50170119764914, -82.44456361565919 35.50165019764611, -82.44464061568051 35.501594197642646, -82.44475761570953 35.50153119764181, -82.44535661585715 35.50121519763909, -82.44536261585874 35.50121119763891, -82.44556661590795 35.50111019763933, -82.44594961600093 35.50091719763941, -82.44603561602348 35.500863197637266, -82.44610261604079 35.50082219763579, -82.44619461606644 35.50075419763146, -82.44624461608028 35.50071819762921, -82.44637161611904 35.50060219761873, -82.44647561615453 35.5004831976052, -82.44663061620918 35.50029419758268, -82.44710261637988 35.49969119750861, -82.44727161644066 35.49947719748249, -82.44737861647617 35.499361197469895, -82.4474606164986 35.49930319746648, -82.4475646165242 35.49924819746599, -82.44767161654799 35.499209197469035, -82.44784961658536 35.49915719747676, -82.44796861661001 35.499125197482456, -82.4479856166134 35.49912119748336, -82.44806761663013 35.499100197487586, -82.4482626166724 35.49903519749435, -82.44838461670135 35.498978197495326, -82.44840661670723 35.49896319749448, -82.44848661672847 35.49891119749213, -82.44860061676167 35.498818197484994, -82.44871361679918 35.49869519747158, -82.4488316168437 35.4985321974505, -82.44895161689199 35.49834719742521, -82.44905461693556 35.498174197400644, -82.44912061696213 35.49807219738671, -82.44919161699042 35.49796419737204, -82.44933461704173 35.49778419735013, -82.44945761708266 35.4976501973355, -82.44960161712837 35.49750719732129, -82.44963161713795 35.497477197318254, -82.45016261730423 35.49696619726887, -82.45034061735971 35.49679619725261, -82.45041761738344 35.496725197246114, -82.4506136174428 35.49654919723043, -82.45065361745431 35.49651719722801, -82.45073661747789 35.496453197223545, -82.45075761748382 35.49643719722247, -82.45082061750172 35.49638819721897, -82.45084261750769 35.49637319721815, -82.45092861753186 35.496308197213835, -82.45110761758191 35.496175197205154, -82.4511836176041 35.49611219720012, -82.45126661762832 35.4960441971948, -82.4513736176594 35.49595719718812, -82.45143561767826 35.495901197183095, -82.45151361770202 35.49583019717672, -82.45164661774683 35.49568119716005, -82.45176261779031 35.49552319713984, -82.45190961785335 35.49527119710367, -82.4520536179101 35.49505619707478, -82.45218161795384 35.494909197058114, -82.4523376180022 35.49476219704419, -82.45295561818386 35.49424419700238, -82.4530016181976 35.494204196998936, -82.45329761828488 35.49395419697852, -82.45341561832224 35.493838196967076, -82.45351161835507 35.49372819695457, -82.45359961838709 35.493614196940385, -82.45361061839141 35.49359819693827, -82.4538056184644 35.49333219690425, -82.45408961857571 35.49291319684825, -82.45421361862488 35.49272619682292, -82.45434761867439 35.49254819680053, -82.45444861870806 35.49243719678831, -82.45449961872342 35.492392196784415, -82.45454961873843 35.49234819678058, -82.45464061876353 35.49228319677669, -82.45468761877517 35.492257196776265, -82.45476061879332 35.49221819677584, -82.45479861880277 35.492197196775514, -82.45494361883425 35.49214919678053, -82.45528561890272 35.49207119679979, -82.45551261894843 35.49201819681235, -82.45568461898284 35.49197919682211, -82.45570361898675 35.491974196823016, -82.45583161901237 35.49194519683026, -82.45586861902008 35.491935196831996, -82.45612361907229 35.49186919684476, -82.45635961912231 35.49179819685456, -82.45639961913055 35.491787196856436, -82.4565166191581 35.49173419685771, -82.45659261917598 35.49169919685836, -82.45681361923539 35.49155019685071, -82.45681961923728 35.49154419685011, -82.45703661930112 35.491362196835354, -82.45715561934 35.491237196822205, -82.45726461937939 35.49109819680509, -82.45738961943262 35.49088619677488, -82.45747961947478 35.49070819674794, -82.45748661947788 35.49069519674605, -82.45763161954976 35.49038319669751, -82.45776461961489 35.49010219665405, -82.4578696196637 35.489897196623104, -82.45793761969503 35.48976619660346, -82.45839461989998 35.488923196479035, -82.45858661998126 35.48860019643305, -82.45866562001244 35.48848219641724, -82.45878062005737 35.48831319639466, -82.45880962006815 35.488274196389725, -82.45890962010276 35.488156196376, -82.45894262011394 35.488119196371855, -82.45899762013269 35.48805619636465, -82.45905962015358 35.48798619635684, -82.45917062019275 35.487851196340785, -82.45928162023566 35.48769119631962, -82.4592926202404 35.4876721963169, -82.45934962026388 35.487580196304066, -82.45942962029555 35.48746019628788, -82.4595256203306 35.487335196272326, -82.45963662036449 35.48723419626321, -82.45973862038993 35.487178196262285, -82.45987562042068 35.48712519626554, -82.46003062045088 35.48709519627529, -82.46024662048944 35.4870771962939, -82.46050262053409 35.48706219631708, -82.46092162060708 35.48703819635517, -82.46098662061888 35.48703119636042, -82.4610956206386 35.487020196369336, -82.4612976206789 35.48697519638094, -82.4613366206866 35.48696719638333, -82.46150562072413 35.48690519638805, -82.46170462077144 35.48681119638935, -82.46214562088463 35.48654919638137, -82.4624186209546 35.486387196376434, -82.46245762096474 35.48636319637558, -82.462575620995 35.48629319637342, -82.4626156210051 35.48627019637289, -82.462806621054 35.48615719636947, -82.46338062120061 35.485820196359924, -82.46357262124963 35.48570819635683, -82.46370262128292 35.48563119635452, -82.46397262135154 35.48547519635047, -82.46406062137376 35.48542519634939, -82.46480662156436 35.484987196336846, -82.46498162160478 35.48491219633956, -82.46509762162998 35.4848731963435, -82.46520562165135 35.484850196349925, -82.46525162166037 35.48484119635287, -82.46546762169775 35.484830196372776, -82.46566762172951 35.48483919639508, -82.46579162174925 35.48484419640877, -82.4658826217638 35.484847196418826, -82.46653062186722 35.484872196490265, -82.46674662190163 35.484881196514316, -82.46703862194818 35.48489219654653, -82.46727762198636 35.48490119657283, -82.46769962205366 35.48491819661957, -82.4678046220702 35.48492319663141, -82.46791562208786 35.484928196643764, -82.46820862213416 35.48494219667669)))",6307,37,021,003202,370210032021,1524,1524,50,1510,1427,22,8,23,3,27,14,1215,34,1181,1208,1148,16,6,16,3,19,7,674,606,68
census_2010_blockgroups_view.fid--2dc29038_13ec899ba8f_-25e4,"MULTIPOLYGON (((-82.57440361869311 35.621858235432875, -82.57447061871531 35.62178623542503, -82.57454161873845 35.621712235417306, -82.57494961887053 35.621295235374305, -82.57510061891429 35.62117423536525, -82.57523261895149 35.62107523535863, -82.57548661901666 35.62092623535435, -82.5755216190255 35.62090623535385, -82.57583861910831 35.620711235346725, -82.5759396191351 35.6206462353439, -82.57605961916676 35.62057023534078, -82.57624961921528 35.62046023533784, -82.57628361922386 35.62044123533751, -82.5763576192417 35.62040523533778, -82.57641361923093 35.62053523537004, -82.5764966192177 35.62071023541412, -82.57665661919272 35.62104523549883, -82.57687161915432 35.62152623561881, -82.5769116191454 35.62162723564352, -82.57703661911805 35.6219392357199, -82.57706561911156 35.62201223573778, -82.57708061910795 35.62205223574738, -82.5771536190905 35.62224423579406, -82.57721561907765 35.6223942358309, -82.57726361906825 35.622507235858926, -82.5772966190614 35.62258723587855, -82.57739661904094 35.62282723593767, -82.57743061903413 35.62290823595764, -82.57736161901944 35.622929235954864, -82.57732161901075 35.6229422359534, -82.57718761897634 35.62302123595573, -82.57717261897214 35.62303223595644, -82.57711661895581 35.62307823596003, -82.57704261893443 35.62313723596439, -82.5769286188977 35.623252235976125, -82.57690061888854 35.62328123597918, -82.57643461872469 35.623842236045554, -82.57639361871011 35.623892236051525, -82.57627061866692 35.624040236069014, -82.57619261863911 35.62413623608052, -82.57609861860529 35.6242542360949, -82.57595661855575 35.62442323611469, -82.57587761852787 35.62451823612593, -82.57558361842328 35.62488023616946, -82.57557561842026 35.6248912361709, -82.57546961838145 35.62502823618781, -82.5753846183465 35.62516323620658, -82.575327618317 35.62529323622725, -82.57527361828141 35.6254662362569, -82.57519261820285 35.62588823633451, -82.57515461815065 35.626186236391234, -82.57513161811794 35.626373236426986, -82.57510761807131 35.62665023648091, -82.57510561806936 35.62666023648272, -82.57510361806416 35.626692236489035, -82.57510361806244 35.62670323649127, -82.57509261804044 35.62683423651687, -82.57508261801918 35.626961236541696, -82.57507361799932 35.627080236565014, -82.57508361797805 35.62722923659635, -82.57511461795252 35.62742823664004, -82.5751346179274 35.62761223667957, -82.57515661791243 35.6277332367065, -82.57519261788994 35.62791823674785, -82.57519961788014 35.62798923676306, -82.5752086178673 35.62808223678289, -82.57521461786044 35.628133236793865, -82.57521161782873 35.62833523683472, -82.57520761782351 35.62836523684037, -82.5751976178073 35.6284592368585, -82.57519561780445 35.62847523686163, -82.57519361778678 35.628588236884376, -82.57520461778122 35.62863623689531, -82.5752186177749 35.62869223690809, -82.57526161777032 35.62876823692798, -82.57530161776843 35.628823236943326, -82.57546461777147 35.628979236991796, -82.57552661776977 35.62905723701412, -82.57558061776808 35.629126237033674, -82.5756266177634 35.62920623705472, -82.57567461775857 35.62928923707653, -82.57567961775767 35.62930023707932, -82.57581961773552 35.629595237153744, -82.57586661772811 35.62969423717877, -82.57591361771979 35.62979823720472, -82.57596561770352 35.62996023724312, -82.57601161768349 35.63013923728428, -82.57602961767066 35.63024223730706, -82.57604961765716 35.63035123733138, -82.57608561762022 35.630629237391666, -82.57611161758724 35.63087123744358, -82.57611261755854 35.63105823748178, -82.57608561748333 35.63151723757254, -82.57606961744473 35.63175023761824, -82.57604661740932 35.63195523765762, -82.57604161739982 35.63201123766852, -82.57600361735958 35.63223123770944, -82.57594561730532 35.63252023776233, -82.57591761727855 35.63266423778878, -82.57590261726257 35.63275123780493, -82.57587561723128 35.63292523783756, -82.57581661715047 35.63338523792515, -82.5758096171392 35.63345123793792, -82.57578761709927 35.63368623798346, -82.57576061705086 35.63397123803872, -82.57574061701203 35.63420123808353, -82.57572661698985 35.63433023810833, -82.57570261696534 35.63446323813297, -82.575667616943 35.63457023815117, -82.57560261691617 35.63467423816564, -82.57552261688679 35.63477823817862, -82.57544661685846 35.634880238191535, -82.57538361683002 35.63499623820869, -82.57537361682445 35.63502223821297, -82.57533661680455 35.635111238227275, -82.57531861678457 35.63522123824783, -82.57531661678037 35.635246238252776, -82.57530061673 35.63555523831399, -82.57530061666971 35.635946238393636, -82.57530161663382 35.63618023844141, -82.5753016166184 35.636280238461715, -82.57530161661255 35.6363182384695, -82.57524461656332 35.63657623851618, -82.57524061655917 35.63659823852023, -82.57521661654367 35.63667323853309, -82.57527761654886 35.636705238545844, -82.57532561654845 35.63675923856176, -82.57544261654789 35.636889238600254, -82.57556461654701 35.637026238640686, -82.5754886165273 35.63707223864222, -82.57617161652718 35.637809238862474, -82.57623461653576 35.63782123887142, -82.5763376165334 35.63794723890767, -82.57627161652535 35.63792823889702, -82.57621661651115 35.63796123889812, -82.5758706164232 35.63815823890266, -82.57576761639938 35.63820223890099, -82.57574261640015 35.63817023889198, -82.57571261640207 35.63812523887969, -82.57565761640609 35.63804023885671, -82.57553361640495 35.63791423881833, -82.57551561640433 35.63789823881323, -82.5755026164039 35.63788723880958, -82.5754636164025 35.637854238798894, -82.57545161640219 35.63784323879542, -82.575377616401 35.6377712387732, -82.5751346163892 35.6375862387105, -82.57491461637441 35.637445238659176, -82.57474961636039 35.63735823862452, -82.57446361632923 35.637252238573545, -82.57401261627629 35.63710923849807, -82.57393761626616 35.6370942384873, -82.5737506162388 35.63707023846318, -82.5735666162104 35.63705623844143, -82.57333261617238 35.63705023841617, -82.5731796161468 35.63705123840055, -82.57293761610629 35.63705323837611, -82.57211661596897 35.63705923829291, -82.57167761589548 35.637062238248426, -82.57114861580702 35.637066238194855, -82.57103761579013 35.6370562381814, -82.57090061577026 35.637037238163416, -82.57084261576217 35.63702723815544, -82.57063161573654 35.636966238121325, -82.57052861572406 35.63693623810466, -82.57043261571292 35.63690523808846, -82.56973661563181 35.63668123797131, -82.56971861562968 35.63667523796821, -82.56914261556132 35.63649823787295, -82.56904161554904 35.636469237856716, -82.56885861552661 35.63641723782729, -82.56857161548977 35.636347237783546, -82.56875761553641 35.63624523778187, -82.56876761553929 35.636237237781245, -82.56887461556849 35.63616323777715, -82.56927061569176 35.63579023774199, -82.5694346157427 35.63563723772769, -82.56956061578194 35.63551823771638, -82.56950261577661 35.63549023770472, -82.5693566157737 35.63535223766158, -82.56918661576694 35.63521323761584, -82.569163615766 35.635194237609554, -82.56907161577233 35.635053237571434, -82.56901061578563 35.634902237534455, -82.56882361583402 35.63438723741033, -82.56878361586529 35.634141237356125, -82.56875261590349 35.6338602372958, -82.56875161590514 35.63384823729324, -82.56874061593867 35.63361923724547, -82.56876161598127 35.633365237195925, -82.56857861594891 35.63337823717969, -82.56853761594152 35.63338223717631, -82.5682046158763 35.63344623715517, -82.568038615843 35.63348323714557, -82.56786061580715 35.63352423713565, -82.56774861578462 35.63354923712918, -82.56760761576152 35.63354723711433, -82.56748761574158 35.633547237101936, -82.5671576156904 35.633523237063166, -82.5668446156428 35.63349523702532, -82.566642615612 35.63347723700086, -82.56659061560345 35.63347623699532, -82.56635261556454 35.63347223697, -82.56610461552633 35.633453236940674, -82.56603761551776 35.63343623693033, -82.56595561550708 35.633417236918014, -82.565846615497 35.63336523689622, -82.56576061549015 35.63331723687757, -82.56554161548843 35.63309223680929, -82.56544461549066 35.63297323677505, -82.56534161549055 35.632863236742075, -82.56526961549314 35.63276923671558, -82.56512361551421 35.63247523664067, -82.56505661552784 35.632314236601005, -82.56500061553541 35.63220523657309, -82.56497161553936 35.63214823655854, -82.56490861555116 35.63200423652273, -82.56479661556732 35.631778236465124, -82.56475461557122 35.63170823644655, -82.56464161554486 35.63175723644492, -82.56462161554005 35.631767236444915, -82.56439161548182 35.631896236447595, -82.56425261544321 35.63199723645388, -82.56413561541041 35.63208423645951, -82.56367761527822 35.63244723648633, -82.56348661522067 35.6326152365009, -82.56341861520205 35.63266223650348, -82.56319761513794 35.63284023651696, -82.56311361511514 35.63289723651991, -82.56296861507917 35.63297423652075, -82.56295261507604 35.63297723651966, -82.5628386150517 35.633012236515114, -82.56272461503168 35.633019236504786, -82.56257161500739 35.63301223648767, -82.56225061495981 35.6329742364469, -82.56212861494336 35.63295023642953, -82.56197961492303 35.632921236408244, -82.56176261489676 35.63285823637312, -82.5616626148844 35.63283023635715, -82.56070761478423 35.632451236181836, -82.56054461476707 35.63238723615206, -82.56035261474472 35.63232523611972, -82.56022661473013 35.63228423609831, -82.5599866146986 35.632230236062746, -82.55977761466778 35.632205236036086, -82.55968361465291 35.63220023602545, -82.5595256146279 35.632192236007555, -82.55847561445881 35.6321572358925, -82.55815761440866 35.63214023585632, -82.55792261437539 35.632103235824665, -82.5576836143447 35.632044235788086, -82.55765061434113 35.63203223578217, -82.55745861431953 35.63196523574887, -82.5572526142995 35.63187323570888, -82.55707561428589 35.63177123566995, -82.55703761428404 35.631742235660106, -82.55698061428151 35.631697235645085, -82.55686261427626 35.631604235614056, -82.55681361427509 35.63155923559983, -82.55676161427387 35.631511235584725, -82.5566696142746 35.63140723555413, -82.55661861427717 35.63133523553419, -82.55654161428107 35.63122723550426, -82.55643361429027 35.63105123545737, -82.55629461431519 35.63074023537977, -82.55620261433185 35.63053323532813, -82.55613761434452 35.63038123529059, -82.5560516143613 35.63017923524057, -82.555949614384 35.6299222351778, -82.55588961439761 35.629769235140465, -82.55583961441013 35.62963423510786, -82.55569261444825 35.629229235010236, -82.55564361446078 35.62909523497796, -82.55553361448827 35.62879823490622, -82.55525261455841 35.62804123472318, -82.55520661457126 35.62790823469144, -82.55518961457646 35.627856234679086, -82.55514861458217 35.62777523465839, -82.55506261459055 35.6276282346196, -82.55502561460595 35.62748823458731, -82.55491761465254 35.62707023449108, -82.55488161466795 35.62693123445908, -82.55487761466729 35.62693123445869, -82.55481161469581 35.62667523439976, -82.5547996147012 35.626627234388764, -82.55471861476735 35.6261112342754, -82.55470061479974 35.625882234226935, -82.55468061483738 35.625616234170764, -82.55452861481255 35.625613234154514, -82.55436061478515 35.62561023413661, -82.55409261474325 35.625593234105665, -82.55407461474041 35.6255922341035, -82.55392361471552 35.6255912340878, -82.55402961475824 35.62542823406551, -82.55403561476045 35.62542023406457, -82.55410861479378 35.625283234044176, -82.55423261485907 35.62499323399783, -82.55426261487919 35.62489523398104, -82.55427761488858 35.62485023397337, -82.55431561491662 35.62470923394858, -82.55438261497054 35.6244312338989, -82.5544176149985 35.624288233873365, -82.55445961503537 35.624094233838214, -82.5545566151127 35.62369723376738, -82.55457661513134 35.62359823374928, -82.55461861516882 35.62340023371328, -82.55462861518316 35.62331823369759, -82.55463661520173 35.6232062336756, -82.55463461520304 35.623195233673165, -82.55463161521101 35.62314023366172, -82.55462361523537 35.622974233627104, -82.55462161524335 35.622920233615865, -82.5546086152657 35.62276123358212, -82.55458761529316 35.622560233539076, -82.5545056154014 35.62177023336985, -82.55447961544162 35.6214812333083, -82.55444761549175 35.62112123323181, -82.55443161551301 35.620966233198565, -82.55438361557634 35.620504233099616, -82.55436861559753 35.620350233066716, -82.55449061561828 35.620347233078576, -82.55457861563272 35.62034823308789, -82.55521161573631 35.620358233154924, -82.55542361577098 35.620362233177595, -82.55557461579568 35.62036423319351, -82.5560296158702 35.62037123324169, -82.556181615895 35.620374233257934, -82.55643361593636 35.62037723328447, -82.5571926160607 35.620388233364736, -82.55744561610213 35.62039223339152, -82.55771761614676 35.620395233420076, -82.55853661628112 35.62040623350651, -82.5585566162843 35.62040723350876, -82.55880961632505 35.620415233536384, -82.55907761636921 35.62041823356459, -82.55983961649413 35.62042823364491, -82.55988161650095 35.62042923364939, -82.56006361653047 35.620434233669194, -82.56014961654358 35.62044123367941, -82.56015861653 35.620539233700285, -82.56016161649502 35.62076923374747, -82.56017061648141 35.62086723376833, -82.56017461648133 35.62087223376978, -82.56020961647977 35.62092023378305, -82.56025961648248 35.62095623379559, -82.56034661649558 35.62096523380635, -82.5606896165584 35.62092723383385, -82.56089361659474 35.620911233851565, -82.56103561661612 35.62092523386904, -82.56112161662645 35.620951233883154, -82.5612106166329 35.62100523390335, -82.56128761663079 35.62110223393097, -82.5613166166237 35.62117923394958, -82.56134061661815 35.6212412339647, -82.56138661659537 35.621438234009496, -82.56139661658055 35.62154523403231, -82.5613916165708 35.62160323404365, -82.56138161655355 35.621704234063124, -82.56139661654564 35.62177223407851, -82.56143061654252 35.621828234093414, -82.56146761654273 35.62186723410522, -82.56153061654946 35.62189123411655, -82.56162261656272 35.621904234128635, -82.5617646165854 35.62191023414445, -82.56190461660886 35.621909234158686, -82.56195961661798 35.621909234164306, -82.56211761664548 35.62190123417888, -82.56226361667274 35.62188123418983, -82.56237561669694 35.62184523419404, -82.56245561671592 35.621808234194745, -82.5625256167371 35.621746234189274, -82.5626136167699 35.62162823417431, -82.56269861679955 35.62152723416249, -82.56277761682242 35.62146423415781, -82.56288061684896 35.62140323415596, -82.5630276168831 35.62134023415819, -82.56330561693946 35.621274234173356, -82.5635936169965 35.621214234190724, -82.56379161703944 35.62114923419789, -82.56387461705876 35.62111323419905, -82.56388961706212 35.621107234199414, -82.56417961713518 35.620946234196396, -82.56430261716429 35.62089023419766, -82.56443661719199 35.620854234204096, -82.56454661721308 35.620836234211765, -82.56456261721621 35.620833234212824, -82.56468661723679 35.62083323422551, -82.5647606172488 35.62083523423352, -82.56482561725915 35.620838234240836, -82.56489261727081 35.620834234246914, -82.56496661728399 35.62082923425345, -82.56498861728824 35.62082523425493, -82.56508761730667 35.620812234262495, -82.56521461733233 35.620782234269406, -82.56539261737088 35.6207242342759, -82.56559761741491 35.62065923428371, -82.56576961745135 35.62060823429104, -82.56594361748431 35.62058223430358, -82.5661466175225 35.62055323431856, -82.56625161754319 35.62053223432512, -82.5664956175942 35.620464234336325, -82.56674361764682 35.62039023434673, -82.56696161768642 35.62036823436467, -82.56698661769057 35.62036723436699, -82.56701961769629 35.62036623437026, -82.56712361771294 35.62037023438171, -82.56724361773115 35.62038123439629, -82.56734161774492 35.620398234409784, -82.56766061778772 35.62046423445604, -82.56775061779743 35.62049823447222, -82.56783561780323 35.62055223449193, -82.56790861780456 35.62062223451376, -82.56795361780148 35.62069023453217, -82.56797761779615 35.62075123454703, -82.56798861779383 35.62077823455367, -82.56800461778491 35.62085323457058, -82.56802561775129 35.62109323462167, -82.56809361769831 35.62151023471353, -82.56811561769145 35.62157923472983, -82.5681636176895 35.62164323474781, -82.56822561769393 35.621681234761915, -82.56828861770104 35.6217032347728, -82.56887661778703 35.621779234848695, -82.56902961780565 35.62182323487346, -82.56911461781448 35.62185723488916, -82.56919261782039 35.621903234906476, -82.56925561782379 35.62194923492228, -82.56942961782646 35.62211923497479, -82.569460617827 35.62214923498406, -82.56955361783427 35.622202235004416, -82.56963761784708 35.62220923501453, -82.56972861786672 35.62218023501797, -82.56979461788632 35.62212423501328, -82.56985261791037 35.622030235000196, -82.56996861796297 35.62181423496807, -82.57003561799372 35.62168723494912, -82.57009161801876 35.6215852349341, -82.570185618056 35.621445234915285, -82.57023961807434 35.62138423490839, -82.57029061808846 35.621347234906075, -82.57030461809225 35.621338234905735, -82.57038661811059 35.62130723490785, -82.57042561811757 35.62130423491127, -82.57046261812417 35.621301234914405, -82.57048361812784 35.62130023491638, -82.5705666181354 35.621340234933065, -82.57057161813594 35.62134223493395, -82.57059461813606 35.6213662349412, -82.57063861813647 35.6214112349549, -82.57068061813217 35.621484234974055, -82.57072161812502 35.62157523499686, -82.57074661811737 35.621651235014845, -82.57076261810847 35.62172623503181, -82.57076561809995 35.62178523504408, -82.57075361808859 35.621845235055034, -82.57073961808098 35.62188023506078, -82.57072861807443 35.62191023506578, -82.57068861805715 35.621979235075685, -82.5706196180211 35.62213923510119, -82.57063961801525 35.62219823511522, -82.57069061801795 35.62223623512822, -82.57076261802668 35.62225723513987, -82.57084661803998 35.62226123514939, -82.57104261807612 35.62223823516483, -82.57123661811079 35.62222223518147, -82.57139161813639 35.62222323519764, -82.57150961815243 35.62224623521443, -82.57159061815928 35.622289235231534, -82.57166261815905 35.62236823525501, -82.57167761815208 35.6224292352689, -82.57166561812512 35.62259123530073, -82.57166161812079 35.622615235305176, -82.57165661811504 35.622647235311156, -82.57166961811132 35.6226852353202, -82.5717016181119 35.62271623532982, -82.5717636181183 35.62274123534127, -82.57182961812947 35.6227402353479, -82.57192661814706 35.622730235355824, -82.57202261816674 35.622706235360845, -82.57213361819053 35.622671235365075, -82.57227461822046 35.62262923537101, -82.57233561823395 35.62260723537282, -82.57249261826843 35.62255323537802, -82.57259661828896 35.622532235384405, -82.57270161830847 35.62251823539232, -82.57279561832368 35.62252123540259, -82.57286961833361 35.622536235413286, -82.57294261834193 35.62256123542584, -82.57295461834329 35.62256523542788, -82.5731076183593 35.62262623545598, -82.57315461836542 35.62263723546309, -82.57318661836955 35.622645235467985, -82.57328161838328 35.62265823548041, -82.57336761839734 35.62266023548971, -82.5734216184072 35.62265423549394, -82.57344161841071 35.62265323549581, -82.57352561842772 35.62263323550041, -82.57362861844987 35.622600235504244, -82.5737376184773 35.62254023550329, -82.5738856185217 35.62241123549215, -82.57407461858425 35.62220923547045, -82.57425961864521 35.622013235449586, -82.57440361869311 35.621858235432875)))",6373,37,021,001600,370210016002,1986,1986,63,1955,1872,27,3,19,0,34,31,1658,48,1610,1638,1572,26,2,10,0,28,20,968,888,80
census_2010_blockgroups_view.fid--2dc29038_13ec899ba8f_-25e3,"MULTIPOLYGON (((-82.55651061937743 35.59812822876335, -82.55680461944854 35.59798322876405, -82.55769061966235 35.5975502287669, -82.55798561973349 35.597406228767895, -82.55830361981035 35.59725022876883, -82.55925762004067 35.59678322877175, -82.55957662011748 35.59662822877293, -82.55962062011685 35.59667922878784, -82.55965462011659 35.59671822879927, -82.55971962011547 35.59679522882163, -82.55975462011536 35.596834228833195, -82.55980062011507 35.596885228848336, -82.56004362011282 35.59716222892966, -82.56016462014705 35.597070228923386, -82.5603336201938 35.59694822891589, -82.56065162028162 35.596721228902275, -82.56112362041068 35.59639222888379, -82.56121762043672 35.596324228879595, -82.56139562048588 35.596197228872064, -82.56151362051779 35.5961172288679, -82.5616426205173 35.59625922891013, -82.56176462051481 35.59640722895275, -82.56181762051439 35.59646722897035, -82.56218262051206 35.59687622909113, -82.56230562051195 35.59700922913082, -82.562497620514 35.59720322919005, -82.5626566205125 35.59738422924325, -82.56270962050297 35.59750322927286, -82.56270962049975 35.597524229277205, -82.56271262048729 35.59760822929456, -82.56269562043181 35.5979502293625, -82.56269862042632 35.59798922937066, -82.56269962042518 35.597997229372424, -82.56260962039993 35.59806422937685, -82.56259462039321 35.59809222938095, -82.5625666203717 35.59820122940031, -82.56255962036563 35.59823322940612, -82.56253962035856 35.59825722940895, -82.56249062034816 35.598272229407, -82.56242662033661 35.59827822940163, -82.56209862028005 35.59829222937076, -82.56208362027489 35.59830922937272, -82.56208562026995 35.59834322937982, -82.56218162025402 35.59855022943177, -82.56227262023936 35.598743229480434, -82.56228662023408 35.59879322949204, -82.5625146202718 35.59879422951565, -82.56252262027297 35.59879522951674, -82.56272862030242 35.598826229544194, -82.56301462034148 35.59888022958456, -82.56321862036698 35.598935229616636, -82.56327962037446 35.59895222962642, -82.56344662039453 35.59900222965378, -82.56355062040704 35.59903322967076, -82.56386562044486 35.599127229722235, -82.56397062045737 35.59915922973956, -82.56403162046502 35.599175229749065, -82.56404262046638 35.59917822975085, -82.56421962049308 35.5991952297725, -82.56428362050272 35.599202229780495, -82.56464862055667 35.59924522982668, -82.56475162057181 35.599258229839926, -82.56471062046802 35.59988822996403, -82.5646946204082 35.600259230037864, -82.56468662037729 35.60045123007611, -82.56467062034753 35.600627230110256, -82.56432262029068 35.6006212300733, -82.56328162012005 35.60060622996336, -82.56293462006322 35.600601229926674, -82.5628056200663 35.60044222988105, -82.56263462002367 35.60053422988222, -82.5621246198965 35.60081022988597, -82.56195461985398 35.60090322988743, -82.56178561981145 35.60099722988921, -82.56133761969812 35.601250229894724, -82.56128061968421 35.60127922989482, -82.56110961964202 35.60136822989532, -82.56103661962436 35.601404229895174, -82.56097861960995 35.601435229895515, -82.56059261951332 35.60164622989881, -82.56046461948112 35.601717229900096, -82.56033661944947 35.60178522990077, -82.55995661935496 35.60198922990328, -82.5598296193232 35.60205822990425, -82.55961661926963 35.602176229906405, -82.5594046192162 35.60229522990888, -82.55897661910961 35.60252522991171, -82.55876361905644 35.602641229913445, -82.55873861905029 35.602654229913504, -82.55866361903117 35.60269722991456, -82.55863961902489 35.60271222991517, -82.55855961900484 35.60275622991584, -82.55832361894507 35.60289022991896, -82.55824461892492 35.602935229919964, -82.55808461888448 35.60302522992184, -82.5580626188789 35.60303822992223, -82.557960618853 35.60309622992358, -82.5576726187814 35.603250229925315, -82.55760461876356 35.603293229927075, -82.5574686187273 35.603382229931256, -82.55745161872245 35.603395229932126, -82.55743061872234 35.60337322992552, -82.55734061872278 35.60327322989589, -82.55728161872445 35.60319922987474, -82.55679961873787 35.602592229701706, -82.55663961874238 35.60239022964412, -82.5566006187435 35.60234122963016, -82.55648561874665 35.60219622958885, -82.55644761874778 35.60214822957514, -82.55633161875107 35.60200222953351, -82.55598661876107 35.60156522940911, -82.55587161876434 35.6014202293678, -82.55578561876645 35.601313229337144, -82.55553061877357 35.60099222924562, -82.55544561877599 35.600885229215145, -82.55541861877684 35.600850229205214, -82.55540561877717 35.60083422920067, -82.55524861878196 35.60063422914375, -82.55502961878835 35.60035622906469, -82.55477361879467 35.60003922897388, -82.55461461879864 35.59984222891746, -82.55449561880248 35.599689228874034, -82.55446561880348 35.599650228863005, -82.55439761880886 35.599542228834075, -82.55436561881336 35.59947822881777, -82.55434161881665 35.59943122880569, -82.55433061881833 35.5994082287999, -82.55429861882594 35.599324228779494, -82.55428261882943 35.59928422876975, -82.55426461883388 35.59923622875813, -82.55435761885634 35.59919022875828, -82.55463661892385 35.59905322875909, -82.5547306189464 35.59900822875957, -82.55500361901268 35.598872228759944, -82.5558246192115 35.59846622876164, -82.55609861927776 35.598331228762376, -82.55618061929782 35.59828922876217, -82.55620861930451 35.598276228762394, -82.55642761935749 35.59816822876294, -82.55651061937743 35.59812822876335)))",4893,37,021,000200,370210002002,726,726,20,702,594,84,4,8,2,10,24,637,10,627,622,529,76,4,7,2,4,15,429,382,47
census_2010_blockgroups_view.fid--2dc29038_13ec899ba8f_-25e2,"MULTIPOLYGON (((-82.49534461068467 35.58868222055584, -82.49539461068751 35.58871722056811, -82.49549561069348 35.58878722059277, -82.49576861070884 35.58898122066034, -82.49636661074223 35.58940822080862, -82.49647861074999 35.589478220834366, -82.49673661077166 35.58961522088877, -82.49688461078604 35.58968122091735, -82.49710961081198 35.589755220955546, -82.49718861082103 35.589781220968995, -82.49742661085328 35.58982822100298, -82.49761861088088 35.58985522102822, -82.49784361091608 35.589869221054194, -82.4980266109469 35.58986622107241, -82.49804361094964 35.58986622107412, -82.49823561098361 35.589852221091014, -82.49843261102045 35.58982522110576, -82.49860861105581 35.589785221115754, -82.49878761109271 35.58973822112458, -82.49897861113492 35.58967022113039, -82.49920461118869 35.58956422113203, -82.49921261119047 35.589561221132264, -82.49935361122677 35.58947722112971, -82.49955261127951 35.589349221124074, -82.49963861130273 35.58929122112116, -82.49989961137213 35.58912122111335, -82.49998661139541 35.58906422111075, -82.50015461141524 35.589116221138575, -82.50082861150103 35.589284221241954, -82.50111361153722 35.58935622128598, -82.50147661158393 35.589443221341, -82.50158061159495 35.58948422135998, -82.5016676116005 35.58954222138072, -82.50200761161076 35.58984122147647, -82.50214461161269 35.58997622151802, -82.50222961161566 35.590048221541466, -82.50240361162545 35.59017222158453, -82.50252861163496 35.59024522161225, -82.5030736116809 35.590533221726815, -82.50384461174609 35.59094022188886, -82.50386161174752 35.59094922189245, -82.50391261175179 35.590976221903176, -82.50393061175323 35.59098622190708, -82.5040156117602 35.59103222192524, -82.50405961176385 35.59105622193462, -82.50427361178237 35.59116622197889, -82.5043606117899 35.59121122199702, -82.50450261180201 35.591285222026706, -82.50458961180945 35.5913302220448, -82.50492661183704 35.591514222116885, -82.50506861184871 35.59159122214709, -82.5051946118596 35.591656222173306, -82.50538261187627 35.591750222211736, -82.50545061188201 35.591786222226034, -82.50557261189229 35.591851222251755, -82.50561761189324 35.59189322226496, -82.505677611891 35.59197222228716, -82.50559561187018 35.59201922228833, -82.5054506118315 35.59211422229278, -82.50535061180602 35.59217222229429, -82.50517561176643 35.592240222290094, -82.50491361170997 35.5923252222805, -82.5046876116626 35.59238922227026, -82.50446561161411 35.59246522226292, -82.50427561157069 35.592542222259034, -82.50412261153365 35.59261822225882, -82.50389361147568 35.59274822226167, -82.50380961145122 35.59281622226684, -82.50375661143117 35.59288922227627, -82.50368761139869 35.59302622229708, -82.5036116113591 35.59320122232481, -82.50350461129665 35.593491222372904, -82.50342061124495 35.59373622241404, -82.50335961121023 35.59389622244035, -82.50325261113672 35.59425822250295, -82.50321461110035 35.59445322253871, -82.5032076110752 35.5946092225697, -82.50321561103979 35.59484722261895, -82.50321861102725 35.59493222263655, -82.50322961098976 35.59518722268958, -82.50323361097712 35.59527322270743, -82.50330961097075 35.595396222740284, -82.50332361096952 35.59541922274638, -82.50352561094842 35.59577422283936, -82.50359761094074 35.59590122287268, -82.50367861093207 35.59604422291006, -82.50368261093217 35.59604822291122, -82.50375961093478 35.59611422293264, -82.50389661093793 35.59624122297259, -82.50390261093816 35.59624622297418, -82.50421961095023 35.596509223060266, -82.50430061095432 35.5965692230808, -82.50436261095206 35.59665122310381, -82.50441261094352 35.59676022313113, -82.50445761094221 35.59681722314735, -82.5045146109433 35.59687122316423, -82.50461661095113 35.596930223186696, -82.5047876109683 35.59700322321913, -82.50498261098923 35.59707722325421, -82.50498561098948 35.59707822325472, -82.50539661102329 35.597301223342335, -82.50526061099836 35.59731722333166, -82.50498361094161 35.597387223317384, -82.50491261092566 35.59741422331562, -82.50484261090968 35.59744222331411, -82.50469961087232 35.59753122331747, -82.50459961084415 35.59760622332245, -82.50451461081661 35.59769322333143, -82.50445461079407 35.59777522334196, -82.50440561076925 35.59788322335884, -82.50436261074525 35.59799322337686, -82.50433661072518 35.59809522339494, -82.50432561070777 35.59819622341432, -82.50432961067057 35.59844222346479, -82.50434261065374 35.59856522349116, -82.5043556106423 35.5986532235104, -82.50436261063656 35.598698223520216, -82.50438961061421 35.59887222355845, -82.50439261060454 35.59893822357213, -82.50437261057424 35.59911322360567, -82.50436561056787 35.59914722361192, -82.50435461055862 35.59919522362057, -82.50429961052379 35.59936222364881, -82.50429261051889 35.59938622365299, -82.50423261048186 35.59956222368264, -82.50415861044088 35.5997482237129, -82.50413061042308 35.599834223727505, -82.50409261040254 35.5999262237423, -82.50407661038848 35.60000022375573, -82.50407261038467 35.60002022375934, -82.50405561036405 35.60013622378119, -82.50403761034772 35.600222223796884, -82.50400061031065 35.60042322383395, -82.50392961023844 35.60081522390635, -82.5039156102195 35.60092322392686, -82.50389561020012 35.601027223946, -82.50386961017301 35.6011752239735, -82.50386761016439 35.60122922398418, -82.50371061013816 35.60123022396833, -82.50356661011124 35.60125022395755, -82.50345261008754 35.6012812239521, -82.5034506100872 35.60128122395188, -82.50322561002217 35.60146122396536, -82.50301660995385 35.601679223988256, -82.50281360988913 35.60188122400854, -82.5026346098386 35.60201622401757, -82.50249060980242 35.60209622401898, -82.50245960979443 35.6021142240195, -82.50212660970907 35.60231022402512, -82.50192760965678 35.602435224030074, -82.50188360964512 35.60246322403129, -82.50176660961559 35.602529224032665, -82.50167060959437 35.60256322402967, -82.50159160957917 35.60257722402441, -82.50151560956579 35.60258222401763, -82.50125660952688 35.60255622398568, -82.50103760949376 35.60253522395892, -82.5010236094918 35.60253322395712, -82.50082160946333 35.60250022392956, -82.50081360946227 35.602498223928336, -82.50069360944595 35.60247522391138, -82.50041960941672 35.60237022386187, -82.50024660939673 35.60231322383243, -82.50020860939209 35.602303223826524, -82.50004960937156 35.602265223802426, -82.50000160936465 35.602258223796035, -82.49985460934367 35.602236223776465, -82.49954260929329 35.602227223742545, -82.49939060926748 35.60223122372772, -82.49924360924233 35.602236223713625, -82.49903760920638 35.602248223694865, -82.49874560915329 35.60227822367095, -82.49845460909692 35.60233122365181, -82.49813360903069 35.6024152236359, -82.49790660898591 35.60246122362192, -82.4975816089214 35.60253022360256, -82.49745160889537 35.60255922359507, -82.49710960882935 35.60262022357233, -82.49697860880485 35.602638223562515, -82.49680860877294 35.602662223549935, -82.49644360870866 35.60268622351727, -82.49623860867271 35.60269922349884, -82.49620960866754 35.60270122349629, -82.49582360860082 35.60271922346026, -82.49537660852505 35.60273022341653, -82.4950676084739 35.602729223384586, -82.49490260844253 35.602755223372874, -82.49482360842386 35.602791223372044, -82.49475260840319 35.6028492233766, -82.49471660838687 35.60291622338648, -82.4947036083698 35.60301322340487, -82.49469560834982 35.60313422342867, -82.49466560833078 35.603225223444085, -82.49460660830633 35.603320223457324, -82.49452060827608 35.6034242234697, -82.49446460825965 35.60347022347323, -82.49441460824478 35.60351322347687, -82.49410360815897 35.60373522349006, -82.49395960811212 35.6038842235055, -82.49390360809271 35.60395022351323, -82.49384560807242 35.60401922352131, -82.49383160806732 35.60403722352349, -82.4937346080253 35.60420522354769, -82.49371060801366 35.604255223555434, -82.4936736079947 35.60433822356844, -82.49360260796001 35.604487223591526, -82.4935766079467 35.60454522360058, -82.49348060790952 35.60468322361881, -82.49339560788495 35.60475122362389, -82.4933396078743 35.60476022361996, -82.49328560786606 35.604755223613374, -82.49324560786263 35.60473422360497, -82.49323460786164 35.60472922360292, -82.49311160785528 35.60463822357168, -82.49291360784513 35.60449122352146, -82.4927616078289 35.604433223494034, -82.49274760782731 35.60442822349159, -82.49257760780637 35.60438122346454, -82.49238860778009 35.60434822343841, -82.49221960775337 35.604340223419335, -82.49206160772641 35.60434522340411, -82.49185660768391 35.60440022339423, -82.49161060763198 35.60447222338359, -82.49156560762326 35.60448022338058, -82.49140060759116 35.60451122337001, -82.49117160754244 35.60458122336059, -82.49069260743902 35.60473622334286, -82.48981360724942 35.60502122331049, -82.48939760716132 35.605145223292915, -82.48937360716475 35.605097223280644, -82.48925660718247 35.60485622321961, -82.48922460719743 35.604725223189725, -82.48921160721483 35.604598223162505, -82.48920660723662 35.60445122313209, -82.48921660726488 35.604279223098125, -82.48928860730777 35.60407822306463, -82.48957160745941 35.60339922295571, -82.4897016075182 35.603157222919826, -82.48977760755504 35.60300022289568, -82.4898276075788 35.602900222880486, -82.48989160762048 35.60269822284603, -82.48990560764885 35.602529222813125, -82.48992960767212 35.60240422279014, -82.48991560770035 35.60220622274836, -82.48987960771771 35.60205522271394, -82.48980960773369 35.60187622267038, -82.48960260775533 35.601513222575235, -82.48938660777281 35.60116722248269, -82.4893216077872 35.60100422244283, -82.48926860780247 35.60084822240566, -82.48924660781562 35.60073922238121, -82.48924360783411 35.60061622235593, -82.48924860785282 35.600500222332805, -82.48930760790323 35.60023622228517, -82.48938260794728 35.600031222251246, -82.48954660803216 35.599657222192015, -82.48963760808299 35.59942522215419, -82.48971560812058 35.5992652221297, -82.48979360816567 35.599056222095136, -82.48988660824202 35.59866122202439, -82.48989660826805 35.598503221993276, -82.48988760829353 35.598328221956805, -82.48986360831734 35.598148221917725, -82.4898636083175 35.59814722191744, -82.48981060833994 35.59794422187076, -82.48968060837299 35.597590221785346, -82.48957860838777 35.597384221732966, -82.4894756084009 35.59718822168256, -82.4893036084151 35.596911221608494, -82.48918160842075 35.59674322156181, -82.48909260842345 35.596630221529665, -82.48900060842621 35.59651322149643, -82.48889160842687 35.596392221460654, -82.4887766084273 35.59626522142297, -82.48850460842016 35.59601922134496, -82.48830860841326 35.59585322129107, -82.4881986084075 35.59577222126325, -82.4881296084039 35.59572122124576, -82.48794560839309 35.595593221200815, -82.48789060838992 35.59555522118745, -82.48763260837121 35.59539922112919, -82.48737460834941 35.595263221075, -82.48722560833556 35.595192221045295, -82.48705160831949 35.59510922101049, -82.4866456082782 35.594941220934594, -82.4863976082518 35.5948452208896, -82.48594160820166 35.59468022080915, -82.48554560815701 35.59454422074073, -82.48490260808127 35.59434422063387, -82.48487860807838 35.59433722063, -82.4844546080263 35.594219220562415, -82.48415960798879 35.594145220517035, -82.48410660798217 35.594131220508785, -82.48405360797523 35.59411922050087, -82.48380260794343 35.59405522046205, -82.48365560792463 35.59401922043962, -82.48363760792184 35.594018220437576, -82.4826646077945 35.59379822029277, -82.48260060778598 35.5937842202834, -82.48232460774908 35.59372722024341, -82.48192360769718 35.5936322201828, -82.48176860767651 35.593600220160376, -82.48126960760885 35.59350222008917, -82.48100560757526 35.59343622004856, -82.48081460755161 35.59338422001839, -82.48056660752253 35.59330621997699, -82.4802526074906 35.59317621991827, -82.48006460747355 35.593084219880254, -82.47985660745765 35.5929642198345, -82.47965560744433 35.59283421978735, -82.47952560743839 35.59273321975346, -82.4792716074323 35.592499219679766, -82.47917360743196 35.59239621964872, -82.47908960743376 35.59229421961933, -82.47899060743829 35.59215821958152, -82.47896260743973 35.59211921957072, -82.47894760744025 35.59209921956504, -82.47879560744809 35.59188521950595, -82.47876360745076 35.59183321949209, -82.47870160746456 35.59167721945398, -82.47866660747243 35.59158821943226, -82.47861860748547 35.59145221939967, -82.47857060750522 35.59127221935813, -82.47852060754283 35.59097421929241, -82.47850860756587 35.59081221925821, -82.4785066075896 35.59065621922631, -82.47851260761367 35.59050621919639, -82.47853360764515 35.59032421916159, -82.47856960767479 35.59017121913419, -82.47857160767616 35.59016421913293, -82.47859160769292 35.590077219117326, -82.47866160773445 35.58988221908483, -82.47881060782177 35.589476219017556, -82.47897560791466 35.589051218948114, -82.47908360797494 35.5887762189033, -82.4791176079941 35.58868821888893, -82.4792206080514 35.588427218846434, -82.47925560807062 35.58834021883235, -82.47934760812285 35.588100218792974, -82.47938660814869 35.587974218771386, -82.47941260816518 35.587895218758, -82.47947260820852 35.58767821872005, -82.47949960823289 35.587549218696566, -82.47952660826522 35.58736821866252, -82.47953860829377 35.587196218628776, -82.47953760831952 35.58702821859451, -82.4795206083471 35.58683021855254, -82.47951960834757 35.58682621855164, -82.47948760837001 35.58664621851178, -82.47943960839277 35.5864472184663, -82.47949460840108 35.58645221847294, -82.47960160841862 35.58645321848418, -82.47972060843787 35.586456218497034, -82.48009160849695 35.586472218538425, -82.48025460852274 35.586480218556794, -82.48033860853606 35.58648421856624, -82.48059460857581 35.586501218596055, -82.4808416086141 35.58651821862486, -82.4812436086752 35.5865542186735, -82.48161460873081 35.586592218719424, -82.48195460878176 35.58662721876148, -82.48207060879899 35.586640218776054, -82.48215860881209 35.58665021878712, -82.48241860884978 35.586685218820975, -82.48253560886656 35.58670221883646, -82.48294060892452 35.58676121889008, -82.4830516089403 35.58677821890495, -82.48374160903747 35.58689021899867, -82.48415360909505 35.586959219055004, -82.48455860915165 35.587028219110735, -82.48469060916977 35.58705221912918, -82.48475860917937 35.58706321913838, -82.48536060926372 35.5871632192206, -82.48556160929179 35.58719721924824, -82.4856016092975 35.5872032192535, -82.4857236093149 35.58722121926971, -82.48576460932082 35.5872272192752, -82.48594060934597 35.587253219298525, -82.48610760936985 35.58727821932076, -82.48647060942267 35.58732521936772, -82.48648460942475 35.58732721936954, -82.48664860944956 35.58734221938945, -82.48680060947277 35.587355219407684, -82.48714060952452 35.587385219448755, -82.48725660954285 35.58739121946188, -82.4874096095666 35.58740121947964, -82.48752160958409 35.5874082194926, -82.48756160959061 35.58740921949694, -82.48789660964394 35.58742321953419, -82.48801860966418 35.58742321954671, -82.4881716096892 35.587425219562874, -82.48857860975686 35.58742421960452, -82.48915760985457 35.587413219661784, -82.48945860990455 35.58741221969254, -82.4899476099868 35.58740421974119, -82.48998960999384 35.58740421974549, -82.49026061003957 35.587399219772315, -82.49082161013375 35.587391219828405, -82.49107661017689 35.587385219853346, -82.49134861022297 35.587379219880084, -82.49136161022518 35.58737821988127, -82.49137861022808 35.58737821988298, -82.49140361023242 35.58737721988537, -82.49141861023482 35.5873772198869, -82.49181561030153 35.587371219926446, -82.49203861033821 35.587373219949825, -82.49223161036927 35.5873792199709, -82.49226761037492 35.58738121997499, -82.49251661041309 35.58740122000464, -82.49286161046317 35.587448220049666, -82.49312661049824 35.587505220088474, -82.49340161053179 35.58758322013265, -82.49355961055007 35.58763522015945, -82.49386261058226 35.587752220214405, -82.4940756106024 35.58785022025619, -82.4942696106194 35.58794922029634, -82.49444861063255 35.58805622033643, -82.49465261064604 35.58818822038424, -82.49465661064626 35.5881912203853, -82.49534461068467 35.58868222055584)))",6501,37,021,001802,370210018023,2223,2223,89,2177,1922,156,10,63,1,25,46,1890,61,1829,1860,1649,138,7,48,1,17,30,1265,1078,187
census_2010_blockgroups_view.fid--2dc29038_13ec899ba8f_-25e1,"MULTIPOLYGON (((-82.68308064890769 35.54285823048815, -82.68324564894252 35.542810230495235, -82.68374364904729 35.542667230517075, -82.68390964908203 35.54262023052448, -82.68388464905969 35.5427392305462, -82.6838706490458 35.54281423056004, -82.68380364899126 35.5430972306109, -82.6837766489684 35.54321723063259, -82.68375864895542 35.54328223064401, -82.6837516489497 35.54331223064939, -82.6837506489489 35.5433162306501, -82.68371564891795 35.54348023067994, -82.68370164890533 35.54354723069218, -82.68367964888225 35.543674230715794, -82.68366864887318 35.543721230724216, -82.68363764884698 35.54385823074899, -82.6835956488202 35.543987230770966, -82.68354164877275 35.5442382308166, -82.68352964876186 35.54429623082724, -82.6835346487444 35.54441523085198, -82.68403464868189 35.545366231097056, -82.68419364866328 35.54566023117329, -82.68454464862245 35.54630723134107, -82.68475764859534 35.546715231446086, -82.68521164854296 35.547549231662565, -82.68530964853612 35.547700231703345, -82.68543064853449 35.54784223174472, -82.68554964854019 35.547934231775635, -82.68570464855203 35.5480252318101, -82.68585564856838 35.548082231837206, -82.68603164859151 35.54812223186341, -82.68644564865261 35.54817323191614, -82.68655064866765 35.54818923193014, -82.68665964868207 35.54821323194625, -82.68676864869546 35.54824423196373, -82.68686264870604 35.54827723198011, -82.686951648714 35.54832223199836, -82.68702764871985 35.548366232015084, -82.68703264872008 35.54837023201642, -82.68714164872445 35.54846023204599, -82.68720664872465 35.54852923206669, -82.68726964872255 35.54861123208981, -82.68732064871817 35.548695232112216, -82.6874646486961 35.548995232188055, -82.68751964868429 35.54913223222165, -82.68756064867051 35.54926623225316, -82.68762064863235 35.549580232323336, -82.68762464862814 35.549612232330276, -82.6876386486141 35.549719232353524, -82.68765664859195 35.54988323238878, -82.6876876485548 35.55015923244821, -82.68771764850838 35.550494232519576, -82.68774964848424 35.550686232562, -82.68775164848306 35.55069623256426, -82.68776564847644 35.55075423257745, -82.6878266484673 35.550880232609394, -82.68786764846459 35.550942232626234, -82.68789064846308 35.55097723263577, -82.68793864846305 35.55102923265127, -82.68806464846799 35.5511342326856, -82.68809164846994 35.55115023269164, -82.68814564847376 35.55118423270406, -82.68829364848779 35.55125323273328, -82.68837964849702 35.55128623274881, -82.68848364850946 35.55131823276601, -82.68874364854341 35.55137923280505, -82.68896964857406 35.55142423283741, -82.68916464860058 35.55146323286532, -82.68927164861435 35.55148923288159, -82.68929764861781 35.55149523288548, -82.6893956486297 35.551524232901436, -82.68950364864179 35.55156223292019, -82.6895856486501 35.551597232935755, -82.68964464865532 35.55162723294792, -82.68965364865609 35.55163223294983, -82.6897236486606 35.551678232966395, -82.68979164866336 35.55173423298475, -82.68984964866395 35.551793233002726, -82.6898986486623 35.55185723302081, -82.68994264865883 35.55192723303956, -82.6899956486473 35.55206023307211, -82.6900706486109 35.55237923314485, -82.69012264857487 35.552670233209476, -82.69012264857443 35.55267323321007, -82.6901446485439 35.55289623325787, -82.69015464851857 35.55307223329475, -82.69015864850978 35.55313323330757, -82.69016364850334 35.55318123331784, -82.69016764849911 35.55321323332477, -82.69019564848257 35.55335123335586, -82.69025764847046 35.55349723339188, -82.69028864846425 35.55357123341018, -82.69030364846262 35.5535982334172, -82.69033564845897 35.55365723343257, -82.69040964845424 35.55376823346274, -82.69023264842195 35.553786233448264, -82.68961564830657 35.55386923340199, -82.68910364820906 35.553949233365834, -82.688854648161 35.553992233349085, -82.6880866480101 35.554143233301225, -82.68656764770938 35.55445523320917, -82.686514647699 35.55446523320582, -82.68583564756567 35.554598233163354, -82.68544864749138 35.55466223313676, -82.68521864744866 35.55469123311909, -82.68506564742015 35.554711233107575, -82.68479164736995 35.554741233085544, -82.68415464725794 35.55478023302831, -82.68388764721225 35.55478823300249, -82.68337064712703 35.55478323294856, -82.68311664708624 35.55477323292049, -82.68284964704446 35.55475623288965, -82.6824636469855 35.55472123284299, -82.68194664690893 35.55466023277755, -82.68086664675067 35.55452023263843, -82.68099064673851 35.554734232694734, -82.6810416467336 35.55482123271769, -82.68114664672144 35.555014232767824, -82.6814096466955 35.555469232887475, -82.68155264667784 35.555739232957166, -82.6816056466687 35.555856232986464, -82.68164164665842 35.55596223301173, -82.68164564665388 35.55599623301907, -82.68165964664207 35.55608823303925, -82.68165464662562 35.55619023305954, -82.68164464661503 35.55624823307038, -82.68162864660495 35.556296233078534, -82.68157264657941 35.55640223309434, -82.68153964656797 35.556441233098894, -82.68150064655411 35.55648923310477, -82.68145064653902 35.55653323310853, -82.68132264650345 35.556626233114436, -82.68123164648028 35.556678233115726, -82.68108964644415 35.556760233117856, -82.68058464631788 35.55703523312214, -82.68035964625925 35.55717323312727, -82.68021964622064 35.55727323313327, -82.68017164620716 35.55730923313566, -82.68009564618339 35.55738123314266, -82.68001764615694 35.557469233152574, -82.6799496461326 35.5575542331629, -82.67988564610735 35.55764923317567, -82.67987564610326 35.557665233177964, -82.67982664608137 35.55775423319104, -82.67978064605916 35.55784923320566, -82.6797496460387 35.55794923322292, -82.67973064602343 35.558028233237046, -82.67972964602247 35.558033233238014, -82.67972464600369 35.558150233261316, -82.67972564600142 35.558166233264714, -82.6797316459849 35.55828023328854, -82.67973364598154 35.558304233293605, -82.67976764596108 35.55847423333175, -82.67980264594497 35.55861723336446, -82.67983064593251 35.5587292333902, -82.67983264593143 35.55873823339228, -82.67984064592818 35.55876823339919, -82.67984364592714 35.55877823340149, -82.67989464590904 35.558951233442016, -82.67992064590007 35.55903823346239, -82.67998664587441 35.55927723351783, -82.68004564585918 35.55944023355715, -82.68005864585687 35.559469233564414, -82.68013064584521 35.5596232336032, -82.68013664584468 35.55963323360583, -82.68022064583884 35.55976223364074, -82.68027164583692 35.559830233659824, -82.68030964583664 35.559873233672455, -82.68041764583604 35.55999423370822, -82.68059664583609 35.56018823376609, -82.68077864583353 35.56040223382836, -82.68088164582764 35.5605522338695, -82.68096364582313 35.56067023390194, -82.68103364581381 35.56080723393702, -82.68105364581133 35.56084523394679, -82.6810876458067 35.56091223396394, -82.68111064580258 35.56096423397692, -82.68112864579942 35.56100423398692, -82.68119164578819 35.561145234022085, -82.6813306457564 35.56150323410935, -82.68142864573821 35.56172823416522, -82.68144064573468 35.5617642341738, -82.68153664570751 35.56204523424096, -82.68157464569417 35.56217323427085, -82.68161564566762 35.56239123431951, -82.68162764565488 35.562487234340374, -82.68163564563882 35.562600234364226, -82.68161964559638 35.56285923441531, -82.68161064557846 35.56296623443626, -82.6815466454921 35.56345923453017, -82.68151864546047 35.5636352345632, -82.68147364542183 35.56383823459994, -82.68141364537685 35.56406623464031, -82.68137564535307 35.56418023465961, -82.68124164526797 35.56458923472924, -82.68109864518799 35.56495523478917, -82.68104164517811 35.564958234783965, -82.68087364514842 35.56496923476901, -82.68081764513836 35.56497423476433, -82.68048664507995 35.564995234734624, -82.67949664490509 35.56506123464664, -82.67937464488337 35.56507023463597, -82.67916664484692 35.565082234617115, -82.67907164483037 35.56508723460841, -82.67878564478005 35.56510523458278, -82.6786916447635 35.565111234574324, -82.67865764475795 35.565110234570646, -82.67855664474119 35.565110234560365, -82.6785236447356 35.56511023455693, -82.678465644726 35.56511023455098, -82.6782296446892 35.5650942345235, -82.67818064468155 35.56509123451794, -82.67793364464625 35.56505323448482, -82.67763464460732 35.564982234439675, -82.67737064457586 35.56490123439615, -82.67736464457518 35.56489923439515, -82.67709764454688 35.564794234346344, -82.67699964453672 35.564754234328156, -82.67670664450635 35.564634234273676, -82.67660964449615 35.564595234255826, -82.67656664449179 35.56457723424775, -82.67643864447851 35.564525234223986, -82.67639664447405 35.5645082342162, -82.67596064442797 35.56433623413653, -82.67580264441159 35.56427123410706, -82.6756086443915 35.564192234071086, -82.67539264436594 35.56412423403511, -82.67520264434107 35.56408023400667, -82.67504464431774 35.56406123398662, -82.67488564429237 35.564054233968875, -82.67468364425692 35.564066233950555, -82.67435964419391 35.56412523392942, -82.67423064416846 35.564151233921486, -82.67412664414745 35.56417523391575, -82.6739356441088 35.56422023390531, -82.67331464398276 35.56436823387181, -82.67306064393144 35.56442723385781, -82.67229864377755 35.56460323381562, -82.67204564372628 35.5646632338019, -82.67187864369251 35.56470223379275, -82.67137764359121 35.564819233765235, -82.67121064355742 35.56485823375609, -82.67101464351768 35.5649042337454, -82.67100364351563 35.564906233744615, -82.67086164348738 35.56493623373622, -82.67073064346374 35.564948233725254, -82.67063664344768 35.56495123371619, -82.67045864342104 35.564931233693926, -82.67037764341183 35.56490323367992, -82.67035464340917 35.56489623367613, -82.67030764340433 35.56487623366717, -82.67025364340043 35.56484323365491, -82.67020064339931 35.56479323363931, -82.67015264339932 35.564741233623835, -82.67006464340427 35.56461323358867, -82.67001464340721 35.56454023356872, -82.66971264343414 35.56403723343526, -82.66959764344467 35.5638442333841, -82.66946864345695 35.56362423332602, -82.66939264346419 35.56349523329199, -82.66911664349023 35.56302623316814, -82.66908164349339 35.56296723315246, -82.6689516435053 35.56274923309469, -82.6687976435179 35.562500233028224, -82.66859864353086 35.562200232946665, -82.66849264353407 35.56206423290809, -82.66825364353723 35.561784232826504, -82.6682306435378 35.56175623281841, -82.66785564353725 35.561353232697925, -82.66765964353644 35.56114623263564, -82.66750464353684 35.560975232584894, -82.66749164353679 35.56096123258067, -82.66725364353607 35.56070823250471, -82.66699464353535 35.56043223242191, -82.66689064353419 35.56032723238984, -82.66680064352961 35.56025923236682, -82.66670564352381 35.56019423234384, -82.66661764351575 35.560151232326135, -82.66653164350636 35.56011923231072, -82.66643864349452 35.560095232296284, -82.66639764348879 35.56008823229067, -82.6663186434774 35.56007723228033, -82.66620664345906 35.56007523226845, -82.66604964343195 35.560081232253594, -82.6650376432514 35.560161232166166, -82.66493864323279 35.56017523215889, -82.66486464321778 35.56019223215477, -82.66476164319535 35.56022723215135, -82.66466364317212 35.56027223215047, -82.66458064315 35.56032623215292, -82.66450164312538 35.56040123216011, -82.66442164309777 35.56049423217087, -82.66431664305574 35.5606542321927, -82.66425964303411 35.56073323220302, -82.66416864300776 35.56080623220851, -82.66406664298073 35.56087223221157, -82.6640106429672 35.56089923221131, -82.66395064295418 35.560919232209216, -82.66381264292694 35.56094723220079, -82.66373464291271 35.560955232194424, -82.6637136429089 35.56095723219269, -82.66346464286877 35.560949232165555, -82.66345264286689 35.56094823216411, -82.66311064281372 35.560924232124165, -82.66237564270108 35.56086123203598, -82.66215264266685 35.560842232009286, -82.66173664260307 35.56080723195945, -82.66148664256546 35.56078123192852, -82.661331642542 35.56076623190964, -82.66126564253265 35.560755231900615, -82.66117264251973 35.56073923188783, -82.66114664251626 35.56073323188394, -82.66099964249686 35.56070023186215, -82.66080364247439 35.56063423182858, -82.66080064247423 35.56063223182792, -82.66069064246334 35.560584231806864, -82.6604096424372 35.56044923175051, -82.66032864242982 35.56041023173425, -82.66002364240272 35.56025623167166, -82.65957664236365 35.56002623157896, -82.65944964235246 35.55996123155268, -82.65929864233877 35.55988723152218, -82.65922364233194 35.55985023150692, -82.65918864232862 35.559834231500034, -82.65903664231237 35.55977523147248, -82.6589906423064 35.55976423146546, -82.65890964229565 35.55974623145352, -82.65882764228374 35.559735231442836, -82.6588106422811 35.55973423144093, -82.65873264226857 35.559731231432394, -82.65863764225246 35.55973323142302, -82.65851464223059 35.55974223141224, -82.65841664221294 35.55975123140405, -82.65825764218431 35.559765231390514, -82.65790964212137 35.559798231361675, -82.65778264209926 35.55980423134978, -82.65762464207164 35.559813231335475, -82.65744864204234 35.55981323131745, -82.65732364202216 35.559809231303795, -82.65725064201033 35.55980723129593, -82.65708864198476 35.559798231277504, -82.65686564195047 35.55978023125099, -82.65675664193436 35.559767231237124, -82.65642564188516 35.55972923119547, -82.6561276418408 35.559695231157946, -82.65609064183542 35.559690231153134, -82.6559796418192 35.559675231138726, -82.65594364181403 35.55967023113402, -82.6556056417638 35.55963123109142, -82.65544364173834 35.55962123107275, -82.65525764170746 35.55962123105374, -82.65503864166791 35.55964123103534, -82.65502164166483 35.559643231034094, -82.65489264163975 35.55966623102552, -82.65459764158125 35.55972823100792, -82.65408864147749 35.559852230981, -82.65365464138996 35.55995223095688, -82.65349964135912 35.55998523094773, -82.65327964131673 35.56002323093292, -82.65314564129262 35.560035230921606, -82.65301364127004 35.5600392309089, -82.65288364124874 35.560037230895134, -82.65272864122421 35.560029230877696, -82.65236064116928 35.55998823083155, -82.65234564116687 35.559987230829826, -82.65213064113573 35.55995723080168, -82.65169464107404 35.559887230742724, -82.65146564104329 35.55983923070945, -82.65138464103265 35.55982123069753, -82.65135164102814 35.5598142306927, -82.65114664100206 35.55976223066105, -82.65106764099203 35.559742230648894, -82.65118864103177 35.55961423063526, -82.65143864111374 35.55935123060725, -82.65154964115088 35.55922923059379, -82.65166864119065 35.559099230579456, -82.6518586412552 35.55888423055517, -82.65225264138859 35.55844223050545, -82.65243164144867 35.55824523048364, -82.65244564145316 35.55823123048226, -82.65263064151331 35.558039230462136, -82.65275864155534 35.55790423044776, -82.65280864157157 35.55785323044245, -82.65289664160213 35.557749230430275, -82.65293564162086 35.557669230417936, -82.65294664163866 35.5575652303979, -82.65294364165754 35.557439230371926, -82.65293964166186 35.55740623036484, -82.6529336416715 35.55733723035014, -82.65293264168929 35.55722023032618, -82.6529516417053 35.55713623031107, -82.65296164171349 35.55709423030348, -82.653031641771 35.55679523024977, -82.6530766417806 35.55678123025153, -82.65344664185704 35.55668423026968, -82.65369064190634 35.556627230283055, -82.65393464195493 35.55657523029747, -82.65419264200533 35.55652623031397, -82.65420164200714 35.55652423031438, -82.6545746420784 35.55646423034044, -82.65481864212381 35.55643323035911, -82.65490664213978 35.556424230366304, -82.65506564216874 35.556407230379136, -82.6553316422165 35.556385230401894, -82.65560464226412 35.55637023042687, -82.65585564230729 35.55636123045075, -82.65625564237487 35.55635423049031, -82.65638264239551 35.556357230503984, -82.65662764243532 35.556363230530266, -82.65690364247916 35.55637723056137, -82.65714364251642 35.55639423058944, -82.65740764255665 35.55641823062139, -82.65765464259316 35.55644823065282, -82.65791064263047 35.556482230686036, -82.65830064268535 35.55654723073925, -82.65854764271893 35.55659623077451, -82.65891964276761 35.5566822308302, -82.65906664278681 35.55671623085217, -82.65940164282866 35.55680723090505, -82.65990364289036 35.55694923098547, -82.66052864296707 35.55712623108559, -82.6610076430264 35.55725923116172, -82.66196964314432 35.557533231316135, -82.66211764316246 35.557575231339904, -82.66295464326605 35.55780823147311, -82.6629766432687 35.55781423147664, -82.66324464330224 35.557886231518765, -82.66332664331252 35.55790823153164, -82.66372164336457 35.55799723159029, -82.66385664338239 35.55802723161025, -82.6643506434522 35.55810823167731, -82.66448064347132 35.55812423169391, -82.66488464353348 35.558157231742065, -82.66492164353946 35.55815823174607, -82.66480464354936 35.55796723169514, -82.66473464356429 35.55779423165268, -82.66463664358552 35.55754923159277, -82.66447964359732 35.55730223152635, -82.66446164359867 35.557274231518754, -82.66435164359646 35.55716923148609, -82.66426664359476 35.55708823146087, -82.66426164359449 35.55708423145959, -82.66414564358811 35.55700023143055, -82.66402464357472 35.55695623140915, -82.66392964356172 35.5569382313958, -82.66380964354506 35.556916231379, -82.66364464352243 35.55688523135578, -82.66335964348313 35.55683223131577, -82.66335164348212 35.55683023131458, -82.66325864346926 35.55681323130154, -82.66315464345712 35.55677923128396, -82.6629956434385 35.55672823125731, -82.66288164342524 35.55669123123804, -82.66275764341061 35.556652231217356, -82.66254264338565 35.55658223118108, -82.66243064337249 35.556546231162294, -82.66237064336538 35.55652723115223, -82.6621626433494 35.55640623110627, -82.66198064332714 35.556354231077, -82.66162464328353 35.55625223101975, -82.66116064319961 35.55629623098118, -82.66097864317699 35.55624623095235, -82.66081764316374 35.55615823091788, -82.66072064316052 35.55607423089084, -82.6606136431568 35.55598223086116, -82.66035364314807 35.55575723078859, -82.66021464313263 35.55570723076421, -82.65994264310247 35.55560923071634, -82.65970764307612 35.55552623067536, -82.65953364307832 35.55532323061618, -82.65940264310629 35.55499923053673, -82.65938564311014 35.55495523052602, -82.65921164310684 35.55478823047414, -82.6591106431049 35.55469123044401, -82.65900264311401 35.554515230397065, -82.65883464316954 35.55397123026897, -82.6587876432291 35.553532230174746, -82.6586736432448 35.55330623011702, -82.65843664323974 35.55308223004705, -82.65837764323861 35.553026230029644, -82.65795364326084 35.5524212298629, -82.65751764323224 35.55213522975993, -82.657441643229 35.55207422973973, -82.65692564320713 35.55165722960186, -82.65678464321736 35.551437229542564, -82.65667664321542 35.55133322951031, -82.65660264320817 35.55130022949601, -82.65639464317958 35.551261229466746, -82.65588364310136 35.551217229405374, -82.65465264293621 35.550959229226684, -82.65377264283035 35.550695229082685, -82.65351564281437 35.55052122902099, -82.6534626428109 35.55048622900841, -82.65316064280113 35.55022222892368, -82.65309364280937 35.55009622889112, -82.65309364283056 35.549958228862934, -82.65316064285595 35.54986522885087, -82.65317464287173 35.5497772288344, -82.6531276428715 35.54972822881957, -82.65259564277981 35.54974922876937, -82.65235364275125 35.549673228729084, -82.65223864274199 35.54960822870401, -82.65213964273418 35.54955222868248, -82.65203064272539 35.54949122865884, -82.65191564273441 35.54930822860983, -82.65186964273823 35.54923322858983, -82.65186364274092 35.54920922858428, -82.65181364276113 35.549023228541294, -82.65176264278283 35.5488262284959, -82.65156364279821 35.548510228411146, -82.65154064279996 35.54847422840145, -82.6515076428167 35.54832922836852, -82.65149564282258 35.54827822835687, -82.65146064283972 35.54812822832278, -82.6514406428438 35.548080228310916, -82.65287664317222 35.54749622833903, -82.65625864394504 35.54612422840611, -82.65718564415707 35.54574722842421, -82.65828964440936 35.5452992284461, -82.65863664448153 35.545205228462464, -82.65891764453977 35.545130228475905, -82.6590726445716 35.54509022848366, -82.65937264463318 35.54501422849897, -82.65966564469208 35.544948228515516, -82.65976664471124 35.54493222852258, -82.66005464476609 35.54488722854294, -82.66033464482115 35.544832228560395, -82.66071664489232 35.54478222858932, -82.66085764491807 35.544767228600726, -82.66110664496311 35.54474322862135, -82.6615166450304 35.544749228664536, -82.66198964511021 35.54474222871164, -82.66272264523003 35.54475522878939, -82.66329364532137 35.544779228852754, -82.66410664545118 35.544814228943174, -82.66479764556212 35.54484022901934, -82.66549864567443 35.544868229096835, -82.66559664569017 35.54487222910763, -82.66687064589414 35.54492322924863, -82.66756164600484 35.54495122932505, -82.6676176460139 35.544953229331234, -82.66778564604058 35.544961229350065, -82.66784264604962 35.54496422935651, -82.66821964611002 35.544979229398194, -82.66935264629166 35.54502422952348, -82.66973064635216 35.545039229565205, -82.67059764649255 35.54506422965916, -82.67205864672906 35.545107229817496, -82.67258164681282 35.54512822987537, -82.67310964690091 35.54512622992909, -82.67319964691636 35.545123229937666, -82.67406764706476 35.545097230021284, -82.6744946471436 35.54504623005465, -82.67452264714882 35.54504223005671, -82.67504064724552 35.544974230095924, -82.67536564730881 35.54491423011695, -82.67563664736322 35.544853230132325, -82.67587664741231 35.54479323014464, -82.67632264750358 35.544682230167744, -82.67665664757135 35.544602230185575, -82.67674364758895 35.54458223019044, -82.6776546477781 35.54433723023384, -82.67798764784695 35.54424923025002, -82.67842464793807 35.544129230270315, -82.67973664821142 35.54377023033153, -82.68017464830258 35.5436512303521, -82.68048364836744 35.54356323036581, -82.6814136485622 35.543302230407924, -82.68172464862734 35.543215230422014, -82.6819956486834 35.54314323043508, -82.68235064875678 35.54305023045245, -82.68280864885153 35.54292923047473, -82.68308064890769 35.54285823048815)))",6564,37,021,002505,370210025052,2193,2193,90,2163,2033,58,4,33,4,31,30,1711,61,1650,1694,1613,34,3,19,4,21,17,1006,899,107
census_2010_blockgroups_view.fid--2dc29038_13ec899ba8f_-25e0,"MULTIPOLYGON (((-82.59001164950794 35.4379051995858, -82.59007064951332 35.437934199597755, -82.59024364952897 35.43801919963277, -82.59039364954279 35.4380921996629, -82.59072864962471 35.43791919966204, -82.59092864967637 35.43779819965781, -82.59096364968534 35.43777719965712, -82.59124164975698 35.437610199651594, -82.59157864984171 35.43742119964758, -82.59163464985647 35.43738519964603, -82.59163564986015 35.437362199641434, -82.59165064988873 35.43719119960816, -82.59165264990187 35.43710719959127, -82.59171664992311 35.43703819958377, -82.59203465002867 35.436692199545874, -82.59264465018147 35.436354199539466, -82.59337165034005 35.43610519956315, -82.5935546503797 35.4360441995694, -82.5936076503926 35.43601719956932, -82.59388265045975 35.435876199568774, -82.59405765049459 35.43583819957893, -82.59456165059508 35.43572719960791, -82.59485165063512 35.43578019964835, -82.5953546507038 35.43587619971936, -82.59601865074113 35.436353199884316, -82.59620465074525 35.43652819993896, -82.59629365074721 35.4366121999652, -82.596446650768 35.436642199986935, -82.5989256511009 35.43715420034468, -82.59896365110676 35.43715720034916, -82.59901765111267 35.43717720035878, -82.59887265106065 35.43736020038114, -82.59879565103466 35.437447200391, -82.5987046510003 35.437573200407314, -82.59865665098128 35.437645200417066, -82.59861265096352 35.43771420042665, -82.59854165093002 35.437856200448266, -82.59848965089823 35.438008200473874, -82.59844665086477 35.438180200504505, -82.59841065083044 35.438366200538695, -82.59838965080638 35.43850120056403, -82.59839365079036 35.43861020058666, -82.59841865078235 35.43869020060545, -82.5984656507768 35.43877720062802, -82.59854265077067 35.438901200661135, -82.59861965076048 35.43905120069949, -82.59870865074654 35.43923920074691, -82.59879365073067 35.4394352007954, -82.59885265071364 35.439611200837284, -82.59888665069772 35.43975220086951, -82.59893365065595 35.44007720094048, -82.59897265064058 35.440220200973556, -82.59902865063101 35.44034320100437, -82.59911265062864 35.44045020103468, -82.59922065062962 35.440561201068306, -82.59934865063269 35.44068020110562, -82.59962965064092 35.440931201185464, -82.59975365063781 35.4410862012297, -82.59985465063085 35.44124120127158, -82.59993865061809 35.441416201315874, -82.5999856506068 35.44154120134607, -82.60001065058789 35.44169220137932, -82.60001465056887 35.44182120140598, -82.59999165054704 35.44193920142773, -82.59998165052022 35.44210420146023, -82.59998065049973 35.4422372014872, -82.59999765048278 35.44236620151519, -82.60014765045237 35.44272820160421, -82.60017865044405 35.442816201625334, -82.60019165042927 35.442927201649184, -82.60019565038192 35.443242201713815, -82.60019465037784 35.44326720171875, -82.60018865035056 35.44343920175314, -82.60017665032316 35.44360620178595, -82.60016865027859 35.443889201842715, -82.60016565025593 35.44403420187199, -82.60016265024683 35.44409020188301, -82.60015465021925 35.44426220191725, -82.60013965018028 35.44450120196433, -82.60009465009111 35.44503620206862, -82.60005765000618 35.445552202169864, -82.60004664997345 35.44575420220987, -82.60001764987607 35.446360202330226, -82.60001564987313 35.44637720233351, -82.59999864984415 35.446548202366614, -82.59991064973207 35.44718620248744, -82.59989164970412 35.447349202518666, -82.59988764969748 35.447388202526184, -82.59988264967677 35.447518202552125, -82.59990264965835 35.447660202583144, -82.59997564963273 35.44790720264082, -82.600025649621 35.44803820267266, -82.6000496496078 35.448151202698085, -82.60005264958838 35.44828120272486, -82.6000156495619 35.44841420274814, -82.59994964953309 35.448531202765196, -82.59984164949846 35.44864020277638, -82.59983664949728 35.44864320277643, -82.59973264946804 35.448721202781705, -82.59961564944084 35.44877220278012, -82.59928264937086 35.44886920276577, -82.5991586493434 35.44891420276224, -82.59883664926524 35.44907620276233, -82.59847564917523 35.449273202765454, -82.59843664916538 35.449295202765946, -82.59828864912767 35.44938120276828, -82.59815764909314 35.44946520277201, -82.5979116490224 35.4496612027867, -82.59779164898656 35.44976520279564, -82.59768064895563 35.449847202801, -82.59764464894648 35.44986820280157, -82.59757264892824 35.44990920280255, -82.59745164889951 35.44996620280173, -82.59743164889505 35.449973202801125, -82.59736964888103 35.449998202799904, -82.5971936488428 35.450057202793936, -82.59675164874945 35.45018820277537, -82.59672664874405 35.450196202774436, -82.59652364870176 35.450253202765275, -82.59641964867986 35.4502832027607, -82.59619664863156 35.45035720275292, -82.59594764857748 35.45044020274435, -82.59548164847475 35.45060720273072, -82.59529164843022 35.45069220272851, -82.59523864841636 35.4507252027299, -82.59507964837474 35.45082520273395, -82.59503064835944 35.45087220273847, -82.59498164834032 35.45094420274808, -82.5949596483309 35.45098220275361, -82.59493764831635 35.45105320276588, -82.59487964826154 35.451349202820104, -82.59484464822134 35.451574202862396, -82.59482964819878 35.45170520288744, -82.59479064813645 35.452071202958, -82.59477564810938 35.45223220298925, -82.59476864808781 35.45236520301555, -82.59476864806585 35.452509203044876, -82.59478364801146 35.45288120312212, -82.59478264795996 35.453217203190434, -82.59479364788633 35.45371120329204, -82.59479364783566 35.45404220335952, -82.59479364780027 35.45427420340674, -82.59480164774902 35.45461820347752, -82.59480064771749 35.4548232035192, -82.59479964769169 35.45499120355333, -82.59479764761389 35.45549820365631, -82.594797647588 35.455667203690666, -82.59479764755741 35.45586720373142, -82.5947976475098 35.456179203794896, -82.59479164746746 35.4564492038492, -82.59478464746321 35.45646920385255, -82.59475864744698 35.45654720386577, -82.5946736474201 35.45663120387422, -82.59450964737594 35.45674220388, -82.59435964734017 35.45681320387908, -82.59390564724075 35.45697120386481, -82.59386964723267 35.45698520386396, -82.59376064720747 35.45703120386217, -82.59362664717533 35.457096203861724, -82.59341764712372 35.457207203862886, -82.59308164703904 35.45739620386704, -82.59292564699808 35.45749520387115, -82.59284664697479 35.45756120387651, -82.59273264693994 35.45766620388621, -82.59227464679071 35.458145203936866, -82.59206264672653 35.458335203953844, -82.59192864668834 35.4584392039613, -82.59176364664324 35.45855520396809, -82.59164264661011 35.45864120397316, -82.59149164657065 35.458735203976794, -82.59138764654519 35.458789203977226, -82.5912916465242 35.458822203974094, -82.59119264650451 35.458843203968236, -82.5909566464617 35.45886720394894, -82.59086264644445 35.45887820394161, -82.59059564639257 35.4589282039244, -82.59055864638513 35.458936203922256, -82.5904006463551 35.45896120391122, -82.59027764633366 35.45896820389999, -82.59014964631284 35.458965203886265, -82.58976164625632 35.45891420383625, -82.58966364624084 35.45890920382515, -82.58956364622307 35.45891720381657, -82.5895046462108 35.458933203813764, -82.58947064620362 35.45894320381231, -82.58936064617815 35.458990203810686, -82.58929964616237 35.45902720381192, -82.589217646141 35.45907820381389, -82.58918464613147 35.45910520381608, -82.58903364608723 35.459230203826046, -82.58898164607191 35.45927420382973, -82.58890464604893 35.4593412038354, -82.58861564596263 35.45959220385699, -82.5885036459277 35.459699203867295, -82.58839764589352 35.45980720387835, -82.58827064585236 35.45993920389231, -82.58821764583419 35.46000020389927, -82.58806364578165 35.4601772039195, -82.58801664576511 35.46023420392629, -82.58774364566814 35.46057220396716, -82.58762064562583 35.460715203983725, -82.58741264555758 35.46093620400736, -82.58738964554996 35.4609612040101, -82.58718964548784 35.46115020402814, -82.58709364545817 35.461240204036606, -82.58708864545669 35.461244204036916, -82.5869386454112 35.46137920404906, -82.58678364536348 35.4615232040625, -82.58668364533244 35.46161720407138, -82.58660664530802 35.46169420407912, -82.58644864525749 35.461853204095384, -82.58637964523425 35.46193020410395, -82.58632864521675 35.46198920411077, -82.58630964520997 35.462013204113724, -82.58613564514883 35.46222420413885, -82.5859946450985 35.4624002041602, -82.58593464507692 35.46247620416954, -82.5856236449633 35.46288220422039, -82.585548644938 35.46296620422978, -82.5854866449196 35.46301920423428, -82.58541664490113 35.463064204236254, -82.58532264488042 35.463097204233264, -82.58523064486229 35.463116204227774, -82.585043644829 35.46313120421164, -82.58481264479114 35.463128204187434, -82.58479064478747 35.46312820418514, -82.58448564473827 35.463119204152136, -82.58431364470947 35.46312120413491, -82.58427564470318 35.46312120413106, -82.58426264470081 35.463122204129874, -82.58415664468129 35.463135204121706, -82.58411364467229 35.46314720411977, -82.58406564466205 35.463162204117914, -82.58403364465538 35.46317120411641, -82.58389964462422 35.463229204114505, -82.58380064460037 35.46327820411432, -82.58375764458991 35.46330020411443, -82.58360764455509 35.46336520411231, -82.58349764453156 35.46339920410797, -82.58335864450295 35.463436204101264, -82.5831196444545 35.4634932040884, -82.58299864442864 35.46353120408381, -82.58297664442392 35.4635382040829, -82.58287364440108 35.46357620408013, -82.58271164436272 35.46365120407874, -82.58258064433153 35.463713204078054, -82.58247564430641 35.46376320407744, -82.58232964427285 35.46382420407487, -82.58219564424367 35.463870204070496, -82.58217764424002 35.463874204069555, -82.58205864421531 35.46390720406408, -82.58203764421104 35.46391220406292, -82.58189864418323 35.46394320405503, -82.58182464416863 35.46395820405048, -82.58164864413396 35.46399420403977, -82.5813606440793 35.464039204019485, -82.58108164402799 35.46407220399767, -82.58081164397804 35.464106203976925, -82.58064764394726 35.46412920396483, -82.58051864392128 35.464159203957685, -82.58047064391124 35.46417320395567, -82.58040864389808 35.464192203953246, -82.58029464387282 35.46423320394988, -82.58015864384066 35.464296203948756, -82.57983664375867 35.46448320395388, -82.57963764370882 35.4645932039559, -82.57947364366957 35.46467220395515, -82.57931064363257 35.46473720395167, -82.57897464355486 35.464881203946554, -82.5788306435196 35.46495520394692, -82.57842364341677 35.465186203952264, -82.57821464336378 35.46530620395535, -82.57758864320309 35.46567820396691, -82.57739364315312 35.46579320397032, -82.5772496431161 35.46587920397308, -82.57704164306377 35.465996203975635, -82.57680464300469 35.46612520397761, -82.57675764299279 35.46615220397828, -82.5766086429552 35.46623620398012, -82.57661964295076 35.46627720398957, -82.57667464294057 35.46640320402092, -82.57670964293588 35.46647220403851, -82.57706164288913 35.467159204214354, -82.57717964287355 35.46738920427326, -82.57733864285228 35.46770020435284, -82.57744764283787 35.467913204407374, -82.57780764278648 35.46863920459194, -82.57796364276433 35.46895320467181, -82.57812264274051 35.46928120475489, -82.57817964273191 35.46939920478473, -82.57821464272563 35.46947820480432, -82.57826564271643 35.469593204832954, -82.57848764267102 35.47013120496525, -82.57854664265632 35.47029120500384, -82.57867564262533 35.47063320508663, -82.5787566426058 35.470849205138876, -82.57898664255106 35.47145620528599, -82.57900264254741 35.47149720529592, -82.57908764252846 35.471713205348635, -82.57911364252266 35.47177920536475, -82.57921464249857 35.472046205429365, -82.57959464240832 35.4730482056722, -82.57972164237829 35.473382205753246, -82.5797236423777 35.47338820575459, -82.57973064237578 35.473408205759405, -82.57973364237517 35.47341520576114, -82.5797366423745 35.47342320576309, -82.57974564237219 35.47344820576914, -82.5797496423714 35.4734572057713, -82.57977464236531 35.47352420578756, -82.57984964234703 35.47372520583611, -82.57987564234098 35.473792205852384, -82.57990264233452 35.47386420586982, -82.57998564231461 35.47408420592309, -82.58001364230806 35.474157205940806, -82.5801026422871 35.474391205997584, -82.580372642224 35.475096206168764, -82.58038964222007 35.47514020617939, -82.58045864220196 35.47533320622578, -82.5806916421476 35.47594120637332, -82.58081964211767 35.47627520645439, -82.58113964204159 35.47711920665901, -82.58138564198325 35.47776720681608, -82.58147664196166 35.47800720687422, -82.58156864193488 35.47828120693936, -82.58159464192347 35.478384206963, -82.5816226419131 35.4784822069858, -82.58165264189013 35.478665207026125, -82.58167564186641 35.47884520706516, -82.58168364183972 35.47902820710319, -82.58166764180508 35.479237207144095, -82.58163864176554 35.47946420718732, -82.58159164170725 35.47979420724969, -82.581469641538 35.48076720743528, -82.58146064152614 35.48083520744811, -82.58142564147963 35.481101207498746, -82.58142364147191 35.48114920750828, -82.58141564146437 35.481190207515795, -82.58131664133569 35.481923207654866, -82.5811796411448 35.4830222078645, -82.58107264100272 35.483834208018855, -82.58103464092173 35.48432220811426, -82.58101964082509 35.48493720823788, -82.58105764076599 35.485364208328654, -82.5810806407338 35.48559920837889, -82.58108664072417 35.48566920839379, -82.58110164071564 35.48574120840996, -82.58111164071006 35.48578820842057, -82.58112364070266 35.48584920843422, -82.58116264068114 35.486032208475436, -82.58117564067378 35.48609420848935, -82.58122564064584 35.48633120854274, -82.5812946406234 35.486552208594745, -82.58149164056039 35.48717720874213, -82.58172564049295 35.487871208907386, -82.58173864048999 35.48790520891559, -82.58191164045084 35.48834820902351, -82.58194964044239 35.488444209047, -82.58198664044062 35.48849620906131, -82.58206464043668 35.48860620909172, -82.5822166404376 35.48876520913959, -82.58233664044415 35.488852209169636, -82.5824036404478 35.488901209186494, -82.58247864045413 35.488941209202295, -82.58254264045952 35.488975209215795, -82.58260064046426 35.48900620922806, -82.58268064047337 35.489034209241886, -82.58274764048166 35.48905220925247, -82.58281864049044 35.48907220926381, -82.5830546405199 35.489135209300805, -82.58309764052524 35.48914720930764, -82.58376464061033 35.489314209409976, -82.58376864061088 35.48931520941056, -82.5840036406386 35.48938820944946, -82.58429264067279 35.48947820949738, -82.58437664068104 35.489515209513556, -82.58473364071578 35.48967520958268, -82.5850286407387 35.48984520964753, -82.5854006407602 35.490108209739134, -82.58543964076233 35.490136209748776, -82.58571564077573 35.4903482098202, -82.5859106407852 35.49049720987061, -82.58602664079082 35.490586209900485, -82.58649464081279 35.49095021002255, -82.586583640817 35.49101921004571, -82.5866896408218 35.491102210073485, -82.58721564084603 35.49151421021114, -82.58832664089714 35.49238421050208, -82.5884096409009 35.49244921052381, -82.58875864091206 35.49275521062183, -82.5887756409122 35.49277221062704, -82.58924664091748 35.493248210772194, -82.59021464091288 35.494327211090955, -82.59022464091287 35.4943382110942, -82.5906326409077 35.49481421123297, -82.591438640901 35.49573121150217, -82.59252364088822 35.49699021186958, -82.5925946408862 35.49708021189515, -82.59279164088302 35.497314211963, -82.59296764087833 35.497536212026255, -82.59299164087584 35.49757821203725, -82.59301364087321 35.49761921204779, -82.59302564087186 35.49764121205357, -82.59306564086754 35.49771221207214, -82.59314664084917 35.49792021212275, -82.59319164082764 35.49810921216583, -82.59320164080333 35.498279212201425, -82.59319164077377 35.49846121223745, -82.59315364073328 35.49868421227899, -82.59307064066374 35.499048212344576, -82.59302964063241 35.49920821237299, -82.592956640575 35.49950421242571, -82.59293364054903 35.49964921245289, -82.59293164054188 35.49969321246168, -82.59292964052499 35.499801212483405, -82.59293664051724 35.49985921249594, -82.59289364050615 35.499885212496864, -82.59284264049408 35.499909212496505, -82.5927776404784 35.499941212496346, -82.59255264042753 35.50002921249121, -82.59254864042676 35.500030212490984, -82.59244764040511 35.50006221248721, -82.59239364039367 35.50007821248488, -82.59227664036852 35.50011521248047, -82.5922326403596 35.500126212478186, -82.59217964034845 35.50014121247585, -82.59221964040562 35.49981121241278, -82.59226064046285 35.49948221234995, -82.59234964058773 35.498763212212666, -82.59243864071283 35.498043212075245, -82.59244764072585 35.497968212060876, -82.59234164072555 35.49785521202705, -82.59201464072498 35.497504211922084, -82.59110864068953 35.49675421167662, -82.58984764062254 35.495825211358316, -82.58964964062876 35.49557021128612, -82.58860464062624 35.49445421095189, -82.5881116406693 35.493639210735594, -82.58775664067424 35.49322221061429, -82.58760964067498 35.49305821056583, -82.58714464067754 35.49253721041215, -82.58662364064672 35.492174210284915, -82.5852326405266 35.491451209995255, -82.58461464046346 35.49119420987963, -82.58430764043187 35.49106720982235, -82.58318464030444 35.49068320962921, -82.58306664028945 35.49065320961099, -82.58238264017845 35.490637209537624, -82.58233764017116 35.49063620953286, -82.58200564010893 35.490682209508265, -82.5812736399719 35.49078420945399, -82.58089863989731 35.490865209432116, -82.58030163977836 35.4909952093974, -82.57970363965921 35.49112520936261, -82.57950163961902 35.4911692093509, -82.57883263946883 35.491425209334444, -82.5788166394645 35.49143620933509, -82.57772963916284 35.492228209384855, -82.5773706390776 35.49239620938232, -82.5763896388447 35.49285420937502, -82.57534563863977 35.49306120931023, -82.57335763832903 35.49293720908133, -82.57324463831272 35.49292120906649, -82.57313163829659 35.49290420905143, -82.5715456380675 35.49268220884373, -82.57090063797648 35.4925782087565, -82.56982763782501 35.49240520861137, -82.56888963770713 35.4921592084652, -82.56803863760987 35.49187220831964, -82.56699863753038 35.491265208089594, -82.56633463747939 35.490879207943024, -82.56561763743845 35.490370207765956, -82.56506463742959 35.48982920759922, -82.56486263747516 35.48931320747348, -82.56477663749462 35.4890932074199, -82.56464563756704 35.48847820728137, -82.56445963769166 35.487463207055704, -82.56430363773116 35.48703620695285, -82.56393463782477 35.486025206709314, -82.56361963783367 35.48562620659587, -82.5633236378457 35.485227206484396, -82.56298863785155 35.48482620636846, -82.56255463783579 35.48445920624932, -82.56219963781595 35.484204206161024, -82.56178663778937 35.48393020606298, -82.56131263775724 35.483627205952764, -82.56074163769412 35.48342120585235, -82.56022863763079 35.483279205770955, -82.55985463759112 35.48313320570287, -82.5595406375606 35.482992205642056, -82.55918563753409 35.48278120556273, -82.55887063751572 35.48256020548549, -82.55867663749652 35.48247520544837, -82.55857463748634 35.48243120542895, -82.55833763747626 35.4822402053658, -82.55810163746918 35.4820312052991, -82.55800463746785 35.48193520526959, -82.55792463746666 35.48185620524537, -82.55786563746398 35.481810205229976, -82.55763163746242 35.481566205156305, -82.55816763756633 35.48146820519126, -82.55925963778188 35.48124320525738, -82.55935363780038 35.48122420526316, -82.55953263783542 35.481189205274404, -82.55947463785336 35.481009205231814, -82.55943163785602 35.48094520521435, -82.5593516378571 35.480851205187, -82.55927463785643 35.4807722051631, -82.55924363785637 35.48073920515319, -82.55910863785353 35.48061120511334, -82.55897063784937 35.48048920507434, -82.5588076378418 35.48036220503179, -82.55833563781563 35.48002220491428, -82.55807963780374 35.47982220484734, -82.55793763780049 35.47969020480598, -82.55773863779919 35.47948320474343, -82.55750663780083 35.47922120466637, -82.55737563780407 35.479058204619776, -82.55728663781065 35.47891820458214, -82.55723163782241 35.478782204548914, -82.55720963783348 35.47868620452705, -82.55719863785056 35.47856220450071, -82.55720063786859 35.4784472044775, -82.55722063788906 35.4783352044568, -82.55725563791277 35.47821820443658, -82.55732263794646 35.478070204413356, -82.5574006379812 35.477928204392455, -82.55751063802678 35.477749204367264, -82.5576026380673 35.47758420434309, -82.55766363809677 35.477458204323746, -82.55771763812771 35.47731420429999, -82.55777463817206 35.47708620425942, -82.55780663821182 35.47686120421693, -82.55788163834316 35.47608420406651, -82.55795563848466 35.475240203902345, -82.55798563854286 35.4748922038346, -82.55798763855289 35.47482920382203, -82.55800663861629 35.47443520374374, -82.55801763863316 35.47433720372493, -82.55803463864663 35.474267203712465, -82.55805663866043 35.47420120370131, -82.55809463867925 35.474119203688495, -82.55815163870406 35.47401920367397, -82.55831563877027 35.4737642036389, -82.55836063878992 35.4736842036272, -82.55837963879813 35.47365120362241, -82.55846963883788 35.47348920359874, -82.55851463886307 35.47337320357975, -82.55853263887543 35.47331220356912, -82.55854063888071 35.473286203564705, -82.55855063889493 35.47320420354898, -82.55855363889772 35.47318920354623, -82.55855563891384 35.47308620352553, -82.55852563893328 35.472926203489905, -82.55851263893796 35.472882203479564, -82.5584816389487 35.472778203455285, -82.55846563895433 35.472724203442645, -82.55845463895784 35.472689203434356, -82.55816763905655 35.47173320321046, -82.55815263906342 35.47167220319657, -82.55812663907611 35.47156120317132, -82.55811563909047 35.471455203148636, -82.55811763910813 35.47134220312581, -82.55812663912556 35.47123820310554, -82.55818063917154 35.47099620306186, -82.55820163919316 35.470877203039805, -82.55822063921897 35.47072920301162, -82.55822663924754 35.47054920297561, -82.5582176392785 35.470337202931574, -82.55821463929112 35.470251202913786, -82.55818763932344 35.47001120286217, -82.55818263933864 35.46990620284035, -82.55818663935295 35.46981720282264, -82.55819163936557 35.46974020280743, -82.55820663938104 35.469655202791714, -82.55823263940023 35.46955720277444, -82.55828363943203 35.469405202748675, -82.5585216395604 35.468824202654886, -82.55870763965727 35.46839220258603, -82.55873463967086 35.468333202576815, -82.55874263967442 35.46831820257451, -82.55879063969593 35.46823020256157, -82.55887263972858 35.46810520254447, -82.55913763982728 35.46774720249881, -82.55928763988672 35.46752120246814, -82.55935163991666 35.4673952024491, -82.55936263992247 35.46736920244497, -82.55938963993651 35.46730620243487, -82.55946263998374 35.46707720239574, -82.55950264001315 35.46692820236949, -82.55953264003892 35.466792202344884, -82.55955464005744 35.466695202327415, -82.5595936400891 35.466530202297854, -82.55962464010986 35.46642820228026, -82.5596586401276 35.46634920226771, -82.55970464014746 35.46626920225618, -82.55975564016526 35.46620820224894, -82.55981764018375 35.46615420224427, -82.55988464020197 35.466107202241595, -82.56000464023072 35.46605020224227, -82.56036764031136 35.46591620225223, -82.56046864033513 35.465870202253164, -82.56053564035284 35.46582720225132, -82.56058264036731 35.465783202247195, -82.56062164038293 35.465723202238934, -82.56063964039498 35.46566420222878, -82.56064364040334 35.46561420221899, -82.56063664040994 35.4655632022079, -82.56063464041205 35.46554720220445, -82.56060564042544 35.46542820217727, -82.56054464044607 35.46522720213015, -82.56050964046216 35.46508420209747, -82.56049264047543 35.464979202074325, -82.5604856404917 35.46486520205039, -82.56048364049732 35.464826202042325, -82.56048964051148 35.46474020202542, -82.56051364053198 35.46463220200587, -82.56054864055288 35.464533201989354, -82.56055264055483 35.464525201988145, -82.56060064057701 35.464432201974155, -82.56061864058537 35.46439720196883, -82.56074564063421 35.46421520194482, -82.56091664069604 35.46399620191774, -82.56096064071167 35.46394220191123, -82.56120764079772 35.463647201876576, -82.5613566408455 35.463496201861076, -82.56147764088176 35.46339020185191, -82.56159864091478 35.463305201846936, -82.56171964094699 35.46322620184327, -82.56189964099254 35.46312320184079, -82.56216364105788 35.46298220183909, -82.56240264111487 35.46286920184062, -82.56240464111546 35.462867201840425, -82.5626636411743 35.4627632018457, -82.56285864121755 35.462692201851254, -82.56297164124324 35.46264620185347, -82.56306864126529 35.46260720185546, -82.56323564130872 35.46250420185155, -82.56339964135735 35.46236420183987, -82.56352464139637 35.462244201828256, -82.56376964147279 35.46201020180577, -82.56403664155147 35.46178520178735, -82.56424964161009 35.46163320177818, -82.56547964193679 35.46083020174072, -82.5655786419641 35.46075920173645, -82.56561564196794 35.46077420174326, -82.56598164208337 35.460416201707865, -82.56647964224369 35.45990720165527, -82.56655364226746 35.45983220164761, -82.56663064229201 35.459755201639794, -82.5671576424595 35.45923120158716, -82.56776364264915 35.45864820153058, -82.56785764267838 35.45855920152205, -82.56831564281944 35.458132201482016, -82.56849364287532 35.457960201465276, -82.5690286430428 35.45744520141523, -82.56903464304455 35.457440201414805, -82.56915364308144 35.457328201404216, -82.56920864309843 35.45727620139924, -82.56923164310571 35.45725420139718, -82.56924564311012 35.457240201395734, -82.56929264312568 35.45718920139019, -82.56935064314602 35.457119201381865, -82.5694256431744 35.45701520136837, -82.56961264325645 35.456681201319505, -82.5696546432735 35.4566152013104, -82.56971964329928 35.456517201297096, -82.56975564331259 35.45646920129101, -82.56984064333953 35.456385201282664, -82.5699236433615 35.45633120128016, -82.57002764338506 35.45629020128245, -82.57012364340449 35.456267201287616, -82.57021964342125 35.45626120129621, -82.57031364343555 35.45627020130768, -82.57043064345154 35.456292201324146, -82.57056964346785 35.456336201347305, -82.57077064348894 35.456416201384144, -82.57095464350967 35.45648020141599, -82.57106064352419 35.45650020143093, -82.57115864353983 35.45650420144178, -82.5712496435557 35.45649920145007, -82.57135664357551 35.456485201458236, -82.57153464361105 35.45644620146851, -82.5717136436478 35.45640020147747, -82.57186864367867 35.45636620148633, -82.57188764368222 35.45636320148774, -82.57205064371215 35.45634420150048, -82.5721526437288 35.4563462015114, -82.57228564374836 35.456362201528286, -82.57248564377363 35.45641420155931, -82.57257164378542 35.45643020157137, -82.57265964379985 35.45643120158056, -82.57264564380422 35.45638720157019, -82.57263864380626 35.4563662015652, -82.57262564381561 35.45629120154859, -82.57260764382968 35.45618020152418, -82.57260264384821 35.45605320149785, -82.572610643868 35.45593220147396, -82.57262064388041 35.455862201460825, -82.57263064389127 35.4558022014496, -82.57265064390677 35.455722201435385, -82.57272064396108 35.455443201385734, -82.57276164399181 35.455286201358, -82.57294064412514 35.454608201238315, -82.57301464417996 35.45433020118937, -82.57311564425524 35.453947201121714, -82.57341064447412 35.45283520092565, -82.57341964448109 35.4527992009193, -82.57351864455615 35.452416200851424, -82.57353264456685 35.452361200841665, -82.57357464459832 35.45220020081325, -82.57358964460911 35.45214620080378, -82.57360464462064 35.45208720079331, -82.57362864463879 35.45199420077686, -82.57370064469202 35.45172420072923, -82.57372064470665 35.451650200716244, -82.57374864472811 35.45154020069677, -82.57378964475802 35.45138920067018, -82.57379164476004 35.45137820066817, -82.57379964476583 35.451349200663074, -82.57380264476768 35.451339200661394, -82.5741036449921 35.450198200459994, -82.57436764518775 35.449204200284676, -82.57439464521046 35.44908520026323, -82.57442364524013 35.44892220023301, -82.57444464526671 35.448771200204526, -82.57445964529435 35.4486062001724, -82.57446264531819 35.44845420014186, -82.57445464534575 35.44826520010252, -82.57442664538146 35.448001200045965, -82.57424964554895 35.4467131997657, -82.57423064556717 35.446573199735326, -82.57415064564326 35.445988199608074, -82.57409164570142 35.445544199511666, -82.57404364574815 35.44518619943391, -82.57397164581944 35.44464119931565, -82.57389864588792 35.44411419920096, -82.57386164592364 35.44384019914141, -82.57385064593451 35.44375719912339, -82.57384864593631 35.44374319912033, -82.57381564596734 35.44350419906837, -82.57371464606638 35.44274619890378, -82.57368164609943 35.442494198849104, -82.57367664610473 35.442454198840416, -82.57364764615234 35.442111198767705, -82.57364364615977 35.442058198756506, -82.5736356462244 35.44162619866773, -82.5736396462527 35.441445198631385, -82.57364464627948 35.44127519859729, -82.57366164633046 35.44096019853491, -82.5736826463925 35.44057719845913, -82.5736876464136 35.440444198432616, -82.57370564647745 35.44004619835345, -82.5737116464986 35.43991419832716, -82.57373664658822 35.43935419821578, -82.57381364685716 35.43767719788245, -82.57383964694691 35.437118197771355, -82.57386464703418 35.43657419766322, -82.57389664714549 35.435880197525286, -82.57393864729536 35.4349441973391, -82.57396364738243 35.43440119723118, -82.57396864740123 35.434283197207634, -82.5739846474578 35.43393019713744, -82.57399064747672 35.43381319711425, -82.57399564749635 35.43369019708977, -82.5740126475555 35.43332119701643, -82.57401864757514 35.43319919699219, -82.57402664760819 35.43299119695073, -82.57405064770064 35.43241219683534, -82.57405064773872 35.43216219678446, -82.57417564774853 35.43223419681191, -82.57429764775804 35.43230419683864, -82.5743766477641 35.432350196856106, -82.57497664783398 35.43254419695688, -82.57524164786476 35.43263019700147, -82.57627664800482 35.43283619714931, -82.57716864813925 35.43292419725843, -82.57752164818586 35.4330021973104, -82.57770964821061 35.43304419733824, -82.57781164823375 35.433003197340376, -82.57782664823752 35.43299519734022, -82.57783964824029 35.43299119734081, -82.57785164824274 35.43298819734134, -82.57786464824537 35.4329851973421, -82.57787764824768 35.432984197343146, -82.57789164824997 35.43298419734468, -82.57790464825193 35.432985197346184, -82.57791764825387 35.43298719734791, -82.57793064825537 35.43299119735006, -82.57794264825674 35.43299519735206, -82.57795464825801 35.43300019735428, -82.57797964825879 35.4330221973614, -82.5780546482663 35.43305419737556, -82.57807064826632 35.43307119738066, -82.5780926482665 35.433094197387554, -82.5781846482788 35.433113197400885, -82.57822364828563 35.4331111974044, -82.57823064828696 35.433110197404936, -82.57823764828825 35.433109197405464, -82.5782436482895 35.4331071974057, -82.57824964829096 35.43310419740566, -82.57825564829221 35.43310219740588, -82.57826164829358 35.43310019740603, -82.57826764829521 35.433096197405895, -82.57827264829648 35.43309319740582, -82.57827764829788 35.433089197405465, -82.57828264829918 35.43308619740536, -82.57828764830066 35.43308219740512, -82.57829164830189 35.43307819740466, -82.57829564830335 35.433073197404084, -82.57829964830457 35.433069197403654, -82.578303648306 35.43306419740308, -82.5783066483073 35.43305919740233, -82.57830964830858 35.43305419740166, -82.57831164830968 35.43304919740086, -82.5783136483106 35.4330451974002, -82.57831664831187 35.43304019739951, -82.57831964831306 35.4330351973988, -82.5783226483144 35.433030197398104, -82.57832664831564 35.433026197397666, -82.57833064831702 35.43302119739707, -82.57833464831839 35.43301719739665, -82.57833964831983 35.43301319739639, -82.57834464832128 35.433009197396025, -82.57834964832256 35.433006197395976, -82.57835464832384 35.433003197395834, -82.57836064832526 35.43300019739587, -82.5783656483266 35.432997197395835, -82.57837264832818 35.43299419739586, -82.57837864832949 35.4329921973961, -82.57838464833063 35.432991197396504, -82.57839164833214 35.43298919739675, -82.57839764833321 35.43298819739718, -82.57845964834348 35.43298819740355, -82.57852364835271 35.43299719741189, -82.5785946483665 35.43298419741659, -82.57866964837575 35.43300519742848, -82.57870364838102 35.4330071974324, -82.57873464838407 35.433021197438435, -82.57875364838647 35.43302619744133, -82.57877364838978 35.433026197443446, -82.57879664839407 35.433023197445124, -82.57881264839635 35.43302519744715, -82.57887164840484 35.43303419745501, -82.5789486484172 35.43303619746334, -82.57897764841948 35.43305319746979, -82.57905864842773 35.43308719748499, -82.57911964843714 35.43309119749205, -82.57914064844041 35.43309319749453, -82.57920364845006 35.43309819750206, -82.57936264846714 35.433159197530735, -82.57941264848007 35.4331281975295, -82.57944464848565 35.43312619753238, -82.57949564849174 35.43314219754087, -82.57951464849701 35.433128197539936, -82.57953264850288 35.433109197537945, -82.5795446485095 35.43307919753304, -82.57956264851309 35.43307519753406, -82.5796006485188 35.43307919753877, -82.57965964852244 35.43311919755298, -82.57967964852249 35.433140197559254, -82.57969864852156 35.433167197566746, -82.57973964852651 35.433179197573345, -82.57977364853143 35.43318419757786, -82.57981064853631 35.433192197583246, -82.57979964852704 35.43324119759212, -82.57979964852579 35.433249197593696, -82.57980164852536 35.43325419759494, -82.57980364852496 35.43325919759619, -82.57980764852488 35.43326419759755, -82.57981264852505 35.433268197598885, -82.57981764852543 35.43327119760005, -82.57982364852616 35.433273197601046, -82.57982964852674 35.43327519760212, -82.57983664852776 35.433276197603, -82.57984364852909 35.433275197603535, -82.57984964853023 35.43327419760393, -82.57985564853158 35.433272197604154, -82.57986164853303 35.433269197604126, -82.5798666485345 35.4332651976038, -82.57987864853624 35.43326619760525, -82.57989164853831 35.43326719760681, -82.57990564854046 35.4332681976084, -82.57992364854299 35.43327119761087, -82.57993764854486 35.4332741976129, -82.5799506485464 35.4332781976151, -82.5799636485481 35.43328119761701, -82.57997564854935 35.433286197619275, -82.57998764855076 35.43329019762129, -82.57999964855195 35.43329519762351, -82.58001164855295 35.43330119762603, -82.58002264855394 35.43330719762835, -82.58003364855479 35.43331319763069, -82.58004464855556 35.433320197633215, -82.58005464855616 35.43332719763571, -82.58007864855715 35.43334719764217, -82.58011064855769 35.43337819765179, -82.58015664856312 35.4333921976593, -82.58020764857373 35.433378197661725, -82.58028264858146 35.43340919767565, -82.58032364858887 35.43340519767906, -82.58037764859854 35.433400197683525, -82.58043964860589 35.433419197693816, -82.5805106486185 35.43341419770003, -82.58058664863181 35.43340919770674, -82.58064764864213 35.433408197712836, -82.58066364864595 35.43340019771282, -82.58068764865129 35.433391197713505, -82.58070764865528 35.433387197714694, -82.58072764865888 35.4333851977163, -82.5807476486621 35.433386197718605, -82.58076064866404 35.4333871977201, -82.58077364866573 35.43339019772215, -82.58078664866744 35.43339319772395, -82.58079864866885 35.433397197725995, -82.58081064866987 35.43340319772849, -82.58084064867283 35.433416197734175, -82.58085964867469 35.43342519773794, -82.58091164867682 35.433467197751796, -82.58087664864752 35.43362119777957, -82.5810206486665 35.433653197800815, -82.58143464872143 35.4337431978615, -82.58147564872684 35.43375219786755, -82.58172064874978 35.43386819791621, -82.58195964879411 35.433837197934295, -82.58211364882358 35.4338111979448, -82.58258164891313 35.43373319797682, -82.58265464875528 35.43484619821073, -82.58271564862292 35.43577919840683, -82.58275664853659 35.436388198534935, -82.58425364863159 35.43739119889225, -82.58478164866516 35.437745199018266, -82.5851816486906 35.438013199113776, -82.58530964869864 35.43809919914432, -82.58593864873868 35.43852019929434, -82.58692964880156 35.43918419953089, -82.58816264914746 35.43825819946853, -82.58889264935192 35.4377121994321, -82.58918264943304 35.437495199417555, -82.589938649501 35.43787119957143, -82.59001164950794 35.4379051995858)))",5798,37,021,002301,370210023012,3062,3062,181,3006,2702,117,16,108,0,63,56,2292,111,2181,2269,2085,70,9,70,0,35,23,1386,1214,172
census_2010_blockgroups_view.fid--2dc29038_13ec899ba8f_-25df,"MULTIPOLYGON (((-82.54446261957719 35.583841224617906, -82.54455261959967 35.583792224617106, -82.54466861962982 35.583721224614635, -82.54477661966669 35.58359822460064, -82.5448356196911 35.58350322458744, -82.54486361970717 35.583429224575234, -82.5448896197265 35.58333122455796, -82.54492561974527 35.58324822454477, -82.54497861976435 35.58318122453652, -82.5449886197677 35.58317022453536, -82.5450666197916 35.58309922452888, -82.54521961983296 35.58299522452343, -82.54570461995748 35.58270922451511, -82.54577961997568 35.58267222451528, -82.54591162000605 35.582617224517584, -82.54602262003309 35.58256122451758, -82.54606362004526 35.58252622451467, -82.54618562008478 35.58240022450157, -82.54627062011379 35.582304224490755, -82.54635062014272 35.582202224478216, -82.54638662015738 35.58214622447056, -82.54640862017007 35.582087224460786, -82.54643662019238 35.581972224440236, -82.54648062022576 35.58180322441039, -82.54652862024768 35.58171222439679, -82.54659162027006 35.581635224387625, -82.54678262033327 35.58143022436546, -82.54681962034537 35.58139122436136, -82.5470686204304 35.58110722432914, -82.5472496204972 35.580868224299095, -82.54728262051276 35.58080322428926, -82.54728862051972 35.5807642242819, -82.54728762052372 35.58073722427631, -82.54732262053126 35.58072622427766, -82.54740562055224 35.58067922427662, -82.5475476206033 35.58050022425475, -82.54758962061723 35.58045522424995, -82.547821620693 35.58021322422454, -82.54788562071094 35.58016522422129, -82.54802462074603 35.58008722421972, -82.54824062079541 35.579999224224, -82.54850562086379 35.579841224219116, -82.5486386208969 35.579769224218026, -82.54894862097345 35.57960622421674, -82.54901062098952 35.57956822421538, -82.5489576209892 35.579513224198685, -82.54888062098694 35.57944522417696, -82.54885262098563 35.579423224169616, -82.54874962098084 35.57934322414271, -82.54854762096934 35.57920022409287, -82.54846862096593 35.57913722407199, -82.54843162096715 35.579089224058414, -82.54842662097221 35.57905122405013, -82.54843762098004 35.579012224043346, -82.54845162098462 35.57899722404175, -82.54849862099923 35.57895322403762, -82.5486146210328 35.5788602240306, -82.54870862105959 35.57878722402535, -82.54880662108711 35.578714224020544, -82.54897862113715 35.578574224009735, -82.54898862114038 35.57856422400871, -82.54907662116742 35.578483224001324, -82.54908762116824 35.57849022400382, -82.54928862117727 35.57864822405665, -82.54960962119159 35.57890122414106, -82.54988762119463 35.57918122422668, -82.54988962119461 35.57918322422726, -82.54998762119251 35.57930322426172, -82.55005362118904 35.57939722428771, -82.55010562118603 35.579472224308255, -82.55014462118385 35.5795282243237, -82.55024962117392 35.57970622437066, -82.5502966211694 35.57978622439178, -82.55039662116005 35.57995522443639, -82.55055262114526 35.580219224506216, -82.5506706211322 35.580431224561465, -82.55068662112942 35.58046722457037, -82.55070962112559 35.580516224582766, -82.55075162111153 35.580653224614906, -82.5508266210838 35.5809142246758, -82.55088862106115 35.58112822472568, -82.55101762101101 35.58159322483359, -82.55104562099939 35.58169922485801, -82.5511176209709 35.5819622249189, -82.5511986209361 35.58227522499099, -82.55121962092484 35.58237122501266, -82.55134762088214 35.58278722511049, -82.55138962086536 35.582941225146186, -82.55140362085476 35.58302522516469, -82.55140362083654 35.583143225188664, -82.55138962081102 35.58329422521802, -82.5513216207197 35.58381422531686, -82.5512386206196 35.58437522542248, -82.55123762060597 35.5844622254401, -82.55123562059562 35.5845272254531, -82.55125562057162 35.58470522549137, -82.55130262055478 35.58486522552879, -82.55147762049238 35.58545922566769, -82.55161962043897 35.58595922578403, -82.55164362042895 35.58605022580504, -82.55169662040667 35.58625222585158, -82.55172062039125 35.58637822587968, -82.55172462038044 35.58645322589536, -82.55173162036105 35.58658622592317, -82.55172462029853 35.58698522600366, -82.55172362027773 35.58711922603076, -82.55172462023833 35.5873762260832, -82.55172662017998 35.58775722616098, -82.55171362011745 35.58814922623938, -82.5517056200765 35.58840722629113, -82.551496620031 35.58847722628389, -82.55117761996121 35.588586226273264, -82.55090861989629 35.58871822627256, -82.55088761989093 35.588730226272844, -82.55074661985448 35.58881522627564, -82.55070161984204 35.588847226277565, -82.55062361982033 35.58890422628109, -82.55055061979915 35.588963226285614, -82.55050261978505 35.58900322628881, -82.55031961972522 35.589194226308955, -82.55016761967079 35.58938422633197, -82.5500496196283 35.58953322635023, -82.54987561955687 35.58980922638847, -82.5498046195268 35.58992822640539, -82.54974561950127 35.59003022642006, -82.54962661944518 35.590266226455924, -82.54951761939033 35.59050522649344, -82.54935461929459 35.59095122656741, -82.54924561923754 35.59120422660766, -82.54920661921687 35.59129622662242, -82.54902861913806 35.5916162266693, -82.548937619098 35.591778226692874, -82.54876461902134 35.59208922673844, -82.5486686189783 35.59226622676456, -82.54858161893853 35.59243022678901, -82.54849961890187 35.59258022681116, -82.54839161885033 35.5927982268444, -82.54784261858738 35.593914227015105, -82.5477006185192 35.59420422705953, -82.5476536184992 35.59428322707078, -82.5476106184813 35.59435322708064, -82.5474986184399 35.594501227099244, -82.54743861842012 35.59456522710613, -82.54741561841222 35.594591227109035, -82.5472746183698 35.59471522711986, -82.54707861831332 35.594870227131224, -82.54686261824898 35.59505522714667, -82.54662161817853 35.59525322716226, -82.54656561816202 35.595300227166035, -82.54635061809795 35.595484227181366, -82.54624061806534 35.59557722718904, -82.54610261801902 35.59572922720578, -82.54603761799503 35.595815227216654, -82.54597461797131 35.59590122722764, -82.5458626179207 35.59610922725846, -82.54584461790958 35.596162227267435, -82.54576761786183 35.59638922730569, -82.54574861783615 35.59653522733348, -82.54574561781406 35.59667522736163, -82.54575761779407 35.59681822739192, -82.54578161777647 35.59695822742291, -82.54581661776504 35.59707022744931, -82.54583261776185 35.59710822745871, -82.54586161775633 35.59717522747533, -82.5460266177301 35.59752322756311, -82.54625761778036 35.59744622757118, -82.54628461778604 35.59743822757232, -82.54707261794955 35.597226227610136, -82.54717761797107 35.59719922761542, -82.54733161800546 35.59714222761963, -82.54745361798805 35.597386227681795, -82.54754561797492 35.59757122772891, -82.54769161794523 35.597921227815135, -82.54776661793447 35.59807222785362, -82.54780661793272 35.59812622786869, -82.54784761793125 35.598180227883894, -82.54794661793315 35.59827422791317, -82.54800661793762 35.59831022792671, -82.54804861794051 35.59833622793632, -82.54817561795363 35.59838822795994, -82.54832761797375 35.598421227982314, -82.54843861798945 35.598439227997346, -82.54856961800797 35.59846022801504, -82.54877461803804 35.59848622804145, -82.54904761807708 35.598526228077645, -82.54940561812927 35.59857322812398, -82.54979161818451 35.598631228175485, -82.54999361821326 35.598662228202485, -82.55024461825171 35.59868322823254, -82.55021161820902 35.59892422827818, -82.55020661820254 35.59896122828523, -82.55013661808484 35.59965022841832, -82.55011661805034 35.599852228457394, -82.55011161804333 35.599892228464974, -82.54983161799778 35.599886228435004, -82.54973561798215 35.599884228424685, -82.5494836179386 35.59989522840107, -82.54920261788772 35.599923228377904, -82.5489946178485 35.599953228362686, -82.54894561783922 35.59996122835924, -82.5487206177949 35.60000622834525, -82.54835461772304 35.60007822832234, -82.54775261760479 35.60019722828464, -82.54726061750786 35.60029622825426, -82.54723961750359 35.60030122825317, -82.54708961747465 35.600327228242975, -82.54689261743835 35.60035122822766, -82.54668361739971 35.60037622821122, -82.54639661734882 35.600397228186054, -82.54625961732545 35.60040222817303, -82.54619861731481 35.60040522816733, -82.5458916172643 35.60040222813514, -82.54576161724317 35.60039922812125, -82.54550961720331 35.600386228092674, -82.54436061702711 35.60029222795552, -82.54406061698099 35.60026822791976, -82.54372961693076 35.60023722787945, -82.54336761687563 35.60020522783579, -82.54290561680503 35.600166227780356, -82.54247361674005 35.600122227726985, -82.54228561671363 35.600091227701384, -82.54192761666334 35.60003222765254, -82.54173661663484 35.60001122762869, -82.5411656165496 35.599949227557396, -82.54116461654947 35.599949227557296, -82.54097561652166 35.59992622753317, -82.54046061647317 35.59968622743143, -82.53902961633837 35.5990192271486, -82.53893061633352 35.59894422712324, -82.53847961631145 35.59860122700703, -82.53854561631893 35.59862422701852, -82.53916261638955 35.598830227123806, -82.5403546165259 35.59922922732752, -82.54058261655372 35.59929422736416, -82.54071661657218 35.59931922738307, -82.54087161659493 35.59933822740283, -82.54104061662294 35.5993382274202, -82.54117961664748 35.599329227432605, -82.54124561665998 35.599319227437434, -82.54133761667725 35.59930622744416, -82.54147961670543 35.599276227452684, -82.54162961673728 35.59923122745898, -82.54176661676799 35.59917922746244, -82.54192561680736 35.59909522746167, -82.54183961680488 35.59901822743715, -82.54175561680007 35.5989592274165, -82.54168061679124 35.598935227403906, -82.54159261677717 35.59893222739425, -82.54158761677635 35.598932227393796, -82.54152261676475 35.59893722738812, -82.54151661676359 35.59893822738772, -82.54144761674988 35.59895322738367, -82.5411136166795 35.59905022736905, -82.54095861664895 35.59908122735942, -82.5409016166394 35.59908222735379, -82.54078661662247 35.59906822733914, -82.54069761661168 35.59904222732473, -82.54061161660434 35.59899722730676, -82.54053961660375 35.59892322728422, -82.5405026166044 35.598879227271446, -82.5404796166097 35.598820227257086, -82.54046661661724 35.59875722724294, -82.54046661663058 35.59867022722526, -82.54047261663843 35.59862622721695, -82.54050761667851 35.59840322717514, -82.54051161669017 35.59833222716111, -82.54050761670241 35.59824822714362, -82.54049561671167 35.59817522712753, -82.54045661676328 35.597798227046745, -82.54043761678629 35.59762822701023, -82.54040761679381 35.59754722699064, -82.54030561681051 35.59732922693574, -82.54028361681436 35.59728022692353, -82.54023661682456 35.597163226894956, -82.54020461683588 35.59705522686963, -82.54020161685237 35.59694522684707, -82.54023361687318 35.59684422682974, -82.54028561690266 35.59670922680758, -82.54032961692498 35.596611226792156, -82.540359616947 35.59650122677285, -82.54037961696507 35.59640522675532, -82.54038761697892 35.596324226739675, -82.54038861699132 35.596244226723506, -82.54036861700085 35.596161226704574, -82.5403296170102 35.59605822667955, -82.54025861701719 35.59593622664748, -82.54017761701859 35.59584022661962, -82.5400766170169 35.595742226589245, -82.53995861700902 35.59566622656175, -82.53971361698746 35.595542226511256, -82.53951761697529 35.59541022646434, -82.53940061696322 35.595362226442504, -82.53929061694943 35.59533322642528, -82.5392056169387 35.59531122641212, -82.53917161693535 35.59529622640554, -82.53914361693423 35.59527322639795, -82.53910561693588 35.595222226383726, -82.5390936169388 35.595190226376005, -82.53908961694535 35.59514322636602, -82.53909161695535 35.59508022635336, -82.5391176169937 35.59485922631105, -82.53912161701086 35.594752226289685, -82.53911361701971 35.594686226275435, -82.53910061702112 35.59466322626942, -82.53907861702035 35.5946442262633, -82.53904461701569 35.5946382262586, -82.53902361701215 35.5946382262565, -82.53898861700544 35.59464422625403, -82.53895361699655 35.5946642262545, -82.53892861697838 35.594755226270465, -82.53892661697678 35.594763226271894, -82.53890061694325 35.59495322630792, -82.53887661691483 35.595112226337825, -82.53885261689543 35.595212226355706, -82.53882661688478 35.59525322636137, -82.5387896168692 35.595314226369986, -82.53873461685458 35.59535022637162, -82.53870161684752 35.59536022637028, -82.53873161689961 35.59505422631109, -82.53872961692305 35.594900226279556, -82.53873961694734 35.594753226250674, -82.53873561696855 35.5946112262214, -82.53871561696829 35.59459122621522, -82.53868161696404 35.594582226209965, -82.53864861695776 35.59458722620756, -82.5386366169529 35.594606226210125, -82.53864461694539 35.594663226222536, -82.53863761692999 35.594756226240804, -82.53857661689952 35.5948882262614, -82.53852161686713 35.59503922628652, -82.53848961684501 35.59514822630536, -82.53844761682976 35.5952022263121, -82.5383986168156 35.59524122631492, -82.53834261680379 35.595257226312405, -82.53829161679579 35.59525422630661, -82.53826761679478 35.59523522630028, -82.53828961680512 35.595192226293776, -82.53832061681541 35.595158226290025, -82.53834961684021 35.59502822626653, -82.5383656168673 35.59487022623602, -82.53838861688787 35.59476122621627, -82.53842761691341 35.59463722619495, -82.53847661695254 35.59443622615916, -82.53851561696678 35.59438522615279, -82.53863461699763 35.594313226150305, -82.53867161700721 35.59429122614963, -82.53912661712057 35.594045226146335, -82.53917761713839 35.59398422613922, -82.53932361720761 35.593692226094745, -82.53934261722199 35.59361922608187, -82.5393246172332 35.593527226061276, -82.53927161724107 35.59341922603386, -82.53913161725119 35.593202225975304, -82.53904561726333 35.5930312259317, -82.53899061727311 35.592908225901006, -82.53888561731635 35.59251422581, -82.53880561732515 35.592371225772695, -82.53884961734008 35.59232122576707, -82.53912261741658 35.59211922575397, -82.53919861744022 35.59204722574712, -82.53926261746258 35.59197122573826, -82.53930961748232 35.591893225727205, -82.53933861749998 35.59181022571326, -82.5393606175175 35.59172022569723, -82.53936961753253 35.59163222568031, -82.53936961754789 35.59153222565987, -82.5393646175577 35.591463225645334, -82.53934261756775 35.59137422562501, -82.53925161758113 35.591189225578006, -82.53919261759401 35.59104222554196, -82.53917561760191 35.59097222552601, -82.53915061762095 35.5908222254929, -82.5391306176628 35.59052822543105, -82.53914061767809 35.59044022541411, -82.53917361769368 35.59037422540411, -82.53939961776459 35.59015722538319, -82.53950461779617 35.5900652253752, -82.53956861782078 35.58997422536329, -82.53962361786441 35.58975022532331, -82.53968161792186 35.58944022526621, -82.53971161793785 35.58936822525465, -82.53974661795041 35.58932422524931, -82.5398056179695 35.58926422524314, -82.53982361798045 35.589212225234384, -82.53986761801383 35.58904322520449, -82.53987861802474 35.58898422519365, -82.53991061803713 35.58893822518756, -82.54013761811677 35.58866522515533, -82.54018061813441 35.58859722514592, -82.54030261820573 35.58826522509089, -82.54034261822731 35.588168225075236, -82.54043861826977 35.5879962250501, -82.54049761829448 35.58789922503643, -82.54054461831147 35.58783922502907, -82.54059961832817 35.58779022502476, -82.5406726183474 35.58774422502287, -82.54093261840978 35.58761922502411, -82.54101061843258 35.58755522501916, -82.54104261844526 35.587507225012686, -82.5410726184569 35.58746422500701, -82.54112061847991 35.587366224992024, -82.54122561852353 35.58719622496816, -82.54128361854357 35.58712822496026, -82.54154961862658 35.58687622493631, -82.54165061866252 35.586751224921294, -82.54172361869105 35.58664522490719, -82.54191161877715 35.58628822485384, -82.54193261878659 35.58624922484805, -82.54205761883847 35.58604722481976, -82.5421076188615 35.58595122480537, -82.54218161890574 35.585744224770856, -82.54221561892179 35.585676224760505, -82.54229361895187 35.58556522474591, -82.5424566190118 35.58535122471914, -82.5425016190335 35.58525922470505, -82.54251661904273 35.58521522469763, -82.54253061905167 35.585172224690325, -82.54253161905365 35.58516022468793, -82.542552619077 35.585031224663865, -82.54256261908488 35.584991224656754, -82.54256461908608 35.58498522465574, -82.54259461909726 35.584945224650646, -82.54257261910064 35.58489922463908, -82.54257961914497 35.58461922458281, -82.5425696191583 35.584521224561854, -82.54250161918263 35.58429022450782, -82.54242861919882 35.58410622446292, -82.54242761919892 35.5841042244624, -82.5423746192053 35.58400522443678, -82.54230761920938 35.58390722440994, -82.542253619215 35.583812224385106, -82.54222961922153 35.58374422436879, -82.54221661923349 35.58365222434873, -82.5422286192463 35.58358222433576, -82.54225061925982 35.583518224325005, -82.54228461927418 35.58346122431681, -82.54233561929216 35.583399224309474, -82.54241761931736 35.58332422430259, -82.54249261933671 35.58327922430118, -82.54258061935565 35.58325122430446, -82.54267461937323 35.583238224311565, -82.5427506193863 35.583235224318734, -82.54282561939496 35.58326022433148, -82.54288461939798 35.58330422434648, -82.54296661939244 35.58342822438012, -82.54313361937803 35.58370222445309, -82.54326961937274 35.58388322450393, -82.54338961937172 35.584019224543844, -82.54348761937692 35.5840912245686, -82.5435456193816 35.584123224581084, -82.54367261939868 35.58414922459944, -82.54368361940007 35.58415222460116, -82.54379561941771 35.58415822461385, -82.54389261943614 35.584143224620846, -82.54397561945416 35.58411522462364, -82.54407561947819 35.58406722462409, -82.54420761951098 35.583996224623206, -82.54436661955323 35.58389322461864, -82.54446261957719 35.583841224617906)))",6027,37,021,000700,370210007001,1139,1139,25,1104,597,481,2,11,3,10,35,984,20,964,961,537,406,2,9,1,6,23,630,563,67
census_2010_blockgroups_view.fid--2dc29038_13ec899ba8f_-25de,"MULTIPOLYGON (((-82.5504036161955 35.61220023100019, -82.55057161622433 35.61219423101626, -82.55083361626895 35.612187231041716, -82.55107561630923 35.612186231066445, -82.5511476163212 35.612186231073885, -82.55123761634134 35.612152231076095, -82.55130361634104 35.61222523109784, -82.55131361634074 35.61223823110143, -82.55153261633556 35.61250723117869, -82.55160661633401 35.61259723120461, -82.55199361632754 35.61305623133788, -82.55214761632982 35.61320723138439, -82.55221261633093 35.613270231403895, -82.55237961633435 35.61342823145322, -82.55268061634234 35.613700231539525, -82.5531396163549 35.61411323167074, -82.55330361635953 35.614260231717516, -82.55370061637245 35.61460423182835, -82.55392361637755 35.61481123189338, -82.55405361638296 35.6149162319282, -82.55415761638861 35.61499123195415, -82.55423761639021 35.61506723197785, -82.55431061638734 35.615164232005114, -82.55433161637498 35.6152672320282, -82.55433861634978 35.61543823206375, -82.55434361633725 35.61552523208195, -82.55433961629895 35.615769232131214, -82.55430561627294 35.61590123215455, -82.55426261625459 35.61597423216506, -82.55421861623961 35.61602423217069, -82.55429861624819 35.616054232185, -82.55443861626311 35.616108232210365, -82.5544846162675 35.61612923221937, -82.55453861627284 35.616153232229856, -82.55461861628051 35.61618923224539, -82.55453061623423 35.616395232278244, -82.5544006161714 35.61666223231926, -82.55430161611612 35.61691423236035, -82.55426361609045 35.61704023238216, -82.55422461606227 35.61718123240683, -82.55419461603374 35.61733323243469, -82.55417161600761 35.61747823246184, -82.55415661596746 35.61772223251003, -82.55415361594069 35.617893232544475, -82.55415561591788 35.61804323257522, -82.5541706158803 35.61830323262964, -82.55417961586716 35.618398232649874, -82.55420661582717 35.618686232711354, -82.55421661581407 35.61878223273191, -82.55422961579507 35.61891923276114, -82.55427161573807 35.61933423284992, -82.55428561571918 35.61947223287943, -82.55430161569483 35.6196472329167, -82.55435161562184 35.620174233029125, -82.55436861559753 35.620350233066716, -82.55438361557634 35.620504233099616, -82.55443161551301 35.620966233198565, -82.55444761549175 35.62112123323181, -82.55447961544162 35.6214812333083, -82.5545056154014 35.62177023336985, -82.55458761529316 35.622560233539076, -82.5546086152657 35.62276123358212, -82.55462161524335 35.622920233615865, -82.55462361523537 35.622974233627104, -82.55463161521101 35.62314023366172, -82.55463461520304 35.623195233673165, -82.55463661520173 35.6232062336756, -82.55462861518316 35.62331823369759, -82.55461861516882 35.62340023371328, -82.55457661513134 35.62359823374928, -82.5545566151127 35.62369723376738, -82.55445961503537 35.624094233838214, -82.5544176149985 35.624288233873365, -82.55438261497054 35.6244312338989, -82.55431561491662 35.62470923394858, -82.55427761488858 35.62485023397337, -82.55426261487919 35.62489523398104, -82.55423261485907 35.62499323399783, -82.55410861479378 35.625283234044176, -82.55403561476045 35.62542023406457, -82.55402961475824 35.62542823406551, -82.55392361471552 35.6255912340878, -82.55382861467736 35.625736234107606, -82.55382061467377 35.62575123410986, -82.55355561455147 35.62625823418577, -82.55346861451088 35.62642823421141, -82.55340861448364 35.626540234228024, -82.5532296144018 35.62687823427848, -82.55317061437454 35.626991234295424, -82.55304961431989 35.62721523432855, -82.55302561430881 35.627261234335506, -82.5528696142339 35.62757923438416, -82.55281961420481 35.627714234406504, -82.55278761418373 35.627816234424046, -82.55276761416437 35.62792023444305, -82.55274261413963 35.628053234467565, -82.55273461412004 35.62817223449102, -82.55272861410465 35.62826523450934, -82.5527306140906 35.62835823452844, -82.55273561406898 35.62850423455869, -82.5527316140203 35.62881523462157, -82.55272761400391 35.62891723464196, -82.55272161397409 35.62910423467937, -82.55253061392231 35.629234234686194, -82.55195761376719 35.629623234706514, -82.55176761371538 35.62975423471361, -82.55152961365164 35.62991123472112, -82.55140361361761 35.629996234725475, -82.55124161357345 35.6301082347316, -82.55113061354122 35.630197234738255, -82.55105861351805 35.630270234745765, -82.55098061349116 35.630360234756075, -82.55091361346508 35.63045723476892, -82.55090261346025 35.63047723477182, -82.55084961343609 35.6305762347866, -82.55077561339971 35.630732234810694, -82.55057261329723 35.631178234880615, -82.55054361328224 35.63124423489106, -82.55050761325981 35.63135123490917, -82.55048961324073 35.63145523492851, -82.5504826132263 35.631541234945274, -82.55048861321363 35.63163023496404, -82.55050761320224 35.6317242349851, -82.55054361319388 35.63181723500771, -82.5505926131856 35.63192323503432, -82.55067461317655 35.63207023507266, -82.5507636131685 35.632218235112035, -82.55086061315797 35.63239123515719, -82.55092761314813 35.63252723519174, -82.55095961314339 35.63259223520825, -82.55097761313668 35.63265523522296, -82.55099861311258 35.63283423526153, -82.55099661310231 35.63289823527438, -82.55097961308591 35.63298623529052, -82.55097261308197 35.63300423529349, -82.5509486130668 35.63307723530582, -82.55090561304313 35.63318423532323, -82.55084061301041 35.63332623534541, -82.55078161298323 35.6334382353622, -82.55075061296873 35.63349923537146, -82.55060261290731 35.63373823540481, -82.55036061281808 35.63405623544464, -82.550161612751 35.63427623546899, -82.55001961270582 35.63441623548285, -82.5498846126649 35.634536235493414, -82.54972061261486 35.63468423550672, -82.54952461255742 35.63484523551931, -82.54950461257822 35.634689235485496, -82.54947961261985 35.63439223542252, -82.5493666128109 35.633032235133975, -82.54936261281956 35.632972235121414, -82.54932661287421 35.63257923503768, -82.5493176128726 35.63258023503695, -82.54919561284059 35.63265623503988, -82.54911961282393 35.63268223503735, -82.54905061280562 35.632726235039286, -82.54876161272853 35.63291523504795, -82.54854461266892 35.63306823505683, -82.5484316126401 35.633133235058466, -82.54831761261387 35.63318023505627, -82.5482616126035 35.6331872350519, -82.5482356125995 35.63318523504889, -82.5482116125957 35.633184235046144, -82.54815961258905 35.63317123503821, -82.54811561258741 35.63313423502615, -82.54808261258982 35.63308323501237, -82.54804861260182 35.63296923498566, -82.54795361263399 35.632658234912576, -82.54794961263538 35.63264523490951, -82.54777361268101 35.63215923479255, -82.5476346127229 35.631738234692534, -82.5475336127537 35.631430234619486, -82.54748961276549 35.63130623458974, -82.54737661278226 35.631076234531314, -82.54735961278341 35.63105023452423, -82.54724661279164 35.63087523447696, -82.54708961279718 35.63067023441906, -82.54674661280461 35.63025323429896, -82.54665061280517 35.630146234267265, -82.54657561280347 35.630076234245365, -82.54654161280274 35.63004423423533, -82.54650561280394 35.629998234222285, -82.5464626128037 35.62995323420865, -82.54645061280559 35.62992823420231, -82.54643561281074 35.62987823419066, -82.54643161282227 35.62979923417418, -82.54644261283805 35.62970923415695, -82.54645661285906 35.62958823413373, -82.54650061292226 35.629225234064414, -82.54651561294328 35.62910523404153, -82.54654761298733 35.628854233993735, -82.54654861298984 35.628839233990725, -82.5465816130431 35.62852923393104, -82.54662561310391 35.62818223386495, -82.54664061312822 35.628041233837806, -82.54667061317421 35.62777523378673, -82.54668561319447 35.62766023376484, -82.54673061325454 35.627319233700106, -82.54674661327478 35.627205233678545, -82.5467616133098 35.626994233637085, -82.54676261331116 35.6269862336356, -82.54677061332518 35.62690423361971, -82.54680461337921 35.62659023355927, -82.54683561344143 35.6262202334872, -82.54686561347994 35.6260032334461, -82.54690861353312 35.6257042333897, -82.54691761355343 35.62558223336571, -82.5469206135763 35.62543723333648, -82.5469236135845 35.62538723332663, -82.54695161364259 35.625041233259104, -82.54699061369868 35.62471923319762, -82.54700561374406 35.62444123314251, -82.54700761374897 35.62441123313663, -82.54703361379728 35.624126233081284, -82.54697661378394 35.6241512330805, -82.54683861375355 35.62420023307632, -82.5467616137364 35.62422823307412, -82.54651061367994 35.624324233067846, -82.54624961362397 35.624406233057655, -82.54624761362356 35.62440623305745, -82.54608461359032 35.62444623304884, -82.54604461358322 35.6244492330454, -82.54593261356392 35.62445423303491, -82.54588561355564 35.624457233030654, -82.54577961353912 35.624450233018365, -82.54566361352342 35.62442723300176, -82.54560261351601 35.624409232991766, -82.5455476135094 35.624393232982904, -82.54549761350432 35.62437223297348, -82.54546761350134 35.62435923296768, -82.54540761349799 35.62431623295285, -82.5454006134976 35.62431123295104, -82.54533261349636 35.62424623293083, -82.54526961349919 35.62416023290689, -82.54521761350497 35.624066232882406, -82.54519761350758 35.62402823287256, -82.54517461351271 35.62397023285843, -82.5452406135301 35.62392823285665, -82.54536761358914 35.623682232819675, -82.54553761366778 35.6233552327706, -82.54542761367986 35.62315823271911, -82.54527061368006 35.6229882326684, -82.54504161363074 35.62306123265976, -82.54470361355767 35.623171232647415, -82.54467661355555 35.62315623264152, -82.54449761353213 35.62311523261479, -82.5443616135105 35.623109232599646, -82.5442396134887 35.623119232589055, -82.54346061334932 35.62318423252225, -82.54339561333849 35.62318423251558, -82.54323161331511 35.62315923249362, -82.54310161330109 35.623110232470204, -82.5430056132923 35.62306423245101, -82.54294361328891 35.623019232435496, -82.54288561328836 35.62296023241752, -82.54281961328756 35.62289423239728, -82.54270861329384 35.62273423235334, -82.54265861330079 35.62263523232806, -82.54265161331077 35.62256323231265, -82.54255561325877 35.622797232350464, -82.5424596132217 35.622934232368436, -82.5421026131251 35.62317623238099, -82.54198661309256 35.62326223238654, -82.54163061299259 35.62352723240391, -82.54122461288812 35.623767232410984, -82.54114961286616 35.6238292324159, -82.54108561284566 35.623893232422375, -82.5410146128171 35.62400223243727, -82.54082061272318 35.62440123249847, -82.54073061269183 35.624508232511026, -82.54012261250911 35.62503823255638, -82.54001361247884 35.625117232561266, -82.53991161245345 35.62517223256193, -82.53982361243439 35.6252012325588, -82.53980161243055 35.62520223255671, -82.53961061239667 35.62521623253997, -82.53942761236797 35.62520523251891, -82.53881161227777 35.62512723243969, -82.53860761224786 35.62510123241343, -82.53799861215865 35.6250242323352, -82.53779561212883 35.6249992323092, -82.53781461213707 35.624966232304374, -82.53783761214416 35.62494523230247, -82.53784461214603 35.62494023230223, -82.53796361217185 35.62490123230647, -82.53803561218643 35.62488423231045, -82.53810361220006 35.624869232314424, -82.53814361219999 35.62491223232729, -82.53821161220736 35.62493823233959, -82.53829661221974 35.624949232350566, -82.5383066122211 35.6249512323519, -82.53836261223194 35.62494123235565, -82.53873561232142 35.624762232357654, -82.53889861235794 35.624701232361964, -82.5391036124035 35.62462623236773, -82.5392526124413 35.62454123236578, -82.53930461245571 35.624504232363606, -82.53936761247786 35.62442823235463, -82.53944061250756 35.62431423233894, -82.53947761252675 35.62423023232555, -82.53968361263048 35.62377923225503, -82.53971061264755 35.62369723224109, -82.53972361266023 35.623629232228595, -82.53973061268009 35.62350823220464, -82.53972761268868 35.62344923219229, -82.53971661269887 35.62337123217538, -82.53969961270612 35.62330623216036, -82.53967461271066 35.62324923214623, -82.53964061271358 35.62319423213155, -82.53951661271331 35.62306223209192, -82.53922861270803 35.62278623200609, -82.53913861270654 35.622699231979155, -82.53907261270915 35.62261123195449, -82.53903161271296 35.62254223193623, -82.53902261272259 35.622470231920616, -82.53903361273471 35.6224032319081, -82.53905961274836 35.62234323189858, -82.53907761275671 35.6223082318933, -82.53908161275878 35.622299231891894, -82.53913061277414 35.62225223188732, -82.53920761279585 35.62219423188344, -82.53927261281166 35.62216223188361, -82.53931661282043 35.62215223188617, -82.53937161283115 35.62214223188975, -82.53946361284795 35.622132231897176, -82.53960461287271 35.622123231909875, -82.53973661289668 35.622110231920814, -82.53993861293544 35.6220762319346, -82.54003561295602 35.62204723193867, -82.54015061298286 35.62199723194033, -82.54016961298828 35.62198223193919, -82.54021961300222 35.62194523193686, -82.54026461301935 35.62188323192886, -82.5403026130353 35.62182023192, -82.54033061305043 35.62175223190894, -82.54033261305176 35.62174623190801, -82.54035361306835 35.621661231892816, -82.54037461309632 35.621502231862586, -82.54038461311592 35.62138623184004, -82.54039161312726 35.621320231827276, -82.54041261314508 35.62122723181052, -82.5404326131584 35.62116223179936, -82.54047961318024 35.62107123178564, -82.54051261319279 35.62102523177969, -82.54055561320672 35.6209812317752, -82.540604613221 35.62094123177212, -82.54081461327722 35.620803231765656, -82.5408986133005 35.62074223176177, -82.54095361331767 35.620690231756896, -82.54102861333949 35.6206292317522, -82.54106161335123 35.62058923174739, -82.54110861336714 35.62053623174144, -82.54121461340915 35.62037823172023, -82.54127761343223 35.62029623170993, -82.54134261345601 35.62021223169957, -82.54137561347366 35.62013323168692, -82.54138461348468 35.62007123167519, -82.5413816135078 35.61991823164374, -82.54134161356451 35.619507231555986, -82.5413066135888 35.61931223151265, -82.54129661359654 35.61925123149928, -82.54125161362562 35.61901423144635, -82.54122261363574 35.618917231423666, -82.54118161364579 35.6188082313973, -82.54111661365486 35.618679231364325, -82.54074561369147 35.61804223119657, -82.54066261370114 35.617890231157055, -82.54062661370897 35.61780023113506, -82.54045861375639 35.617312231018424, -82.54040561377823 35.617113230972556, -82.54040261378898 35.617040230957365, -82.54042661381317 35.616909230933125, -82.54045661382713 35.61685123092445, -82.54054561386624 35.61669323090141, -82.54061961389412 35.61659223088845, -82.54066161391201 35.61652123087838, -82.54067361391711 35.61650123087548, -82.54077561396797 35.61628123084118, -82.54101061411724 35.61556623071985, -82.54102761412899 35.61550823070977, -82.54107161415878 35.61536223068461, -82.54107461416359 35.615334230679224, -82.54108261417404 35.615275230668026, -82.5411256141803 35.615280230673456, -82.54114561418322 35.61528323067616, -82.5412586142019 35.61528323068775, -82.54130361420933 35.615284230692616, -82.54131761421162 35.615284230693995, -82.541511614246 35.61527023071106, -82.54152461424874 35.61526623071164, -82.54159361426301 35.61524823071511, -82.54172061429166 35.61519923071815, -82.54192161433954 35.615105230719664, -82.54197261435446 35.615063230716345, -82.5420516143822 35.61496823070522, -82.54207861439272 35.614929230699964, -82.54217461442958 35.614793230682174, -82.54221361444228 35.61475323067801, -82.54218461445713 35.614625230648976, -82.54217261446333 35.614572230637016, -82.54214961448051 35.61443623060696, -82.54214461449025 35.614367230592414, -82.54215761450155 35.61430823058168, -82.54220461451658 35.614261230576986, -82.54220761451735 35.614259230576906, -82.54232661454563 35.61420423057793, -82.54270561463663 35.6140222305798, -82.54283161466681 35.61396223058059, -82.54384561490917 35.61348223058712, -82.54422661499994 35.613303230589835, -82.5444956150645 35.613174230591184, -82.54530261525777 35.61278923059581, -82.54546261529607 35.61271323059675, -82.5455766153215 35.61267123059999, -82.54558661533913 35.612567230579835, -82.54561861539254 35.6122552305196, -82.54562961541029 35.61215223049974, -82.54569761542034 35.61216023050841, -82.54590361545068 35.61218523053466, -82.54597261546073 35.61219423054355, -82.5460836154767 35.6122102305582, -82.54613961548534 35.61221423056484, -82.54617361549062 35.61221723056896, -82.54640561552874 35.61221923059319, -82.54664761556923 35.61221723061765, -82.5468176155976 35.61221623063495, -82.54695061562008 35.612214230648156, -82.54735061568717 35.61220923068823, -82.54748461570962 35.61220823070179, -82.54774361575274 35.61220723072823, -82.54811061581383 35.61220623076577, -82.54852261588333 35.612199230806674, -82.54852661588403 35.612199230807065, -82.54878261592634 35.61220023083355, -82.54910661598043 35.61219823086646, -82.54930261601311 35.61219723088647, -82.55007861614162 35.612199230966546, -82.5504036161955 35.61220023100019)))",6376,37,021,000500,370210005003,1723,1723,54,1703,1602,67,5,11,0,18,20,1335,35,1300,1320,1256,44,2,5,0,13,15,886,790,96
census_2010_blockgroups_view.fid--2dc29038_13ec899ba8f_-25dd,"MULTIPOLYGON (((-82.33436358057608 35.61114620855097, -82.33433558054591 35.611311208581505, -82.33429958050644 35.61152820862189, -82.33426758046247 35.61177820866933, -82.33426458045707 35.61181020867555, -82.33425258042914 35.611978208708386, -82.33422458037005 35.612330208776946, -82.33421058034035 35.61250720881143, -82.33416358019625 35.61338920898565, -82.33415758017706 35.61350720900901, -82.33414958013925 35.61374320905611, -82.3341275800565 35.61425520915777, -82.3340945799294 35.61504220931411, -82.33407357987087 35.61539820938425, -82.33407057981022 35.61578720946287, -82.33407057980929 35.61579320946411, -82.33408457973233 35.616306209569736, -82.33400057971521 35.616327209565355, -82.33398857971265 35.61633120956492, -82.33390157969343 35.61636220956226, -82.33376157965974 35.61643020956157, -82.33374657965607 35.616438209561665, -82.33368757964061 35.616475209563134, -82.3336515796313 35.61649720956383, -82.33358157961096 35.61655320956805, -82.33353357959537 35.61660320957319, -82.33351057958768 35.616628209575936, -82.3334035795501 35.61675720959104, -82.3333635795356 35.61680820959736, -82.33315857946056 35.61707420963021, -82.33311157944317 35.61713620963791, -82.33305557942555 35.61719020964309, -82.33301757941545 35.617215209644286, -82.33295157940164 35.617234209641325, -82.33295057940138 35.617234209641225, -82.33293657932914 35.61768720973178, -82.33293657932458 35.61771620973762, -82.33290757922163 35.61835120986356, -82.3328935791304 35.61892620997882, -82.33288857911104 35.61904621000268, -82.33287157903817 35.619499210092854, -82.33265757900331 35.619496210070224, -82.33236757895587 35.619493210039714, -82.33210157891365 35.61948221001004, -82.33201557889946 35.619482210001195, -82.33185457887262 35.61948320998481, -82.33180257886302 35.61949020998086, -82.33172057884879 35.619494209973226, -82.33158757882786 35.61948720995806, -82.33130457878347 35.61947220992587, -82.3310455787439 35.61945120989495, -82.33094657872822 35.61944720988382, -82.33073257869381 35.61944120986058, -82.33073857868558 35.61950020987316, -82.33074957864741 35.619759209926954, -82.33075457863377 35.619852209946266, -82.33076457852809 35.620546210088186, -82.33075157849956 35.62071721012163, -82.33073657846504 35.62092421016208, -82.33064557843986 35.6209902101661, -82.33067357844 35.621019210174865, -82.33071357843579 35.621089210193205, -82.33073057843117 35.62113721020471, -82.33073757842087 35.62121121022041, -82.33071457838061 35.62144721026599, -82.33070357836003 35.6215682102894, -82.33068557835912 35.62155521028484, -82.3304975784171 35.620979210148576, -82.33042557839904 35.62101921014925, -82.33035757838392 35.621044210147346, -82.33029157836901 35.62107021014584, -82.33012757833384 35.62112221013947, -82.33003457831519 35.621143210134164, -82.32994557830028 35.62114521012534, -82.32991057829524 35.6211402101207, -82.32983457828388 35.621132210111256, -82.3297595782746 35.62111221009948, -82.32965757826192 35.62108521008348, -82.32946357823775 35.621034210053146, -82.32935957822724 35.62099121003373, -82.3293545782267 35.620989210032754, -82.32926557821843 35.6209472100151, -82.32925757821779 35.620943210013436, -82.3290825782059 35.620833209973064, -82.32893157819568 35.62073820993818, -82.32873057818534 35.62059020988741, -82.32855457817543 35.62046620984415, -82.32848657817156 35.6204182098274, -82.32838357816698 35.62033820980047, -82.3282755781621 35.62025420977231, -82.32820957816003 35.620197209754, -82.32816357815858 35.62015720974111, -82.32806357815333 35.62008420971591, -82.32796957814666 35.62002720969471, -82.32789757814002 35.61999320968041, -82.32769157811123 35.619959209652244, -82.32760357809765 35.6199532096419, -82.32748657807925 35.619947209628684, -82.32738057806237 35.61994320961693, -82.32736657800898 35.62027320968243, -82.32736257799006 35.62039120970603, -82.32733257790434 35.620913209808926, -82.3273165778473 35.62126520987872, -82.32730257779377 35.62159620994449, -82.32700857774383 35.621605209915934, -82.32675557770355 35.62159520988781, -82.32669357769366 35.62159320988099, -82.3256225775211 35.62156420976468, -82.32533857747433 35.62156420973547, -82.32507857743303 35.621553209706434, -82.32486957740056 35.621540209682195, -82.32466157736799 35.62152820965831, -82.32426157730224 35.62152620961669, -82.32415857728522 35.621526209606024, -82.3240905772738 35.62152720959922, -82.32387157723763 35.62152720957665, -82.3238515772347 35.621525209574166, -82.32375057721951 35.62151520956181, -82.3237055772152 35.621495209553096, -82.32368557721512 35.6214742095467, -82.32368257721947 35.62144320954019, -82.32367857722656 35.62139320952958, -82.32368457727033 35.62111620947401, -82.32368757728766 35.621007209452124, -82.32341757724306 35.621007209424334, -82.32256557710528 35.62098820933256, -82.3223315770657 35.62099420930973, -82.32206157702355 35.62097820927863, -82.32189357699606 35.620976209260846, -82.32180657698315 35.62096720925007, -82.32182357699305 35.620921209242546, -82.32186557701404 35.62083020922835, -82.32205757710818 35.620427209166344, -82.32212157713944 35.62029320914573, -82.32218957717511 35.620135209120704, -82.32226057720968 35.619987209098, -82.3222905772344 35.61985920907513, -82.3222865772398 35.61982020906679, -82.32227757725383 35.61972020904551, -82.32221457727002 35.61954820900412, -82.32201357727564 35.61929720893249, -82.3218145772826 35.61903920885956, -82.32144857729318 35.618580208728645, -82.32143957729349 35.61856820872527, -82.32114157730452 35.61817920861558, -82.32106457730717 35.61807920858737, -82.32102057730877 35.618022208571276, -82.32082157731193 35.617789208503446, -82.32081857731187 35.617786208502544, -82.32071057730242 35.6177322084804, -82.32077157732714 35.61763720846741, -82.32095557740134 35.61735420842896, -82.3209655774051 35.61734020842713, -82.3210145774259 35.617258208415514, -82.32104857744032 35.61720120840752, -82.32115157748353 35.61703220838379, -82.32118657749793 35.61697620837602, -82.32129457754218 35.6168052083525, -82.32154657764431 35.61641420829907, -82.32161957767492 35.6162942082823, -82.32172557771896 35.616122208258275, -82.32175857773282 35.61606820825077, -82.32176857773682 35.616053208248765, -82.3218465777665 35.61594420823461, -82.32186357777407 35.61591320823009, -82.32189657778777 35.615860208222685, -82.32194657780902 35.61577620821082, -82.32206357785411 35.61560920818897, -82.32215057788419 35.61550820817743, -82.32218857789708 35.615465208172644, -82.32236457794983 35.6153122081598, -82.32256857800357 35.61518220815441, -82.32271557803932 35.61510820815454, -82.32291157808486 35.61502320815749, -82.32318357814617 35.614917208164044, -82.3232785781673 35.61488220816669, -82.32361757824212 35.614760208176854, -82.32368957825744 35.61473820817981, -82.32401257832622 35.614638208192794, -82.32435857839731 35.614548208210245, -82.32503457853603 35.614373208244416, -82.32540057861073 35.61428120826344, -82.32612657876074 35.61408620829867, -82.32637657881415 35.61400820830863, -82.32645157882985 35.61398620831191, -82.32681557890947 35.613860208323885, -82.3270315789587 35.61377320832849, -82.3271865789937 35.61371220833206, -82.32726457901214 35.61367620833283, -82.32755557908052 35.61354520833623, -82.32794257917472 35.613349208336295, -82.32794557917553 35.613347208336236, -82.32816557923101 35.613223208333736, -82.32820957924234 35.61319720833295, -82.32834257927571 35.61312320833167, -82.32838757928704 35.6130982083312, -82.32854257932624 35.61301020832936, -82.32884457940256 35.61283920832579, -82.32948357956359 35.61248020831871, -82.32978357963775 35.6123212083174, -82.33006057970466 35.61218420831812, -82.33023757974634 35.61210420832013, -82.33042357978972 35.61202220832269, -82.33072057985794 35.61189820832811, -82.33091857990212 35.611824208333545, -82.33096457991235 35.61180720833477, -82.3313195799901 35.61168320834618, -82.33151958003263 35.6116222083544, -82.33172258007535 35.61156220836314, -82.331877580108 35.61151720836999, -82.33197858012882 35.61149020837497, -82.33214658016303 35.61144820838375, -82.33246658022752 35.61137320840152, -82.33275758028554 35.611309208418504, -82.33301858033728 35.61125320843399, -82.33327458038808 35.611198208449224, -82.3340465805407 35.611036208495946, -82.33430358059131 35.61098320851168, -82.33431558058838 35.61101520851938, -82.33435158057918 35.61111320854302, -82.33436358057608 35.61114620855097)))",6276,37,021,003104,370210031044,810,810,10,791,744,42,0,4,0,1,19,635,7,628,624,592,29,0,3,0,0,11,436,365,71
census_2010_blockgroups_view.fid--2dc29038_13ec899ba8f_-25dc,"MULTIPOLYGON (((-82.5478966118409 35.63773623594044, -82.54801761180106 35.638125236032025, -82.5481256117657 35.63847023611341, -82.54819861173881 35.63872323617234, -82.54829261169532 35.639106236259984, -82.54833261167079 35.63930823630526, -82.54839161163517 35.63960223637118, -82.54840761162123 35.639710236394805, -82.54858161146467 35.64091123665712, -82.54865561139877 35.64141823676795, -82.54882361126538 35.64246323699796, -82.54889861122486 35.64280623707554, -82.54899061119299 35.6431122371473, -82.54913961115673 35.643507237243014, -82.54920761113574 35.64371623729257, -82.54923161112147 35.643834237319034, -82.54923361110765 35.64392623733798, -82.54921661109088 35.64401623735454, -82.54918261107152 35.64410523736919, -82.54911961104146 35.64423223738856, -82.549051611015 35.644330237401505, -82.54899061099272 35.64440923741134, -82.54893661097265 35.64448123742039, -82.5488706109456 35.644585237434754, -82.54882461091977 35.64470323745411, -82.54878661089384 35.64483023747602, -82.54876861086427 35.64500223750923, -82.54877861083939 35.64517423754517, -82.5488046108254 35.64529323757211, -82.54884361081868 35.645378237593405, -82.54890661080279 35.64554923763471, -82.54892661079614 35.645613237649805, -82.54894461078241 35.6457222376739, -82.5489276107578 35.64586323770081, -82.54889561073479 35.64597823772094, -82.54889361073381 35.64598223772155, -82.54882261069422 35.646162237750836, -82.54880461067557 35.64626323776958, -82.54881861066686 35.64633523778566, -82.54885161066493 35.64638323779887, -82.54890461066663 35.64642923781365, -82.5489846106733 35.64647223783064, -82.54911261068783 35.646515237852526, -82.54921361070122 35.64653723786748, -82.54965761077263 35.646552237916126, -82.54971461078 35.64656623792481, -82.54974761078422 35.646574237929876, -82.54982761078992 35.646623237948084, -82.54986261078355 35.646702237967766, -82.54986161077107 35.646782237983935, -82.54982861075648 35.64684123799263, -82.549768610741 35.64687723799368, -82.54975661073844 35.64688023799308, -82.54970361072796 35.6468912379899, -82.54963561071747 35.64688623798191, -82.5493556106845 35.646798237935165, -82.54935461068435 35.64679823793505, -82.54922361066568 35.646778237917516, -82.54910661064795 35.646767237903255, -82.54869661057799 35.64677923786347, -82.54857661055884 35.646774237850096, -82.54847361054516 35.64675223783508, -82.54834961053238 35.64670123781198, -82.54815561051743 35.64658923776918, -82.54806561051059 35.646537237749335, -82.54795861049509 35.64652223773521, -82.54789361048182 35.64653823773188, -82.54784361046661 35.646583237735854, -82.54782361045459 35.64663923774524, -82.54782761045425 35.64664623774705, -82.54784961045063 35.646693237758825, -82.54790661045423 35.64673123777253, -82.54807861047459 35.646784237800965, -82.54817661048529 35.64682023781839, -82.54834561050241 35.6468912378502, -82.54860561052493 35.64702523790425, -82.54869161052993 35.647085237925296, -82.54873361052996 35.647130237938754, -82.54874961052998 35.64714723794387, -82.54878361052592 35.6472102379602, -82.54880661051865 35.647282237977265, -82.54880461050267 35.64738323799758, -82.54878361045648 35.64766023805183, -82.5487686104374 35.64776723807211, -82.54872061040433 35.647930238100315, -82.54868061038356 35.648021238114666, -82.5485886103433 35.648183238138216, -82.548537610318 35.648292238155214, -82.5485086103007 35.648373238168666, -82.54847561027066 35.648532238197646, -82.54843161025087 35.648613238209606, -82.54836361022976 35.64867623821542, -82.54817861017627 35.64882423822654, -82.54812261015533 35.64889923823601, -82.54808661013655 35.648982238249225, -82.54807161012018 35.64907223826596, -82.54806861008689 35.64928423830884, -82.54804061006793 35.649377238324874, -82.54797361004135 35.64947723833836, -82.54791961002574 35.64952023834154, -82.54771960997341 35.649644238346234, -82.54764460995213 35.649701238350104, -82.54760360993572 35.64976323835855, -82.54758760992375 35.64982323836909, -82.54758060991833 35.6498512383741, -82.54758060987322 35.6501432384335, -82.54755060985083 35.65025623845339, -82.54746960981232 35.650418238478046, -82.54740960979305 35.650478238484084, -82.54740060979015 35.65048723848497, -82.547302609764 35.65055123848796, -82.54720360974105 35.65059323848634, -82.54709960971951 35.650621238481335, -82.5469666096919 35.650657238475, -82.5469306096859 35.65065723847126, -82.54641060959774 35.650668238420046, -82.5463876095939 35.65066923841781, -82.54631060957733 35.65069323841479, -82.54624460956319 35.65071423841228, -82.54613260953914 35.65074923840786, -82.54606460951752 35.65081623841458, -82.54602560949078 35.650947238437226, -82.54609460942065 35.651475238551775, -82.5462826093983 35.6518222386418, -82.54621860937873 35.65188023864701, -82.5461226093625 35.651882238637505, -82.54605160935733 35.65183923862147, -82.54599760936551 35.651728238593286, -82.5456726094341 35.65093423839827, -82.54565960945035 35.65081523837268, -82.54575960950915 35.65054223832739, -82.54601560958504 35.65032623830979, -82.54617860963297 35.650191238299094, -82.54617260965264 35.650057238271174, -82.54610060965139 35.64998723824948, -82.54590960962024 35.6499842382292, -82.54510360932187 35.65104923836314, -82.54503260928679 35.651200238386544, -82.544984609211 35.65163923847096, -82.54493460918094 35.651780238494524, -82.54480760913339 35.65195123851626, -82.54463860908592 35.652077238524576, -82.54424760899059 35.65227423852442, -82.5439436088963 35.65255723855073, -82.54371660884318 35.652657238547725, -82.54328260876015 35.65272823851755, -82.5423256085015 35.653373238550394, -82.54213360839891 35.65383123862384, -82.54182160832099 35.65400023862614, -82.541772608303 35.65406423863413, -82.54176860828808 35.654156238652455, -82.54188360829674 35.65422423867811, -82.54222560837091 35.654111238690284, -82.54232560839961 35.654033238684754, -82.54256660848878 35.653715238644835, -82.54266660851125 35.65367723864739, -82.54276360852597 35.653686238659134, -82.54285360853041 35.65375423868228, -82.54295060850805 35.65400323874295, -82.54296260848612 35.65415823877567, -82.54288760843409 35.65441423882011, -82.54268260834493 35.65477123887171, -82.54253060829417 35.654936238889604, -82.54230260824217 35.655028238884924, -82.54227660823776 35.65502823888222, -82.54179060815474 35.655043238835255, -82.54163860812267 35.65508723882857, -82.5413886080568 35.65524523883502, -82.54089860789199 35.65578523889449, -82.54057060782225 35.65588423888092, -82.5403646077642 35.65603823889106, -82.5402766076988 35.65636723894902, -82.54030560768771 35.65647023897296, -82.54059060767628 35.65685023907965, -82.54059760766572 35.65692623909582, -82.5406016076622 35.656953239101746, -82.54059160765408 35.656995239109236, -82.54055060763895 35.657049239115985, -82.54050160762678 35.657075239116274, -82.54044360761448 35.657092239113744, -82.54043660761393 35.65708823911221, -82.54040260760867 35.65708623910837, -82.54033060760392 35.657039239091354, -82.54021760759923 35.656948239061244, -82.53984660759227 35.65659423895101, -82.53978260760142 35.65646623891831, -82.53975560762409 35.65629023887975, -82.53973960764851 35.656115238842496, -82.53971960766854 35.65596423880969, -82.53971060767743 35.65589623879488, -82.53969760769803 35.655749238763605, -82.53971660771963 35.655630238741395, -82.53981960778368 35.655326238690094, -82.53984960781276 35.65517023866143, -82.53981960783257 35.65500923862551, -82.53974860783757 35.65490123859624, -82.53966160783298 35.65483723857428, -82.53957060782099 35.65481723856081, -82.53942760779164 35.654853238553535, -82.53930560775348 35.65496923856449, -82.53923660771825 35.65512223858854, -82.53916160768333 35.65526823861053, -82.53909060765243 35.65539223862849, -82.53898960761865 35.6555022386405, -82.53889260759371 35.65555923864213, -82.53877860756725 35.65560823864033, -82.53853660752382 35.65562923861979, -82.53838060749757 35.65563123860412, -82.5381336074552 35.655640238580546, -82.53794960741763 35.655685238570776, -82.53789960740141 35.65573623857598, -82.53784860737535 35.65585023859392, -82.53781360735239 35.65596123861301, -82.53775360732568 35.65607023862892, -82.53768360730454 35.65613123863411, -82.53734360724646 35.656142238601376, -82.53727660723193 35.656164238598954, -82.53726360722813 35.656174238599704, -82.53723260721918 35.656199238601616, -82.53720460720805 35.65624123860729, -82.53717560718297 35.65637223863089, -82.53714960716505 35.65646023864615, -82.53710760714577 35.65654023865817, -82.53704460712463 35.65660923866565, -82.53696860708905 35.65675723868799, -82.53692160706218 35.65688123870839, -82.53688460702931 35.65705423873985, -82.53688460701257 35.65716223876175, -82.53687260700333 35.657209238770115, -82.53685260699423 35.657246238775606, -82.53681560698296 35.65728023877869, -82.53677760697322 35.65730223877927, -82.53672160696061 35.657323238777735, -82.5366806069526 35.657331238775186, -82.53662460694441 35.65732423876804, -82.53658160693806 35.657319238762554, -82.53651160693367 35.65727223874578, -82.53644560693186 35.65721323872696, -82.53637260692706 35.65716523870971, -82.53629960692052 35.65712923869488, -82.53619560690832 35.65709623867747, -82.53607160689036 35.65707923866125, -82.5358846068607 35.65707023864017, -82.53568460682706 35.6570732386202, -82.53566960682475 35.65707223861844, -82.53534460677199 35.657064238583395, -82.53516560674116 35.657071238566346, -82.5350556067211 35.6570832385575, -82.53492660669487 35.657114238550506, -82.53481560667035 35.65715323854703, -82.53465960663428 35.65721923854439, -82.53427260654315 35.65739323854001, -82.5341046065005 35.65748823854208, -82.53399660647102 35.657563238546246, -82.53382160641212 35.65775623856751, -82.53367960635933 35.65794523859137, -82.5336206063347 35.658041238604774, -82.53353660631038 35.65810823860977, -82.53347760629494 35.65814523861127, -82.5334056062786 35.658173238609514, -82.53333760626579 35.658183238604586, -82.53324360625147 35.658175238593316, -82.53310660623391 35.65814123857225, -82.5329956062169 35.65813223855899, -82.53297060621304 35.65813023855603, -82.53288460619797 35.65813523854822, -82.53281360618004 35.65817523854902, -82.53275160615983 35.65823923855566, -82.53272160614475 35.65830423856588, -82.53269160612393 35.65840723858373, -82.53268360610686 35.6585092386036, -82.53265960608167 35.65864623862903, -82.53262560605637 35.65877323865138, -82.53251760601884 35.65890023866612, -82.53250360601412 35.65891523866773, -82.53246560600157 35.658956238672204, -82.53235760596117 35.65910123869055, -82.53228160592712 35.659240238711085, -82.53222260587606 35.65950723875928, -82.53219460586173 35.65957023876927, -82.53216260585177 35.6596002387721, -82.53214460584597 35.65961823877391, -82.53206560582915 35.65964223877061, -82.53190660579982 35.659661238758154, -82.53180360577932 35.65968323875206, -82.53174160576599 35.65970223874951, -82.53165260574512 35.659742238748514, -82.53157360572325 35.65979823875177, -82.53144660568432 35.65991423876226, -82.5313036056433 35.66002623877035, -82.53120160561394 35.66010623877618, -82.53107860558296 35.660174238777316, -82.53096560556257 35.66018523876792, -82.53093560555756 35.66018523876487, -82.53085760554664 35.66017223875421, -82.53050960550225 35.66008523870066, -82.53029560547846 35.66000923866316, -82.5300996054557 35.65994623863018, -82.5300356054501 35.65991323861687, -82.52968360541921 35.65973523854438, -82.52934760539276 35.65954523847122, -82.52916360537833 35.65944123843104, -82.52896760535701 35.659368238396006, -82.52872160533033 35.65927623835202, -82.52834460528189 35.659185238294704, -82.52813660525196 35.6591552382672, -82.5278256052051 35.659124238228834, -82.5277406051917 35.65911923821906, -82.52732160512561 35.65909723817154, -82.52706060508443 35.65908323814175, -82.5269586050683 35.659078238130206, -82.52681960504736 35.659064238113075, -82.52670560503152 35.659044238097266, -82.52656760501483 35.65900323807479, -82.52639960499599 35.658945238045604, -82.52630660498748 35.65890023802691, -82.52607260496607 35.65878723797978, -82.52602460496163 35.65876423797019, -82.5257826049329 35.658690237930195, -82.52557260490347 35.658655237901485, -82.52542160488028 35.658643237883524, -82.52533060486434 35.658648237875155, -82.52529160485746 35.65865123787173, -82.52518160483363 35.6586872378678, -82.52511960481789 35.6587222378685, -82.52505560479405 35.6588072378792, -82.52495260473842 35.65905723791953, -82.52492760471617 35.659174237940725, -82.5249076046923 35.659307237965734, -82.52488260467182 35.65941323798479, -82.52483160464645 35.65952223800167, -82.5247886046302 35.659581238009245, -82.52471760461302 35.65961623800905, -82.52462560459554 35.65963023800242, -82.52458260459076 35.65961523799503, -82.52451960458674 35.65957323797994, -82.52435060457921 35.659440237935485, -82.5240336045688 35.65916723784729, -82.52386360455652 35.65906423780884, -82.5238076045525 35.659030237796166, -82.5236156045374 35.658921237754186, -82.52340860451416 35.658849237718286, -82.52322960448721 35.658831237696134, -82.52315360447388 35.658836237689336, -82.52309860446414 35.65884023768449, -82.52301860444423 35.658883237685, -82.52296760442135 35.65897623769873, -82.5229386044015 35.65907323771545, -82.52292160438667 35.6591512377296, -82.5228766043597 35.65927723775056, -82.52286360435079 35.659321237758235, -82.52284960434038 35.65937323776735, -82.52281260432122 35.659457237780636, -82.52277460430675 35.659510237787494, -82.52269860428706 35.65955623778904, -82.52264460427668 35.659565237785344, -82.52257960426577 35.659566237778876, -82.52250260425586 35.65954723776702, -82.5223266042374 35.65947823773489, -82.52214260421947 35.659396237699276, -82.52194160419843 35.65931623766229, -82.52186060418829 35.65929523764973, -82.52179960417841 35.659293237643034, -82.52174860416842 35.65930323763975, -82.5216976041564 35.65932623763919, -82.52165760414401 35.659363237642594, -82.52159960412169 35.65944523765336, -82.52145260405202 35.6597382376978, -82.52143260404245 35.65977923770412, -82.52135560399886 35.65997823773667, -82.52129260395611 35.66018723777271, -82.5212326039271 35.66031023779164, -82.52117760390236 35.66041123780647, -82.52112760388745 35.66045423781014, -82.52105960387074 35.66048923781026, -82.52105060386877 35.66049223780994, -82.520979603853 35.66051823780792, -82.52080460382516 35.66051023778821, -82.52064660380933 35.66044323775832, -82.52037160379115 35.66026523769386, -82.52032760378721 35.660243237684796, -82.52024060377923 35.66020123766733, -82.52007460375687 35.66016823764353, -82.51995860373876 35.66016023762995, -82.51980360371078 35.66017423761679, -82.51967860368549 35.66020423761004, -82.51957460365993 35.660258237610364, -82.51946260362709 35.66035023761754, -82.51934460358581 35.66049023763386, -82.51911360349871 35.66080623767442, -82.51887060340634 35.66114223771778, -82.51875560336474 35.66128823773566, -82.51860160332144 35.66140323774326, -82.51848660329395 35.66145723774232, -82.51839960327491 35.6614872377395, -82.51822660323985 35.661528237730096, -82.51803060320431 35.66154723771375, -82.517863603177 35.66154423769596, -82.51767960315237 35.661506237669286, -82.51752660313379 35.66146223764455, -82.51727060310549 35.66137023759948, -82.51702260308613 35.66122923754523, -82.51665460306569 35.66096623745386, -82.51658460306133 35.66091923743706, -82.51644860304928 35.66085123740921, -82.51630860303118 35.66081823738811, -82.51613560300174 35.660822237371114, -82.51590260295957 35.66084523735181, -82.51588960295709 35.66084723735086, -82.51566860291426 35.66088723733634, -82.5154266028646 35.66094823732381, -82.51529460283652 35.66098823731828, -82.51512360280474 35.661010237305284, -82.51501960278753 35.661010237294555, -82.51490260276962 35.661000237280454, -82.51480760275851 35.660970237264515, -82.51468560274564 35.66092223724222, -82.5145696027364 35.660857237217066, -82.5144716027322 35.660779237191086, -82.51431260273803 35.660570237132205, -82.5142296027392 35.660474237104125, -82.51413060273197 35.66041423708176, -82.51400460271992 35.66035723705713, -82.51395760271535 35.660336237048, -82.51386160270718 35.66028623702794, -82.51377860270217 35.66022923700784, -82.51374160270088 35.66019823699769, -82.5136846027019 35.66013023697798, -82.51365160271291 35.660023236952824, -82.51358360271637 35.65992823692649, -82.513572602717 35.659912236922125, -82.51351560271355 35.659873236908325, -82.51346260270816 35.659851236898355, -82.51344060270516 35.65984723689532, -82.51339860269798 35.659848236891186, -82.51319960265845 35.65989023687922, -82.51293660260467 35.65995623686561, -82.51260460253131 35.6600742368554, -82.51183860236702 35.66031423682539, -82.51161060231941 35.660377236814725, -82.51148760229363 35.66041223680924, -82.51110560220637 35.660566236801166, -82.51079160212676 35.660744236805115, -82.51069160210135 35.660801236806414, -82.51052160206292 35.66086723680233, -82.5103696020307 35.66091223679583, -82.50993360194722 35.66098423676564, -82.50973260190696 35.6610292367541, -82.50952560186072 35.66110623674843, -82.50951060185726 35.661112236748096, -82.5093076018073 35.66121723674856, -82.50837460157022 35.66174923676078, -82.50757960137072 35.662186236767866, -82.50728960130374 35.66230823676282, -82.5069896012389 35.662405236751674, -82.50675560119561 35.66243423673351, -82.50657360116394 35.66244423671676, -82.50639060113474 35.66243623669629, -82.50617460110247 35.66241323666942, -82.50593460106397 35.66240423664282, -82.50587760105387 35.662408236637795, -82.50571160102402 35.66242323662375, -82.50554760099263 35.66245023661236, -82.5051846009087 35.66260323660614, -82.5049426008476 35.66273923660885, -82.5047536007969 35.66286423661482, -82.50467760077609 35.66291723661777, -82.50462960076295 35.662950236619565, -82.504486600724 35.66304923662502, -82.50443960071091 35.66308323662704, -82.50434460068492 35.66314923663073, -82.50425260065961 35.66321423663445, -82.50406360060691 35.663352236643085, -82.5039976005882 35.66340223664645, -82.50397060058096 35.66342023664733, -82.50376360052495 35.66356023665451, -82.50357960047693 35.66367323665855, -82.50338660042951 35.66377323665903, -82.5032156003902 35.66384323665569, -82.50317960038184 35.66385923665528, -82.50299760033508 35.66396623665829, -82.50278360027554 35.66412123666779, -82.50252460019887 35.66433923668545, -82.50235160015174 35.66445823669182, -82.50222260012085 35.664520236691146, -82.50208260009317 35.66454823668245, -82.5018366000482 35.66457523666265, -82.50134359995383 35.664656236628346, -82.50099859988238 35.664748236611494, -82.50085959985006 35.66480823660937, -82.50063459979754 35.6649062366062, -82.50039559972912 35.6650922366194, -82.50022459966134 35.665347236653695, -82.50021759965841 35.66535823665521, -82.50013659962524 35.665486236672955, -82.50013159962376 35.66549023667326, -82.50000759958155 35.665630236688926, -82.49981559952143 35.66581323670637, -82.4997965995165 35.66582423670667, -82.49966459948116 35.66591123671081, -82.49950959943979 35.66601223671535, -82.4992205993662 35.66617823671941, -82.49920059936127 35.6661882367194, -82.49888959928548 35.66634523671922, -82.4985355992109 35.66644723670359, -82.49829459916488 35.66648623668674, -82.4979645991098 35.66648823665311, -82.49768959905873 35.666523236631946, -82.49763759904823 35.666535236629024, -82.49711259894136 35.66666323660095, -82.49683459888828 35.66670823658149, -82.49662759885608 35.66669423655733, -82.49642059882822 35.66665223652743, -82.49634159882407 35.666594236507535, -82.49628159882097 35.6665502364924, -82.49611159881023 35.666437236451955, -82.49590959879032 35.666349236413225, -82.49560759873273 35.666397236391866, -82.49540459868349 35.66649823639147, -82.49523659865771 35.66648423637136, -82.49505359863542 35.66643223634195, -82.49490359862747 35.666322236304154, -82.49473159862158 35.66617623625672, -82.49456259862151 35.66599523620246, -82.4943515986286 35.665723236125395, -82.49409659863484 35.66540923603527, -82.49402559865061 35.66523123599175, -82.49396159865049 35.66516323597131, -82.49387759864699 35.665095235948854, -82.4937265986264 35.665066235927384, -82.49348759859255 35.665029235895204, -82.49337059857685 35.665005235878304, -82.4932505985606 35.66498123586108, -82.49315259854747 35.66496123584688, -82.49282559850666 35.66487423579554, -82.49239059844457 35.6648092357375, -82.49196559838575 35.6647332356783, -82.49187459838092 35.66466723565546, -82.49184459837919 35.66464623564814, -82.49163259836574 35.66450523559762, -82.49146659836107 35.664357235550426, -82.49123259833685 35.66426323550718, -82.49121659833489 35.664258235504505, -82.49091559829829 35.66417223545603, -82.49060059825528 35.66411223541137, -82.4904325982331 35.664075235386505, -82.49022659820581 35.664031235356404, -82.49017159819903 35.664015235347435, -82.49000259817865 35.663966235320125, -82.48990859816722 35.66393923530489, -82.48968759814636 35.66383723526137, -82.489537598138 35.66373023522415, -82.48951159813662 35.663711235217626, -82.48940859813467 35.66361323518704, -82.48940059813451 35.66360623518487, -82.48937959813416 35.66358523517843, -82.48937259813415 35.66357823517624, -82.4893045981394 35.66347123514748, -82.48920959816353 35.663213235085244, -82.48914159816852 35.66310823505684, -82.48900959815956 35.66302423502617, -82.48882959814468 35.66292723498795, -82.48858759811093 35.662886234954634, -82.48823959806691 35.66279723490073, -82.48801259803828 35.662739234865505, -82.48781959801691 35.662670234831616, -82.48748659798316 35.66253123476908, -82.48708359794624 35.66233723468808, -82.48687159792543 35.66224423464734, -82.48675159792558 35.66211523460873, -82.4866035979274 35.6619442345587, -82.48643459792464 35.661781234508204, -82.4862585979146 35.66165723446478, -82.48539959783005 35.66128223430006, -82.48513559780301 35.66117423425092, -82.48492259778351 35.66107123420799, -82.48473459775713 35.661040234182344, -82.4846245977377 35.66104823417263, -82.48455559772175 35.66107723417139, -82.48449959770477 35.661127234175794, -82.48447159769164 35.66118223418412, -82.48445159767236 35.66128523420298, -82.48444859766134 35.661353234216534, -82.48444359763748 35.66150223424632, -82.4844285976076 35.66167923428082, -82.48434759757264 35.661818234300725, -82.48421259753667 35.66190623430472, -82.48404459749501 35.661995234305486, -82.483858597454 35.66206123429981, -82.48372059742677 35.662089234291244, -82.48340659737013 35.66211823426486, -82.48328859734879 35.66213023425515, -82.48311059731533 35.6621552342419, -82.48295059727981 35.662213234237214, -82.48281159724486 35.66229023423855, -82.48256659718727 35.6624002342357, -82.48245559716335 35.66243523423138, -82.48231859714079 35.66243423421707, -82.48222259712998 35.66240123420047, -82.48211559712404 35.66232523417397, -82.4820425971223 35.66225823415282, -82.48191359711909 35.66214023411555, -82.4817145971105 35.661982234062954, -82.48158659709736 35.661930234039204, -82.48149559708241 35.66192923402955, -82.48142559706754 35.66195023402667, -82.48134959704961 35.661984234025766, -82.48127259701927 35.66209823404097, -82.48119859696659 35.66235923408646, -82.48112559692179 35.662571234122055, -82.48107559688653 35.662745234152304, -82.48107659686448 35.66288923418172, -82.48112959684967 35.66304123421807, -82.48124059684505 35.66319023425981, -82.48130159684008 35.66328823428605, -82.48130259681919 35.66342423431377, -82.48125359678721 35.66357823434012, -82.48114159674604 35.66372423435822, -82.48098059669097 35.663908234379086, -82.48065659656842 35.664352234436066, -82.48054959652382 35.664526234460396, -82.48043859647389 35.66473023449043, -82.4802185963687 35.665174234558094, -82.48018559635271 35.66524223456855, -82.48010159631623 35.665388234589585, -82.48001159628213 35.6655122346056, -82.47988259623891 35.665653234620954, -82.47971959619107 35.665787234631445, -82.47952759613345 35.6659542346456, -82.47936259608706 35.666077234653635, -82.47928359606819 35.666114234652994, -82.47914959604398 35.66612723464185, -82.47916559605386 35.66608023463389, -82.47917159606556 35.666011234620555, -82.47916259609573 35.66580623457793, -82.47914359612108 35.6656222345385, -82.47914059613393 35.66553623452075, -82.47913659614885 35.665435234499796, -82.47913759617315 35.66527923446814, -82.47914659618456 35.66521523445606, -82.47915359619282 35.66516923444739, -82.47918459621594 35.66505323442699, -82.47924659624955 35.664902234402675, -82.47937859631486 35.664621234359096, -82.47947759635868 35.66444423433333, -82.47955659639821 35.664273234306634, -82.47957059641296 35.664193234291794, -82.47954359642144 35.66410923427195, -82.47948059641799 35.66406423425634, -82.47939159640465 35.66405523424529, -82.47931159638857 35.664073234240796, -82.47923259636426 35.664145234247286, -82.47916359633989 35.664229234257185, -82.4790815963072 35.66435223427387, -82.47863659614322 35.664935234346565, -82.47856759612156 35.66500123435282, -82.47851259610755 35.665033234353686, -82.47846859609903 35.66504123435084, -82.47845659609655 35.66504423435015, -82.47840359608823 35.66504123434413, -82.47835959608341 35.665025234336326, -82.47832159608123 35.66499823432697, -82.47829259608498 35.66494323431275, -82.47828259610328 35.66481423428549, -82.47829259611822 35.66472823426905, -82.4782855961336 35.664621234246574, -82.47824259614576 35.66449623421665, -82.4781275961592 35.66428623416208, -82.47888259638188 35.663656234111684, -82.47931659653939 35.663103234043916, -82.47944559662372 35.662696233974486, -82.47956359680488 35.66165123377406, -82.47971859687767 35.66134723372823, -82.4799475969485 35.66113423370839, -82.48041659705851 35.660926233714434, -82.48115959718636 35.66089623378487, -82.48168059727585 35.66087623383443, -82.48216659737743 35.66074123385707, -82.4824525974528 35.66056023384968, -82.48341359774724 35.659687233771045, -82.48444159802649 35.65898423373389, -82.48460559807825 35.65882523371844, -82.48475959812681 35.65867623370404, -82.48495259822505 35.6582482336368, -82.48490559830647 35.65767123351459, -82.48475159832847 35.65736323343606, -82.48395959835096 35.65636823315223, -82.48391859842205 35.65586423304537, -82.48415559851979 35.65548623299292, -82.48500859876235 35.65483223294772, -82.48527059885183 35.6545352329143, -82.48539759893315 35.654145232848066, -82.48534359908031 35.653135232637005, -82.48544559914386 35.652833232586104, -82.48581459927735 35.65236623252913, -82.48600559934036 35.65216323250744, -82.4861205993793 35.65203423249306, -82.48631559945052 35.65178323246213, -82.48639659948373 35.6516552324444, -82.48646659951712 35.65151423242294, -82.48650259953614 35.65143023240957, -82.48654859956315 35.651304232388654, -82.48658259959142 35.65115823236245, -82.48660259961592 35.65102123233661, -82.48660559963793 35.65088123230846, -82.48660159965789 35.650748232281046, -82.48658559967211 35.65063923225714, -82.48656259968558 35.65052723223199, -82.48652959970002 35.65039823220237, -82.48639659974283 35.649978232103244, -82.48625659978492 35.64955623200297, -82.48621159980799 35.64935823195806, -82.48620359982164 35.64926123193756, -82.48620459982921 35.649213231927845, -82.48620659983781 35.64916023191732, -82.4862185998535 35.64907123190042, -82.48624159987216 35.64897523188333, -82.48626759988886 35.648895231869666, -82.48632159991347 35.6487942318547, -82.48641759994942 35.64866423183816, -82.48650659997917 35.648567231827585, -82.48660860000953 35.648480231820386, -82.48673060004123 35.648406231817916, -82.48686860007415 35.648341231818925, -82.48701460010611 35.64829123182373, -82.48720160014389 35.648247231833984, -82.48736160017452 35.648221231845234, -82.48753060020424 35.64821023186038, -82.48771960023666 35.64820323187837, -82.4882096003179 35.64820323192888, -82.48858260037653 35.64822423197149, -82.48969360054821 35.64830623210262, -82.48997160059261 35.648317232133444, -82.49009160061244 35.648317232145786, -82.49022560063548 35.648312232158545, -82.49041060067177 35.64827623217026, -82.49062460071805 35.648206232178104, -82.49073360074466 35.648151232178115, -82.49076860075394 35.648128232177015, -82.49083860077205 35.648086232175665, -82.49087260078238 35.64805623217308, -82.49090560079205 35.64802923217101, -82.49097160080625 35.648008232173524, -82.49104360081793 35.64801023218137, -82.49117960083963 35.6480152321964, -82.49127860085449 35.64802523220862, -82.4913776008705 35.648028232219346, -82.49146460088679 35.6480162322259, -82.49146760088738 35.648015232226044, -82.4915056008956 35.64800323222744, -82.49156260091338 35.64794923222234, -82.49157060091814 35.6479272322187, -82.49177260094767 35.64795223224458, -82.49181160095341 35.64795723224958, -82.4919626009738 35.64798723227123, -82.49207660098658 35.64802723229117, -82.49220060099674 35.64809423231757, -82.49231960100124 35.64819323234994, -82.49237960100348 35.648243232366276, -82.49248160100879 35.648318232392086, -82.49262160101432 35.648432232429634, -82.49301960103581 35.648721232529425, -82.49318560104389 35.648847232572145, -82.49330160104512 35.64896323260767, -82.49337660104197 35.64906423263597, -82.49344060103068 35.64920623267137, -82.49346960101543 35.64933623270081, -82.49348060099608 35.64947323272987, -82.49345660097387 35.649591232751426, -82.4934146009499 35.64970123276944, -82.4933196009176 35.64980823278141, -82.49314760086618 35.64995623279377, -82.49275660075884 35.650231232809496, -82.4926886007366 35.65030223281693, -82.49267260072553 35.65035623282633, -82.49269760071655 35.65044123284614, -82.4927526007117 35.65053223287032, -82.49284760071399 35.6506192328978, -82.49294660071986 35.65068723292181, -82.4930416007265 35.650746232943575, -82.4931496007375 35.6507912329639, -82.49327160075154 35.6508312329846, -82.493530600788 35.650873233019816, -82.49370560081577 35.65088123303938, -82.49388060084159 35.65090223306174, -82.49426160090033 35.650931233106824, -82.49458060094629 35.65097623314883, -82.49467760095514 35.65102323316839, -82.49474860095751 35.65108423318807, -82.49478660095265 35.65115623320668, -82.49478560094153 35.651227233221015, -82.49477260092912 35.651293233233076, -82.49475260091491 35.65136423324546, -82.49475260090186 35.6514482332626, -82.4948006008989 35.65151923328191, -82.49492160090354 35.6516192333148, -82.49513160090665 35.65182423337811, -82.49515560085298 35.65219723345648, -82.49544860083999 35.65259623356773, -82.49561360085107 35.65270123360608, -82.49629260095823 35.652737233683354, -82.49681360101638 35.65292023377419, -82.49702560105358 35.65290723379343, -82.49717660109124 35.65282523379223, -82.49710560110546 35.652657233750766, -82.49643760099721 35.652640233678575, -82.49591260094643 35.6524052335767, -82.49578060094818 35.65225223353198, -82.49592260100502 35.65203723350287, -82.49594560102952 35.65190323347791, -82.49577060103404 35.6516862334158, -82.49559560102897 35.65153123336624, -82.4955616010313 35.65147923335216, -82.495546601036 35.65143323334124, -82.49555160104889 35.65135523332593, -82.49558060106781 35.651263233310196, -82.49565760111263 35.65105623327597, -82.49575060116159 35.6508392332414, -82.49577560117672 35.650768233229535, -82.4957956011924 35.65068823321529, -82.4957906012024 35.65061823320055, -82.49576860120764 35.65056023318654, -82.49571560120786 35.65050223316928, -82.4956036012007 35.65042823314267, -82.49544360118544 35.65035523311134, -82.49527560116478 35.650308233084466, -82.49502360113212 35.650249233046544, -82.49496260112633 35.65022123303455, -82.49490960112432 35.65017723302015, -82.49489160113127 35.65011323300525, -82.49491160114388 35.65005323299512, -82.49495460116191 35.6499822329851, -82.4950506011933 35.64988223297468, -82.49525060125697 35.64968523295518, -82.49534160128752 35.649585232944176, -82.49547560133199 35.64944123292871, -82.4958686014582 35.649046232888786, -82.4959846014965 35.64892323287568, -82.49603160151474 35.648855232866694, -82.49605860153113 35.648778232853815, -82.49606860154505 35.648699232838815, -82.49606860155788 35.64861623282188, -82.49605960156869 35.64853623280478, -82.49604160157841 35.64845423278615, -82.4960376015862 35.64839923277457, -82.49605660160178 35.64831923276028, -82.49607260160774 35.648297232757436, -82.49608860161385 35.6482752327546, -82.4961776016393 35.64820623274975, -82.49632860167765 35.64812023274773, -82.49651260172423 35.64801623274554, -82.49668660176438 35.64794323274862, -82.49681360179063 35.64790923275478, -82.49691260180585 35.647917232766595, -82.49697960181116 35.64795523278122, -82.49700560180781 35.6480042327939, -82.49699660179928 35.64805023280228, -82.49697160178798 35.648096232809095, -82.49690560176977 35.64814323281186, -82.49680760175032 35.64816423280603, -82.49666360172435 35.648177232793856, -82.49651660169705 35.64819623278256, -82.49643860167886 35.648230232781486, -82.49639560166477 35.64827523278618, -82.49636960165171 35.648332232795184, -82.49636960164423 35.64838023280489, -82.49637960164247 35.64840223281037, -82.49639960163951 35.648443232820746, -82.49648460163567 35.64855923285316, -82.49655560163043 35.648669232882824, -82.49658460162071 35.64876323290493, -82.49660360160244 35.648902232935164, -82.49659460158423 35.649010232956186, -82.49658860156862 35.64910523297489, -82.49655460154001 35.649253233001524, -82.49651360151853 35.64934823301667, -82.49635760146317 35.64953923303944, -82.49632860144474 35.649627233054346, -82.49632460143377 35.64969423306756, -82.49634660142829 35.64975323308185, -82.49641960143394 35.64979523309784, -82.49652960144893 35.64981623311344, -82.49669160147253 35.64983723313447, -82.49679660148497 35.649869233151755, -82.49686860149109 35.64990723316692, -82.49693960149193 35.64997823318863, -82.49699560148515 35.65008223321557, -82.49701960147654 35.650163233234466, -82.49702760146447 35.65025023325303, -82.49702060143998 35.65040123328304, -82.49701060142405 35.65049323330076, -82.49699960140526 35.65060323332195, -82.49702360139719 35.65068123334033, -82.49706360139629 35.65073023335435, -82.49714460140339 35.65077123337112, -82.49722260141485 35.65078023338097, -82.4973006014303 35.65076423338572, -82.49737560144848 35.650727233385915, -82.49741360146358 35.650670233378214, -82.49741460146565 35.650658233375886, -82.4974216014737 35.65061323336748, -82.49740960148732 35.65051223334569, -82.49733960152626 35.65018523327192, -82.49733060155326 35.65000123323355, -82.49733760156904 35.649906233214956, -82.4973736016004 35.64974223318536, -82.49744760163414 35.64960323316467, -82.49752860166065 35.64951823315568, -82.4976196016815 35.64948123315751, -82.49773660170261 35.6494702331673, -82.49775360170503 35.64947323316971, -82.4978256017145 35.64948923318042, -82.49789560171682 35.649549233199814, -82.49791260171202 35.64959823321154, -82.49791660170375 35.64965623322371, -82.49789860169177 35.64971423323373, -82.49785760167289 35.64979223324535, -82.49784760166276 35.64984723325548, -82.49790860165417 35.649968233286344, -82.49797760165406 35.65004323330867, -82.4980366016577 35.65008323332291, -82.49809260166313 35.65010823333379, -82.4981576016744 35.65010523333989, -82.49822960168906 35.65008723334366, -82.49844560173482 35.65002323335283, -82.49869360178428 35.64996923336734, -82.49883360181033 35.64995123337812, -82.49896860183257 35.64995223339222, -82.49907660184797 35.64996823340659, -82.49918060186111 35.649995233422814, -82.49928660187274 35.650033233441455, -82.49938160188175 35.650077233460166, -82.49945660189154 35.65009423347134, -82.49955660190759 35.65009823348247, -82.49964360192277 35.650093233490374, -82.49973260193971 35.65007923349672, -82.49984360196297 35.650048233501785, -82.4999076019785 35.65001623350188, -82.49999460200097 35.64996423350027, -82.50017360205119 35.649831233491604, -82.50023360206998 35.64977423348622, -82.50030160208802 35.64973023348427, -82.50038760210414 35.64971823349072, -82.50045860211378 35.649732233500906, -82.50054060212105 35.64977323351765, -82.50064760212642 35.649853233544924, -82.50072860213497 35.64988523355979, -82.50080260214739 35.64988423356716, -82.50087660216303 35.64986223357038, -82.50092860217802 35.64982123356729, -82.50095560219196 35.64976023355773, -82.50094660220017 35.64969723354394, -82.50090060220396 35.649623233524174, -82.50081060219603 35.649578233505736, -82.50071560218393 35.649554233491074, -82.50068960218054 35.649548233487174, -82.50046160214826 35.64951223345641, -82.50020660211075 35.64948123342382, -82.50007860209367 35.649454233405194, -82.49996860208466 35.6493942333817, -82.49988160208166 35.649320233357635, -82.4998216020856 35.64923023333316, -82.49977760209765 35.649105233303224, -82.49975260211232 35.6489832332758, -82.49974860213645 35.64882323324282, -82.49975260214129 35.648796233237746, -82.4997686021614 35.64868323321637, -82.49981260219249 35.6485292331896, -82.49988560222883 35.64837223316514, -82.50000660228648 35.64812923312819, -82.5000516023041 35.64806323311937, -82.50025160236709 35.64787023310065, -82.50047760243247 35.64769023308733, -82.50056060245564 35.6476292330835, -82.50062860247169 35.64759823308422, -82.50083960251578 35.647539233093866, -82.5009136025301 35.647526233098844, -82.50101660254985 35.64750923310598, -82.5011716025812 35.64747223311443, -82.50123460259584 35.64744523311544, -82.50142960264321 35.64734823311576, -82.50169760271272 35.64718623311036, -82.50247060290883 35.646747233100626, -82.50258760293512 35.6467022331035, -82.50272460296372 35.64666423310992, -82.50281460298089 35.646650233116276, -82.50291160299737 35.646647233125655, -82.50295360300423 35.64664823313021, -82.50306260302172 35.646652233142255, -82.50321860304544 35.64666623316115, -82.50374660312099 35.64674423323132, -82.5041916031857 35.646803233289155, -82.50445160322518 35.64682723332084, -82.50481560328535 35.64682823335844, -82.50506860333036 35.646809233380644, -82.50519160335352 35.646791233389614, -82.5052986033743 35.64677123339653, -82.50555460342548 35.64671523341152, -82.50617660355415 35.64655023344198, -82.5069246037087 35.646353233478884, -82.50755260383785 35.646192233510796, -82.50795760392016 35.64609423353248, -82.50818760396693 35.646038233544786, -82.5084076040104 35.64599323355824, -82.50845060401882 35.645985233561085, -82.50860560405012 35.645949233569674, -82.50880560408756 35.64592123358455, -82.50977760426804 35.645797233659366, -82.5102356043529 35.645740233694866, -82.51049860440152 35.645708233715496, -82.51105060450335 35.64564123375863, -82.51128760454675 35.64561523377773, -82.5113826045639 35.645606233785635, -82.51153860459291 35.64558623379767, -82.51155160459523 35.645585233798776, -82.51182160464374 35.64556123382173, -82.51183260464559 35.64556123382288, -82.51217460470434 35.64554823385539, -82.5126346047833 35.645531233899284, -82.51290560482983 35.64552123392509, -82.51360260494978 35.64549323399118, -82.51395960501166 35.6454762340244, -82.5144636050989 35.64545323407164, -82.51600460536426 35.645391234217556, -82.51712260555833 35.64533623432142, -82.51722860557668 35.645331234331366, -82.51807960572205 35.645304234413395, -82.51817760573756 35.64530923442451, -82.51842060579395 35.645205234428346, -82.51854260582238 35.64515223443006, -82.5189096059072 35.644997234436325, -82.51893460591296 35.64498723443692, -82.51903060593577 35.64494223443756, -82.51919160597413 35.6448672344389, -82.51932460600638 35.64480123443918, -82.51954560605975 35.644693234439885, -82.52019160622037 35.64434723443595, -82.52047960629186 35.644194234434494, -82.52055260630988 35.64415623443426, -82.52083660638094 35.64400123443191, -82.52151860655091 35.643633234427185, -82.52191060664786 35.6434272344256, -82.52201560667378 35.643372234425186, -82.52214060670296 35.643317234426924, -82.52228160673472 35.643263234430414, -82.52232260674388 35.6432482344316, -82.52234560674894 35.64324023443232, -82.52245060676995 35.643217234438445, -82.52249360677835 35.64320823444111, -82.52257860679501 35.64319223444654, -82.5226466068081 35.643180234451115, -82.52283660684398 35.643152234465, -82.52292360686035 35.64314023447144, -82.52304960688409 35.64312123448056, -82.52342760695518 35.64306723450843, -82.52355460697913 35.64304923451781, -82.52397360705825 35.64298723454834, -82.52411760708534 35.64296623455883, -82.5247166072007 35.64286323459958, -82.52506660726964 35.64279323462138, -82.52522360730106 35.64275823463036, -82.52563760738397 35.642666234654165, -82.5256846073936 35.64265423465661, -82.52582560742198 35.6426222346646, -82.52587360743155 35.64261223466754, -82.52603860746466 35.64257523467694, -82.52625660750881 35.642523234688774, -82.526880607635 35.64237723472326, -82.52740660774097 35.64225623475279, -82.52779060781819 35.64216923477459, -82.52792060784427 35.64214023478201, -82.52800660786082 35.64212523478787, -82.52825560790855 35.64208423480512, -82.52866060798407 35.64203023483575, -82.52887960802475 35.642002234852654, -82.52936360811513 35.64193723488921, -82.52960460815997 35.64190623490766, -82.5308166083854 35.6417492350004, -82.53112660844286 35.64171023502438, -82.53130260847453 35.64169423503922, -82.53143460849809 35.6416842350508, -82.53145760850187 35.64168423505315, -82.53152360851281 35.64168423505994, -82.53167160853752 35.641683235074936, -82.53192560857909 35.641687235101905, -82.53208260860468 35.64169023511866, -82.53230360863999 35.64169923514319, -82.53242260865902 35.64170423515647, -82.53257360868186 35.641718235174785, -82.53281560871623 35.641756235207474, -82.53295660873277 35.641800235230924, -82.53297360873465 35.64180623523394, -82.53316260875411 35.64188423526922, -82.53321160875906 35.64190423527836, -82.5335996087937 35.642097235357554, -82.53381560881232 35.64220923540255, -82.53535060894426 35.64300523572251, -82.53559260896665 35.64312023577074, -82.53572460898282 35.64315823579206, -82.53578060899163 35.64316123579842, -82.53582360899824 35.64316423580345, -82.53592360901655 35.643153235811575, -82.53602260903686 35.64312823581661, -82.53610360905621 35.64309023581722, -82.53618760907848 35.64303623581484, -82.53642960914488 35.64286623580517, -82.53656660917981 35.642787235803176, -82.53664360919635 35.64276323580624, -82.53674860921652 35.64274523581336, -82.53681760922865 35.64274123581966, -82.53684560923342 35.6427402358223, -82.53695960924954 35.642758235837725, -82.53714960927415 35.642803235866396, -82.53743060930785 35.642887235912454, -82.53793960937124 35.64302423599267, -82.53802660938432 35.64303323600342, -82.53808660939318 35.643040236011004, -82.5382046094149 35.64302623602037, -82.5383146094381 35.64299423602516, -82.53842260946485 35.6429372360246, -82.53857460950636 35.642832236018904, -82.53881260957574 35.642638236003855, -82.53886860959183 35.642594236000654, -82.53905760964795 35.642434235987594, -82.53915060967765 35.642342235978376, -82.53922860970805 35.642229235963455, -82.53929560973685 35.642114235946906, -82.53934160976317 35.641993235927025, -82.53940760980564 35.641789235892304, -82.53947660984385 35.641616235864184, -82.53958860989252 35.64142123583602, -82.53960860990115 35.641387235831175, -82.5397666099587 35.6411842358061, -82.5398946100026 35.641037235789334, -82.53998861003508 35.64092823577677, -82.54009661007657 35.64077523575674, -82.54016161010752 35.64064523573703, -82.54020961013724 35.640504235713266, -82.5402346101668 35.64033923568221, -82.54025161019752 35.64015823564709, -82.54030161023442 35.639973235614576, -82.54034361025451 35.639888235601646, -82.54037561026678 35.639843235595706, -82.54044261029229 35.63975023558374, -82.54055561032737 35.639644235573726, -82.54070861036796 35.63954623556954, -82.54081161039274 35.63949623557001, -82.5409266104207 35.639439235570194, -82.54127761050317 35.639282235574356, -82.54139561053077 35.639230235575944, -82.54146861054802 35.63919723557673, -82.54150261055601 35.63918223557713, -82.54168961059972 35.63910023557972, -82.54176361061677 35.639069235581005, -82.54183861063419 35.63903723558217, -82.54188661064569 35.63901423558248, -82.54221361072354 35.638861235584905, -82.54225361073364 35.63883923558452, -82.54231561074887 35.63880723558444, -82.54236761076388 35.63876623558141, -82.54241761077846 35.63872523557824, -82.54252061081175 35.63862023556746, -82.5425846108361 35.63853123555591, -82.54258661083679 35.6385292355557, -82.54264761086259 35.638427235541215, -82.54275061091234 35.63821623550887, -82.54282261094 35.63811423549553, -82.54290761096786 35.6380252354861, -82.5430126109969 35.63795023548166, -82.54311061102231 35.637890235479546, -82.54321661104679 35.63784623548145, -82.54323461105083 35.637839235481955, -82.54351861111373 35.637737235490384, -82.54389861119687 35.63760723550301, -82.54396961121245 35.63758323550538, -82.54431561128851 35.63746223551634, -82.54455661133842 35.63739823552813, -82.54474861137525 35.63736623554132, -82.54506661143368 35.637330235566665, -82.545466611507 35.63728523559873, -82.54570261155112 35.63725323561647, -82.54577661156486 35.63724423562219, -82.54624061164816 35.6372032356616, -82.54640361168171 35.63716123566984, -82.54640861168288 35.63715923566992, -82.54654061171162 35.63711523567454, -82.54663161173302 35.63707423567553, -82.5467296117561 35.6370302356767, -82.54682561177947 35.63698223567677, -82.54689361179581 35.636949235677044, -82.54706861184005 35.636851235675074, -82.54724961188829 35.6367332356697, -82.54737161192261 35.63664223566373, -82.54741161193351 35.63661423566211, -82.5475416119711 35.636511235654524, -82.54755061196221 35.636578235669134, -82.54755661195682 35.63661923567804, -82.5475916119382 35.63677823571401, -82.54759261193803 35.63678023571451, -82.54761461193189 35.63684323572962, -82.54763261192107 35.636933235749844, -82.54765461191434 35.63700023576572, -82.54780761186854 35.6374622358755, -82.54785861185307 35.63761723591225, -82.5478606118523 35.63762423591392, -82.5478966118409 35.63773623594044)))",6002,37,021,001700,370210017002,1418,1418,23,1394,1352,29,1,7,0,5,24,1243,14,1229,1230,1198,23,1,5,0,3,13,760,650,110
census_2010_blockgroups_view.fid--2dc29038_13ec899ba8f_-25db,"MULTIPOLYGON (((-82.54688861742035 35.600463228250064, -82.5468896174268 35.60042222824181, -82.54689261743835 35.60035122822766, -82.54708961747465 35.600327228242975, -82.54723961750359 35.60030122825317, -82.54726061750786 35.60029622825426, -82.54775261760479 35.60019722828464, -82.54835461772304 35.60007822832234, -82.5487206177949 35.60000622834525, -82.54894561783922 35.59996122835924, -82.5489946178485 35.599953228362686, -82.54920261788772 35.599923228377904, -82.5494836179386 35.59989522840107, -82.54973561798215 35.599884228424685, -82.54983161799778 35.599886228435004, -82.55011161804333 35.599892228464974, -82.55014961804949 35.599893228469135, -82.55022161806134 35.59989422847669, -82.55049361810536 35.599901228506056, -82.55055161811457 35.599904228512635, -82.55066261813194 35.59991122852548, -82.5506946181371 35.59991222852893, -82.55079061815206 35.59991822854001, -82.55082361815705 35.59992122854405, -82.55089661816864 35.59992522855232, -82.55111761820311 35.59993922857787, -82.55119161821465 35.599944228586516, -82.55162861828347 35.59996822863629, -82.551638618285 35.59996922863753, -82.55191561833013 35.59997522866722, -82.55217261837377 35.59996822869217, -82.55231761839958 35.59995722870484, -82.55254261844202 35.59992422872129, -82.55271661847632 35.599889228732025, -82.55292761851962 35.59983522874265, -82.55320961858109 35.59974022875229, -82.55333961861115 35.599685228754474, -82.55341261862807 35.599654228755696, -82.55345161863764 35.59963422875565, -82.55378361871772 35.59947222875675, -82.55389461874445 35.599418228757145, -82.5539676187622 35.59938122875709, -82.55418961881588 35.59927222875776, -82.55426461883388 35.59923622875813, -82.55428261882943 35.59928422876975, -82.55429861882594 35.599324228779494, -82.55433061881833 35.5994082287999, -82.55434161881665 35.59943122880569, -82.55436561881336 35.59947822881777, -82.55439761880886 35.599542228834075, -82.55446561880348 35.599650228863005, -82.55449561880248 35.599689228874034, -82.55461461879864 35.59984222891746, -82.55477361879467 35.60003922897388, -82.55502961878835 35.60035622906469, -82.55524861878196 35.60063422914375, -82.55540561877717 35.60083422920067, -82.55541861877684 35.600850229205214, -82.55544561877599 35.600885229215145, -82.55553061877357 35.60099222924562, -82.55578561876645 35.601313229337144, -82.55587161876434 35.6014202293678, -82.55598661876107 35.60156522940911, -82.55633161875107 35.60200222953351, -82.55644761874778 35.60214822957514, -82.55648561874665 35.60219622958885, -82.5566006187435 35.60234122963016, -82.55663961874238 35.60239022964412, -82.55679961873787 35.602592229701706, -82.55728161872445 35.60319922987474, -82.55734061872278 35.60327322989589, -82.55743061872234 35.60337322992552, -82.55745161872245 35.603395229932126, -82.55759261871655 35.60358522998526, -82.55761161871803 35.603596229989506, -82.55769761872179 35.603664230012136, -82.55784261872945 35.60377123004887, -82.5580226187433 35.603875230088526, -82.55826261876639 35.60398423013534, -82.55847961878871 35.60407323017576, -82.55900861884297 35.60429123027451, -82.55923361886373 35.60439923031961, -82.55947361888552 35.60451623036808, -82.55967161890297 35.60461623040873, -82.5597866189129 35.6046752304326, -82.55980761891462 35.60468723043719, -82.56021161894706 35.604912230524505, -82.56023661894908 35.60492623052996, -82.56034261895607 35.60499523055486, -82.56055361896992 35.60513223060444, -82.56068161897716 35.60522323063612, -82.56085461898687 35.60534723067917, -82.56114861899938 35.60558223075712, -82.56150461900941 35.605901230858706, -82.56161761901035 35.60601723089392, -82.56174461901136 35.6061472309334, -82.56189661901028 35.60631823098384, -82.56176661898068 35.60637023098109, -82.56165361895789 35.60639623097476, -82.56090861880755 35.606569230933424, -82.56066061875742 35.6066272309198, -82.56053861873303 35.606654230912696, -82.56042961871026 35.606684230907646, -82.5600116186228 35.606801230888486, -82.55974261856797 35.6068672308743, -82.5595126185209 35.606925230862466, -82.55921161845875 35.60700423084765, -82.55897061840867 35.60706923083611, -82.55868461835006 35.607141230821355, -82.55831161827251 35.60724223080358, -82.5582336182563 35.607264230800084, -82.55800961821153 35.607313230787035, -82.55788661818809 35.60733223077828, -82.55737561809775 35.607368230733115, -82.55711061805066 35.60738823070996, -82.55660161795954 35.6074312306664, -82.555470617774 35.60741623054714, -82.55483461766953 35.6074092304803, -82.5546126176328 35.607408230457295, -82.55394661752254 35.60740623038847, -82.55372461748563 35.607406230365704, -82.55350661744893 35.60740923034389, -82.55340461743286 35.607404230332406, -82.55244761728127 35.60735623022421, -82.55212961723079 35.60734123018854, -82.55206261722039 35.60733723018079, -82.55186361718917 35.60732523015792, -82.55179761717885 35.607321230150404, -82.55170061716362 35.60731523013918, -82.55140961711804 35.60729723010556, -82.55131361710288 35.6072922300947, -82.5510226170569 35.60727723006169, -82.55065861699929 35.60725923002067, -82.55015361692027 35.60722722996225, -82.55004761690365 35.60722122995016, -82.5498636168731 35.6072212299312, -82.54976761685742 35.60721922992097, -82.54947961681049 35.60721422989036, -82.54938461679481 35.60721322988037, -82.549304616782 35.60721022987156, -82.54906561674325 35.60720422984575, -82.5489866167305 35.60720222983724, -82.54896861672756 35.607201229835205, -82.5488386167057 35.60720322982226, -82.54883961670619 35.60720122982194, -82.54861961666995 35.60719922979896, -82.54827561661304 35.607198229763355, -82.5479616165618 35.60719222972987, -82.54785661654456 35.607191229718865, -82.54774261652642 35.60718622970618, -82.54766061651318 35.607183229697156, -82.54741561647391 35.60717422967013, -82.54733461646093 35.60717122966117, -82.5471126164252 35.6071642296369, -82.54688261638802 35.607157229611865, -82.54644761631894 35.60713722956313, -82.54632161629887 35.60713222954912, -82.54622661628412 35.60712522953792, -82.54625361632142 35.606912229497354, -82.5463386164337 35.60627522937644, -82.5463676164711 35.606063229336314, -82.54637961648729 35.60597122931876, -82.54638961649931 35.605904229306155, -82.54641161653511 35.60569522926591, -82.54642161655084 35.60560422924842, -82.54645861659593 35.60535122920069, -82.54645961659753 35.60534222919903, -82.5465616167359 35.60455422904908, -82.54659561678191 35.60429222899925, -82.5465986167881 35.60425522899198, -82.54661161680718 35.604145228970964, -82.54661661681357 35.60410922896414, -82.54663761685275 35.60387722891915, -82.54666761690623 35.603562228858074, -82.54669361694124 35.60336322882032, -82.54670861697143 35.60318322878517, -82.54672961701057 35.60295222874031, -82.54674061702697 35.602857228722115, -82.54674961705074 35.602713228693695, -82.54679761716899 35.601997228552904, -82.54681361720826 35.60175922850606, -82.54684061727671 35.601344228424445, -82.54686161736632 35.60078522831282, -82.54687061737977 35.60070722829785, -82.54687761739186 35.600636228284124, -82.5468826173995 35.60059222827565, -82.54688861742035 35.600463228250064)))",6121,37,021,000600,370210006002,1354,1354,48,1326,1115,189,5,12,0,5,28,1201,40,1161,1180,1000,160,5,11,0,4,21,743,639,104
census_2010_blockgroups_view.fid--2dc29038_13ec899ba8f_-25da,"MULTIPOLYGON (((-82.6476596419771 35.549631228239484, -82.64771164198932 35.5496082282401, -82.64778264200586 35.54957722824102, -82.64851364217341 35.549277228254816, -82.65070864267618 35.54837922829681, -82.6514406428438 35.548080228310916, -82.65146064283972 35.54812822832278, -82.65149564282258 35.54827822835687, -82.6515076428167 35.54832922836852, -82.65154064279996 35.54847422840145, -82.65156364279821 35.548510228411146, -82.65176264278283 35.5488262284959, -82.65181364276113 35.549023228541294, -82.65186364274092 35.54920922858428, -82.65186964273823 35.54923322858983, -82.65191564273441 35.54930822860983, -82.65203064272539 35.54949122865884, -82.65213964273418 35.54955222868248, -82.65223864274199 35.54960822870401, -82.65235364275125 35.549673228729084, -82.65259564277981 35.54974922876937, -82.6531276428715 35.54972822881957, -82.65317464287173 35.5497772288344, -82.65316064285595 35.54986522885087, -82.65309364283056 35.549958228862934, -82.65309364280937 35.55009622889112, -82.65316064280113 35.55022222892368, -82.6534626428109 35.55048622900841, -82.65351564281437 35.55052122902099, -82.65377264283035 35.550695229082685, -82.65465264293621 35.550959229226684, -82.65588364310136 35.551217229405374, -82.65639464317958 35.551261229466746, -82.65660264320817 35.55130022949601, -82.65667664321542 35.55133322951031, -82.65678464321736 35.551437229542564, -82.65692564320713 35.55165722960186, -82.657441643229 35.55207422973973, -82.65751764323224 35.55213522975993, -82.65795364326084 35.5524212298629, -82.65837764323861 35.553026230029644, -82.65843664323974 35.55308223004705, -82.6586736432448 35.55330623011702, -82.6587876432291 35.553532230174746, -82.65883464316954 35.55397123026897, -82.65900264311401 35.554515230397065, -82.6591106431049 35.55469123044401, -82.65921164310684 35.55478823047414, -82.65938564311014 35.55495523052602, -82.65940264310629 35.55499923053673, -82.65953364307832 35.55532323061618, -82.65970764307612 35.55552623067536, -82.65994264310247 35.55560923071634, -82.66021464313263 35.55570723076421, -82.66035364314807 35.55575723078859, -82.6606136431568 35.55598223086116, -82.66072064316052 35.55607423089084, -82.66081764316374 35.55615823091788, -82.66097864317699 35.55624623095235, -82.66116064319961 35.55629623098118, -82.66162464328353 35.55625223101975, -82.66198064332714 35.556354231077, -82.6621626433494 35.55640623110627, -82.66237064336538 35.55652723115223, -82.66243064337249 35.556546231162294, -82.66254264338565 35.55658223118108, -82.66275764341061 35.556652231217356, -82.66288164342524 35.55669123123804, -82.6629956434385 35.55672823125731, -82.66315464345712 35.55677923128396, -82.66325864346926 35.55681323130154, -82.66335164348212 35.55683023131458, -82.66335964348313 35.55683223131577, -82.66364464352243 35.55688523135578, -82.66380964354506 35.556916231379, -82.66392964356172 35.5569382313958, -82.66402464357472 35.55695623140915, -82.66414564358811 35.55700023143055, -82.66426164359449 35.55708423145959, -82.66426664359476 35.55708823146087, -82.66435164359646 35.55716923148609, -82.66446164359867 35.557274231518754, -82.66447964359732 35.55730223152635, -82.66463664358552 35.55754923159277, -82.66473464356429 35.55779423165268, -82.66480464354936 35.55796723169514, -82.66492164353946 35.55815823174607, -82.66488464353348 35.558157231742065, -82.66448064347132 35.55812423169391, -82.6643506434522 35.55810823167731, -82.66385664338239 35.55802723161025, -82.66372164336457 35.55799723159029, -82.66332664331252 35.55790823153164, -82.66324464330224 35.557886231518765, -82.6629766432687 35.55781423147664, -82.66295464326605 35.55780823147311, -82.66211764316246 35.557575231339904, -82.66196964314432 35.557533231316135, -82.6610076430264 35.55725923116172, -82.66052864296707 35.55712623108559, -82.65990364289036 35.55694923098547, -82.65940164282866 35.55680723090505, -82.65906664278681 35.55671623085217, -82.65891964276761 35.5566822308302, -82.65854764271893 35.55659623077451, -82.65830064268535 35.55654723073925, -82.65791064263047 35.556482230686036, -82.65765464259316 35.55644823065282, -82.65740764255665 35.55641823062139, -82.65714364251642 35.55639423058944, -82.65690364247916 35.55637723056137, -82.65662764243532 35.556363230530266, -82.65638264239551 35.556357230503984, -82.65625564237487 35.55635423049031, -82.65585564230729 35.55636123045075, -82.65560464226412 35.55637023042687, -82.6553316422165 35.556385230401894, -82.65506564216874 35.556407230379136, -82.65490664213978 35.556424230366304, -82.65481864212381 35.55643323035911, -82.6545746420784 35.55646423034044, -82.65420164200714 35.55652423031438, -82.65419264200533 35.55652623031397, -82.65393464195493 35.55657523029747, -82.65369064190634 35.556627230283055, -82.65344664185704 35.55668423026968, -82.6530766417806 35.55678123025153, -82.653031641771 35.55679523024977, -82.6526986416998 35.55689823023661, -82.65223064159645 35.55706423022244, -82.65199864154411 35.55715423021706, -82.65131564138647 35.55744123020545, -82.64912964087877 35.55838023017273, -82.64848364072975 35.558651230161715, -82.64837164070438 35.558695230159245, -82.6482936406866 35.5587262301575, -82.64819764066497 35.558763230155215, -82.64770364055602 35.55893823014029, -82.64734964047966 35.55905223012719, -82.64702264041031 35.55914923011342, -82.64664164033123 35.559252230095396, -82.64613964022911 35.559373230068566, -82.64563164012851 35.5594782300379, -82.64510764002785 35.55956623000208, -82.64483963997756 35.559604229982334, -82.6443276398833 35.55966322994192, -82.64418363985737 35.5596762299298, -82.64406663984143 35.55965322991306, -82.64131663938716 35.5596342296273, -82.64132163938658 35.55964322962963, -82.64133363938335 35.559677229637806, -82.6413756393719 35.55979722966659, -82.64138763935635 35.55991122969107, -82.64140063934074 35.56002722971601, -82.64141163932646 35.56013222973851, -82.64143463929686 35.560349229785125, -82.64144563928355 35.56044822980638, -82.64145763926929 35.56055422982924, -82.6414826392378 35.56078622987906, -82.641632639139 35.56159223005864, -82.64165663912335 35.56172023008718, -82.64171063910959 35.56186823012281, -82.64188563909381 35.56216023020027, -82.64230163909978 35.56257223032692, -82.6423286390949 35.56263323034209, -82.64231563906998 35.56278123037088, -82.64231463902178 35.563094230434594, -82.64242863899176 35.56341323051123, -82.6429406389976 35.56392923066889, -82.64315963899138 35.56420723074802, -82.64339063898464 35.564501230831546, -82.64355863899138 35.56463923087689, -82.64376063901571 35.56469923090983, -82.64392163903489 35.56474923093656, -82.64399763904193 35.564785230951685, -82.64412963905424 35.56484823097801, -82.6449096390615 35.56564523122038, -82.64501063906532 35.56573023124807, -82.64546063908237 35.566106231370824, -82.64572963910416 35.56625523142879, -82.64573663909783 35.566304231439446, -82.6460996390873 35.5667662315708, -82.64623363906993 35.56702423163712, -82.64654363909183 35.56721723170825, -82.64687263910432 35.56749223179799, -82.64743763909536 35.56816223199238, -82.64796163911498 35.56860223213585, -82.64796663911531 35.56860523213699, -82.64804763912066 35.56865823215612, -82.64838563914243 35.568882232236355, -82.6488626391441 35.56938823238833, -82.64892363913566 35.56950923241928, -82.64892763912688 35.56957023243208, -82.64907263914347 35.56961923245695, -82.64913063914584 35.56966723247263, -82.64918363914776 35.569712232487326, -82.64929463913559 35.56991123253917, -82.64942563910105 35.570278232627444, -82.64943563909867 35.5703042326338, -82.64950063909151 35.57042123266425, -82.64953763908895 35.57047823267962, -82.64958763908528 35.57055623270068, -82.64968263908492 35.57066123273186, -82.64976363908463 35.57075123275844, -82.6501636390914 35.571140232878726, -82.65018063909142 35.571158232884144, -82.65028863909201 35.57127123291824, -82.6503046390921 35.57128823292337, -82.65033863909083 35.57133323293602, -82.65045863908637 35.57149223298069, -82.6504816390835 35.57153623299205, -82.65051763907896 35.57160423300955, -82.65054363907608 35.571651233021775, -82.6507016390387 35.5720652331224, -82.65077263902586 35.57222623316249, -82.65078063902443 35.572244233166984, -82.65086563901586 35.57239223320587, -82.65089963901397 35.572441233219294, -82.65102263900688 35.57262023326836, -82.65115163899998 35.57280523331932, -82.65117263899978 35.57282923332633, -82.65134763899844 35.57302723338466, -82.6515296390039 35.5731882334362, -82.65174263901879 35.57332223348526, -82.6519846390406 35.57344223353457, -82.65231063907413 35.57357723359549, -82.65235163907937 35.573587233601685, -82.65252163910127 35.573629233627685, -82.65281763914281 35.57367923366824, -82.65295763916238 35.5737032336875, -82.65309063918102 35.57372623370584, -82.6533806392223 35.573771233744765, -82.65339163922386 35.573773233746245, -82.65352063924115 35.57380023376498, -82.65370063926527 35.57383823379117, -82.653951639293 35.57392923383548, -82.65421963931715 35.57406223389006, -82.65506463938512 35.57453523407304, -82.65530463940348 35.57467523412618, -82.65553563942332 35.57479623417459, -82.65572663943824 35.57490623421653, -82.65579463944015 35.57496723423596, -82.65581063944035 35.57498323424086, -82.65586363943045 35.575105234271135, -82.65587163942074 35.575177234286734, -82.65587863941475 35.575223234296786, -82.65584063935638 35.57556223436195, -82.65579963930162 35.57587423442131, -82.65579763929131 35.57593923443432, -82.65565763927358 35.5759032344127, -82.65522663922508 35.57575223433772, -82.65484663917968 35.57563623427504, -82.6547336391654 35.575607234257646, -82.65464063915279 35.57558823424421, -82.65458263914311 35.575588234238225, -82.65452763913217 35.57560023423506, -82.6544656391177 35.57562723423419, -82.6543886390959 35.57568523423814, -82.65428063905892 35.57580923425233, -82.6540996389927 35.5760442342816, -82.65336863874577 35.57686023437295, -82.65299963861665 35.577301234424965, -82.65287163857556 35.57743023443818, -82.65283163856252 35.57747123444238, -82.6528096385568 35.57748523444301, -82.65267063851886 35.5775812344483, -82.65259763850212 35.577611234446906, -82.6525216384844 35.57764423444592, -82.65245463846914 35.57767123444448, -82.65245263846849 35.57767323444467, -82.65224863842474 35.57773723443686, -82.65223763842228 35.57774123443654, -82.65217963841049 35.57775523443341, -82.65214363840323 35.5777632344313, -82.65203763838143 35.577790234425976, -82.65200263837424 35.577799234424255, -82.65181163833483 35.57784923441485, -82.65166863830503 35.57788823440813, -82.65145263825447 35.5779832344053, -82.65126963820968 35.578077234405725, -82.65123863820183 35.578094234406024, -82.65108863816752 35.578155234403084, -82.6508486381133 35.57824823439735, -82.6508106381048 35.57826223439634, -82.65070663808115 35.578304234394196, -82.65047363802631 35.57840823439153, -82.65032763798811 35.57849923439514, -82.65023263796041 35.578576234401105, -82.65019463794566 35.57863123440838, -82.650106637911 35.57876123442585, -82.65003963788857 35.57883523443405, -82.64998563787047 35.57889423444051, -82.6499336378588 35.57891423443929, -82.64984263783832 35.57894923443711, -82.64981263783366 35.57894623443336, -82.64973663782216 35.57893923442413, -82.64962763781448 35.57887123439916, -82.6495246378146 35.578759234365734, -82.64936563781657 35.57857423431172, -82.64922863781221 35.57845423427326, -82.64922363781177 35.57845123427211, -82.64905763779973 35.578350234234506, -82.64899563779373 35.57832223422248, -82.64892263778644 35.578290234208424, -82.6488996377842 35.578280234204016, -82.64868863775418 35.57824723417565, -82.648652637749 35.578242234170965, -82.64860963774163 35.57824323416673, -82.64853063772851 35.57824323415865, -82.6482936376891 35.57824323413428, -82.64821563767613 35.578243234126354, -82.64797163763643 35.57823723410011, -82.64794363763275 35.578231234096016, -82.64780363761399 35.57820123407554, -82.6475846375919 35.57810823403419, -82.6473066375675 35.577966233976674, -82.64720163756043 35.57789823395208, -82.64711063755438 35.577839233930675, -82.64700863755553 35.577721233896185, -82.64700763755643 35.577714233894646, -82.64696063757353 35.57755223385682, -82.64690563759653 35.57734323380863, -82.64689163760659 35.57726223379071, -82.64679763767728 35.57670023366648, -82.64676863770505 35.57648823362038, -82.64677763774023 35.576269233576646, -82.64681463777339 35.57609323354463, -82.64683763781044 35.57587723350293, -82.64683963781248 35.575866233500896, -82.64681563783506 35.57569323346316, -82.64673963784334 35.575557233427695, -82.64665663784383 35.57546423340024, -82.64659163784405 35.575392233378885, -82.6464956378415 35.57530523335133, -82.64640363783872 35.575223233325126, -82.64629563783568 35.57512623329432, -82.64616463782957 35.57502423326011, -82.64602363782147 35.5749242332253, -82.64596263781675 35.57488923321184, -82.64584663780724 35.57482523318698, -82.64575863779723 35.5747952331718, -82.64566163778612 35.57476223315516, -82.64544263775578 35.574723233124736, -82.64527763773273 35.574694233101916, -82.64479963767118 35.574577233029, -82.64463163765126 35.57452523300118, -82.64450763763968 35.57446623297647, -82.64445863763507 35.57444323296676, -82.64424563762486 35.57427923291154, -82.64419163762238 35.57423723289739, -82.64407263761365 35.574165232870506, -82.64406163761285 35.57415823286799, -82.64388963759667 35.574077232833844, -82.6435826375651 35.57395023277648, -82.64350063755506 35.57392723276334, -82.64330163753024 35.573873232731955, -82.64302463749503 35.573802232689076, -82.64293863748419 35.57378023267579, -82.64274463745888 35.573735232646726, -82.64248463742892 35.573648232602345, -82.64225163740574 35.57354723255793, -82.6422146374027 35.573526232549796, -82.64207463739122 35.573450232519995, -82.6419606373804 35.573397232497484, -82.6419346374248 35.57308023243019, -82.64192563744541 35.57293623239995, -82.64191663746723 35.57278423236801, -82.64188763750892 35.57248123230333, -82.64187463755748 35.57215123223476, -82.64185163759873 35.57185823217268, -82.64184163761655 35.57173123214584, -82.64182363764047 35.5715562321083, -82.64180963766127 35.57140523207612, -82.64179463770628 35.5710962320116, -82.64178263772168 35.570983231987356, -82.6417756377323 35.57090623197097, -82.64175163775414 35.5707382319343, -82.64174063776645 35.57064623191444, -82.64172763778146 35.57053423189022, -82.6417196377863 35.570494231881284, -82.64169563780025 35.570377231855, -82.64168763780489 35.570338231846186, -82.64154563777348 35.570389231842015, -82.64147663776045 35.57039923183702, -82.6412956377262 35.57042623182393, -82.64104463768336 35.570433231799605, -82.64087363765738 35.57041723177882, -82.64081963765061 35.57040323177045, -82.64070063763522 35.57037423175233, -82.64060963762539 35.570340231736054, -82.6404446376074 35.57027823170656, -82.64042863760584 35.570271231703465, -82.64014563757759 35.570148231649405, -82.63989763755382 35.57003523160093, -82.63972263753693 35.56995523156664, -82.63950863751845 35.56984423152211, -82.63949163751688 35.56983623151872, -82.63887463746575 35.56950123138726, -82.63866363744812 35.5693872313424, -82.6384056374269 35.56924623128716, -82.63827063741465 35.569180231259864, -82.63815863740325 35.569133231238794, -82.63801063738578 35.56908623121407, -82.63774563735342 35.56901023117143, -82.6375196373248 35.568952231136485, -82.63747163731861 35.56894023112903, -82.63718863728351 35.56886223108415, -82.6369916372602 35.568801231051516, -82.63682363724128 35.56874223102222, -82.63666863722548 35.56867723099317, -82.63651563721142 35.568603230962374, -82.63617063718561 35.56839723088501, -82.6353776371293 35.56790623070366, -82.63513763711042 35.56776923065114, -82.63490963708983 35.56765623060474, -82.63481763708057 35.56761723058733, -82.63470463706915 35.56756923056596, -82.63445663704186 35.56747823052204, -82.63419863701223 35.56739223047801, -82.6335746369403 35.56718523037185, -82.63301663686622 35.56706323028978, -82.6329506368568 35.567053230281005, -82.63293463685426 35.56705223027917, -82.63282563683651 35.56705023026754, -82.6326956368136 35.56705823025583, -82.63268863681233 35.567059230255445, -82.63260963679615 35.56707923025137, -82.6325206367778 35.56710223024691, -82.63248963677212 35.56710523024434, -82.63221463672093 35.56714123022349, -82.63212463670291 35.56716123021829, -82.632005636679 35.56718823021161, -82.6318056366365 35.5672482302033, -82.63171063661623 35.56727723019954, -82.63165263660511 35.56728723019558, -82.63159363659513 35.56728823018968, -82.63152463658516 35.56727823018062, -82.63125163654779 35.56722623014201, -82.63119063653919 35.56721623013377, -82.6309856365102 35.567183230106075, -82.63073863647509 35.56714423007272, -82.63064363646146 35.56713023006015, -82.62999663636707 35.56704422997623, -82.62999363636658 35.56704422997593, -82.62987063634937 35.567023229959055, -82.62980563633782 35.567028229953365, -82.62976163632621 35.56705622995459, -82.62976063632543 35.56706022995531, -82.6296546363205 35.566977229927524, -82.62949463631573 35.56683522988219, -82.62943063631369 35.566779229864196, -82.62925163630464 35.56664422981834, -82.62919263630407 35.56658422980004, -82.62911563630715 35.56648122977124, -82.62896163631609 35.56625622970957, -82.62892263632142 35.56617922968992, -82.62879063631375 35.56608622965743, -82.62878563631341 35.56608322965632, -82.62856563630994 35.56586722958975, -82.62854163630938 35.56584522958279, -82.62845963630687 35.56577322955973, -82.62831663630035 35.56566022952206, -82.62824363629711 35.565602229502694, -82.62788063627927 35.56532622940925, -82.62761763626472 35.565136229343615, -82.62756363626171 35.565097229330114, -82.62737163624733 35.564983229287165, -82.62724863621051 35.56508922929618, -82.62688263610055 35.565409229323805, -82.62676063606385 35.56551622933306, -82.62669863604542 35.56556922933751, -82.62651363598978 35.565731229351556, -82.62645263597139 35.56578522935634, -82.62654863606298 35.565292229265786, -82.6266766361705 35.564731229164586, -82.62677763623232 35.56443822911524, -82.62691863629234 35.56420022908126, -82.62694063630133 35.564165229076366, -82.62709563635707 35.56397022905254, -82.62729863641775 35.56379422903751, -82.62765063651271 35.563557229025314, -82.6285726367616 35.562934228992965, -82.62929563695465 35.56246022897055, -82.6297096370643 35.56219422895877, -82.63002263714849 35.5619852289483, -82.63040063724675 35.56175422893999, -82.63057463729209 35.561647228936025, -82.63102963740555 35.56140122893262, -82.63119463744663 35.56131222893141, -82.63251463776783 35.5606492289317, -82.63306263790135 35.56037322893172, -82.63391763810935 35.55994422893193, -82.63467163829361 35.559560228931005, -82.63470463830191 35.559542228930766, -82.63524463843636 35.5592512289268, -82.63538963847105 35.559182228927625, -82.63565163853349 35.559059228929435, -82.63582563857523 35.55897622893034, -82.63597163861006 35.55890722893123, -82.63645063872545 35.5586742289329, -82.63661363876452 35.5585962289337, -82.63787963907248 35.55796122893413, -82.63835563918822 35.55772322893441, -82.6385736392415 35.55761222893415, -82.63922763940073 35.55728322893418, -82.6394466394539 35.55717422893442, -82.63970463951951 35.55702622893072, -82.63976563953526 35.556989228929446, -82.6398826395653 35.55692022892737, -82.64008163962083 35.55677422891802, -82.64026463967868 35.55659522890029, -82.64041263972943 35.55642522888088, -82.64053963978205 35.556220228852105, -82.64073563986247 35.555908228808654, -82.64107764000103 35.55537622873531, -82.64210564041683 35.553781228515746, -82.64216164043918 35.55369622850418, -82.64248464055746 35.553275228451476, -82.64257564058978 35.55316322843796, -82.64269664063208 35.55301822842085, -82.64279764066536 35.55291122840941, -82.64296264071949 35.552737228390946, -82.64327764082155 35.55241322835716, -82.6437486409648 35.551990228319234, -82.64396664103086 35.55179622830207, -82.64450164118485 35.551372228270544, -82.6448746412885 35.55110122825356, -82.6453896414259 35.550763228237486, -82.64618864162921 35.55030422822581, -82.64643964169058 35.55017622822547, -82.64650664170682 35.55014322822564, -82.64675764176742 35.55002022822633, -82.64678464177385 35.55000722822639, -82.64701564182936 35.54989622822745, -82.64742964192317 35.549733228236704, -82.64749964193973 35.549701228237325, -82.6476596419771 35.549631228239484)))",6431,37,021,002506,370210025061,1193,1193,92,1164,1062,41,2,12,0,47,29,915,46,869,904,842,26,2,7,0,27,11,578,517,61
census_2010_blockgroups_view.fid--2dc29038_13ec899ba8f_-25d9,"MULTIPOLYGON (((-82.35562358206063 35.6242722134073, -82.3554145819987 35.62444921342174, -82.35539758199342 35.624465213423214, -82.35533858197482 35.62452221342872, -82.35524558193858 35.62465721344655, -82.35521358192139 35.62473421345883, -82.35519258190612 35.62481021347215, -82.35517958189182 35.624889213486824, -82.35517458186983 35.62502621351412, -82.3551765818438 35.62519621354891, -82.35517758182915 35.62529221356844, -82.35518058180641 35.62544221359921, -82.3551855817844 35.625590213629806, -82.35520158171326 35.626067213728355, -82.35520458168995 35.62622121375988, -82.35520758166525 35.62638421379332, -82.3552195815938 35.62685921389104, -82.35522058158838 35.626895213898464, -82.35521958156035 35.6270752139349, -82.35523458144466 35.62783921409155, -82.3552515814048 35.62811521414935, -82.35529358131421 35.62874621428186, -82.35529858130324 35.628822214297834, -82.35532658129232 35.6289232143212, -82.35543558125124 35.629305214409975, -82.35547558123575 35.629448214443144, -82.3555255812169 35.62962321448383, -82.35556258120232 35.62975721451483, -82.35559458119029 35.62986921454094, -82.35560458117762 35.62996221456089, -82.3556005811494 35.63014021459654, -82.35559258114338 35.63017021460184, -82.35556158111706 35.63030721462647, -82.35555658111294 35.63032921463042, -82.35551658108413 35.63047221465533, -82.35543758102654 35.630760214705695, -82.35538558098558 35.630969214742755, -82.35536258096676 35.63106621476004, -82.35535158095401 35.63113721477339, -82.35534358094327 35.631198214784916, -82.35534258094061 35.63121421478807, -82.35533558092179 35.63132821481047, -82.35533558090339 35.63144721483464, -82.35533658089153 35.63152521485059, -82.35541458089854 35.63156321486632, -82.35548858090284 35.6316142148844, -82.35562358090162 35.63176621492918, -82.35563858090194 35.631780214933535, -82.35570058090373 35.631835214951096, -82.355799580909 35.63190721497588, -82.35590558091758 35.63196521499862, -82.35610258093745 35.632047215035556, -82.35673058100735 35.63226621514479, -82.3571095810495 35.63239921521087, -82.3569775809871 35.63266121525049, -82.3569375809499 35.63285921528653, -82.3569175809322 35.632952215303405, -82.35687058091258 35.63302921531418, -82.356809580899 35.63305121531239, -82.35666958087354 35.63306621530106, -82.35645258083396 35.63309021528347, -82.35622458077415 35.633233215289, -82.35598158068461 35.63355221532876, -82.3558275805937 35.6339752153988, -82.35581358056754 35.63412921542858, -82.35584758050604 35.634563215520274, -82.35598258045619 35.635030215628994, -82.35603958042891 35.635267215682994, -82.35615158037615 35.63572821578816, -82.35615158031244 35.63614021587182, -82.35635758034523 35.63614821589472, -82.35637358034906 35.63614021589477, -82.35636858032052 35.63631921593057, -82.35636158026682 35.63665921599891, -82.35646158025708 35.63682921604372, -82.3564805802551 35.63686221605236, -82.35661158026825 35.63691721607709, -82.35661458023698 35.637122216119025, -82.35658557997893 35.63875921644849, -82.35657857990813 35.6392092165391, -82.3564605796193 35.64095021688055, -82.35638157941459 35.642188217123795, -82.35633357911233 35.64409021750512, -82.3562965790773 35.64427721753933, -82.35597657876602 35.64594621784522, -82.35586557873344 35.646038217852485, -82.3558585786755 35.64640521792626, -82.3554765784875 35.64721121805057, -82.35536057842971 35.64746121808939, -82.35521157835487 35.64778521813986, -82.35462657807301 35.64898121832238, -82.35424157784911 35.650016218492915, -82.35414857777667 35.650384218558024, -82.35408957774544 35.65052321858016, -82.35399457764105 35.65109621868675, -82.35373557756968 35.65128021869741, -82.35361857751117 35.65153321873669, -82.35354457748716 35.65160921874448, -82.3530435773234 35.65213221879904, -82.35269957722718 35.65238621881513, -82.35232757715137 35.65247821879543, -82.3523055771422 35.65251421880045, -82.35222057710911 35.65263721881672, -82.35221357710714 35.65264221881699, -82.35210357707302 35.65274521882654, -82.35198457704183 35.65281921882937, -82.35181757699962 35.65291321883124, -82.35171257697363 35.65296921883176, -82.35155657693473 35.65305421883288, -82.3515395769295 35.65306921883421, -82.35151957692378 35.65308521883536, -82.35151457692214 35.65309021883586, -82.35147857690708 35.65314921884411, -82.35146557690133 35.65317221884752, -82.35145857689868 35.65318221884882, -82.3514385768903 35.65321521885341, -82.35143257688759 35.65322621885504, -82.35141957688214 35.65324721885793, -82.35135157685849 35.6533272188672, -82.3512285768206 35.65344021887743, -82.35102557675434 35.65365221889958, -82.35092557671867 35.653775218914255, -82.35083957668401 35.65390721893219, -82.35077257665667 35.65401221894656, -82.35067657660734 35.65422821898052, -82.35059857656206 35.65443721901497, -82.3505765765391 35.65456221903804, -82.35030557631234 35.655737219248685, -82.35024657626818 35.655959219287695, -82.35005057615265 35.65649621937661, -82.34989657606103 35.6569232194474, -82.34998857600765 35.65736621954692, -82.34999957600363 35.65740421955571, -82.3500325759914 35.65751821958224, -82.35004357598731 35.657556219591136, -82.35006757597853 35.65763821961024, -82.35009257596596 35.65774621963472, -82.35012357592807 35.658024219694376, -82.35013157590531 35.65817921972668, -82.35013157590252 35.658197219730376, -82.35013157588337 35.658321219755514, -82.3500925757734 35.65898921988715, -82.35004757570171 35.65940421996678, -82.35001057567425 35.65954221999098, -82.34996057565111 35.65963822000532, -82.34986857561499 35.659773220023254, -82.34967857554301 35.660035220056876, -82.34955057549426 35.660213220079854, -82.34948557547031 35.66029822009039, -82.34943157545189 35.660359220097156, -82.34935457542728 35.6604362201049, -82.34925457539721 35.66052322011226, -82.34924657540228 35.66048222010306, -82.34922357541748 35.66035922007574, -82.34921657542259 35.66031922006694, -82.34908157538005 35.660449220079386, -82.3489065753245 35.66062122009625, -82.34872557527419 35.660753220104446, -82.34864557525357 35.660800220105656, -82.34848457521215 35.660896220108555, -82.34842857519794 35.66092822010929, -82.34826157515498 35.66102722011213, -82.34820657514064 35.66106122011334, -82.34791757506547 35.66123722011927, -82.34782857503768 35.6613222201274, -82.3477085749995 35.661440220138964, -82.34740557491698 35.66164922015011, -82.34725057488633 35.66168222014088, -82.34700157484926 35.66165522010966, -82.34687357483831 35.66158922008308, -82.34666457481234 35.66153422005037, -82.34658757479603 35.66155722004706, -82.34630857473647 35.66164422003596, -82.34618657471715 35.66163822002215, -82.34614157471154 35.661626220015044, -82.34615057472452 35.66155222000098, -82.34618357478111 35.661222219937386, -82.34624557483967 35.66091021988035, -82.34637557494163 35.66039021978823, -82.34640757497463 35.66021221975537, -82.34643057501806 35.65995621970573, -82.34648657511279 35.65940421959942, -82.34648757513109 35.65928721957576, -82.34647557514559 35.65918121955299, -82.34643257515505 35.65907421952689, -82.34634857516498 35.658920219486866, -82.34626657516833 35.658811219456354, -82.34618057516585 35.658735219431954, -82.3460705751579 35.658669219407244, -82.3459535751468 35.65861621938439, -82.34581457512813 35.65858821936445, -82.34566057510254 35.65858921934872, -82.34542057505787 35.65862121933043, -82.34512057499624 35.65869821931512, -82.34480857493325 35.65877221929792, -82.34417957480964 35.65889921925882, -82.34403257478122 35.658925219248914, -82.34363457470029 35.65902321922785, -82.34326157462291 35.659124219209865, -82.34307857458775 35.65915621919743, -82.34252757448995 35.65919921914938, -82.342385574464 35.65921521913793, -82.34226557444104 35.65923521912957, -82.3420865744029 35.65929021912232, -82.34187457435874 35.659349219112435, -82.34183157435089 35.659354219108984, -82.34169457432651 35.65936521909712, -82.34156657430715 35.65935321908144, -82.34116657425315 35.65927521902436, -82.34079957420505 35.65919421896999, -82.34037057415223 35.65907721890201, -82.3397185740751 35.65887921879457, -82.33956357405934 35.65881521876551, -82.33953657405705 35.6588012187599, -82.33948057405227 35.65877221874825, -82.33943457405415 35.6587112187311, -82.33929757407041 35.65846021866601, -82.33922857407032 35.658387218644044, -82.33916757406843 35.65833421862695, -82.33905357405969 35.65826921860202, -82.33886257404296 35.658173218562894, -82.3386485740199 35.658093218524535, -82.3382905739807 35.6579642184614, -82.33824457397604 35.65794521845275, -82.33801557396063 35.65780021839969, -82.33792357396561 35.65767021836381, -82.33783257400029 35.65734921828919, -82.33789357404103 35.657151218255336, -82.33828257417743 35.65668621820106, -82.33836657422151 35.656491218170096, -82.33838957425012 35.65633121814007, -82.3383965742619 35.656262218126706, -82.33838957427317 35.65618221810976, -82.33837457428541 35.65608721808899, -82.33831357429543 35.65595721805626, -82.33828257430149 35.655885218038385, -82.33826757430667 35.65583521802666, -82.338267574312 35.65580121801985, -82.33826757431447 35.65578521801663, -82.3382825743257 35.65572821800653, -82.33831357433739 35.65568621800116, -82.33838957435816 35.6556332179983, -82.33845757437537 35.655595217997586, -82.33858757440578 35.655537217999225, -82.33864857442225 35.65549621799719, -82.33871757444666 35.65541221798724, -82.33874057445941 35.655354217977866, -82.33874757446998 35.65529321796619, -82.33874757448707 35.655183217943865, -82.33870957451512 35.65496121789488, -82.33869457454209 35.65477121785475, -82.33864857458528 35.65444321778335, -82.33862557463823 35.65407721770668, -82.33861857465311 35.653973217684815, -82.33861057473533 35.65343421757457, -82.33860957473664 35.65342421757244, -82.33860957474128 35.65339421756644, -82.33860957474269 35.65338521756448, -82.33860757475682 35.65329221754547, -82.33859857476567 35.65322521753089, -82.33858157478237 35.65309921750356, -82.33853557479523 35.65296721747205, -82.33847057479683 35.65288721744904, -82.33838457479303 35.65282021742658, -82.33835357479163 35.65279621741858, -82.33824657478229 35.65274221739648, -82.33820657477875 35.65272221738834, -82.33809457476738 35.652676217367414, -82.33803857476155 35.6526542173572, -82.3377165747231 35.652558217304474, -82.33762557471401 35.652520217287496, -82.33751257470247 35.65247421726639, -82.33747657469978 35.65245321725845, -82.3374315746962 35.65242821724867, -82.33739957469523 35.65240021723965, -82.33734457469576 35.65233821722142, -82.33732457469767 35.65230421721244, -82.33732257469813 35.65229921721128, -82.33730957470114 35.65226621720325, -82.3373015747083 35.65221121719117, -82.33730157472564 35.65209921716852, -82.33735757479757 35.65169421709203, -82.33735757480532 35.651644217081845, -82.33735957482338 35.65153021705893, -82.33735157483846 35.65142421703658, -82.33734957484255 35.65139521703052, -82.33728757486756 35.651168216977965, -82.3372555748807 35.651049216950504, -82.33709557492921 35.65056521683573, -82.33704157494297 35.65041821680038, -82.33697257496065 35.65023021675508, -82.33696057496834 35.65016821674123, -82.33695857497028 35.65015321673792, -82.33696057497616 35.650117216730884, -82.33696457498246 35.650081216724, -82.3369645749834 35.65007521672274, -82.33700557500491 35.649980216707675, -82.33701057500649 35.64997521670714, -82.33704857501799 35.64994121670424, -82.33710557503562 35.6498882166994, -82.33721357505986 35.649847216702156, -82.3373495750867 35.649819216710476, -82.337560575122 35.649816216731615, -82.33772757514802 35.649826216750945, -82.33877257531098 35.64988921687146, -82.33949057542429 35.649924216952684, -82.339857575482 35.6499432169944, -82.34021857553864 35.64996321703568, -82.34033057555764 35.64996021704663, -82.34043557557757 35.64994321705401, -82.34048957558859 35.64993021705691, -82.34051957559569 35.64991621705717, -82.34055157560546 35.649887217054605, -82.34056357560918 35.64987621705365, -82.34058657561941 35.64983421704741, -82.34059457562836 35.649785217038364, -82.340601575639 35.64972421702669, -82.34058657565011 35.649636217007235, -82.34054057566792 35.64947221696919, -82.3404725756791 35.64932721693272, -82.34026657569707 35.64899121684327, -82.34019757570687 35.64885421680829, -82.34014457571763 35.648728216777265, -82.34012857572564 35.64865921676164, -82.34011357573496 35.648583216744655, -82.34009557575612 35.64842721671118, -82.34010057580547 35.648114216648054, -82.34011557586548 35.64774221657406, -82.34010257597483 35.64702221642654, -82.34008957600214 35.64683221638661, -82.340069576042 35.64655321632789, -82.34006857604385 35.646540216325185, -82.34006357607007 35.64636521628909, -82.34006557609638 35.64619721625525, -82.34008157612705 35.64601621622009, -82.34012757616057 35.645849216190946, -82.34018657619389 35.64569721616618, -82.34018957619665 35.64568221616346, -82.34022657622535 35.64553621613764, -82.340237576249 35.64539521611007, -82.34024157625839 35.645339216099174, -82.34021957628161 35.64516521606151, -82.3402145762841 35.64514421605676, -82.34013957632001 35.64483221598568, -82.3400665763384 35.64463521593815, -82.33997557635578 35.64442621588638, -82.33992957636481 35.644318215859634, -82.33989457637917 35.64418821582967, -82.33983957640194 35.6439822157821, -82.33983557640461 35.64396121577745, -82.3398185764171 35.64386221575564, -82.33980457643895 35.64370621572247, -82.33979857645724 35.643581215696464, -82.33982057648876 35.643401215662244, -82.33985157651466 35.64326721563824, -82.33986957652878 35.643195215625404, -82.33992257656074 35.643045215600445, -82.33997457658978 35.64291321557899, -82.34004357662795 35.64274021555097, -82.3401265766763 35.642516215514135, -82.3401505767018 35.6423772154883, -82.34016957671676 35.642301215474866, -82.34017357673089 35.64221421545762, -82.34012657678457 35.641817215372164, -82.34006257685752 35.641277215256, -82.34014357701318 35.6403582150777, -82.34011857704411 35.64013121502901, -82.3400955770747 35.63990921498156, -82.34001757711322 35.639577214906126, -82.33997557713367 35.63940021486582, -82.33986757718698 35.63894021476125, -82.33983257719079 35.63887821474513, -82.33974357720055 35.63872021470388, -82.33970557720465 35.638653214686336, -82.33959257721662 35.63845521463446, -82.33955557722068 35.638389214617256, -82.33942057723524 35.638151214554945, -82.3393885772389 35.63809321453994, -82.33932957725843 35.637904214495464, -82.33941657735778 35.637355214393004, -82.33945957740647 35.63708621434274, -82.3394635774116 35.6370572143373, -82.3394775774271 35.636972214321524, -82.33948257743216 35.6369442143163, -82.33943657743106 35.636902214303014, -82.33941257743102 35.636877214295474, -82.33932557743108 35.63678421426759, -82.33922057743258 35.636662214232025, -82.33915857743347 35.636590214211004, -82.33915257743352 35.63658321420899, -82.33915057743354 35.6365812142084, -82.33913557743388 35.636563214203186, -82.33913057743398 35.636557214201446, -82.3391255774339 35.63655221419992, -82.33911357743423 35.636537214195656, -82.33911057743438 35.636533214194486, -82.33910557743434 35.63652821419301, -82.33909457743485 35.636513214188795, -82.33909057743496 35.63650821418741, -82.33904957743604 35.63645721417277, -82.33896457743623 35.63636521414531, -82.33887757743624 35.63627221411749, -82.33876657743645 35.63615221408165, -82.3385585774309 35.63596621402247, -82.33840757742401 35.635849213983114, -82.33834557742117 35.63580121396699, -82.33824557741669 35.63572321394089, -82.33816057741245 35.635660213919294, -82.33809857740927 35.63561421390355, -82.33807557740815 35.635597213897704, -82.33802457740556 35.63555921388475, -82.33800857740465 35.63554821388088, -82.33798657740344 35.63553221387536, -82.33795557740177 35.63551021386769, -82.33786257739648 35.63544521384492, -82.3378315773945 35.63542421383748, -82.33770457738744 35.635334213806104, -82.33761057738073 35.63527721378483, -82.33732957736052 35.63510821372147, -82.3371975773497 35.635037213693536, -82.3369275773309 35.63487021363172, -82.3368715773269 35.634836213619046, -82.33671057731841 35.634719213578656, -82.33656657731316 35.634599213539474, -82.33639957730722 35.63445921349385, -82.336185577303 35.63425821343097, -82.33615157730237 35.6342252134208, -82.3360185773006 35.63409521338067, -82.33594757729978 35.634024213358906, -82.3358545772987 35.63393221333065, -82.33574057729881 35.63380921329388, -82.33567657730023 35.63373221327164, -82.3355605773038 35.63358521322986, -82.3352135773147 35.63314421310461, -82.3350985773184 35.63299721306287, -82.33506657731935 35.63295721305139, -82.33505057731962 35.63293821304594, -82.33490957732369 35.63276121299542, -82.33486357732524 35.63270221297878, -82.33478957732724 35.63261021295241, -82.33456857733337 35.63233421287362, -82.33449557733556 35.63224221284737, -82.33445157733678 35.63218721283174, -82.3343215773406 35.63202421278517, -82.3342945773413 35.63199021277549, -82.33427757734148 35.63197121276991, -82.33416657734335 35.6318402127318, -82.33405257734654 35.63169821269123, -82.33384957735225 35.631444212618746, -82.33373657735903 35.63128021257381, -82.3336125773775 35.63102821250987, -82.33351957739845 35.63079321245255, -82.33339157742806 35.63046521237274, -82.33332857744375 35.630296212332, -82.33331657744597 35.63026921232523, -82.33323557746226 35.63007721227791, -82.33317557746648 35.629986212253286, -82.33309057746551 35.62990121222723, -82.33296657745765 35.62982021219803, -82.33293057745445 35.629802212190604, -82.33282957744517 35.629754212170496, -82.33273757743456 35.629724212154855, -82.33275057750325 35.629294212068906, -82.3327695776014 35.62868021194629, -82.33278657765231 35.62836921188487, -82.3328065777005 35.62807921182808, -82.33280757771192 35.62800621181335, -82.33281957778028 35.62757721172745, -82.33282257780952 35.62739121168999, -82.33282357781249 35.62737321168645, -82.33286057790166 35.626836211581235, -82.33287457793269 35.6266512115451, -82.33287957793358 35.626650211545446, -82.33288357794164 35.626602211536145, -82.33288357795966 35.62648621151255, -82.33288657797164 35.62641221149793, -82.33289257798678 35.626320211479836, -82.33290357800858 35.62619121145472, -82.33291057802101 35.62611821144065, -82.33292057803939 35.62601021141977, -82.332928578066 35.62584621138732, -82.33295657815697 35.62528821127686, -82.33295757818591 35.62510221123921, -82.33294757819539 35.6250302112236, -82.33293257821039 35.624917211199076, -82.33291457821922 35.62484121118179, -82.3328825782252 35.62476821116374, -82.33286257822682 35.62473621115509, -82.33280457823173 35.624642211130116, -82.33278557823353 35.62461121112186, -82.33266757824366 35.624419211070645, -82.33264957824518 35.624390211063016, -82.33238057826053 35.624003210956715, -82.33227957826493 35.6238672109186, -82.33224957826616 35.623827210907365, -82.33214157826953 35.62369021086844, -82.33225857828556 35.62371121088484, -82.33227457828771 35.62371421088701, -82.3326025783279 35.62380521093932, -82.33271757834177 35.6238382109579, -82.33285657835826 35.623880210980744, -82.33288757836183 35.62389021098596, -82.33303257838004 35.62392721100846, -82.33328557841708 35.62395821104081, -82.33335157842659 35.62396721104945, -82.33343057843831 35.62397521105922, -82.33340357846684 35.62376221101319, -82.33335757850038 35.62349621095443, -82.3333445785143 35.62339221093194, -82.33332557853552 35.623235210898144, -82.33331157856905 35.62300321084962, -82.33332457863293 35.62260421076996, -82.33334157866415 35.622420210734404, -82.33334357867918 35.62232521071525, -82.33333857871057 35.62211721067254, -82.33334157873848 35.62194021063689, -82.33335257877549 35.62171221059173, -82.33335257878859 35.621627210574516, -82.33335657886784 35.62111921047177, -82.33336857888214 35.62103921045677, -82.33337657889267 35.62098021044563, -82.33340357892389 35.620807210413254, -82.33341257893436 35.62074921040247, -82.33342957895229 35.620651210384274, -82.33343157896961 35.62054121036212, -82.33343957901944 35.62022721029922, -82.33343957906791 35.61991421023569, -82.33343957910007 35.61970621019345, -82.3334395791171 35.61959621017117, -82.3334415791394 35.61945421014261, -82.33343857916752 35.61926921010467, -82.33343757918419 35.619160210082434, -82.3334375792315 35.6188542100203, -82.33344857926889 35.61862420997475, -82.33345657932624 35.61826120990188, -82.33346657941884 35.617673209783526, -82.33345457943754 35.61753920975511, -82.33342557944715 35.617446209733195, -82.3333525794475 35.617366209709516, -82.3332545794415 35.61730020968593, -82.33301757941545 35.617215209644286, -82.33305557942555 35.61719020964309, -82.33311157944317 35.61713620963791, -82.33315857946056 35.61707420963021, -82.3333635795356 35.61680820959736, -82.3334035795501 35.61675720959104, -82.33351057958768 35.616628209575936, -82.33353357959537 35.61660320957319, -82.33358157961096 35.61655320956805, -82.3336515796313 35.61649720956383, -82.33368757964061 35.616475209563134, -82.33374657965607 35.616438209561665, -82.33376157965974 35.61643020956157, -82.33390157969343 35.61636220956226, -82.33398857971265 35.61633120956492, -82.33400057971521 35.616327209565355, -82.33408457973233 35.616306209569736, -82.33407057980929 35.61579320946411, -82.33407057981022 35.61578720946287, -82.33407357987087 35.61539820938425, -82.3340945799294 35.61504220931411, -82.3341275800565 35.61425520915777, -82.33414958013925 35.61374320905611, -82.33415758017706 35.61350720900901, -82.33416358019625 35.61338920898565, -82.33421058034035 35.61250720881143, -82.33422458037005 35.612330208776946, -82.33425258042914 35.611978208708386, -82.33426458045707 35.61181020867555, -82.33426758046247 35.61177820866933, -82.33429958050644 35.61152820862189, -82.33433558054591 35.611311208581505, -82.33436358057608 35.61114620855097, -82.33435158057918 35.61111320854302, -82.33431558058838 35.61101520851938, -82.33430358059131 35.61098320851168, -82.33561658085092 35.610707208590966, -82.33825658137253 35.61015420875081, -82.33955758163 35.60987920882899, -82.33995858170927 35.609795208853285, -82.34046058180765 35.60969520888476, -82.34087158188932 35.609606208909035, -82.34089658187227 35.60974320893939, -82.34094558183898 35.610011208998834, -82.34100258182738 35.61014720903234, -82.34105658181622 35.610277209064265, -82.3414105818875 35.61019420908392, -82.34168158194187 35.61013220909925, -82.34247658210137 35.609950209144266, -82.3428325821726 35.60987020916466, -82.3428605821783 35.60986320916618, -82.3429475821957 35.60984320917108, -82.3429775822017 35.60983720917299, -82.34326058225842 35.60977220918891, -82.34410958242844 35.6095802092374, -82.34439358248528 35.60951620925369, -82.34440258247514 35.60959120926986, -82.34439458243938 35.60981420931426, -82.34437558234973 35.61037420942604, -82.34437858229809 35.61071120949477, -82.34438158225238 35.61101020955582, -82.34435458224728 35.61101420955377, -82.34408558219097 35.611091209541726, -82.34380258213426 35.61115520952553, -82.34337558204857 35.611253209501434, -82.34278358192897 35.611394209469054, -82.34251258187552 35.611450209452514, -82.34246958186532 35.61147020945208, -82.3424225818525 35.61150320945406, -82.34242158184351 35.61156020946548, -82.34247358181638 35.61179120951773, -82.34249458181016 35.61185420953266, -82.34258658178317 35.61212720959766, -82.3425965817608 35.61228220963012, -82.34253258173699 35.61236820964091, -82.34248858172735 35.61238320963943, -82.34242658171391 35.612404209637305, -82.34235158169922 35.61241920963266, -82.3421955816682 35.6124532096235, -82.341938581615 35.612522209611, -82.34180258158686 35.612559209604456, -82.34185758156782 35.61274120964708, -82.34202558151081 35.61328920977573, -82.34205858150005 35.61339420980039, -82.34208458149246 35.61347120981876, -82.3421185814822 35.6135742098431, -82.34222158145124 35.61388420991668, -82.34222558145025 35.61389520991938, -82.34223258144317 35.61394820993083, -82.34222458143505 35.61399220993891, -82.3422135814269 35.61403320994615, -82.34219158141683 35.61407520995233, -82.34213758139957 35.61412920995779, -82.34203458137078 35.614205209962584, -82.34196758135299 35.61424820996449, -82.34103158110265 35.614867209993584, -82.34072058101924 35.61507421000363, -82.34048658095604 35.61523321001178, -82.34026258089521 35.615387210019925, -82.34009558084803 35.6155142100285, -82.33999758081792 35.61560421003668, -82.33993358079528 35.61568221004592, -82.33986658076684 35.615794210061715, -82.3398595807639 35.61580621006342, -82.33979858073602 35.615921210080494, -82.3397665807191 35.615996210092476, -82.3397475807121 35.61602121009555, -82.33974458070779 35.61604621010038, -82.3398145807169 35.61606221011085, -82.33987158072257 35.61608621012153, -82.33998258073056 35.61615321014658, -82.34016558073779 35.61630221019573, -82.34032058073971 35.61645521024275, -82.34059558074321 35.616726210326064, -82.34096458075109 35.61707021043401, -82.34107858075623 35.6171582104636, -82.34117658076347 35.61721621048547, -82.34128458077507 35.61725721050491, -82.34145558079634 35.61730221053169, -82.34189558085396 35.6174002105969, -82.3421495808869 35.6174582106349, -82.34284858097739 35.617620210739815, -82.34299458099625 35.617654210761835, -82.34301558099895 35.617659210765, -82.34307058100586 35.61767321077354, -82.34322058102373 35.61771821079811, -82.3432925810311 35.617747210811395, -82.34333358103547 35.61776321081894, -82.34345458104632 35.61782221084328, -82.34349458104874 35.617849210852924, -82.34363758105737 35.617946210887325, -82.3436595810584 35.61796321089314, -82.34375058105954 35.618053210920735, -82.34378758105868 35.61809821093369, -82.34384358105713 35.61816821095364, -82.34406758104636 35.61847721103947, -82.34418658104667 35.61860221107715, -82.34420058104686 35.61861621108144, -82.34427358104837 35.61868421110279, -82.34435158105266 35.618740211122166, -82.34452358106309 35.61885621116347, -82.34469058107327 35.61896921120362, -82.34486058108509 35.61907421124245, -82.34495558108998 35.61914421126643, -82.34503058109293 35.619205211286534, -82.345035581093 35.61921021128808, -82.3450875810931 35.61926521130468, -82.34513358108988 35.61933521132359, -82.34515658108707 35.6193782113347, -82.34524458107727 35.61953521137565, -82.34524958107687 35.61954321137777, -82.34528258107413 35.61959621139192, -82.34533658107347 35.619658211410076, -82.34544658107639 35.619757211441495, -82.34553058108085 35.61981821146258, -82.34566758109078 35.61990021149335, -82.34567958109206 35.619905211495535, -82.3457515810988 35.61993821150967, -82.34585758111105 35.619972211527525, -82.3459485811239 35.61998621153976, -82.3462665811714 35.6200192115793, -82.34644758119842 35.620038211601795, -82.34716758129989 35.62015121169888, -82.34724958131088 35.620168211710805, -82.34732558132012 35.620189211722874, -82.34744858133274 35.62023921174573, -82.34747458133506 35.62025221175104, -82.34767558135201 35.62035721179313, -82.34777258135988 35.620410211813834, -82.34784358136774 35.62043521182627, -82.34789858137377 35.62045521183597, -82.34794358137911 35.6204682118433, -82.34805158139206 35.62050021186088, -82.34825458141945 35.62054021188995, -82.34835958143358 35.62056121190502, -82.34866158147344 35.620626211949315, -82.34873458148098 35.62065521196275, -82.34882458148843 35.62070321198184, -82.34887958149088 35.62074621199616, -82.34890358149204 35.62076421200233, -82.34908858149547 35.620940212057135, -82.3492055815026 35.621019212085244, -82.34934458151348 35.621097212115394, -82.34951158152998 35.621169212147244, -82.349833581564 35.62129321220558, -82.35007258158699 35.62140021225199, -82.35034758161193 35.62153321230729, -82.35052458162802 35.621618212342874, -82.35074958165049 35.62171321238528, -82.35086358166353 35.62175121240476, -82.35100758168198 35.6217852124265, -82.35112358169845 35.62180321244211, -82.35118158170759 35.621806212448746, -82.35129358172497 35.62181321246167, -82.35191458182763 35.621813212525666, -82.35215358186518 35.62182521255278, -82.35247758191602 35.62184321258982, -82.352788581965 35.62185921262505, -82.35297558199436 35.621869212646374, -82.35372458211415 35.62189521272889, -82.35403758216418 35.62190621276335, -82.35427958220332 35.62191221278954, -82.3544425822293 35.62191821280762, -82.35489858230156 35.6219382128586, -82.35559658241039 35.621981212939275, -82.35565858242029 35.62198321294615, -82.35595958246805 35.62199621297969, -82.3560645824852 35.62199721299075, -82.35607758247053 35.622106213014234, -82.35607758245632 35.62219821303294, -82.35607758244869 35.62224721304288, -82.35606358236012 35.622805213154734, -82.3560595823281 35.62300821319558, -82.3560545822999 35.623185213231025, -82.35605458229358 35.62322621323931, -82.35605258224206 35.62355721330629, -82.35604358222558 35.623654213325146, -82.35603358221451 35.62371521333641, -82.356031582212 35.6237292133391, -82.35597758218206 35.623865213361114, -82.35596958217845 35.62388021336338, -82.35593958216512 35.62393421337128, -82.35591358215537 35.62396921337565, -82.35586158213547 35.62404221338516, -82.35572158208949 35.624190213400745, -82.35570358208429 35.62420421340176, -82.35562358206063 35.6242722134073)))",6269,37,021,003104,370210031042,1456,1456,35,1408,1232,155,2,5,1,13,48,1153,23,1130,1126,993,120,2,3,1,7,27,736,651,85
census_2010_blockgroups_view.fid--2dc29038_13ec899ba8f_-25d8,"MULTIPOLYGON (((-82.5581536249852 35.56345522187458, -82.55836062502868 35.56339622188382, -82.5585796250685 35.56337322190162, -82.5590946251542 35.56337222195423, -82.55970262525506 35.56337222201666, -82.56078162542958 35.56340222213352, -82.56160762556645 35.56340322221853, -82.5619436256152 35.563449222262356, -82.56275362573261 35.56356022236809, -82.56288162574783 35.56359922238918, -82.56289962575006 35.56360422239203, -82.56293662575435 35.563616222398245, -82.56295662575675 35.56362222240153, -82.5629766257591 35.563628222404795, -82.56348262581962 35.56378122248789, -82.56360662583437 35.563819222508386, -82.56417062588507 35.564098222623066, -82.5645476259101 35.56434222271138, -82.56464162590795 35.5644582227447, -82.56465362588904 35.56459422277355, -82.56460662586879 35.56467522278521, -82.56451162583804 35.56477222279519, -82.5642156257491 35.56503122281756, -82.5640866257102 35.56514522282754, -82.56387362564469 35.565341222845554, -82.56368862557858 35.56557122287338, -82.56363362555852 35.565642222882204, -82.56354262551335 35.56583822291282, -82.563473625471 35.56603922294659, -82.56334962534582 35.566719223072276, -82.5632986252456 35.56731622318858, -82.56333762519132 35.56771122327299, -82.56334662518293 35.56777522328694, -82.56338562514667 35.568053223347505, -82.56339562514148 35.56809822335767, -82.5634406251208 35.56828122339958, -82.56341962509902 35.56840022342166, -82.56339862507721 35.568519223443715, -82.5634976250941 35.56851622345319, -82.5635716251066 35.56851522346063, -82.56376462513013 35.568570223491655, -82.5637906251347 35.568568223493884, -82.56389062515177 35.56856522350351, -82.56387262514558 35.56858622350595, -82.56381162510844 35.568762223535536, -82.56368562503073 35.56913122359773, -82.56360162490655 35.569848223735015, -82.56363162482478 35.570412223852934, -82.56367762476312 35.57086322394948, -82.56377662470861 35.57132422405349, -82.56389162468727 35.57158722411881, -82.5647226246955 35.5724302243757, -82.56761462479487 35.574906225176576, -82.56807262480342 35.575345225313, -82.5684236247725 35.575925225467095, -82.56862162471799 35.576493225603045, -82.56868262461018 35.57726022576547, -82.56852762443502 35.578231225947235, -82.56842362428901 35.57906822610692, -82.56819462410071 35.58004522628226, -82.56798062393902 35.580865226427235, -82.5677976237333 35.58200522664047, -82.56769862357821 35.582906226813726, -82.56772162346118 35.58369122697591, -82.56804162329827 35.58509522729456, -82.56820962327285 35.58544222738253, -82.5683176232675 35.58559322742437, -82.56825162324677 35.58565722743059, -82.56800662316897 35.58589822745442, -82.56792962314462 35.58597322746181, -82.56772062307805 35.58618022748252, -82.56769762307174 35.586196227483406, -82.56761162304763 35.586260227487585, -82.5675386230275 35.5863122274907, -82.56732062296686 35.58647122750065, -82.56729362295913 35.586492227502156, -82.56724462294682 35.5865192275026, -82.56723562294475 35.58652322750258, -82.56721162293876 35.58653622750269, -82.56720362293669 35.586541227502956, -82.56706562290232 35.58661522750383, -82.56700862288798 35.58664722750451, -82.56664562279954 35.586830227504464, -82.5665066227653 35.58690222750487, -82.566447622774 35.586782227474366, -82.56627062279954 35.586425227383515, -82.56621162280811 35.58630622735329, -82.5660016228295 35.58594022725714, -82.56596062283371 35.58586922723846, -82.56592662283352 35.58583322722762, -82.56578462282644 35.58572622719126, -82.56555062281281 35.585562227133906, -82.56540262280518 35.585452227096276, -82.56530462280234 35.585365227068486, -82.56522362280239 35.585277227042305, -82.56515862280388 35.58519722701931, -82.56512262280967 35.58512122700019, -82.56510562281342 35.585078226989644, -82.56508862281724 35.58503522697913, -82.56502962285681 35.58471422690772, -82.56501162286062 35.58467022689695, -82.56500062286293 35.58464322689038, -82.56498962287233 35.58457022687436, -82.56497562291577 35.58427322681245, -82.56495662296025 35.58396322674741, -82.56491862305133 35.58333022661462, -82.56490262307705 35.58314622657556, -82.56484862309574 35.58296622653339, -82.56450662319624 35.58194422629016, -82.5644926232011 35.581897226279175, -82.56447062320983 35.58181722626063, -82.56439162329228 35.58119522612588, -82.56429562327598 35.58119822611667, -82.56420362326001 35.58120222610803, -82.56400962322479 35.58122222609213, -82.5639996232228 35.58122422609155, -82.56391662320611 35.58124322608695, -82.5638206231848 35.58127822608418, -82.56370862315701 35.581338226084846, -82.56357962312403 35.58141322608696, -82.56321062302936 35.581630226093225, -82.56303862298742 35.581717226093254, -82.56295362296815 35.58175122609144, -82.56287962295275 35.58177122608791, -82.56255462289901 35.581769226054114, -82.56253462289588 35.581768226051885, -82.5622536228508 35.581758226021016, -82.56215762283459 35.58175922601134, -82.5621346227784 35.5821002260784, -82.56212962276392 35.582189226095934, -82.56211862275482 35.58223622610441, -82.56207662273675 35.58230822611473, -82.56203562272367 35.582349226118914, -82.5619836227104 35.582379226119656, -82.56170662265008 35.58247222611016, -82.56143562258896 35.582577226103695, -82.56137762257674 35.58259422610122, -82.561333622568 35.5826032260985, -82.56124762255092 35.582621226093316, -82.56099462250539 35.58264422607209, -82.56072262245657 35.582668226049016, -82.56068762245016 35.58267222604622, -82.55991162230549 35.5827752259875, -82.55964162225501 35.58281222596734, -82.55967662234664 35.582254225857326, -82.55972862247752 35.581460225701, -82.55978262262141 35.580583225528095, -82.55981762271291 35.58002622541832, -82.55972562269844 35.58002122540782, -82.55953062266644 35.580018225387164, -82.55939462264409 35.58001722537301, -82.55922062261264 35.58003322535842, -82.5591016225888 35.5800602253517, -82.55896462255727 35.580117225349255, -82.5588596225321 35.580167225348674, -82.55871862249609 35.58024922535082, -82.55847262243269 35.580396225355486, -82.5582966223879 35.58049722535799, -82.55777062225381 35.580801225365846, -82.5575956222091 35.58090322536866, -82.5575036221855 35.5809572253702, -82.55722762211445 35.581121225375284, -82.55713662209085 35.581176225377114, -82.5569016220303 35.581316225381414, -82.55688262202557 35.581326225381545, -82.55630962188069 35.58165022538861, -82.55614862184207 35.581727225387795, -82.55610262183201 35.58174322538633, -82.55602162181377 35.58177422538429, -82.55587362178386 35.5818092253762, -82.55581762177373 35.581814225371495, -82.55573262175854 35.581821225364166, -82.55564362174376 35.58182122535504, -82.5555466217277 35.58182122534508, -82.55533562169727 35.58179122531736, -82.55512962166974 35.581748225287384, -82.55495962164686 35.581713225262824, -82.55472862161626 35.581663225228894, -82.55448462157844 35.58164522520022, -82.554342621554 35.58165122518683, -82.55416662151968 35.581684225175536, -82.55344162136893 35.58188222514128, -82.55335162135017 35.581907225137215, -82.55323562133057 35.581909225125685, -82.55268062121584 35.5820562250986, -82.55241662116508 35.582101225080656, -82.55229362114254 35.582115225070886, -82.55211862110944 35.58214122505821, -82.55188362106387 35.582184225042795, -82.55152262099699 35.58222922501488, -82.55130662095561 35.582265225000015, -82.5511986209361 35.58227522499099, -82.5511176209709 35.5819622249189, -82.55104562099939 35.58169922485801, -82.55101762101101 35.58159322483359, -82.55088862106115 35.58112822472568, -82.5508266210838 35.5809142246758, -82.55075162111153 35.580653224614906, -82.55070962112559 35.580516224582766, -82.55068662112942 35.58046722457037, -82.5506706211322 35.580431224561465, -82.55055262114526 35.580219224506216, -82.55039662116005 35.57995522443639, -82.5502966211694 35.57978622439178, -82.55024962117392 35.57970622437066, -82.55014462118385 35.5795282243237, -82.55010562118603 35.579472224308255, -82.55005362118904 35.57939722428771, -82.55019862122073 35.57934722429231, -82.55020362122173 35.57934622429264, -82.55057262130386 35.579210224302855, -82.55063162131731 35.579186224304074, -82.55077562134981 35.579130224307484, -82.55091362138488 35.579051224305594, -82.55102162141796 35.578953224296676, -82.55110062144553 35.57885922428564, -82.55119462148963 35.5786742242577, -82.55122162150748 35.57858722424275, -82.55123262152469 35.57848722422352, -82.55122462153845 35.57838922420275, -82.55118862155211 35.57826122417304, -82.5511596215678 35.578128224142965, -82.55115162157627 35.57806422412909, -82.55115762159882 35.57792422410118, -82.55130262166647 35.577641224058475, -82.55142562172564 35.5773892240199, -82.55099562177952 35.57657522381, -82.55089762179598 35.57636222375662, -82.55084762180861 35.57622622372378, -82.55081762182165 35.57610922369691, -82.55079762183725 35.57598622366983, -82.55065562200144 35.57476622340692, -82.55061562204803 35.57442022333243, -82.55055562212586 35.57384922321005, -82.55053962214303 35.573720223182185, -82.5504936221945 35.57333622309927, -82.55047862221167 35.57320822307172, -82.55045462224427 35.5729702230208, -82.5504446222586 35.57286622299856, -82.5504446222786 35.57273622297214, -82.55045462230186 35.572596222944675, -82.55050162236166 35.572258222880684, -82.55053462240343 35.57202222283601, -82.5505686224476 35.571771222788435, -82.55067362258059 35.57102022264641, -82.55070962262505 35.57077022259919, -82.55072462264455 35.57065922257821, -82.5507426226662 35.57053822255544, -82.5507486226904 35.570387222525284, -82.55074162269871 35.57032522251193, -82.55073362270896 35.57025022249583, -82.55072262271237 35.57021622248788, -82.5506886227224 35.57011422246358, -82.55061062273026 35.56997922242805, -82.55044762272873 35.56981322237754, -82.55035962272267 35.56975722235716, -82.55016962270946 35.569638222313415, -82.55012562270551 35.56961622230443, -82.54974462267094 35.56943022222746, -82.5492206226186 35.56920522212779, -82.54873562257193 35.56898522203325, -82.54818962251933 35.56873822192695, -82.54797462249876 35.568640221884884, -82.54733262243711 35.56834822175955, -82.54711862241648 35.56825122171785, -82.5470556224105 35.568222221705525, -82.54686662239243 35.56813622166862, -82.54680462238638 35.56810822165654, -82.5466106223678 35.56802022161869, -82.54603062231216 35.5677562215054, -82.5459646223058 35.56772622149258, -82.54590162229977 35.56769722148018, -82.54583762229369 35.56766822146774, -82.54596362234128 35.56749422144524, -82.54597862234628 35.5674782214435, -82.54611962239144 35.56733622142908, -82.54617162240824 35.567283221423615, -82.54649462250704 35.56698922139694, -82.54667062256078 35.56683022138264, -82.54678062259435 35.566730221373625, -82.54721662271396 35.56642322135596, -82.54760462281064 35.56621322135306, -82.54836562298917 35.565873221362004, -82.54871062307564 35.56568322135868, -82.54961562330212 35.56518722135065, -82.54992262339054 35.564943221332555, -82.55028862350294 35.564607221301735, -82.55089062369143 35.56403122124631, -82.5511296237595 35.56384622123313, -82.55139962381972 35.56374622124057, -82.55172862387916 35.56371422126783, -82.55208362393134 35.56375822131317, -82.55311462407218 35.56395422145889, -82.5535616241324 35.56404522152334, -82.55420862422677 35.564130221607, -82.55491462433633 35.56417922168948, -82.55506862436165 35.56418122170567, -82.5554856244299 35.56418722174975, -82.55587162449878 35.564156221783, -82.55624462457449 35.56406622180294, -82.55666962466528 35.563934221819736, -82.55734362481512 35.563687221838656, -82.55750562484923 35.563640221845745, -82.55799062495116 35.563501221867284, -82.5581536249852 35.56345522187458)))",6367,37,021,000900,370210009003,1545,1545,27,1495,407,1063,10,1,4,10,50,1129,18,1111,1111,353,745,5,1,2,5,18,563,524,39
census_2010_blockgroups_view.fid--2dc29038_13ec899ba8f_-25d7,"MULTIPOLYGON (((-82.64681664323268 35.54053322629941, -82.6469826432682 35.5404812263059, -82.64714364330293 35.540429226311716, -82.64802364349167 35.54015322634567, -82.6491966437433 35.53978422639068, -82.64949464380706 35.53969122640225, -82.64980064387251 35.539596226414204, -82.65028564397616 35.5394462264334, -82.6505106440228 35.53938622644422, -82.65075764407227 35.53933122645832, -82.6509956441183 35.539289226474175, -82.65124764416528 35.539256226493315, -82.65149864421086 35.539231226513884, -82.65177464425834 35.53922022653986, -82.6520486443033 35.53922422656881, -82.65232764434809 35.53923522659964, -82.65249564437426 35.53924622661906, -82.65281064442331 35.53926822665585, -82.65361764454889 35.539324226749905, -82.65384964458286 35.539354226779764, -82.65403464460913 35.539383226804674, -82.65407564461502 35.539389226810115, -82.6546726446933 35.53952622689914, -82.65472764470053 35.53953922690748, -82.65484764471564 35.53957022692612, -82.65510464474524 35.5396562269699, -82.65533064476516 35.53977122701646, -82.65547664477404 35.53987122705185, -82.65560764477905 35.53998122708763, -82.65571964477819 35.540108227124975, -82.65583664477141 35.540279227171844, -82.65608264474446 35.54072122728706, -82.656095644743 35.5407452272933, -82.65641164470749 35.54131922744265, -82.65641964470649 35.54133422744655, -82.6564436447036 35.54137922745816, -82.65645264470281 35.54139422746218, -82.6564606447017 35.54141022746624, -82.6564876446988 35.54145822747873, -82.65649664469788 35.541474227482986, -82.65670464467433 35.54185322758151, -82.65689064465205 35.54220022767124, -82.65690764465047 35.54222922767894, -82.65711164463353 35.54256022776728, -82.65785464456307 35.54382522810115, -82.6582116445257 35.544456228266284, -82.65846164449964 35.54489722838174, -82.65863664448153 35.545205228462464, -82.65828964440936 35.5452992284461, -82.65718564415707 35.54574722842421, -82.65625864394504 35.54612422840611, -82.65287664317222 35.54749622833903, -82.6514406428438 35.548080228310916, -82.65070864267618 35.54837922829681, -82.64851364217341 35.549277228254816, -82.64778264200586 35.54957722824102, -82.64771164198932 35.5496082282401, -82.6476596419771 35.549631228239484, -82.64749964193973 35.549701228237325, -82.64742964192317 35.549733228236704, -82.64701564182936 35.54989622822745, -82.64678464177385 35.55000722822639, -82.64675764176742 35.55002022822633, -82.64650664170682 35.55014322822564, -82.64643964169058 35.55017622822547, -82.64618864162921 35.55030422822581, -82.6453896414259 35.550763228237486, -82.6448746412885 35.55110122825356, -82.64450164118485 35.551372228270544, -82.64396664103086 35.55179622830207, -82.6437486409648 35.551990228319234, -82.64327764082155 35.55241322835716, -82.64296264071949 35.552737228390946, -82.64279764066536 35.55291122840941, -82.64269664063208 35.55301822842085, -82.64257564058978 35.55316322843796, -82.64248464055746 35.553275228451476, -82.64216164043918 35.55369622850418, -82.64210564041683 35.553781228515746, -82.64107764000103 35.55537622873531, -82.64073563986247 35.555908228808654, -82.64053963978205 35.556220228852105, -82.64041263972943 35.55642522888088, -82.64026463967868 35.55659522890029, -82.64008163962083 35.55677422891802, -82.6398826395653 35.55692022892737, -82.63976563953526 35.556989228929446, -82.63970463951951 35.55702622893072, -82.6394466394539 35.55717422893442, -82.63922763940073 35.55728322893418, -82.6385736392415 35.55761222893415, -82.63835563918822 35.55772322893441, -82.63787963907248 35.55796122893413, -82.63661363876452 35.5585962289337, -82.63645063872545 35.5586742289329, -82.63597163861006 35.55890722893123, -82.63560563855532 35.55886722888555, -82.63450763839124 35.558747228748594, -82.6341416383365 35.558707228702914, -82.63378463828337 35.55866722865817, -82.63292563815476 35.558574228551144, -82.63271463812369 35.55854822852422, -82.63235863807107 35.55850522847895, -82.63213763803859 35.55847822845076, -82.63161963796301 35.558409228383596, -82.6311536378962 35.55834022832179, -82.63110563788926 35.55833322831541, -82.6300726377435 35.55816422817506, -82.62979163770464 35.55811322813589, -82.62756163739651 35.55770622782434, -82.62684563729745 35.55757622772446, -82.62636663723134 35.55748822765743, -82.62602963718487 35.55742622761026, -82.62501863704522 35.55724122746882, -82.6246826369987 35.55718022742198, -82.62395663689851 35.55704722732044, -82.62343863682696 35.55695222724798, -82.62288063674991 35.556850227169996, -82.62222863666211 35.556716227075825, -82.62178763660435 35.556615227010056, -82.62158563657783 35.556569226979974, -82.62107163651204 35.556441226901185, -82.62062263645464 35.55632922683239, -82.61995063636857 35.556162226729455, -82.61927763628289 35.55599222662578, -82.61882963622583 35.55587922655686, -82.61827163615476 35.55573822647087, -82.61659963594158 35.55531622621349, -82.61604263587064 35.55517622612789, -82.61517263575952 35.55495822599425, -82.61516163575811 35.55495522599252, -82.61453963567719 35.55480922589903, -82.61401463560577 35.55470622582426, -82.61387263558598 35.55468122580454, -82.61377263557218 35.554663225790634, -82.61350263553396 35.554620225754164, -82.61311563547731 35.55457022570427, -82.61270563541608 35.554525225653144, -82.61248063538181 35.554505225625995, -82.61243963537532 35.55450222562114, -82.61224263534457 35.55449022559848, -82.61218163533502 35.55448622559143, -82.61192163529395 35.55447222556191, -82.61166163525245 35.55446122553301, -82.61157563523837 35.55446022552398, -82.61156663524082 35.554434225517795, -82.61154563524683 35.554372225503016, -82.61151063526313 35.554228225470105, -82.61146263527085 35.55412622544437, -82.61136863529379 35.55387522538359, -82.61130563529883 35.55377422535661, -82.61124463530554 35.553664225327985, -82.61119163531144 35.553568225302975, -82.61100463532355 35.553287225226505, -82.61085663532786 35.55309922517305, -82.61078063532842 35.55301322514781, -82.61042463533893 35.552559225018825, -82.61028763534361 35.55238122496848, -82.60965863535804 35.55160622474618, -82.60929263536667 35.55115422461662, -82.6091376353774 35.55091622455226, -82.60912463537665 35.550907224549086, -82.60912263537666 35.55090522454848, -82.60908963537757 35.550863224536506, -82.60907863537776 35.55085022453278, -82.60843563539241 35.550059224305706, -82.60824663539657 35.54982722423909, -82.60805963539998 35.5496032241743, -82.60775663540274 35.54925722407281, -82.60648963543048 35.54770522362676, -82.60584663544488 35.546916223400146, -82.60559863545046 35.54661122331265, -82.60531863545664 35.5462682232141, -82.60511463546227 35.54601022314066, -82.60490763547048 35.54573322306299, -82.60487363547232 35.54568422304957, -82.60477963547817 35.54554422301147, -82.60465963548715 35.54535622296086, -82.60471663550032 35.54533222296177, -82.60482763552626 35.54528322296317, -82.60484963553147 35.54527322296338, -82.60493463555231 35.54522922296313, -82.60500063556833 35.54519622296316, -82.60512463559952 35.54512722296188, -82.60525263563413 35.54504022295725, -82.60536363566622 35.544951222950566, -82.60555463572459 35.54477822293489, -82.6056396357495 35.54470722292915, -82.60566363575627 35.54468922292791, -82.60571263576959 35.544655222926096, -82.60590563581793 35.54454922292424, -82.60592863582296 35.54454122292498, -82.60602963584503 35.544507222928424, -82.60616863587313 35.54447422293597, -82.60634663590692 35.54444722294867, -82.60651163593616 35.54443522296316, -82.6068766359988 35.54442222299796, -82.6070216360244 35.54441222301075, -82.60714963604899 35.54439022301941, -82.60724663606987 35.54435922302303, -82.60735063609559 35.5443042230225, -82.60743963612202 35.54422822301611, -82.60753463615626 35.54410822300144, -82.60777263625137 35.543746222952144, -82.60799663635179 35.54333422289119, -82.60804763637204 35.54325722288077, -82.60817863641972 35.543088222859815, -82.60821563643778 35.54301122284788, -82.60823163645165 35.542938222834636, -82.60822263646541 35.54283822281338, -82.60819863647927 35.54272222278729, -82.60818563649615 35.5425982227607, -82.60819663651381 35.542495222740904, -82.60823763654 35.542369222719465, -82.60828363655975 35.54229022270799, -82.60836963658713 35.54220422269929, -82.60851563662399 35.54212222269763, -82.6086626366581 35.54205922269987, -82.60923063678423 35.54185222271589, -82.60955963685403 35.541753222729525, -82.60970663688354 35.541720222737844, -82.609862636913 35.54169722274911, -82.60997663693165 35.541699222761245, -82.61013363695312 35.54172922278342, -82.61035663697787 35.54180922282255, -82.61044763698916 35.54183422283703, -82.61053363700323 35.541835222846, -82.6106186370211 35.54181122284984, -82.6106946370403 35.54176822284891, -82.61076263706465 35.541683222838515, -82.61088163712498 35.54141922279697, -82.61094963715527 35.54129522277873, -82.61101463717952 35.54120722276747, -82.6111076372086 35.54111822275886, -82.61122563724203 35.54102822275264, -82.61136563727854 35.540942222749486, -82.6117466373753 35.54072422274413, -82.61178863738606 35.54069922274336, -82.61181963739402 35.54068122274288, -82.61224663750235 35.54043722273696, -82.61252163757325 35.540273222731756, -82.61276563764245 35.54008622271866, -82.61303963772427 35.539849222698486, -82.61328463780373 35.53959722267231, -82.61339863784535 35.5394492226538, -82.6134976378853 35.539296222632785, -82.6136046379299 35.53912122260815, -82.61365063794752 35.539056222599605, -82.61392463803686 35.53877022256942, -82.61401663807155 35.5386442225532, -82.61407763810165 35.53851422253304, -82.6141386381417 35.53831922249951, -82.61420763817871 35.53815222247264, -82.61426863820714 35.53803322245464, -82.6143136382246 35.537968222446004, -82.61436463823902 35.53792922244324, -82.61462963829347 35.537861222456584, -82.61489163839009 35.53751522241298, -82.61537763852326 35.53717322239312, -82.61576663862826 35.536910222379454, -82.61583463867606 35.536672222338, -82.61620763878351 35.53637622231595, -82.61658763894096 35.535761222229624, -82.61694963908565 35.53521022215447, -82.61702163915861 35.534812222080845, -82.61722063924739 35.53444922202727, -82.61731663926719 35.53442422203204, -82.61779863936609 35.53430122205633, -82.61807063941788 35.53425822207547, -82.61831763948163 35.534110222070694, -82.61839563950146 35.53406522206952, -82.61840563950405 35.53405922206928, -82.61861363956456 35.533890222056165, -82.61879963961823 35.5337412220449, -82.61889963964576 35.53367022204074, -82.61906063968999 35.533556222033944, -82.61929863975205 35.53340922202844, -82.6194046397795 35.5333452220263, -82.61953863981378 35.53326722202411, -82.61991863991089 35.53304522201783, -82.62003363994015 35.53297922201616, -82.62016663997576 35.53289122201188, -82.62025464000143 35.53281922200629, -82.62041364005319 35.53265422198894, -82.62065564013479 35.5323842219588, -82.62088764020737 35.53216222193731, -82.62116064029246 35.531903221912515, -82.62120864030679 35.531861221908926, -82.62135364031555 35.53196122194415, -82.62147564032206 35.5320512219749, -82.62167664033196 35.53220422202671, -82.62200464034602 35.53246822211409, -82.62221064035401 35.53263922216998, -82.62256164036307 35.532960222271335, -82.62275264036862 35.53313122232574, -82.62277264036841 35.5331542223325, -82.62279764036899 35.53317722233973, -82.62295964037199 35.533333222388165, -82.62345464038182 35.53380522253504, -82.6236206403852 35.5339632225842, -82.62364864038575 35.5339902225925, -82.62369864038682 35.53403722260725, -82.62373564038762 35.534072222618214, -82.62376464038815 35.53410022262689, -82.62390864039098 35.53423722266953, -82.6243436404002 35.53464822279778, -82.62448864040313 35.53478622284078, -82.62450864040352 35.53480522284667, -82.62456964040476 35.5348632228648, -82.62459064040529 35.534883222871024, -82.62473464040801 35.535021222913855, -82.62491964041165 35.53519822296884, -82.62516764041645 35.53543522304253, -82.62531264041941 35.5355732230855, -82.62542064042174 35.535675223117316, -82.62574764042861 35.53598422321377, -82.625856640431 35.53608722324598, -82.62600764043395 35.53623122329072, -82.62617464043743 35.53638922334005, -82.626397640442 35.536601223406144, -82.62646264044331 35.53666322342533, -82.62661364044615 35.53680822347039, -82.62670264044789 35.536893223496776, -82.62697264045346 35.537149223576655, -82.62706264045522 35.53723522360335, -82.62712664045657 35.53729622362233, -82.62724664045913 35.537409223657654, -82.6273226404612 35.5374782236795, -82.62738964046306 35.537538223698604, -82.62769264047269 35.53780422378384, -82.62798664048366 35.53805122386432, -82.6283396405012 35.538319223955035, -82.62882564053002 35.53865722407365, -82.62911664054924 35.53884722414221, -82.62943864057289 35.5390422242149, -82.62988864060897 35.539294224312385, -82.63027464064244 35.539494224392676, -82.63045164065839 35.539582224428706, -82.631288640734 35.53999622459887, -82.63206064080397 35.540376224755384, -82.63242064083668 35.54055322482828, -82.6329476408845 35.54081222493511, -82.63424964100273 35.54145222519888, -82.63504064107444 35.54184222535935, -82.63560964112605 35.542122225474785, -82.63595464115704 35.54229322554491, -82.63612564117315 35.54237422557898, -82.63649564120576 35.54256222565518, -82.63667064125138 35.54245422565113, -82.6369016413083 35.54233322565014, -82.6370146413356 35.542278225650485, -82.6373506414138 35.54213222565521, -82.63760864147274 35.54202822566045, -82.63792064154352 35.54190422566719, -82.63818464160298 35.54180322567366, -82.63837864164374 35.54174722568212, -82.63846364166149 35.541723225685885, -82.6387596417211 35.541656225702596, -82.63899364176581 35.54161822571885, -82.63927264181707 35.541586225740964, -82.63954464186459 35.5415712257658, -82.64125364215406 35.54153622593372, -82.6419706422754 35.54152222600439, -82.64248164236143 35.541515226055274, -82.64249164236305 35.54151522605634, -82.64293864243872 35.54150622610031, -82.64302564245338 35.54150522610905, -82.64325964249353 35.54149722613131, -82.6435236425406 35.54147622615417, -82.64376864258706 35.541439226171704, -82.64393764262022 35.5414062261823, -82.64402864263809 35.541388226187976, -82.64426564268666 35.54132822620002, -82.64429264269206 35.54132222620157, -82.64469464277792 35.541198226217475, -82.64480364280143 35.54116322622155, -82.64513064287135 35.54106122623422, -82.64524064289476 35.54102822623884, -82.64556164296349 35.540928226251296, -82.6457126429958 35.54088122625725, -82.64588564303297 35.540826226263725, -82.64618664309762 35.54073122627526, -82.6464536431549 35.54064722628548, -82.64681664323268 35.54053322629941)))",6428,37,021,002302,370210023021,2262,2262,128,2225,2024,83,15,36,1,66,37,1812,84,1728,1792,1663,48,12,24,1,44,20,1181,1073,108
census_2010_blockgroups_view.fid--2dc29038_13ec899ba8f_-25d6,"MULTIPOLYGON (((-82.57367862706846 35.56666822412201, -82.57362762708765 35.56648822408011, -82.57349262714041 35.565999223966735, -82.57347162714439 35.5659502239546, -82.57339762715839 35.565779223912195, -82.57412462730618 35.56560322395095, -82.57501262747724 35.56544922401078, -82.57612562767618 35.56535722410623, -82.57749362792055 35.565245224223816, -82.57873162817009 35.56495922429268, -82.58027162844951 35.56480522441931, -82.5803116284527 35.564827224427944, -82.58111162858562 35.56482722451003, -82.58157662865604 35.56487122456668, -82.58193262870498 35.56493722461664, -82.5822286287391 35.565035224666985, -82.58259162877138 35.56521722474132, -82.5832436288214 35.56559622488533, -82.58410562892492 35.5658542250263, -82.58416762893353 35.56586522503487, -82.5848986290348 35.56599622513659, -82.58567862916851 35.56596922521115, -82.5869096294009 35.565787225300355, -82.5869406293853 35.565922225331065, -82.5870356293387 35.56632822542346, -82.58706762932306 35.56646422545446, -82.58707762931765 35.56651022546485, -82.58709162931126 35.56656722547788, -82.5871276293052 35.566645225497496, -82.58714862930188 35.56668922550857, -82.58688662923616 35.56683422551121, -82.58653862914852 35.567028225515024, -82.58614362903569 35.56733522553694, -82.5861216290293 35.567353225538355, -82.58599662898702 35.56749322555404, -82.58594462896828 35.567559225562185, -82.58574862889714 35.56781022559316, -82.58557362881781 35.56813722564174, -82.58551862878686 35.56827922566502, -82.58546062875364 35.568432225690266, -82.58539462870587 35.56867222573232, -82.58535262866583 35.56888722577182, -82.5851526284367 35.57016122601068, -82.58507662835298 35.57062422609713, -82.585048628328 35.570756226121155, -82.58501162829448 35.570934226153604, -82.58496262825759 35.57112122618662, -82.58484862818874 35.57144622624114, -82.58479962816334 35.57155822625889, -82.58478262815484 35.571595226264634, -82.58476362814477 35.5716402262719, -82.58472962812928 35.571704226281405, -82.58471162812066 35.57174122628713, -82.58466962810098 35.57182322629949, -82.58465462809477 35.571847226302815, -82.58451562803641 35.57207722633543, -82.58446062801546 35.57215422634544, -82.5843916279886 35.5722542263587, -82.58432662796375 35.57234522637059, -82.5843016279541 35.57238122637534, -82.58403362785052 35.57276522642603, -82.58394462781602 35.57289322644293, -82.58391562780496 35.57293422644829, -82.583904627801 35.572948226450066, -82.58387562779005 35.57298822645524, -82.58373462773555 35.57319022648182, -82.58368062771218 35.57328422649545, -82.58362762768704 35.57339022651157, -82.58351562763733 35.57359222654122, -82.58339062757966 35.57383222657721, -82.58331362753772 35.5740222266081, -82.58323762749231 35.574235226643665, -82.58314462743152 35.574530226694115, -82.58308462738161 35.574790226740916, -82.58302562732585 35.575089226795725, -82.58299662728142 35.575346226845056, -82.58287262708845 35.57646722706062, -82.58284362704326 35.57673022711117, -82.58283962703814 35.57675922711671, -82.58274662688777 35.57763622728574, -82.58273062686098 35.577793227316064, -82.58271662683774 35.57792922734225, -82.58263762682826 35.57790522732929, -82.58263162682765 35.57790322732829, -82.58240362679715 35.57785522729509, -82.58239762679625 35.57785422729426, -82.58231662678439 35.577844227283904, -82.58207662674883 35.5778162272536, -82.58205462674545 35.577814227250904, -82.58173562669216 35.57781622721855, -82.58135762662141 35.5778682271904, -82.58134662661926 35.577870227189635, -82.58112062657563 35.577910227174534, -82.58108462656878 35.57791522717191, -82.58097962654844 35.57793422716496, -82.58094462654158 35.57794122716278, -82.58092862653888 35.57794122716121, -82.58088062653036 35.577945227157095, -82.58086562652751 35.57794722715594, -82.5807726265115 35.57795122714716, -82.58060062648144 35.577961227131546, -82.58049462646476 35.577955227119524, -82.5804026264501 35.5779512271092, -82.58024662642539 35.57794322709157, -82.5797816263518 35.577919227038976, -82.57962662632717 35.577912227021656, -82.57930662627557 35.57790222698671, -82.57895162621908 35.577886226947086, -82.57787562604747 35.57784022682722, -82.57692862589538 35.5778062267231, -82.57625462578712 35.57778222664907, -82.5760696257577 35.57777422662837, -82.57551662566956 35.57775022656681, -82.57533262564004 35.57774322654647, -82.57535362565973 35.57763822652724, -82.57536862569113 35.577450226490505, -82.57542262579912 35.57680622636488, -82.57544762584008 35.5765662263186, -82.57547862589043 35.5762732262621, -82.57550662595165 35.575905226190066, -82.5755726260933 35.57505522602384, -82.57559462613564 35.57480322597476, -82.57562862619784 35.57443622590362, -82.57569662633601 35.57361122574255, -82.57570262634793 35.57354022572879, -82.57573962641281 35.57315822565475, -82.575775626501 35.5726232255496, -82.57581162656756 35.57222922547303, -82.57583262660508 35.57200822543024, -82.57583962663354 35.57183022539466, -82.57589662670212 35.57144622532236, -82.57589762670617 35.571421225317344, -82.57592262678622 35.57092722521934, -82.57592862679812 35.57085622520554, -82.5759546268476 35.57056222514833, -82.57598362692657 35.570080225053175, -82.57597162694289 35.56996122502769, -82.57585462694176 35.56984222499146, -82.57581062693241 35.56985522498961, -82.57550862693007 35.569544224895296, -82.57532262692862 35.56935322483731, -82.5745596269086 35.568659224617754, -82.57442862690515 35.5685402245801, -82.57432962690497 35.5684342245483, -82.5742686269069 35.56835622452619, -82.57426362690738 35.56834722452384, -82.57420462691334 35.56824522449697, -82.57417862691618 35.568198224484846, -82.57413662692524 35.56809422445929, -82.5740766269423 35.56791822441733, -82.57403962695328 35.567807224390926, -82.5740036269631 35.567704224366274, -82.57389562699235 35.56739722429266, -82.57385962700205 35.56729522426822, -82.57381162701314 35.56717122423808, -82.57366762704628 35.56680022414777, -82.57365062705023 35.566756224137016, -82.57361662705658 35.56667822411765, -82.57361762705675 35.5666782241178, -82.57367862706846 35.56666822412201)))",6085,37,021,001000,370210010002,1686,1686,88,1610,1019,535,8,9,0,39,76,1214,43,1171,1186,844,310,8,7,0,17,28,763,701,62
census_2010_blockgroups_view.fid--2dc29038_13ec899ba8f_-25d5,"MULTIPOLYGON (((-82.43910359997864 35.597685216602606, -82.43922759997463 35.5978442166476, -82.43923659997361 35.59786021665183, -82.4393205999646 35.59800921669074, -82.43940159995088 35.59818521673487, -82.43950759992873 35.59844221679799, -82.4395165999273 35.598461216802846, -82.43961159991218 35.598661216853216, -82.439661599906 35.59875521687746, -82.43968259990362 35.59879321688732, -82.4398135998946 35.59899221694129, -82.43983859989376 35.59902421695035, -82.4399045998915 35.59911021697465, -82.4399965998882 35.5992302170085, -82.44003059988705 35.59927421702098, -82.44032359989363 35.599546217106386, -82.44037359989476 35.59959221712083, -82.4404495999018 35.599628217135994, -82.44049159990473 35.59965421714564, -82.4406185999138 35.59973221717456, -82.4406615999169 35.59975821718421, -82.44069159991906 35.59977621719099, -82.44078259992538 35.59983321721196, -82.44081359992754 35.59985221721899, -82.44086259993101 35.59988221723018, -82.44129459997392 35.6000682173124, -82.44138759998295 35.60010921733034, -82.44185660002367 35.6003492174273, -82.44235360005835 35.60065721754106, -82.442488600068 35.60074021757189, -82.44265460007485 35.60087421761617, -82.44306660009158 35.60120721772626, -82.44319760009454 35.601329217764516, -82.44339960009899 35.60151721782356, -82.44358860010253 35.60169721787954, -82.44371860010493 35.60182121791817, -82.44392360010153 35.602063217988466, -82.44417060009538 35.60236821807578, -82.44420760009163 35.60243221809267, -82.44436160007544 35.60270221816338, -82.44446260005361 35.60295221822463, -82.44456560002489 35.6032492182956, -82.44463759998547 35.60358221837068, -82.4446835999469 35.60388121843618, -82.44466259986153 35.6044122185419, -82.44461159981005 35.604691218593395, -82.44460159979894 35.604752218604794, -82.44454459973325 35.60511721867312, -82.44445859966606 35.605460218733995, -82.44441459963116 35.60563921876587, -82.4443465995707 35.605958218823716, -82.44429959952858 35.606180218863976, -82.44415359940939 35.60679621897425, -82.4440185992852 35.607456219094445, -82.44393459920674 35.60787421917085, -82.44391759919117 35.60795721918591, -82.4439015991762 35.60803721920059, -82.4438935991687 35.6080772192079, -82.44382859911963 35.60832521925156, -82.44379459909342 35.608458219275086, -82.44368659898488 35.609046219383494, -82.4435995989098 35.609439219454515, -82.44357459888765 35.60955621947571, -82.44349559883644 35.609803219517765, -82.44341859879307 35.610001219550064, -82.44338859878144 35.61004421955568, -82.44321759871379 35.610299219589976, -82.44303659863043 35.61064521964168, -82.44300359861101 35.61073521965663, -82.44295259858056 35.61087821968037, -82.44292859855963 35.610988219700275, -82.4428885985246 35.611172219733575, -82.4428045984426 35.61161321981461, -82.44279359842453 35.611718219834785, -82.44275659836026 35.61209521990761, -82.4426945982992 35.61242421996812, -82.44257559824567 35.61264322000038, -82.4422885981571 35.61290922002488, -82.44190459806387 35.61310122002447, -82.4416345980083 35.61317122001083, -82.4414645979793 35.61317721999454, -82.44106459791037 35.61319421995685, -82.4408355978661 35.61323521994168, -82.44072859784458 35.61326021993573, -82.44066359782921 35.61329021993513, -82.44054959779898 35.61336321993822, -82.44031359773255 35.613540219949876, -82.43964659754415 35.6140452199839, -82.43934959746245 35.61425621999625, -82.43910859739702 35.61442122000496, -82.43909659739415 35.61442722000491, -82.43888659734068 35.61454822000794, -82.43875959731052 35.61460722000688, -82.43864859728504 35.614653220004755, -82.43849259725282 35.61469421999705, -82.43821159719445 35.6147712199838, -82.438021597159 35.614797219969525, -82.43786259712907 35.61482021995782, -82.4376605970938 35.614832219939444, -82.43757459707956 35.61483221993065, -82.43750259706748 35.614833219923376, -82.43737959704956 35.6148172199075, -82.43717259702133 35.61477821987827, -82.43697759699567 35.61473521984938, -82.43673359696697 35.614659219808864, -82.43645959693474 35.61457421976337, -82.43631759692028 35.61451521973675, -82.43612459689822 35.6144512197039, -82.43594259687731 35.614391219672946, -82.43561659684231 35.61426821961444, -82.4352685968032 35.61414821955419, -82.43511959678737 35.6140912195273, -82.43505759678077 35.61406721951599, -82.4347945967557 35.61394721946458, -82.43464459674205 35.61387521943448, -82.4345015967316 35.613789219402314, -82.43430859671923 35.61366221935662, -82.43335659667909 35.61290121910396, -82.43299159666633 35.61259221900353, -82.43269759665611 35.612343218922625, -82.4325575966501 35.61223221888571, -82.43251359664818 35.61219721887403, -82.43250559664757 35.612192218872245, -82.43233459663412 35.61209621883513, -82.4323045966318 35.61207921882858, -82.43227559662856 35.61206921882351, -82.43215659661513 35.61202821880293, -82.43214659661395 35.61202521880132, -82.43188459657922 35.61196921876303, -82.43178959656238 35.61197621875458, -82.43166559654013 35.61198721874408, -82.43143259649862 35.61200621872396, -82.43104859642627 35.612063218695994, -82.43097559641248 35.6120742186908, -82.4305985963426 35.6121222186617, -82.43029359628471 35.612170218639996, -82.42994159622 35.612212218612314, -82.42953959614525 35.6122652185817, -82.4292975961016 35.612288218561524, -82.42919859608322 35.61230121855398, -82.42891359603011 35.612339218532334, -82.42858259596927 35.61237821850617, -82.42690159566072 35.61257421837299, -82.42629559554939 35.612645218325, -82.42528059536484 35.612752218242285, -82.42354059505976 35.61286221808548, -82.42326659501784 35.61284021805285, -82.42311359499558 35.61282021803303, -82.42296859497496 35.6127982180136, -82.42289859496576 35.612783218003365, -82.42265559493316 35.612733217968184, -82.42238659489713 35.61267821792934, -82.42229559488483 35.61266021791625, -82.42196959483618 35.61262621787579, -82.42174959480046 35.612621217852116, -82.42166559478696 35.61261921784306, -82.42104659468863 35.61259221777394, -82.42070659463741 35.612559217732176, -82.42061559462353 35.61255121772112, -82.42029259458015 35.61248621767475, -82.42009459455389 35.61244421764581, -82.41986559452627 35.612377217608575, -82.41964259450154 35.612298217569574, -82.41914959445612 35.61206421747121, -82.4190255944422 35.61202121744973, -82.41897159443602 35.612003217440495, -82.4187885944127 35.611958217412564, -82.4186305943913 35.611927217389955, -82.41815159431701 35.61189521733414, -82.41756959422375 35.61187521727023, -82.41712659415442 35.61184921721929, -82.41692559412608 35.61181721719206, -82.41626959404006 35.61167121709491, -82.41609059401837 35.61161921706593, -82.41597359400517 35.611579217045744, -82.41588659399778 35.61153421702759, -82.41582959399483 35.61149221701324, -82.41571059399195 35.611383216978815, -82.41534459401122 35.610866216836044, -82.41456459405288 35.60976021653104, -82.41452359405504 35.60970221651502, -82.41440059406116 35.609530216467405, -82.41435959406324 35.60947321645163, -82.41421159407065 35.60926621639431, -82.41376759409289 35.60864621622262, -82.41368759409694 35.60853421619159, -82.41360959409715 35.60844921616631, -82.4134495940975 35.60827521611449, -82.41319359408423 35.608087216049896, -82.41296759406914 35.60794221599716, -82.41278059405668 35.607822215953554, -82.41244459403227 35.60762021587786, -82.41233159402303 35.607559215853875, -82.41206659400125 35.607416215797535, -82.41080459389377 35.60675921553412, -82.41063259387951 35.60666721549768, -82.41036359385791 35.60651921544001, -82.4101975938446 35.60642721540415, -82.41009759383975 35.60635121537837, -82.41006059383766 35.60632521536929, -82.41002159383599 35.60629421535902, -82.40999159383462 35.60627121535123, -82.4099225938326 35.60621021533176, -82.40983859383107 35.60613021530683, -82.40964059383315 35.605904215240514, -82.40941859384584 35.605584215152696, -82.40927359384834 35.60541221510276, -82.40919759384634 35.60534421508111, -82.4091295938421 35.60529821506483, -82.40904559383472 35.605256215047575, -82.40888459381391 35.60521821502336, -82.40799859368796 35.60508421490489, -82.40771959364876 35.60503921486695, -82.40711559356438 35.604938214784276, -82.40640259347066 35.60478121467902, -82.40560459338333 35.60449121453787, -82.40558559338166 35.604482214534144, -82.40552959337617 35.60445721452333, -82.40551159337451 35.60444921451985, -82.40548859337241 35.60443821451522, -82.40541959336586 35.60440621450158, -82.40539659336359 35.60439621449721, -82.40527759335241 35.60434121447375, -82.40494659332126 35.604188214408616, -82.40492459331969 35.60417521440375, -82.40481159331082 35.60411121437912, -82.40444559328247 35.60390221429891, -82.40384859323622 35.60356221416836, -82.40335759320126 35.60326221405684, -82.40299859317564 35.60304321397541, -82.40278059316127 35.602903213924506, -82.4023535931326 35.60263121382532, -82.40228659312798 35.60258921380987, -82.40226759312833 35.60256621380333, -82.40216059311837 35.60251621378206, -82.40212759311711 35.602489213773204, -82.40192859310936 35.60232621371954, -82.40175359308701 35.60228321369282, -82.40122959301993 35.60215621361305, -82.40105559299755 35.60211421358667, -82.40083559296943 35.602061213553235, -82.40064859294384 35.602026213526855, -82.40050759292326 35.602008213508654, -82.40037359290267 35.6019982134929, -82.40020759287522 35.601998213475746, -82.40009959285669 35.60200221346548, -82.39999459283747 35.60201421345704, -82.3997775927951 35.602056213443326, -82.39887959261094 35.6022872133977, -82.39848659253009 35.602389213378004, -82.39798859242644 35.60252721335473, -82.39796759243343 35.60245921333876, -82.39794759243861 35.602404213325535, -82.39792659244384 35.60234821331202, -82.39791459244711 35.602314213303906, -82.39789559245212 35.60226121329112, -82.3978445924653 35.602121213257476, -82.39779659247522 35.602005213228956, -82.39776159248245 35.60192121320823, -82.39802959254294 35.60181621321457, -82.39809059255678 35.601792213215965, -82.39908359277922 35.60141521324159, -82.3994145928533 35.60129021325029, -82.39992459296793 35.60109421326292, -82.40026359304392 35.600965213271614, -82.40097159320145 35.600703213291304, -82.4013705932879 35.60057121330556, -82.40146959330936 35.60053821330908, -82.40160659333894 35.60049321331401, -82.40168659335534 35.600473213318175, -82.40199259342062 35.60037821333039, -82.40202659342775 35.60036821333187, -82.40208159343929 35.60035221333426, -82.4023505934949 35.60028021334733, -82.40244059351355 35.600256213351706, -82.4024825935223 35.60024421335355, -82.4026085935484 35.60021021335969, -82.40265159355728 35.60019921336187, -82.40278359358452 35.600164213368295, -82.4030385936367 35.600099213381384, -82.40318259366579 35.600065213389286, -82.40331659369257 35.60003521339697, -82.40337459370431 35.60002121340015, -82.40354859373933 35.599981213409976, -82.40360759375105 35.59996821341334, -82.40378059378587 35.59992821342302, -82.40391559381237 35.599901213431444, -82.4045035939271 35.59978821346904, -82.40484759399239 35.59973421349343, -82.4050215940253 35.599707213505866, -82.40515959405133 35.59968621351582, -82.40612659423233 35.599550213587705, -82.40707559440996 35.5994172136584, -82.40769159452515 35.59933121370433, -82.40836059465254 35.59922321375123, -82.40874559472759 35.599149213775846, -82.4090205947822 35.59909021379215, -82.40933559484453 35.599024213811205, -82.4095075948789 35.59898621382116, -82.40977959493418 35.59891921383553, -82.40997259497351 35.59887121384569, -82.41018659501755 35.598815213856284, -82.41032359504557 35.59878121386349, -82.41068659512102 35.59868121388059, -82.41082659515088 35.598638213886225, -82.41103959519599 35.59857421389514, -82.411159595222 35.598534213899384, -82.41151959529957 35.598417213912704, -82.41164059532561 35.59837821391716, -82.41174359534804 35.59834321392062, -82.41185259537211 35.598304213924, -82.41199159540238 35.5982572139287, -82.41243759550154 35.598093213941326, -82.41248659551269 35.5980732139423, -82.41269759555995 35.597993213947746, -82.41291259560835 35.59791021395301, -82.41322959567945 35.59778921396102, -82.41352659574495 35.597683213970114, -82.4135625957528 35.597671213971324, -82.4137825957998 35.597602213979975, -82.41400759584789 35.59753221398894, -82.41418659588551 35.5974802139968, -82.41451559595448 35.59738621401153, -82.41496459604558 35.59727721403557, -82.4153525961229 35.59719221405828, -82.415419596136 35.59717921406247, -82.41583559621665 35.59710321408988, -82.41585759622106 35.59709821409116, -82.41587759622479 35.59709521409256, -82.41592559623385 35.597088214096125, -82.41594859623805 35.59708521409785, -82.41633559631093 35.59702821412609, -82.41634159631192 35.59702821412672, -82.41682259640032 35.5969712141647, -82.41750459652316 35.596906214221605, -82.41789459659347 35.59686921425425, -82.4180155966153 35.59685721426425, -82.41837859668058 35.59682421429491, -82.41850059670239 35.59681321430524, -82.41879159675524 35.59678321432908, -82.41906759680519 35.5967552143518, -82.4194705968798 35.59670421438293, -82.41966259691634 35.59667321439637, -82.41995159697119 35.596627214416785, -82.42014459700813 35.59659521443009, -82.42017059701335 35.59658921443161, -82.42061659710123 35.59649821445898, -82.42082459714354 35.59644721447004, -82.42104159718744 35.59639521448174, -82.42115059720948 35.59636921448769, -82.42124959723013 35.596342214492445, -82.421597597302 35.596249214509385, -82.42187159736056 35.59616321452002, -82.4220775974044 35.59610021452845, -82.42217859742672 35.59606421453152, -82.42248459749356 35.59595921454171, -82.42258759751603 35.59592421454519, -82.4225995975188 35.59591921454536, -82.42263859752737 35.59590521454654, -82.42265159753016 35.59590121454711, -82.42266659753356 35.595895214547426, -82.42271159754362 35.59587821454861, -82.42272759754704 35.59587321454923, -82.42322459765735 35.59569121456337, -82.42446559793231 35.5952402145994, -82.42471459798794 35.59514721460617, -82.42495459804123 35.595059214612945, -82.42518859809275 35.594976214620154, -82.42521259809811 35.59496721462078, -82.4255055981627 35.5948632146298, -82.42552159816628 35.594857214630274, -82.42607059828535 35.59467421464954, -82.42645659836845 35.5945502146641, -82.42661759840274 35.594500214670475, -82.42666659841335 35.59448421467231, -82.42677059843533 35.59445321467674, -82.42704959849425 35.594370214688546, -82.4270755984997 35.5943632146898, -82.42789259866981 35.59413721472791, -82.42800259869263 35.594107214733114, -82.42817559872789 35.5940642147422, -82.42844759878278 35.59400021475714, -82.42872859883916 35.59393621477307, -82.42917959892831 35.59384221480037, -82.4292685989455 35.59382621480628, -82.42954459899862 35.59377821482495, -82.42969259902699 35.593753214835026, -82.4301305991104 35.59368221486574, -82.43013859911207 35.59368021486617, -82.43028859913994 35.59366021487746, -82.43034959915151 35.593651214881916, -82.43053359918578 35.59362621489582, -82.43059559919728 35.593618214900545, -82.43085359924511 35.59358521492039, -82.43113959929785 35.593550214942674, -82.431629599387 35.59349821498252, -82.43188959943402 35.59347221500401, -82.43235259951851 35.59342121504134, -82.43374559977278 35.593268215153486, -82.43420959985744 35.59321721519092, -82.4344925999092 35.5931852152135, -82.43495259999311 35.5931352152507, -82.435326600062 35.593090215280036, -82.43534160006492 35.59308721528094, -82.43562360011823 35.59304421530124, -82.43571860013628 35.593029215307965, -82.43577560014694 35.59302121531218, -82.43600260019102 35.59297921532697, -82.43609760020932 35.592962215333316, -82.4360616001852 35.593080215353595, -82.43601460012943 35.593391215411955, -82.436012600124 35.59342421541847, -82.43599760006198 35.593810215495346, -82.43589059988636 35.594834215692536, -82.43588459987504 35.59490121570549, -82.43587259984979 35.59505221573494, -82.43587159983267 35.59516221575719, -82.43589559981469 35.59530421578852, -82.43592559980164 35.595421215815385, -82.43592759980092 35.595428215817066, -82.4359715997895 35.59554921584617, -82.43601859978152 35.5956512158717, -82.4360985997772 35.59576521590314, -82.43610259977713 35.595770215904544, -82.43618759977605 35.59586821593321, -82.43621759977678 35.59589621594196, -82.43629859977871 35.59597021596541, -82.43630959977914 35.59597921596832, -82.43634259978046 35.596006215977226, -82.4363695997815 35.596028215984454, -82.43641859978342 35.59606821599769, -82.4364545997857 35.59609221600619, -82.43648459978746 35.596113216013556, -82.43655259979151 35.5961602160301, -82.4365545997916 35.59616121603058, -82.43676959980841 35.59628321607751, -82.43684259981418 35.596324216093315, -82.43690959981937 35.596362216107956, -82.43700159982659 35.59641421612794, -82.43711259983576 35.5964742161516, -82.43718059984116 35.596512216166275, -82.43727959984899 35.596567216187694, -82.4372995998507 35.59657821619198, -82.43734359985439 35.59660121620115, -82.43758059987411 35.59672821625137, -82.43768159988237 35.596783216272925, -82.43784159989555 35.59686921630686, -82.43818959992426 35.597056216380686, -82.43832159993474 35.59713021640933, -82.43848159994755 35.597219216443825, -82.43855459995332 35.59726021645967, -82.43856959995429 35.5972692164631, -82.43874059996571 35.59737921650306, -82.4387665999671 35.59739821650958, -82.43883459997053 35.59744921652692, -82.438890599973 35.597493216541615, -82.43896959997663 35.59755421656219, -82.43905159997794 35.59763421658681, -82.43910359997864 35.597685216602606)))",6514,37,021,003002,370210030025,2197,2197,209,2146,1943,76,23,34,3,67,51,1770,131,1639,1743,1599,59,13,28,3,41,27,854,766,88
census_2010_blockgroups_view.fid--2dc29038_13ec899ba8f_-25d4,"MULTIPOLYGON (((-82.59282562630112 35.59233323131299, -82.5928296263081 35.592292231304995, -82.59283562631855 35.592231231293226, -82.59285162634195 35.59209623126736, -82.592883626378 35.59189623122997, -82.59290362639327 35.591819231216284, -82.59293262641414 35.59171423119787, -82.59295162642437 35.59166823119052, -82.59301862643507 35.59167123119797, -82.59336662647844 35.59176523125283, -82.5934216264853 35.59178023126152, -82.59357562650332 35.591829231287306, -82.59376162652407 35.591895231319896, -82.59384862653343 35.59192823133553, -82.59404162655416 35.59200223137041, -82.59420162657104 35.59206523139962, -82.59450762660174 35.59219623145775, -82.59456862660842 35.59221823146852, -82.59461562661386 35.59223423147662, -82.59472962662647 35.592275231496636, -82.59480862663585 35.5922992315096, -82.59490062664855 35.59231623152257, -82.59498162665969 35.592331231533876, -82.59503962666783 35.59234123154185, -82.595094626676 35.59234723154876, -82.59531062670779 35.592374231576414, -82.59543562672619 35.592389231592314, -82.59554962674297 35.59240323160689, -82.5956396267563 35.59241423161837, -82.59575162677287 35.5924272316325, -82.59606462681643 35.59248223167586, -82.59616562683016 35.59250223169024, -82.59634862685513 35.59253723171617, -82.59654762688203 35.59257723174481, -82.59664662689548 35.59259723175901, -82.59671762690587 35.592606231768116, -82.5968776269292 35.59262723178886, -82.59708662696515 35.5926192318086, -82.59723162699314 35.59259423181848, -82.59740262702587 35.59256623183032, -82.59774362709119 35.59250923185377, -82.59797562713426 35.592480231871605, -82.59820362717645 35.59245223188928, -82.59864962725575 35.59241823192817, -82.5988176272849 35.592410231943816, -82.59894762730531 35.59241823195883, -82.59914062733299 35.592447231984494, -82.59927062734869 35.592485232005544, -82.59944162736593 35.59255823203795, -82.59959362737273 35.59267823207802, -82.59962662737122 35.59272323209062, -82.59966862736943 35.59278023210646, -82.599735627362 35.592901232138054, -82.59989062733575 35.593239232222736, -82.59995362732532 35.59337523225691, -82.59999862731333 35.59350123228721, -82.60001162730552 35.59356623230176, -82.60002062729497 35.59364423231854, -82.60002662727076 35.59380823235262, -82.60002762726934 35.59381823235477, -82.60004562724924 35.593968232387155, -82.60007662723687 35.59408223241356, -82.60012162722856 35.594185232439145, -82.60017462722178 35.594286232465144, -82.60017662722169 35.594289232465954, -82.60024062721594 35.59439523249414, -82.60033462721269 35.59451823252881, -82.60042962721383 35.594613232557904, -82.60047262721443 35.59465623257113, -82.60068562721929 35.59485423263328, -82.60080462722216 35.594964232667934, -82.60088662722248 35.595051232694075, -82.60096062722275 35.59512923271753, -82.60103662722148 35.59521923274373, -82.60110262721892 35.59530723276839, -82.60111062721836 35.595319232771665, -82.60113462721625 35.5953592327822, -82.60117562721308 35.595424232799694, -82.60120462720894 35.59548223281451, -82.60122562720586 35.59552523282539, -82.6012396272038 35.59555323283256, -82.60132962718242 35.595789232889885, -82.60135762717617 35.59586023290717, -82.60150062713929 35.596254233002085, -82.60159362711049 35.59654223307031, -82.60159862710287 35.596597233082015, -82.6016056270942 35.59666123309575, -82.60160262708506 35.59671723310683, -82.60158462707405 35.59676923311558, -82.60151862704966 35.59685623312654, -82.60153362704831 35.59688123313317, -82.60157962704407 35.59695823315359, -82.60159562704276 35.59698423316053, -82.60170162701577 35.597274233230486, -82.60178262700106 35.59745723327601, -82.60190262698774 35.59767323333239, -82.60197562698345 35.59778023336169, -82.60251062696139 35.59850123356342, -82.6026626269568 35.59869523361852, -82.6027746269535 35.59883723365896, -82.60279562695314 35.59886223366618, -82.60289462695272 35.59897223369879, -82.60303862695498 35.599113233742266, -82.60306762695546 35.59914123375096, -82.60313362695746 35.59919923376958, -82.60336562696638 35.59939223383266, -82.60360862697465 35.59960023389998, -82.60415062699326 35.60006523405035, -82.60444862700363 35.60031923413266, -82.60457062700719 35.6004282341674, -82.60467962700808 35.600540234201375, -82.6047826270058 35.600666234237615, -82.60488662699845 35.60082623428093, -82.604929626994 35.60090123430057, -82.60524262696308 35.601440234442485, -82.60526862696052 35.60148523445437, -82.60534762695248 35.601622234490335, -82.60537462694997 35.60166823450247, -82.60546062694218 35.60181123454046, -82.60551862693863 35.60189723456393, -82.60559262693401 35.60200723459393, -82.60572762692985 35.60218023464302, -82.60586962692695 35.60235223469264, -82.60595562692782 35.60243923471916, -82.60603862692905 35.60252123474437, -82.60614262693029 35.60262523477625, -82.60623562693299 35.60270823480272, -82.60621862690655 35.60286123483215, -82.60622962687405 35.603084234878665, -82.60623562685586 35.60320923490477, -82.60626062678982 35.603665235000214, -82.60628062675801 35.6038932350487, -82.60629162672511 35.60411923509584, -82.60628762671153 35.60420323511265, -82.60627562669413 35.60430323513173, -82.60624962667488 35.60440023514881, -82.60621162665193 35.604508235166854, -82.60615062662038 35.60464723518894, -82.60612962661061 35.60468823519516, -82.60604162656887 35.604864235222, -82.60597962654387 35.60495923523491, -82.60590562651775 35.60504923524568, -82.60585062650043 35.60510223525078, -82.60573362646457 35.605209235260595, -82.60571562645954 35.60522223526136, -82.60563462643594 35.60528723526632, -82.60528162633784 35.605544235282416, -82.60527462633571 35.60555023528298, -82.60520162631447 35.60560923528746, -82.60514662629693 35.60566423529295, -82.60507762627309 35.60574423530225, -82.6050286262526 35.60582423531349, -82.60502462625092 35.60583123531453, -82.6049646262231 35.605947235331946, -82.60492562620243 35.60603923534668, -82.60479662612912 35.60637623540211, -82.6047816261201 35.606418235409066, -82.60474362609438 35.606544235430825, -82.60474062609038 35.606567235435215, -82.60472262606338 35.60672323546514, -82.60471962605327 35.60678523547744, -82.60471862604633 35.606829235486344, -82.60472462602424 35.60697923551751, -82.60474862599915 35.607168235558476, -82.604802625967 35.60743523561837, -82.60484662594118 35.60765023566671, -82.60494262588747 35.60810323576882, -82.60495362588138 35.60815423578033, -82.60506762582354 35.60865323589365, -82.60509362580247 35.60881823592999, -82.60510462578608 35.608936235955134, -82.60510562576194 35.609094235987385, -82.6050916257368 35.60924223601611, -82.60507862572113 35.60933023603274, -82.60502062567258 35.60958323607829, -82.60499162565371 35.60967423609385, -82.60497362564128 35.60973523610442, -82.60489062559301 35.60995923614154, -82.60482762555114 35.61016323617656, -82.6047776255199 35.610312236201835, -82.60476262551012 35.61035923620982, -82.60473562549518 35.61042723622088, -82.60459162542205 35.610746236271126, -82.6045776254146 35.610780236276604, -82.60452262538874 35.61088823629298, -82.6040126252198 35.611435236351966, -82.60377062511932 35.611826236406785, -82.60353562503715 35.6121062364397, -82.6033196249716 35.61229823645655, -82.60286062480662 35.612874236526764, -82.60271462475421 35.61305723654902, -82.60244962467641 35.61327623656642, -82.60235162464734 35.613359236573245, -82.60225162461978 35.613430236577464, -82.60177962448954 35.61376623659745, -82.60158462444187 35.613865236597555, -82.60126862437579 35.61395323658302, -82.60106662433884 35.61397523656678, -82.60091662430848 35.614010236558464, -82.60062262424889 35.61408023654254, -82.60037262418976 35.614194236540115, -82.59990962408035 35.61440423653532, -82.59883962380432 35.615042236555354, -82.59817362362836 35.615465236573115, -82.59791762355535 35.61566323658713, -82.59760162347908 35.615817236586054, -82.59745162344052 35.61590623658871, -82.59733962342966 35.61585523656687, -82.59709562340328 35.615763236523065, -82.59697162339094 35.61570923649935, -82.59688562338532 35.61565323647907, -82.59682262338339 35.615598236461395, -82.59678262338504 35.61554423644626, -82.59674262338952 35.61547223642754, -82.59669962339652 35.615380236404405, -82.5965386234328 35.61497023630434, -82.59646962345124 35.614776236257725, -82.59644462346405 35.61466623623273, -82.59643262347693 35.614570236212025, -82.59644262349379 35.61447123619283, -82.59646762351504 35.614360236172786, -82.59654262355478 35.6141832361444, -82.59665962360164 35.614005236120185, -82.59673462363378 35.613877236101885, -82.59680262366238 35.61376523608606, -82.59691862371574 35.61354423605288, -82.59700162375637 35.61337023602601, -82.59705462378871 35.61321723600027, -82.59706862381164 35.613083235974415, -82.59705762383355 35.61292923594194, -82.59704662384094 35.612869235928585, -82.59702162385818 35.612730235897786, -82.59696562388159 35.612518235848746, -82.5969226238972 35.612370235814254, -82.59690962390037 35.61233523580575, -82.5968626239133 35.61220123577365, -82.59682362392637 35.6120742357438, -82.59680662393878 35.61197523572186, -82.59680762395342 35.611881235702896, -82.59681662397051 35.61178023568316, -82.59682962399329 35.611646235657275, -82.59684062400339 35.61159223564734, -82.59685062401343 35.61153823563738, -82.59685262401486 35.61153123563614, -82.59688362403658 35.611423235617394, -82.59690962404672 35.61138523561229, -82.59694162405891 35.61134123560658, -82.5969956240797 35.61126423559651, -82.59706662410258 35.611192235589115, -82.59733162418547 35.61094023556504, -82.5976206242797 35.61064023553356, -82.59766362429681 35.61057523552479, -82.59768562430807 35.61052623551706, -82.59769162431722 35.61047323550684, -82.59768262432186 35.61043323549781, -82.5976616243248 35.610391235487086, -82.59763062432556 35.610353235476154, -82.59762362432501 35.61034923547462, -82.59757362432113 35.61032023546362, -82.59750762431348 35.6102992354525, -82.59742762430024 35.61029823544415, -82.5971216242465 35.61031723541657, -82.59693562421513 35.6103202353981, -82.59639762413232 35.61027723533408, -82.5962636241127 35.61026023531681, -82.5961456240969 35.61023523529965, -82.59605762408621 35.610209235285275, -82.5959766240785 35.61017223526941, -82.59586462407007 35.61010623524455, -82.5955306240517 35.60986523516111, -82.59540362404599 35.60976523512769, -82.59533662404559 35.609695235106564, -82.59529462404723 35.60963923509087, -82.59525962405203 35.609570235073235, -82.59502862410535 35.60897523492825, -82.59494862411759 35.608809234886266, -82.59489162412012 35.6087312348645, -82.59483562411728 35.60868923485019, -82.59472962411016 35.60862123482545, -82.59463562409746 35.608602234812025, -82.59455362408399 35.608601234803324, -82.59454962408326 35.60860123480297, -82.5944196240597 35.608614234792185, -82.59401562398313 35.608675234763176, -82.59372162393088 35.60869723473739, -82.59360762391209 35.60869623472556, -82.59348062389267 35.60868523471029, -82.59338562387958 35.608668234697014, -82.59325962386549 35.6086232346749, -82.59318162385888 35.60858223465853, -82.59308562385449 35.60850723463347, -82.59307662385432 35.608498234630645, -82.5930076238538 35.60842723460918, -82.59295162385511 35.608358234589296, -82.59279862386572 35.60812423452593, -82.59271962387264 35.60799423449135, -82.59269362387383 35.60795823448131, -82.59256462388014 35.60777823443144, -82.59255562388046 35.6077662344281, -82.59244962387919 35.60766023439563, -82.59230962387132 35.60756023436088, -82.59230662387112 35.60755823436013, -82.59199862384914 35.607369234290026, -82.5919406238459 35.607327234275495, -82.59182862384239 35.60722923424406, -82.5916836238426 35.60707123419701, -82.59155362384594 35.60690923415072, -82.59134362385124 35.606648234075955, -82.59112862385588 35.60638623400047, -82.5910676238559 35.60632023398076, -82.59099462385609 35.60624023395702, -82.59091962385409 35.60617223393547, -82.59084162385008 35.60611423391566, -82.59067662383822 35.60601323387816, -82.59057162382922 35.60595823385616, -82.59013462379062 35.60573723376626, -82.58997862377748 35.60565423373332, -82.58974062375736 35.60552823368322, -82.5896056237475 35.60544623365265, -82.58959162375587 35.605377233637114, -82.58958062377408 35.60524723360959, -82.58958062377664 35.60523023360611, -82.5895816237842 35.60518223359641, -82.58958862379812 35.605099233580226, -82.58959162380572 35.60505323357119, -82.58959362381187 35.60501523356366, -82.58967162389101 35.604585233484066, -82.58971162393053 35.604372233444806, -82.58972662394598 35.60428823342925, -82.58977462399257 35.60403723338307, -82.58977662399364 35.604032233382206, -82.5897956240087 35.60395523336851, -82.5898416240461 35.603762233333946, -82.58988162407027 35.60364823331484, -82.58993162409567 35.60353723329734, -82.58997462411588 35.60345223328452, -82.58999462412521 35.603413233278644, -82.59005062414808 35.603325233266425, -82.5900926241641 35.60326623325874, -82.59018262419825 35.60314223324274, -82.59025362422186 35.60306523323431, -82.59039162426974 35.60290323321547, -82.59045262429329 35.6028162332041, -82.59050362431522 35.60272823319135, -82.59053662433203 35.602655233179945, -82.59055862434735 35.602579233166686, -82.59056462437243 35.60242323313557, -82.59055662438256 35.602348233119436, -82.59053762439558 35.60224323309615, -82.59048762441905 35.602037233049046, -82.5904706244276 35.60196323303221, -82.59045562443438 35.60190323301851, -82.59042062445161 35.60175323298434, -82.59038462447394 35.60156923294312, -82.59037562448107 35.60151323293077, -82.59037362448288 35.601499232927715, -82.59036762448822 35.601458232918766, -82.59036562448993 35.60144523291593, -82.59034662451103 35.60128723288187, -82.59032762453394 35.60111823284544, -82.59029962457625 35.60081323278045, -82.59029962457686 35.60080923277962, -82.59029662458813 35.60073223276368, -82.59029462459976 35.60065523274781, -82.59029562461377 35.60056523272956, -82.59031562463599 35.600442232706534, -82.590342624654 35.60035423269143, -82.59034562465564 35.60034723269026, -82.59039762467842 35.600255232676865, -82.5904606247023 35.60016823266566, -82.59052562472509 35.600090232656456, -82.59086162483524 35.59973723261902, -82.59092762485925 35.59965223260857, -82.5909736248759 35.599594232601476, -82.59102662489789 35.599508232589386, -82.59106662491793 35.59942123257577, -82.59107662492488 35.59938723256986, -82.59109462493751 35.5993242325589, -82.59112662495868 35.59922123254122, -82.59113362496778 35.59917023253151, -82.59114062497521 35.59912923252386, -82.59114562498971 35.59904023250628, -82.59112762505245 35.59861323241753, -82.59113262507088 35.59849923239475, -82.59113362507354 35.598483232391665, -82.59115462510883 35.598276232351616, -82.59115662511181 35.59825923234838, -82.59116662512453 35.59818723233475, -82.59117462513308 35.59814023232598, -82.59120362516504 35.597964232293094, -82.5912516252084 35.59773423225123, -82.59128062523381 35.59760023222692, -82.59128662523868 35.5975752322224, -82.59131462526257 35.59745023219986, -82.59137262531175 35.59719323215347, -82.59140962534774 35.59699923211779, -82.59143962537581 35.596849232090285, -82.59144962538674 35.596789232079125, -82.59148262541949 35.59661223204644, -82.59149462543051 35.59655323203563, -82.59150362544061 35.59649723202521, -82.59153362547093 35.59633323199482, -82.59154362548098 35.59627823198472, -82.59156062550187 35.59616123196265, -82.59161562556467 35.59581223189715, -82.5916216255712 35.595776231890476, -82.59163962558634 35.59569723187623, -82.59165462559817 35.59563723186555, -82.59166362560435 35.59560623186018, -82.59169462561972 35.59554023184993, -82.59173562563693 35.59547223184038, -82.59176762565033 35.59542023183298, -82.59179662566234 35.59537323182637, -82.59183862567805 35.59531623181904, -82.5920396257521 35.595052231786, -82.59206262576195 35.59501323178041, -82.59212962578933 35.59490723176571, -82.59215162579878 35.59487023176039, -82.59220662582341 35.59476923174546, -82.59222362583093 35.5947392317411, -82.59229762586698 35.59458423171717, -82.59235362589962 35.59443323169215, -82.5923856259201 35.5943342316753, -82.59243462595119 35.59418523164991, -82.59247762598108 35.59403723162428, -82.59260862607087 35.59359523154772, -82.59265062609954 35.59345423152333, -82.59265262610077 35.59344823152226, -82.59269262613255 35.59328523149318, -82.59272762616126 35.59313623146644, -82.5927456261848 35.59300323144118, -82.59278862624097 35.59268423138062, -82.5928076262674 35.592533231351865, -82.5928086262702 35.59251623134852, -82.59281362627856 35.59246723133898, -82.59281562628135 35.592451231335964, -82.59282562630112 35.59233323131299)))",6042,37,021,001400,370210014004,1190,1190,287,1170,895,60,8,2,0,205,20,901,173,728,892,722,42,8,2,0,118,9,505,460,45
census_2010_blockgroups_view.fid--2dc29038_13ec899ba8f_-25d3,"MULTIPOLYGON (((-82.61157563523837 35.55446022552398, -82.61166163525245 35.55446122553301, -82.61192163529395 35.55447222556191, -82.61218163533502 35.55448622559143, -82.61224263534457 35.55449022559848, -82.61243963537532 35.55450222562114, -82.61248063538181 35.554505225625995, -82.61270563541608 35.554525225653144, -82.61311563547731 35.55457022570427, -82.61350263553396 35.554620225754164, -82.61377263557218 35.554663225790634, -82.61387263558598 35.55468122580454, -82.61401463560577 35.55470622582426, -82.61453963567719 35.55480922589903, -82.61516163575811 35.55495522599252, -82.61517263575952 35.55495822599425, -82.61604263587064 35.55517622612789, -82.61659963594158 35.55531622621349, -82.61827163615476 35.55573822647087, -82.61882963622583 35.55587922655686, -82.61927763628289 35.55599222662578, -82.61995063636857 35.556162226729455, -82.62062263645464 35.55632922683239, -82.62107163651204 35.556441226901185, -82.62158563657783 35.556569226979974, -82.62178763660435 35.556615227010056, -82.62222863666211 35.556716227075825, -82.62288063674991 35.556850227169996, -82.62343863682696 35.55695222724798, -82.62395663689851 35.55704722732044, -82.6246826369987 35.55718022742198, -82.62501863704522 35.55724122746882, -82.62602963718487 35.55742622761026, -82.62636663723134 35.55748822765743, -82.62684563729745 35.55757622772446, -82.62756163739651 35.55770622782434, -82.62979163770464 35.55811322813589, -82.6300726377435 35.55816422817506, -82.63110563788926 35.55833322831541, -82.6311536378962 35.55834022832179, -82.63161963796301 35.558409228383596, -82.63213763803859 35.55847822845076, -82.63235863807107 35.55850522847895, -82.63271463812369 35.55854822852422, -82.63292563815476 35.558574228551144, -82.63378463828337 35.55866722865817, -82.6341416383365 35.558707228702914, -82.63450763839124 35.558747228748594, -82.63560563855532 35.55886722888555, -82.63597163861006 35.55890722893123, -82.63582563857523 35.55897622893034, -82.63565163853349 35.559059228929435, -82.63538963847105 35.559182228927625, -82.63524463843636 35.5592512289268, -82.63470463830191 35.559542228930766, -82.63467163829361 35.559560228931005, -82.63391763810935 35.55994422893193, -82.63306263790135 35.56037322893172, -82.63251463776783 35.5606492289317, -82.63119463744663 35.56131222893141, -82.63102963740555 35.56140122893262, -82.63057463729209 35.561647228936025, -82.63040063724675 35.56175422893999, -82.63002263714849 35.5619852289483, -82.6297096370643 35.56219422895877, -82.62929563695465 35.56246022897055, -82.6285726367616 35.562934228992965, -82.62765063651271 35.563557229025314, -82.62729863641775 35.56379422903751, -82.62709563635707 35.56397022905254, -82.62694063630133 35.564165229076366, -82.62691863629234 35.56420022908126, -82.62677763623232 35.56443822911524, -82.6266766361705 35.564731229164586, -82.62654863606298 35.565292229265786, -82.62645263597139 35.56578522935634, -82.62640063592072 35.56605822940657, -82.62629663584386 35.566446229475005, -82.6262496358104 35.56661322950416, -82.62619663577867 35.56676222952905, -82.62616663576337 35.56682922953964, -82.62613663574753 35.56690022955104, -82.6258106356354 35.56727722959438, -82.62534763548828 35.56773422964, -82.6250306353908 35.568025229666766, -82.62465963528233 35.568330229690815, -82.6241976351389 35.568764229731855, -82.6238566350335 35.56908122976151, -82.62384163502908 35.56909322976239, -82.62341863489924 35.56948122979802, -82.62303263478363 35.56981622982672, -82.62290063474384 35.56993222983682, -82.62251063462557 35.57028022986763, -82.62250663462451 35.570282229867644, -82.62237363458478 35.570397229877415, -82.62226263454988 35.57050422988781, -82.62206963448887 35.57069222990638, -82.62192463444559 35.57081722991695, -82.62180963441082 35.57091922992595, -82.62121363424231 35.5713712299569, -82.62107763420371 35.571475229964044, -82.62057663406861 35.57181222998137, -82.62009463394118 35.57212022999465, -82.61947863378165 35.572492230007214, -82.61932063374257 35.572575230007914, -82.6187546336024 35.57287523001098, -82.61866263357857 35.57293123001297, -82.61861463360248 35.57272322996566, -82.618611633604 35.57271022996271, -82.61832263361086 35.57235322986032, -82.61827263362667 35.57219622982323, -82.61823463363928 35.572073229794235, -82.61822763365085 35.571990229776624, -82.61822163365964 35.571926229763, -82.61820663368653 35.57173522972253, -82.61820163369538 35.57167222970919, -82.618200633697 35.57166122970695, -82.61814663372012 35.57145222965877, -82.61815663373729 35.57135122963924, -82.61816663375215 35.571265229622725, -82.61805863380859 35.570781229513024, -82.61799863381957 35.57064422947902, -82.61785763382797 35.57043722942236, -82.61767463383924 35.570166229348445, -82.61723763382531 35.569784229225746, -82.61721063382456 35.569760229218076, -82.61682763379035 35.56956822913971, -82.61665163378474 35.569414229090334, -82.61657163379007 35.569293229057436, -82.61646363382285 35.56896322897917, -82.61646363385643 35.568744228934555, -82.61650963389285 35.56855722890122, -82.61644963390194 35.56843322886978, -82.61619863394047 35.56791122873768, -82.61608563395744 35.56767822867869, -82.61595163399096 35.56731522859102, -82.61588363402528 35.567018228523466, -82.61569463404874 35.566661228431386, -82.61557363407573 35.566354228356445, -82.61539863411507 35.56590922824788, -82.61529063412077 35.56575522820543, -82.6151356341194 35.56559622815715, -82.61497463410792 35.565497228120456, -82.614126634016 35.56517822796855, -82.6136086339449 35.56508022789546, -82.6128826338354 35.56500822780631, -82.61248563376506 35.56503622777129, -82.61150363361286 35.564965227656145, -82.61108363355609 35.56488022759575, -82.6106296334945 35.56479022753079, -82.61040763345514 35.564806227511326, -82.6096746333088 35.56496622746867, -82.60942763326483 35.564985227447245, -82.60938863325784 35.564988227443806, -82.6092736332374 35.56499722743389, -82.60925063323317 35.56499922743196, -82.60923563323107 35.56499722742996, -82.60918163322326 35.564989227422814, -82.60902163320037 35.56496522740153, -82.60896863319283 35.56495722739444, -82.60888063318025 35.56494422738278, -82.60866063315439 35.56487422734599, -82.60855163314147 35.56484022732784, -82.60814063306817 35.56487322729239, -82.60775763299343 35.56494522726777, -82.60772163298417 35.56496622726839, -82.60744863291336 35.565132227274184, -82.60734063287688 35.56525322728773, -82.60727463284084 35.565416227314095, -82.60715463280057 35.56554822732872, -82.6069726327518 35.56566922733468, -82.60676063270428 35.565749227329206, -82.60608863257464 35.56586622728417, -82.60582963252081 35.565936227271784, -82.60556263244798 35.56612222728234, -82.60530763236802 35.56636622730586, -82.6051876323306 35.5664802273167, -82.6049006322406 35.56675522734332, -82.60444963211917 35.56705822735876, -82.60408163203 35.56724022735806, -82.6039246319946 35.567301227354434, -82.60385763197952 35.56732722735279, -82.60339163187714 35.56748922733803, -82.60311363182409 35.56753422731869, -82.6028806317877 35.5675192272917, -82.60274763177506 35.56745722726541, -82.60265363177318 35.56736822723762, -82.60261463177397 35.56732022722389, -82.6025446317962 35.56710022717189, -82.60244263183213 35.56675622709134, -82.60226463190105 35.56611522694254, -82.60204963193057 35.56569022683392, -82.60188463196073 35.565316226740855, -82.60172563200355 35.56486522663274, -82.60162663201162 35.5647062265902, -82.60126063200958 35.56432322647462, -82.60114263201773 35.56414322642595, -82.6008516320615 35.563543226273794, -82.60071263206207 35.56338922622819, -82.6005026320474 35.5632572261798, -82.60019063201196 35.563151226126216, -82.59988463196358 35.563135226091596, -82.5998656319601 35.56313722608997, -82.5995486318997 35.56318722606767, -82.59895563176855 35.563400226050184, -82.59875663173004 35.563435226036916, -82.59855563169494 35.56344622601854, -82.59831363165785 35.56342622598974, -82.59782463160303 35.56325422590444, -82.5977506315948 35.56322822589154, -82.5973646315625 35.5630212258098, -82.59728763156447 35.56292522578239, -82.59727163156471 35.56290622577684, -82.59726463156471 35.56289822577453, -82.59720863155815 35.56288022576515, -82.59720863156544 35.562833225755554, -82.59712763157259 35.56269922571994, -82.59709463157583 35.562642225704984, -82.59703363159156 35.562474225664495, -82.59701063161586 35.56229122562486, -82.59701063164331 35.56211222558841, -82.5970256316593 35.56202422557207, -82.59703563167004 35.56196522556105, -82.59705463168734 35.56187322554428, -82.59707163170155 35.561799225530976, -82.59717863176803 35.561482225477384, -82.59728563181164 35.5613142254542, -82.59737663184659 35.561185225437235, -82.59748363192654 35.56078022536577, -82.59755963199477 35.56041822529974, -82.59756763206711 35.559956225206555, -82.5975146320852 35.55978122516549, -82.59746863209622 35.55965922513592, -82.59729263211736 35.559331225051054, -82.59705663212502 35.55902622496474, -82.59688063212636 35.55882722490614, -82.59662163213193 35.558511224815234, -82.5965456321334 35.55841922478869, -82.59631663213288 35.55817522471553, -82.59619463213555 35.558026224672645, -82.59611863213439 35.557951224649564, -82.5961486321414 35.55793822465, -82.59601163214187 35.557787224605256, -82.5962376321915 35.55770822461235, -82.59636063221872 35.557664224616005, -82.59645463223892 35.55763422461959, -82.59670863229296 35.55755722462997, -82.5967496323016 35.5575452246317, -82.59694863234289 35.55749122464108, -82.59719663239376 35.55742822465374, -82.59793463254441 35.5572462246924, -82.59833063262491 35.557150224713375, -82.59844163264755 35.55712222471912, -82.59877463271535 35.55704122473681, -82.59888663273816 35.557014224742744, -82.59894963275102 35.55699822474596, -82.59914063278994 35.55695122475598, -82.59920463280292 35.55693622475948, -82.59932163282677 35.55690722476562, -82.59952863286897 35.55685622477639, -82.59955863287509 35.5568492247781, -82.59960063288375 35.55683822478014, -82.60064863309684 35.55658422483593, -82.60079263312625 35.55654822484342, -82.60104363317747 35.556486224856435, -82.60118963320726 35.55645022486411, -82.601536633278 35.5563652248824, -82.60206063338455 35.55623822491031, -82.60257763348989 35.556111224937474, -82.60292463356066 35.55602622495567, -82.603318633641 35.55592922497642, -82.60370263371873 35.55583822499728, -82.60545863407673 35.55540622508931, -82.60667263432379 35.55511122515375, -82.60673063433558 35.555097225156864, -82.60678063434575 35.55508522515954, -82.60688863436756 35.5550592251653, -82.60735463446278 35.554944225189644, -82.60760863451446 35.55488222520314, -82.60811463461575 35.55477022523221, -82.60863663471717 35.55467422526624, -82.60876663474205 35.55465322527525, -82.60913263481144 35.55459722530137, -82.60924263483169 35.554584225309995, -82.60963163490324 35.55453922534074, -82.60969363491448 35.55453322534591, -82.61021563500793 35.55448922539045, -82.61074163509917 35.55446422543928, -82.61080563511007 35.55446222544545, -82.61100363514358 35.5544582254649, -82.61119863517611 35.55445722548471, -82.61126763518763 35.55445722549184, -82.61141363521173 35.55445822550698, -82.61144163521642 35.554458225509805, -82.61154463523316 35.55446022552083, -82.61157563523837 35.55446022552398)))",6410,37,021,001200,370210012005,862,862,195,833,625,100,5,5,0,98,29,622,113,509,605,484,55,4,4,0,58,17,368,326,42
census_2010_blockgroups_view.fid--2dc29038_13ec899ba8f_-25d2,"MULTIPOLYGON (((-82.43240660016352 35.589296214208474, -82.43244760022908 35.58891521413523, -82.43245260023676 35.588871214126854, -82.43245960026343 35.588705214093814, -82.4324486002717 35.5886402140795, -82.43242160027748 35.58857321406308, -82.43237460027882 35.58851421404623, -82.43227160027214 35.58844721402205, -82.43173260022407 35.58818021391237, -82.43151260020427 35.58807221386775, -82.43139060019367 35.588010213842594, -82.43136860019192 35.58799821383791, -82.4313286001883 35.58797821382976, -82.43130460018656 35.587964213824456, -82.43128360018493 35.58795221381985, -82.4312356001802 35.58793121381056, -82.43118960017625 35.58790721380095, -82.43080060014461 35.58769521371791, -82.43072460014037 35.58764121369908, -82.43067760013783 35.58760721368739, -82.4305946001402 35.587502213657515, -82.43053460014755 35.5873902136285, -82.43028860022075 35.58665121345302, -82.43018360025005 35.58634821338067, -82.43000560029294 35.585879213267056, -82.42989660031958 35.58558921319686, -82.42985660032902 35.585485213171616, -82.42983160034173 35.58537621314691, -82.42982360035668 35.585270213124616, -82.42981060040005 35.58497521306325, -82.42980860040171 35.584962213060386, -82.42978260044538 35.58465121299449, -82.42974360049938 35.58425921291085, -82.42973460051074 35.58417521289282, -82.42973260052757 35.58406421287005, -82.42973460053148 35.5840412128656, -82.4297446005433 35.58397521285323, -82.42977660056275 35.58388321283786, -82.4298446005935 35.58375721281928, -82.42986460060234 35.58372121281398, -82.42992660062875 35.583616212798965, -82.42994760063766 35.58358121279401, -82.42997960065141 35.58352621278619, -82.42998960065556 35.583510212783956, -82.4300576006895 35.5833622127608, -82.43006060069158 35.583352212759216, -82.43008160070433 35.583292212749086, -82.43010260071756 35.583229212738416, -82.4301196007331 35.583146212723385, -82.4301386007497 35.5830592127076, -82.43018860081331 35.582700212639786, -82.43020960083963 35.58255221261188, -82.43026060091434 35.58212221252977, -82.43036360106454 35.58125821236473, -82.43037660109336 35.58108521233088, -82.4303766011131 35.58095721230492, -82.4303506011279 35.58083321227705, -82.43034860112972 35.58081921227396, -82.43031260113922 35.580719212249925, -82.43027660114633 35.58063421222899, -82.43020460115596 35.5804942121931, -82.43016060115534 35.58045121217985, -82.43016860116283 35.58041121217252, -82.43022060118558 35.58031921215914, -82.43024960119803 35.580270212152236, -82.43039660126925 35.57996521210537, -82.43040760127758 35.57992321209795, -82.43043260129478 35.57983821208324, -82.43044260130529 35.579781212072696, -82.43045360131747 35.57971321206001, -82.4304586013554 35.57947321201176, -82.43045260140376 35.57915321194613, -82.43046060142949 35.57899421191461, -82.43048260149376 35.57860121183702, -82.43053460151764 35.57850221182221, -82.43060460154236 35.578417211812194, -82.43075860158548 35.578302211804655, -82.4315566017996 35.57777021177857, -82.4316206018199 35.57770721177236, -82.43166760184343 35.57760521175646, -82.43168860186086 35.57751421174018, -82.43169160187834 35.5774042117181, -82.43166260188681 35.57731821169764, -82.43161260188974 35.5772452116777, -82.43160360188952 35.57723721167517, -82.43156460188897 35.577199211663384, -82.43148860188437 35.57714721164498, -82.43135760187019 35.57709821162159, -82.43119160184932 35.57705521159576, -82.43105660183322 35.57701521157371, -82.43099460182628 35.57699321156293, -82.4309296018209 35.57695821154907, -82.4308936018201 35.57692521153861, -82.43085260181894 35.57688821152695, -82.43084760181894 35.576883211525406, -82.43080960182019 35.57683421151154, -82.4307756018245 35.576769211494835, -82.43076760182632 35.57674921148992, -82.43074860183083 35.576699211477795, -82.43071860185225 35.57652821144001, -82.4307176018669 35.576432211420375, -82.43074360192581 35.5760782113511, -82.43075460194909 35.57593821132379, -82.43078060199828 35.57564721126729, -82.43079060203955 35.575390211216096, -82.4307876020807 35.57512021116097, -82.43077960211154 35.57491121111767, -82.43072960214424 35.57464521105849, -82.43068760215623 35.5745222110291, -82.430578602182 35.57423821096022, -82.43054360219031 35.574146210937975, -82.43049460220979 35.573967210896484, -82.43047660223209 35.57380321086132, -82.43048460226028 35.57362921082676, -82.4304936022731 35.57355521081268, -82.43050360228665 35.573478210798044, -82.43053060231315 35.57333521077174, -82.43054460232673 35.57326221075831, -82.43058560237432 35.5729972107087, -82.43060060240101 35.572840210678365, -82.43060860241361 35.57276721066438, -82.43062360244934 35.57255121062199, -82.43062960248113 35.572351210581985, -82.43061560251682 35.57210421053038, -82.43061560257539 35.571724210453134, -82.4306366026031 35.57156721042335, -82.43066860264487 35.57133021037847, -82.43068160267052 35.57117821034896, -82.4306796026752 35.571145210342, -82.4306756026827 35.57109221033084, -82.43067160268451 35.57107621032715, -82.43063160270918 35.570873210281796, -82.43062660271218 35.57084821027623, -82.43062360271836 35.57080521026718, -82.43062060272676 35.57074721025504, -82.43063560274946 35.57061621023005, -82.43065060276534 35.570529210213905, -82.43069260280899 35.57029121016979, -82.43074160286898 35.56995421010643, -82.4307516028894 35.56983221008264, -82.43074960290568 35.569724210060436, -82.43074660290813 35.56970521005628, -82.43072960292352 35.569587210030505, -82.43067960293834 35.56943720999499, -82.43064460294846 35.56933420997035, -82.4306426029493 35.5693262099686, -82.43060860296173 35.56920920994134, -82.4305986029898 35.56901620990108, -82.430598602991 35.56900820989938, -82.43056560299999 35.56891420987693, -82.43063160301917 35.568861209872956, -82.43072560305157 35.56875120986029, -82.43080660308968 35.56859120983604, -82.43084660312846 35.56838220979771, -82.43091460316164 35.56824020977581, -82.43101460319512 35.568130209763765, -82.43184060341777 35.567572209735296, -82.43190260343435 35.56753120973335, -82.43213160349086 35.56741020973228, -82.43240760355351 35.56730020973833, -82.43297260369522 35.56698720973286, -82.43342960382678 35.56662420970608, -82.4335306038604 35.566514209694034, -82.43363760390694 35.56632720966704, -82.43381360396657 35.56612920964492, -82.4340016040197 35.565986209635184, -82.43425660408464 35.56583820963138, -82.43457260417594 35.56558520961243, -82.43488260427448 35.56527820958192, -82.43530560442316 35.564767209521506, -82.43542660447376 35.56456920949376, -82.43569660456589 35.56426120945888, -82.43585760461619 35.564107209444174, -82.43613360468896 35.563931209436745, -82.4361776047023 35.56389220943338, -82.43624060472102 35.5638382094289, -82.4363216047598 35.563673209403674, -82.43637560479591 35.56349720937348, -82.4367316049141 35.56311220933182, -82.43696060503312 35.56258520924821, -82.43719560511697 35.562293209213024, -82.43715060521814 35.56158820906513, -82.43701860552149 35.55947520862222, -82.43697460562264 35.55877120847458, -82.43703960563496 35.55876120847922, -82.4371096056479 35.558752208484584, -82.43723060566269 35.558786208503896, -82.43729460567052 35.55880420851415, -82.4388056058549 35.55923120875627, -82.44237460629027 35.560240209328164, -82.44337760645935 35.5602202094272, -82.44405460657329 35.56020820949438, -82.44493460674356 35.560048209552356, -82.446016607005 35.55951320955475, -82.44739860733857 35.55883220955844, -82.4487426077434 35.557648209455934, -82.44900860780496 35.557534209460066, -82.449684607961 35.557247209471214, -82.44971860796893 35.557232209471685, -82.45013260805841 35.55709620948661, -82.45053560814559 35.556963209500935, -82.45174660840742 35.5565642095443, -82.45215060849468 35.55643220955899, -82.45269460857499 35.55649520962766, -82.4533986086744 35.55660720972288, -82.45389160873702 35.55673020979848, -82.45397460874753 35.55675120981131, -82.4547106088251 35.55703920994549, -82.45541460888255 35.557423210095884, -82.45600660889191 35.55799921027388, -82.45634260888845 35.55838321038639, -82.45685460890175 35.55884721053333, -82.45739860896484 35.559023210625, -82.45791060903967 35.5590872106906, -82.45842160911236 35.559165210758984, -82.4585346091283 35.559183210774265, -82.46008660929661 35.559759211050896, -82.460758609366 35.56003121117524, -82.46111060940217 35.56017521124067, -82.46192660950518 35.56038321136681, -82.46206360952026 35.56043321139104, -82.46283860960459 35.56071921152884, -82.46338260963553 35.561103211662754, -82.46408660965362 35.561743211865306, -82.46504660970922 35.56241521210056, -82.46594260977386 35.56295921230318, -82.4664546097847 35.563439212453396, -82.46695060978068 35.56399921261822, -82.46702960977103 35.564147212656536, -82.46730360973817 35.564655212787834, -82.46842360976606 35.56567921311115, -82.46967160992843 35.565967213297995, -82.46994560996502 35.5660242133377, -82.47210361025243 35.566479213652045, -82.47267961031831 35.56667121375026, -82.47327161035724 35.56705521388921, -82.47424761046975 35.56737521405454, -82.47438461048915 35.567396214072915, -82.47525561061205 35.56753521419061, -82.47589361068177 35.56776921430381, -82.4753046103619 35.56921321453689, -82.47353960940231 35.57354621523653, -82.47295160908241 35.57499121546988, -82.47419160929167 35.57496621559223, -82.47788560991494 35.574893215957054, -82.47791160991939 35.574892215959544, -82.4789066100871 35.574873216058, -82.47915261012696 35.57487921608457, -82.47913361011662 35.57492621609208, -82.47909761009605 35.57502121610774, -82.4790866100865 35.57507121611674, -82.47907661007699 35.5751222161261, -82.47906361006498 35.57518621613772, -82.47905061005237 35.57525421615023, -82.47904961005159 35.57525821615096, -82.47902761002885 35.57538221617388, -82.4790066099888 35.575619216219955, -82.47900560998701 35.575630216222095, -82.47900360998007 35.57567321623065, -82.47899660995746 35.57581221625814, -82.47899160994432 35.57589221627391, -82.47898160991328 35.57608321631168, -82.47897760990497 35.57613221632128, -82.47897760990261 35.57614821632452, -82.47897360989197 35.576213216337294, -82.47896960988075 35.576281216350786, -82.47896960987912 35.576292216353, -82.47895760984733 35.57648521639103, -82.47895460983636 35.576553216404534, -82.47893860978834 35.57684821646286, -82.47891860975666 35.5770322164982, -82.4788886097254 35.57720321652997, -82.4788416096893 35.57738721656247, -82.47878860965847 35.5775302165861, -82.4786826096044 35.57776721662342, -82.47853760954244 35.578013216658555, -82.47840560949194 35.57819921668276, -82.47825960943936 35.578383216705255, -82.47822560942696 35.57842721671064, -82.47663160886144 35.58038421694477, -82.4764676088019 35.580594216970546, -82.47633760875176 35.58078021699503, -82.47623160870798 35.58095021701873, -82.47614360866696 35.58112221704464, -82.4760826086308 35.58129121707278, -82.47603660859701 35.581461217102614, -82.47601160856897 35.58161621713149, -82.47599860854245 35.5817742171623, -82.47599860851516 35.581951217198316, -82.47600960849316 35.582106217230994, -82.47603760847436 35.582258217264716, -82.4760706084581 35.58239921729682, -82.47611160844471 35.58253021732772, -82.47616860843166 35.582676217363236, -82.47623660842001 35.582825217400554, -82.47631760841124 35.582969217438105, -82.47639660840628 35.58308621747009, -82.47650760840226 35.583232217511146, -82.4766266084007 35.5833702175514, -82.47670660840177 35.58344921757572, -82.47673360840227 35.58347521758375, -82.4771546084127 35.58386021770532, -82.4778396084336 35.58446121789795, -82.47807960844133 35.58466921796497, -82.47820660844539 35.58477921800034, -82.4784736084536 35.585013218075424, -82.47852060845436 35.585059218089576, -82.47869260845722 35.58522521814101, -82.47884860845795 35.58538821819023, -82.47896660845576 35.585529218231024, -82.47907360845062 35.58567821827234, -82.47919260844169 35.58586421832234, -82.47928860842838 35.58605321837066, -82.4792906084281 35.586057218371714, -82.47937860841238 35.58625421842082, -82.47943960839277 35.5864472184663, -82.47938460838321 35.586450218461295, -82.4793076083707 35.5864482184529, -82.47919360835218 35.586446218440784, -82.47891160830571 35.5864442184114, -82.47877960828386 35.586444218397794, -82.47818360818366 35.586453218338384, -82.47814760817771 35.58645321833468, -82.47806560816365 35.586456218326866, -82.47732860803832 35.586477218255446, -82.47695760797686 35.58647721821728, -82.47676160794596 35.586467218195075, -82.47655260791386 35.586450218170135, -82.47625760787032 35.58641521813265, -82.47624560786853 35.5864142181312, -82.47603660783903 35.58638121810306, -82.47582660781019 35.58634221807348, -82.47563860778597 35.586297218045054, -82.4755206077709 35.58626821802706, -82.47550560776885 35.58626521802484, -82.4751706077283 35.58616821797068, -82.47514260772493 35.58616021796617, -82.47505560771512 35.586130217951094, -82.47494460770258 35.586092217932006, -82.47490360769854 35.58607421792412, -82.47480260768846 35.586031217904974, -82.47461060766881 35.58595221786919, -82.47445860765424 35.58588321783954, -82.47438860764747 35.58585221782599, -82.47431360764088 35.58581421781061, -82.47421260763215 35.585762217789615, -82.47390960760549 35.585609217727345, -82.47380860759667 35.585558217706634, -82.47361760757998 35.58546121766731, -82.47306960753185 35.58518421755458, -82.4730446075295 35.585172217549584, -82.47285160751144 35.58508221751146, -82.47275360750228 35.585036217492, -82.47264960749261 35.58498721747136, -82.47245860747347 35.58490621743525, -82.47236060746366 35.58486421741667, -82.47234560746227 35.58485721741364, -82.47230160745772 35.58483921740551, -82.47228760745635 35.5848332174028, -82.47221060744867 35.58480021738815, -82.47199660742625 35.58471521734888, -82.47195360742174 35.584698217341085, -82.47166660739059 35.58459221728992, -82.47110760732664 35.58440621719471, -82.47108660732422 35.58439921719113, -82.47080760729044 35.584318217145906, -82.47072060727996 35.584293217131915, -82.4704646072489 35.58421921709052, -82.47046160724851 35.584218217090076, -82.47037460723726 35.584198217077045, -82.47034160723294 35.58419021707204, -82.4702456072208 35.584166217057216, -82.47021360721654 35.584159217052544, -82.46984660716952 35.58407021699673, -82.46946260711805 35.583991216941165, -82.46922560708619 35.583943216907, -82.46895360704846 35.58389521686927, -82.46860160699859 35.58384021682197, -82.46815560693413 35.583779216763695, -82.4678246068847 35.58374421672254, -82.4671886067862 35.58370021664819, -82.46717660678429 35.58369921664677, -82.46688960673794 35.58369121661561, -82.46654260668095 35.583688216579375, -82.46640860665842 35.583690216565984, -82.46627860663679 35.58369121655281, -82.4661516066154 35.583693216540155, -82.4658906065707 35.58370321651536, -82.46576160654855 35.58370821650313, -82.46537860648155 35.58373121646843, -82.46532160647145 35.583735216463324, -82.46537760646113 35.583862216494936, -82.46541960645393 35.583954216517924, -82.4655496064304 35.5842462165907, -82.46561260641909 35.58438821662604, -82.46566360640179 35.584555216665244, -82.4657096063858 35.58470821670105, -82.46574660633578 35.585072216778826, -82.46575360632066 35.585178216801154, -82.46577860627553 35.58549821686884, -82.46581760620384 35.58600521697588, -82.46586160611002 35.586661217113765, -82.46607060602881 35.58741321728815, -82.46616360593923 35.58809421743626, -82.46626960586049 35.58871921757415, -82.46627960585305 35.588778217587205, -82.46639260577854 35.58938321772185, -82.46649360574574 35.589704217797454, -82.46655460570877 35.59001021786604, -82.46651260564677 35.59036721793419, -82.46642360560365 35.59055121796249, -82.46626560555497 35.59069721797588, -82.46586860545575 35.59091421797924, -82.46558760537744 35.591120217992206, -82.46539760531928 35.59129321800786, -82.46531660527785 35.59147521803654, -82.46532960523544 35.59176421809663, -82.465411605216 35.59197821814857, -82.4655236052017 35.592191218203375, -82.46570660521064 35.59233021825053, -82.4659716052407 35.59242021829605, -82.4662996052625 35.592631218372645, -82.46652660528281 35.59274321841875, -82.4676906054094 35.59317321862596, -82.46822460546323 35.59339821872657, -82.46844260547945 35.59352721877527, -82.46857760547917 35.59367421881897, -82.4686686054668 35.593852218864576, -82.46875160544614 35.59407521891845, -82.46889460541709 35.59441721900267, -82.4690546053665 35.59491721912083, -82.46916660531373 35.59538021922652, -82.46921560527792 35.59566521928942, -82.46923660525657 35.595826219324366, -82.46925660523745 35.59597221935603, -82.46925960519255 35.596266219416115, -82.46923860516627 35.59641421944413, -82.46911560512292 35.596563219461764, -82.4689376050729 35.59669621947049, -82.46867460501299 35.59680221946505, -82.46839060496131 35.5968322194419, -82.46806560491412 35.59678921939971, -82.46745660485107 35.5965432192871, -82.4667946047804 35.596290219167535, -82.46666960476712 35.59624221914489, -82.46645260474766 35.59613521910084, -82.46617260472259 35.59599721904399, -82.4655176046888 35.59551221887805, -82.46521660467327 35.59528921880168, -82.46505960466536 35.59517221876175, -82.46486060464741 35.59507421872139, -82.46462960461592 35.595030218688734, -82.46425860455251 35.59504321865317, -82.46376260445862 35.595119218617576, -82.4629996043064 35.595286218573094, -82.4625456042197 35.595361218541655, -82.46214260413937 35.59544921851807, -82.46167760405334 35.59550721848201, -82.46157060403347 35.59552121847385, -82.46129860397143 35.59563121846829, -82.46113260392394 35.5957612184776, -82.46101960388543 35.595889218491976, -82.46097660386482 35.59597721850549, -82.46094160384776 35.596050218516794, -82.46086560380381 35.59625321855019, -82.46088460377088 35.59648721859971, -82.46098760375108 35.596726218658894, -82.46112260374314 35.596923218712845, -82.46130060374041 35.597132218773645, -82.46145560374781 35.59725021881362, -82.4617986037611 35.59753321890644, -82.46223060379063 35.59780521900613, -82.46255360382087 35.59795621907009, -82.4630496038748 35.5981392191583, -82.46344860391 35.598340219240264, -82.4637656039238 35.598591219323836, -82.46398960392247 35.59884021939753, -82.46409360390048 35.59909521946009, -82.46415160387687 35.59931021950975, -82.46418160384141 35.59957221956609, -82.46423660378767 35.59998021965475, -82.4643216037626 35.60023421971515, -82.46444760376187 35.60037421975652, -82.464755603786 35.600548219823594, -82.46490760379552 35.60065021985998, -82.4651046037896 35.600900219931, -82.46519260379381 35.60096721995373, -82.46546160383366 35.60099821998767, -82.46561560385472 35.60102722000949, -82.46576460386997 35.60108822003721, -82.46651860393968 35.60144622018752, -82.46678160396847 35.6015422202341, -82.467206604018 35.6016772203053, -82.46749560405637 35.60173922034767, -82.46772460408273 35.601814220386345, -82.46790160409866 35.601901220422306, -82.4679386040988 35.60194022043407, -82.46804060409886 35.60204922046671, -82.4681556040882 35.60224222051776, -82.46828060406584 35.60252122058734, -82.46832960404154 35.60273122063512, -82.46835960400983 35.60296922068655, -82.4684086039854 35.603180220734565, -82.46842160396588 35.60332122076452, -82.46838560392119 35.60357222081187, -82.46840460389502 35.60376222085243, -82.46850460386752 35.604048220920866, -82.4685206037939 35.60454222102298, -82.46858160376381 35.60480322108234, -82.46890160377934 35.605046221164685, -82.46913460380733 35.605115221202624, -82.46926860382334 35.60515522122456, -82.46965660388042 35.605202221274006, -82.46996460392835 35.605222221309795, -82.47039660400183 35.60521022135179, -82.47080760407025 35.60520822139369, -82.47085860407711 35.60521822140096, -82.47103860410141 35.605254221426804, -82.4712536041293 35.605304221459015, -82.4714126041396 35.6054082214966, -82.47152760414247 35.605513221529776, -82.47161760411927 35.60576022158923, -82.47162160406259 35.606132221665284, -82.47160560403339 35.6063042216986, -82.47152860398131 35.606559221742515, -82.47141960394461 35.60668022175598, -82.4712726039044 35.606783221761816, -82.47101160385195 35.60684222174693, -82.47070360380036 35.606846221716026, -82.4703476037443 35.60682722167559, -82.47012660370397 35.606851221657706, -82.46989160364807 35.6069612216559, -82.46978060362267 35.60700622165362, -82.46953860357982 35.607024221632436, -82.46928160353983 35.60700722160248, -82.46909160351659 35.606954221572174, -82.46864160346988 35.60677322148907, -82.46841760344235 35.60671122145346, -82.46832660342866 35.60670222144219, -82.46817860340622 35.60668822142416, -82.46790460335605 35.60671922140228, -82.4675746032883 35.606804221385595, -82.466958603153 35.607019221365974, -82.46665660308807 35.607116221354566, -82.46668660308222 35.607186221371926, -82.46669160307997 35.60720622137651, -82.46676760304933 35.607486221441256, -82.46679360303919 35.607580221463074, -82.46659060299801 35.60762922145217, -82.46591960286442 35.60777422141261, -82.46565760281204 35.60783222139742, -82.46545260277193 35.60787222138448, -82.46522360272881 35.60790522136762, -82.46497260268448 35.607923221345494, -82.46481860265914 35.60792222132938, -82.46455160261746 35.60790522129853, -82.46438060259305 35.60788022127579, -82.46394560253236 35.60780622121601, -82.46382260251396 35.6077932212007, -82.46368260249173 35.607787221185085, -82.46355060246921 35.60779122117234, -82.4632586024167 35.60781822114776, -82.4629486023607 35.607848221122, -82.46236860225486 35.60791122107516, -82.46227060223633 35.607926221068105, -82.46224560223153 35.607930221066354, -82.46209360220175 35.60796022105679, -82.46188060215837 35.60801222104546, -82.46183860214977 35.60802322104339, -82.46176160213346 35.60804622104013, -82.46130360203706 35.608179221020016, -82.46126460202915 35.60818822101785, -82.46107160199001 35.60823522100753, -82.46098660197383 35.60824822100145, -82.46087160195351 35.60825622099124, -82.46076360193588 35.60825522097998, -82.46064260191737 35.60824522096541, -82.460505601898 35.6082232209469, -82.46031960187436 35.60817722091841, -82.46013960185225 35.60812722088973, -82.45996860183021 35.608086220863775, -82.45978360180494 35.608051220837645, -82.45974560179941 35.60804622083268, -82.45956660177326 35.6080232208096, -82.45947460175874 35.60801922079938, -82.4593306017328 35.60803222078715, -82.45923260171412 35.6080482207803, -82.4591876017056 35.60805522077716, -82.4591686017018 35.608059220775985, -82.45905460167856 35.60808722076993, -82.45901060166949 35.608099220767855, -82.45873660161263 35.608173220754736, -82.45821260150049 35.608337220734136, -82.45820460149879 35.608340220733886, -82.45796360144553 35.608426220726635, -82.45781060141093 35.608486220723144, -82.45766460137452 35.608565220724124, -82.45743960131462 35.60871222073083, -82.45731760128497 35.60877322073071, -82.45716560125041 35.60883422072747, -82.45695860120473 35.608908220721176, -82.45655660111834 35.609036220705846, -82.45627160105596 35.60913422069643, -82.45604060100538 35.60921422068894, -82.45590260097464 35.60926522068507, -82.45587460096833 35.60927622068447, -82.45575360093964 35.60933222068346, -82.45561560090546 35.609405220684096, -82.45543560085859 35.609516220688135, -82.4551816007913 35.609679220695085, -82.45511660077416 35.60972022069674, -82.45496960073763 35.60979922069765, -82.45480760069938 35.60987322069604, -82.45475060068628 35.60989722069514, -82.45440160060537 35.61004722068968, -82.4541716005507 35.61015422068779, -82.45403760051693 35.61022922068917, -82.45390460048125 35.61031722069342, -82.45375160043795 35.610434220701464, -82.45357860038507 35.61059122071559, -82.4535236003679 35.610643220720476, -82.45317360025852 35.61097622075215, -82.45301460020887 35.61112722076652, -82.4529116001748 35.611237220778285, -82.45285160015304 35.61131422078776, -82.45282260014044 35.61136422079491, -82.4527856001211 35.61145022080863, -82.45276260010523 35.61152822082209, -82.45273960007441 35.61170322085533, -82.45268759995143 35.61244422100061, -82.4526695999317 35.61255322102091, -82.45264159990944 35.61266722104118, -82.45259359988329 35.61278522106031, -82.45254959986657 35.6128462210681, -82.45234159980079 35.613049221087984, -82.45219759975745 35.61317522109878, -82.45206959972117 35.61327322110561, -82.45197959969765 35.61332822110749, -82.45195659969167 35.613343221108146, -82.45182959966161 35.61340122110684, -82.45170159963612 35.61342922109937, -82.45154659960842 35.613442221086046, -82.45138259958094 35.61344422106966, -82.45130059956611 35.61345222106276, -82.45124659956431 35.61340622104792, -82.45120159956114 35.613378221037514, -82.4510225995481 35.61327022099718, -82.45087859953537 35.61319822096773, -82.45076859952569 35.613143220945204, -82.45049359949553 35.613043220896564, -82.45022559946102 35.61297922085601, -82.44997359942532 35.61294022082215, -82.44977859939512 35.61292622079925, -82.44954359935764 35.61291722077325, -82.44896159926212 35.61291122071216, -82.44857259919812 35.61290822067147, -82.44825659914564 35.61290922063911, -82.44770359905208 35.61292222058488, -82.44728759898034 35.61294022054573, -82.44714659895668 35.61294222053162, -82.44704459894078 35.61293622051991, -82.44694659892696 35.612920220506574, -82.44686959891854 35.612892220493, -82.4468525989169 35.612884220489555, -82.4468035989122 35.61286222048007, -82.44672359890798 35.612804220459985, -82.44665359890931 35.612720220435726, -82.44660059891534 35.612624220410765, -82.44655359892772 35.6124932203793, -82.44651559894103 35.612366220349614, -82.44649159895546 35.61224722032292, -82.44647359897193 35.61212122029548, -82.44647259899126 35.611995220269684, -82.44652459906851 35.61155022018465, -82.44651159909228 35.611382220149096, -82.44649859910001 35.61131822013476, -82.44647559910437 35.61126522012161, -82.44643659910791 35.61120022010441, -82.44639359910957 35.61114322008842, -82.44633959910911 35.61108822007163, -82.44619259909982 35.61099122003679, -82.44602359908309 35.61091822000463, -82.44576959905612 35.61082021995853, -82.44562059904297 35.610745219927885, -82.4455435990382 35.61069321990944, -82.44548859903634 35.610646219894214, -82.44542959903625 35.61058421987552, -82.44536359903789 35.61050221985209, -82.44524359904626 35.61031921980253, -82.44522359904704 35.61029321979518, -82.44518659904813 35.610246219781864, -82.44511859904652 35.61018321976207, -82.44503959904308 35.61012121974132, -82.44494859903523 35.610074219722364, -82.44477359901393 35.610024219694175, -82.44445459896842 35.609977219651775, -82.44349559883644 35.609803219517765, -82.44357459888765 35.60955621947571, -82.4435995989098 35.609439219454515, -82.44368659898488 35.609046219383494, -82.44379459909342 35.608458219275086, -82.44382859911963 35.60832521925156, -82.4438935991687 35.6080772192079, -82.4439015991762 35.60803721920059, -82.44391759919117 35.60795721918591, -82.44393459920674 35.60787421917085, -82.4440185992852 35.607456219094445, -82.44415359940939 35.60679621897425, -82.44429959952858 35.606180218863976, -82.4443465995707 35.605958218823716, -82.44441459963116 35.60563921876587, -82.44445859966606 35.605460218733995, -82.44454459973325 35.60511721867312, -82.44460159979894 35.604752218604794, -82.44461159981005 35.604691218593395, -82.44466259986153 35.6044122185419, -82.4446835999469 35.60388121843618, -82.44463759998547 35.60358221837068, -82.44456560002489 35.6032492182956, -82.44446260005361 35.60295221822463, -82.44436160007544 35.60270221816338, -82.44420760009163 35.60243221809267, -82.44417060009538 35.60236821807578, -82.44392360010153 35.602063217988466, -82.44371860010493 35.60182121791817, -82.44358860010253 35.60169721787954, -82.44339960009899 35.60151721782356, -82.44319760009454 35.601329217764516, -82.44306660009158 35.60120721772626, -82.44265460007485 35.60087421761617, -82.442488600068 35.60074021757189, -82.44235360005835 35.60065721754106, -82.44185660002367 35.6003492174273, -82.44138759998295 35.60010921733034, -82.44129459997392 35.6000682173124, -82.44086259993101 35.59988221723018, -82.44081359992754 35.59985221721899, -82.44078259992538 35.59983321721196, -82.44069159991906 35.59977621719099, -82.4406615999169 35.59975821718421, -82.4406185999138 35.59973221717456, -82.44049159990473 35.59965421714564, -82.4404495999018 35.599628217135994, -82.44037359989476 35.59959221712083, -82.44032359989363 35.599546217106386, -82.44003059988705 35.59927421702098, -82.4399965998882 35.5992302170085, -82.4399045998915 35.59911021697465, -82.43983859989376 35.59902421695035, -82.4398135998946 35.59899221694129, -82.43968259990362 35.59879321688732, -82.439661599906 35.59875521687746, -82.43961159991218 35.598661216853216, -82.4395165999273 35.598461216802846, -82.43950759992873 35.59844221679799, -82.43940159995088 35.59818521673487, -82.4393205999646 35.59800921669074, -82.43923659997361 35.59786021665183, -82.43922759997463 35.5978442166476, -82.43910359997864 35.597685216602606, -82.43905159997794 35.59763421658681, -82.43896959997663 35.59755421656219, -82.438890599973 35.597493216541615, -82.43883459997053 35.59744921652692, -82.4387665999671 35.59739821650958, -82.43874059996571 35.59737921650306, -82.43856959995429 35.5972692164631, -82.43855459995332 35.59726021645967, -82.43848159994755 35.597219216443825, -82.43832159993474 35.59713021640933, -82.43818959992426 35.597056216380686, -82.43784159989555 35.59686921630686, -82.43768159988237 35.596783216272925, -82.43758059987411 35.59672821625137, -82.43734359985439 35.59660121620115, -82.4372995998507 35.59657821619198, -82.43727959984899 35.596567216187694, -82.43718059984116 35.596512216166275, -82.43711259983576 35.5964742161516, -82.43700159982659 35.59641421612794, -82.43690959981937 35.596362216107956, -82.43684259981418 35.596324216093315, -82.43676959980841 35.59628321607751, -82.4365545997916 35.59616121603058, -82.43655259979151 35.5961602160301, -82.43648459978746 35.596113216013556, -82.4364545997857 35.59609221600619, -82.43641859978342 35.59606821599769, -82.4363695997815 35.596028215984454, -82.43634259978046 35.596006215977226, -82.43630959977914 35.59597921596832, -82.43629859977871 35.59597021596541, -82.43621759977678 35.59589621594196, -82.43618759977605 35.59586821593321, -82.43610259977713 35.595770215904544, -82.4360985997772 35.59576521590314, -82.43601859978152 35.5956512158717, -82.4359715997895 35.59554921584617, -82.43592759980092 35.595428215817066, -82.43592559980164 35.595421215815385, -82.43589559981469 35.59530421578852, -82.43587159983267 35.59516221575719, -82.43587259984979 35.59505221573494, -82.43588459987504 35.59490121570549, -82.43589059988636 35.594834215692536, -82.43599760006198 35.593810215495346, -82.436012600124 35.59342421541847, -82.43601460012943 35.593391215411955, -82.4360616001852 35.593080215353595, -82.43609760020932 35.592962215333316, -82.43600260019102 35.59297921532697, -82.43577560014694 35.59302121531218, -82.43571860013628 35.593029215307965, -82.43562360011823 35.59304421530124, -82.43534160006492 35.59308721528094, -82.435326600062 35.593090215280036, -82.43495259999311 35.5931352152507, -82.4344925999092 35.5931852152135, -82.43420959985744 35.59321721519092, -82.43374559977278 35.593268215153486, -82.43235259951851 35.59342121504134, -82.43188959943402 35.59347221500401, -82.431629599387 35.59349821498252, -82.43113959929785 35.593550214942674, -82.43085359924511 35.59358521492039, -82.43059559919728 35.593618214900545, -82.43053359918578 35.59362621489582, -82.43034959915151 35.593651214881916, -82.43028859913994 35.59366021487746, -82.43027659914489 35.59361521486714, -82.43024059915946 35.593482214836385, -82.43022859916431 35.59343821482614, -82.43020759917258 35.59336221480855, -82.43016159919142 35.593190214768924, -82.43014659919719 35.59313721475663, -82.43012659920525 35.59306321473956, -82.43010859921233 35.592998214724474, -82.43004359923262 35.592796214676724, -82.43000159924301 35.592684214649594, -82.4299515992558 35.592547214616616, -82.42984059927015 35.59233521456215, -82.42967059927287 35.592135214504005, -82.42927259926496 35.59175921438663, -82.42914859926267 35.591641214349906, -82.42898459925952 35.591485214301294, -82.42888459925747 35.59139121427195, -82.42869759925395 35.59121321421649, -82.42858659925132 35.5911112141843, -82.42848659924893 35.591019214155374, -82.42903959934944 35.59096121420044, -82.429267599392 35.59093021421762, -82.43111659973661 35.59068021435703, -82.43160659982772 35.590615214394234, -82.43225159994745 35.590531214443516, -82.43238759997229 35.59051621445449, -82.43238759998518 35.590433214437624, -82.4323636000061 35.59027121440225, -82.4323306000349 35.590049214353755, -82.43231960005896 35.58988121431842, -82.43234360008701 35.589725214289196, -82.4323756001145 35.58958121426326, -82.43237960012146 35.589540214255315, -82.43240660016352 35.589296214208474)))",6526,37,021,003001,370210030011,2001,2001,47,1975,1798,134,14,12,4,13,26,1646,32,1614,1628,1480,113,12,10,4,9,18,890,810,80
census_2010_blockgroups_view.fid--2dc29038_13ec899ba8f_-25d1,"MULTIPOLYGON (((-82.51532861871199 35.55805321637882, -82.51541361873936 35.55796721637006, -82.51566861882087 35.55771221634433, -82.51568061882439 35.55770221634356, -82.51575861884814 35.557632216337325, -82.51583461887128 35.55756321633109, -82.51586261887998 35.55753721632869, -82.51586761888143 35.55753321632834, -82.51595261890398 35.557478216325926, -82.51604361892525 35.55743821632707, -82.5161386189453 35.55741021633119, -82.51625061896696 35.55739021633861, -82.51625261896743 35.55738921633858, -82.51639261899312 35.55737321634968, -82.51663961904018 35.557333216366985, -82.51694161909757 35.55728521638819, -82.51724861915602 35.557236216409756, -82.51738361918193 35.55721321641892, -82.5175486192135 35.55718621643038, -82.51763261922844 35.55717921643757, -82.5176716191141 35.557965216601474, -82.51767361910458 35.55802921661473, -82.51770161899238 35.558789216772226, -82.51770861896455 35.55897721681112, -82.51775561892882 35.559260216873575, -82.51784461889974 35.55954521694063, -82.5179176188804 35.55975021698985, -82.51803861886494 35.5599812170493, -82.51818761885148 35.56022921711501, -82.51827361884688 35.560351217148735, -82.51833961884547 35.560432217171964, -82.51837461884477 35.560474217184094, -82.5185486188475 35.560644217236536, -82.51868961885087 35.56077421727749, -82.51883561885911 35.56087821731362, -82.5189846188672 35.56098621735089, -82.51919961888444 35.56110621739741, -82.51942961890643 35.5612112174424, -82.51948461891237 35.56123121745204, -82.51963161892846 35.561285217478144, -82.5197736189456 35.56132721750124, -82.51997261897023 35.56138121753269, -82.5202986190136 35.561451217580384, -82.52111361912529 35.56160321769503, -82.52166261920053 35.561706217772304, -82.52212061926313 35.561793217837106, -82.52259261932593 35.56189321790592, -82.52280161935407 35.56193621793616, -82.52316561940286 35.5620112179888, -82.52365661946462 35.56213921806519, -82.52417861952613 35.56230221815198, -82.52464361957702 35.56247221823436, -82.52504261961643 35.56264621831068, -82.5259356197049 35.563034218481306, -82.5260806197194 35.563096218508775, -82.52654061976524 35.56329421859635, -82.52716361983394 35.56351921870608, -82.5278436199157 35.56372121881704, -82.52838661998712 35.56384221889736, -82.52906062008049 35.563962218991044, -82.52931762011585 35.564009219026964, -82.5297756201787 35.564094219091324, -82.53056562029096 35.56421621919724, -82.53131162040461 35.564282219287286, -82.53151962043758 35.564292219310616, -82.5322246205491 35.56432721939018, -82.53276962063362 35.56436521945391, -82.53321862070024 35.56441621951031, -82.53364662075714 35.56450821957301, -82.53406462080629 35.564639219642515, -82.53454262086146 35.56479621972361, -82.53502662091344 35.56498021981078, -82.53579062099709 35.56526021994613, -82.53629262105213 35.565444220035126, -82.5372536211592 35.56578422020303, -82.53787162122653 35.56601322031308, -82.5380256212434 35.56606922034022, -82.53849062129432 35.566240220422785, -82.53864562131123 35.566297220450295, -82.53874062132257 35.56632622046594, -82.53902862135698 35.56641322051327, -82.53912462136846 35.56644222052904, -82.53952362140507 35.56663422060903, -82.53979062142542 35.5667902206682, -82.53985362143031 35.566826220681975, -82.53997162143936 35.56689422070793, -82.54006862144693 35.56695022072926, -82.54017162145439 35.56701222075246, -82.54040462147155 35.56715222080493, -82.54079262150582 35.56734822088465, -82.54116862154375 35.5675072209556, -82.5414966215836 35.56760122100842, -82.5417616216174 35.56766822104926, -82.54196262164533 35.56770322107699, -82.54213462167061 35.56772422109892, -82.54230762169597 35.56774622112114, -82.54294662178246 35.567873221212594, -82.54316362181483 35.56789622123958, -82.5434456218567 35.56792822127506, -82.54381362190986 35.56798022132346, -82.54403062194109 35.56801122135202, -82.54432162198506 35.56803922138754, -82.54519562211681 35.56812522149478, -82.54535962214162 35.5681412215149, -82.54548762216093 35.568153221530444, -82.54539262212498 35.56828522154757, -82.54532562209963 35.56837722155947, -82.54529762208898 35.568416221564476, -82.54513562204507 35.568527221570434, -82.54482362196947 35.56868222157001, -82.54459362192313 35.56873522155712, -82.54432462186881 35.56879822154239, -82.54400062180333 35.56887422152452, -82.54393562179038 35.56888822152069, -82.54280162156398 35.56913722145499, -82.54276662155632 35.56914922145375, -82.54239162147348 35.569283221442596, -82.54204562139893 35.56939422142964, -82.54182562135652 35.56943322141493, -82.54157062130712 35.56947922139813, -82.54127662124829 35.569544221381186, -82.54088662117537 35.56959822135208, -82.54050662110183 35.56966622132699, -82.54018662103962 35.56972522130606, -82.53964562092962 35.56985722127743, -82.5390796208009 35.57008322126525, -82.53844462065378 35.570355221255355, -82.53801062055093 35.570555221251524, -82.53726662036631 35.57095322125612, -82.53676362024633 35.57119022125273, -82.53514361988871 35.57176822120396, -82.53489361983335 35.57185822119658, -82.533884619645 35.57199522112084, -82.53324261954305 35.57196522104883, -82.5325776194394 35.57192222097179, -82.53241461941373 35.57191322095321, -82.53188961933111 35.57188422089344, -82.53115961921034 35.57188222081802, -82.5306596191232 35.57190922077214, -82.53034961906488 35.571954220749454, -82.53015261901923 35.572038220746364, -82.52997061897506 35.57212922074611, -82.52990761895947 35.57216222074635, -82.52924561879297 35.57253122075353, -82.52874661866753 35.57280822075858, -82.52842261858584 35.57299022076234, -82.52806861849062 35.57322722077419, -82.52731861830316 35.573637220780576, -82.52726961829013 35.57366922078212, -82.52687761818385 35.57393722079641, -82.52680461816234 35.57399822080125, -82.52658061809643 35.57418522081635, -82.5262996180002 35.574507220852986, -82.52616961795559 35.574657220870115, -82.52602061788889 35.574930220910446, -82.52558561767115 35.57587622105812, -82.5253716175728 35.57628422111918, -82.52526161753995 35.57637922112724, -82.52520061752146 35.576433221131985, -82.5249986174774 35.57650222112522, -82.52457461740644 35.57650622108249, -82.52397661731715 35.57644222100801, -82.52362861726401 35.57641222096619, -82.5235766172556 35.57641122096065, -82.52320661719527 35.57640422092123, -82.5228846171405 35.57641322088996, -82.52247261706397 35.57646622085841, -82.52200561697414 35.57654722082694, -82.52144861686257 35.57667122079494, -82.5208606167386 35.57684322076953, -82.52063561668773 35.57693122076435, -82.52047061665034 35.57699622076059, -82.52009861655789 35.57719622076304, -82.51975861646841 35.57741122077184, -82.51970161646676 35.577360220755665, -82.51969061646649 35.57735022075247, -82.51968561646648 35.57734522075093, -82.51947961646468 35.57713522068712, -82.519411616464 35.57706622066605, -82.5192496164624 35.57690222061602, -82.51895461645957 35.576602220524734, -82.5187586164556 35.57641722046692, -82.51859161645207 35.57626022041787, -82.51821761644453 35.57590622030744, -82.51819861644425 35.57588722030164, -82.51708261642729 35.57479521996484, -82.51703961642723 35.57474921995104, -82.51694361642713 35.57464621992022, -82.5168366164294 35.574516219882774, -82.51675661643552 35.574390219848915, -82.51672261644141 35.57431521983014, -82.51669261644645 35.57425021981385, -82.51664261646322 35.57408721977554, -82.51661061648154 35.57393421974109, -82.51659861649163 35.57385521972383, -82.51658961650044 35.573788219709286, -82.51652761666566 35.57264821947098, -82.51652561669998 35.572423219425026, -82.51652461674257 35.572145219368316, -82.51650861674963 35.57208221935389, -82.51648861675478 35.57202721934066, -82.51644561675728 35.57196421932341, -82.51640261675799 35.57191321930862, -82.51629061675135 35.571836219281444, -82.51626561674914 35.57182321927626, -82.51605861673033 35.57172221923449, -82.5158896167176 35.57162321919698, -82.51573461670804 35.57151821915968, -82.51567461670575 35.57146821914336, -82.51549761669905 35.57132121909525, -82.51543561669756 35.57126421907724, -82.5153616166979 35.57118221905295, -82.5153556166981 35.571174219050775, -82.5153136166996 35.57111921903524, -82.51519061671019 35.570918218981724, -82.51506561673271 35.57063721891173, -82.51503361673844 35.570565218893776, -82.51498861674885 35.5704492188656, -82.51493461675912 35.57032421883456, -82.51490261676109 35.57027721882172, -82.51487861676048 35.57025521881482, -82.51486161675976 35.57024121881023, -82.51480961675517 35.5702152187996, -82.51475861674778 35.57020821879292, -82.51470861673981 35.57020621878741, -82.51463961672678 35.570216218782356, -82.5145136167016 35.57024421877508, -82.5144406166884 35.57025121876902, -82.5143816166794 35.57024621876193, -82.514319616672 35.570227218751675, -82.51426561666804 35.57019521873962, -82.51424361666842 35.57016921873208, -82.51409761667043 35.56999921868252, -82.51406161667035 35.56996021867085, -82.51397261667087 35.56986121864156, -82.51395561667069 35.569844218636355, -82.51391961667039 35.56980721862516, -82.51388461666998 35.56977221861439, -82.51373461666726 35.56962821856973, -82.51372861666721 35.569622218567886, -82.51361261667206 35.56946521852409, -82.51355961667824 35.569368218498845, -82.51350261669293 35.56921121846105, -82.51348661670588 35.56911021843892, -82.51348761672091 35.56901321841923, -82.51349961673662 35.568924218402344, -82.51350261673976 35.56890721839921, -82.51355861678466 35.56867521835778, -82.51358661680963 35.56854321833384, -82.51358961681153 35.56853421833231, -82.51360661682976 35.5684342183137, -82.51361261684174 35.56836221829961, -82.51361261685807 35.568256218278094, -82.51360061687338 35.56814421825409, -82.51359361688284 35.5680752182394, -82.51358461689117 35.56801121822533, -82.51355261691897 35.56779621817836, -82.51350961694735 35.56756521812693, -82.51318561708779 35.56630321783699, -82.51316161710041 35.56619521781255, -82.51328561712502 35.56616921781996, -82.51424361730886 35.56600621788522, -82.51446061735045 35.56597021790014, -82.5149126174366 35.56589721793169, -82.51511261747537 35.56586121794499, -82.51533061751734 35.565823217959625, -82.5153776175263 35.56581521796281, -82.51561661757229 35.565774217979, -82.51647561773665 35.56563121803815, -82.5165026177418 35.5656272180401, -82.51676361779049 35.565592218059834, -82.51771461795823 35.565526218144015, -82.51773461796078 35.56553121814711, -82.51783461797682 35.565535218158175, -82.51817261803454 35.565524218190674, -82.51842961807914 35.56551121821444, -82.51838161809152 35.56537921818259, -82.51834761810068 35.56528321815959, -82.51830661811657 35.5651352181253, -82.51827261813543 35.56497621808949, -82.5182536181617 35.564785218048705, -82.51823661816915 35.56471821803326, -82.51822461818162 35.564624218012945, -82.51820761819114 35.564544217994914, -82.51817861819639 35.56447821797851, -82.51809961820582 35.564332217940674, -82.51801961821135 35.56421021790764, -82.51794061822193 35.564056217868206, -82.51784561823224 35.5638862178239, -82.5177796182412 35.563757217790894, -82.5177626182422 35.56373221778403, -82.51768661824696 35.56361921775324, -82.51760461824617 35.563536217727915, -82.51731461823793 35.56327721764543, -82.51726761823828 35.563224217629845, -82.51724061824044 35.56318121761831, -82.51722961824625 35.56313121760698, -82.51722661825274 35.56308621759758, -82.51722561825642 35.56306121759232, -82.51723461827264 35.56296521757379, -82.51728161833242 35.56262721750987, -82.51728161834845 35.56252321748865, -82.51725761836065 35.56241721746462, -82.5172036183727 35.56228121743141, -82.51712761838368 35.562128217392505, -82.51704461838798 35.56201021736001, -82.51693361838623 35.561902217326626, -82.51681361838031 35.56181121729582, -82.51672861837746 35.56173821727222, -82.51667761837994 35.56166721725254, -82.51664761838468 35.56160421723663, -82.51662061839617 35.561500217212654, -82.51661661839786 35.561485217209274, -82.51660861842414 35.56130521717179, -82.51661061848759 35.56089521708859, -82.51661061849728 35.560832217075735, -82.5166386185625 35.560438216998456, -82.51665761858825 35.56029121697055, -82.51665961859074 35.5602772169679, -82.51665661860316 35.560193216950545, -82.516639618611 35.56012421693469, -82.5166136186145 35.56007321692168, -82.51655061861207 35.56002121690459, -82.51600061856522 35.559732216789335, -82.51563161853704 35.55951821670793, -82.51522861850471 35.559294216620955, -82.51514561849794 35.55924821660312, -82.51470961846643 35.55898321650441, -82.51473961848218 35.55891321649331, -82.51476161849595 35.55884721648211, -82.51482361852867 35.55870121645878, -82.51483161853265 35.55868421645617, -82.5148576185447 35.55863421644857, -82.51486861854998 35.558611216445065, -82.51489761856297 35.55855821643735, -82.51490561856632 35.55854521643542, -82.51492061857186 35.558525216432905, -82.51498761859885 35.55842221641888, -82.51498861859926 35.55842021641848, -82.51515561865463 35.55824021639908, -82.5152416186838 35.55814321638815, -82.51527661869552 35.558105216384, -82.51532861871199 35.55805321637882)))",5980,37,021,002000,370210020001,2273,2273,207,2191,1621,425,11,12,1,121,82,1689,138,1551,1660,1287,268,10,11,1,83,29,1059,1002,57
census_2010_blockgroups_view.fid--2dc29038_13ec899ba8f_-25d0,"MULTIPOLYGON (((-82.60912563315361 35.56538222749715, -82.60914663316909 35.565304227483416, -82.60919263320119 35.56514522745575, -82.60921263321552 35.565073227443115, -82.60923563323107 35.56499722742996, -82.60925063323317 35.56499922743196, -82.6092736332374 35.56499722743389, -82.60938863325784 35.564988227443806, -82.60942763326483 35.564985227447245, -82.6096746333088 35.56496622746867, -82.61040763345514 35.564806227511326, -82.6106296334945 35.56479022753079, -82.61108363355609 35.56488022759575, -82.61150363361286 35.564965227656145, -82.61248563376506 35.56503622777129, -82.6128826338354 35.56500822780631, -82.6136086339449 35.56508022789546, -82.614126634016 35.56517822796855, -82.61497463410792 35.565497228120456, -82.6151356341194 35.56559622815715, -82.61529063412077 35.56575522820543, -82.61539863411507 35.56590922824788, -82.61557363407573 35.566354228356445, -82.61569463404874 35.566661228431386, -82.61588363402528 35.567018228523466, -82.61595163399096 35.56731522859102, -82.61608563395744 35.56767822867869, -82.61619863394047 35.56791122873768, -82.61644963390194 35.56843322886978, -82.61650963389285 35.56855722890122, -82.61646363385643 35.568744228934555, -82.61646363382285 35.56896322897917, -82.61657163379007 35.569293229057436, -82.61665163378474 35.569414229090334, -82.61682763379035 35.56956822913971, -82.61721063382456 35.569760229218076, -82.61723763382531 35.569784229225746, -82.61767463383924 35.570166229348445, -82.61785763382797 35.57043722942236, -82.61799863381957 35.57064422947902, -82.61805863380859 35.570781229513024, -82.61816663375215 35.571265229622725, -82.61815663373729 35.57135122963924, -82.61814663372012 35.57145222965877, -82.618200633697 35.57166122970695, -82.61820163369538 35.57167222970919, -82.61820663368653 35.57173522972253, -82.61822163365964 35.571926229763, -82.61822763365085 35.571990229776624, -82.61823463363928 35.572073229794235, -82.61827263362667 35.57219622982323, -82.61832263361086 35.57235322986032, -82.618611633604 35.57271022996271, -82.61861463360248 35.57272322996566, -82.61866263357857 35.57293123001297, -82.61823863347284 35.5731602300161, -82.61696663315558 35.57384923002588, -82.61654363304993 35.574079230029426, -82.61607563293353 35.57433023003256, -82.61520963271796 35.574796230038565, -82.61467163258426 35.57508423004205, -82.61465063257901 35.575096230042384, -82.61423663247776 35.57530723004287, -82.61420363246805 35.575334230044916, -82.61414163246673 35.57527623002684, -82.61395863246267 35.575104229972965, -82.61389863246154 35.57504722995521, -82.61367463240857 35.575149229952984, -82.613359632334 35.575294229950195, -82.61301163224954 35.57546722994975, -82.61300163224695 35.57547322994992, -82.61280063219526 35.57559222995358, -82.61276863221272 35.57544422992013, -82.61272363223823 35.57522922987172, -82.61266863226415 35.575001229819634, -82.61266663226537 35.57499122981747, -82.61263163226819 35.5749352298024, -82.61256763226336 35.57489722978813, -82.61243863223281 35.57495622978694, -82.61238063221771 35.574992229788315, -82.61233263220508 35.57502222978943, -82.61215063215407 35.57515722979824, -82.61195763209332 35.57534422981659, -82.61190263207554 35.57540022982239, -82.61175863202811 35.575553229838754, -82.6116746320189 35.57552222982379, -82.61166663201757 35.57552222982296, -82.61154063199525 35.57553122981189, -82.61137563196917 35.57552222979308, -82.6112786319539 35.57551722978209, -82.61122863194616 35.57551322977616, -82.61109963192779 35.57549322975887, -82.61104563192008 35.57548522975176, -82.61088363189573 35.57546822973164, -82.61074063187253 35.575464229716154, -82.6106056318475 35.57548122970572, -82.61056563183777 35.57550122970572, -82.61051863182627 35.575525229705825, -82.61042663179752 35.57561322971428, -82.61036563176813 35.5757382297335, -82.61030263173141 35.57590922976182, -82.61027763171667 35.575978229773355, -82.61020663168838 35.57608522978779, -82.61013463166583 35.57615422979454, -82.61010863165781 35.57617822979676, -82.60994563161381 35.57628822980242, -82.60975763156877 35.57637822980143, -82.60954763152272 35.57645022979456, -82.60949663151138 35.57646922979324, -82.60924063145744 35.57654322978198, -82.60903563141463 35.57660022977259, -82.60902563141275 35.57660122977171, -82.60885563138028 35.576629229759995, -82.60868363135027 35.576638229744205, -82.6085046313234 35.576619229722006, -82.60836163130261 35.57660022970341, -82.60822363128239 35.57658222968564, -82.60814163127094 35.57656822967435, -82.60813663128184 35.5764922296583, -82.60804063135075 35.575940229536016, -82.60803963135174 35.57593222953433, -82.60800663138045 35.57571022948569, -82.60796063140732 35.575485229435216, -82.6079276314369 35.57525722938533, -82.60787863146685 35.575009229329844, -82.60779563152757 35.57452522922274, -82.60776163156092 35.574271229167515, -82.60772463158767 35.57405722912017, -82.60763863165009 35.57355822900968, -82.60763263166895 35.57342922898283, -82.60741163163355 35.57342022895828, -82.60675163152807 35.57339322888505, -82.60653163149271 35.57338522886087, -82.60635263146415 35.57337722884088, -82.60581763137904 35.57335322878108, -82.60563963135047 35.57334622876142, -82.60566363138905 35.57312122871809, -82.6056636313908 35.57311022871582, -82.6056746314291 35.572872228668494, -82.60571463150822 35.572401228576645, -82.60573563154782 35.57216622853092, -82.60573063154698 35.57216622853045, -82.6056826315396 35.57216222852471, -82.60567163153776 35.57216222852361, -82.60538463149261 35.572146228490865, -82.6050056314327 35.572126228447914, -82.60452663135804 35.57209422839223, -82.60424063131326 35.572076228359236, -82.60395363126781 35.57206122832671, -82.60392063126278 35.57205822832279, -82.60345463119006 35.572028228268806, -82.60305863112744 35.572007228223946, -82.60296163111256 35.5719992282123, -82.60288863110125 35.57199422820379, -82.60264563106709 35.57195322817052, -82.6026556310706 35.57194122816912, -82.60268763108107 35.571908228165704, -82.6026986310845 35.57189722816463, -82.60278563111272 35.571808228155426, -82.6028156311221 35.57177922815254, -82.60298263118779 35.571532228119366, -82.6029936311945 35.571500228113976, -82.60303763121966 35.57138422809493, -82.60316363129319 35.57104222803815, -82.60326363134318 35.57082522800424, -82.60336363137685 35.570714227991886, -82.60340863139177 35.5706662279867, -82.60360663144735 35.570518227976905, -82.60379863149988 35.57038422796929, -82.60403863156363 35.57022822796221, -82.60418163160733 35.57009922795061, -82.6042996316512 35.56994122793047, -82.60455263175517 35.56953822787443, -82.60470363180596 35.569371227855896, -82.60496663188161 35.569163227840484, -82.60538763200226 35.568833227816505, -82.60555463205148 35.568693227805106, -82.60561963207903 35.56858422778954, -82.60564663209028 35.568540227783345, -82.60569663212561 35.568364227752696, -82.60571363215055 35.568220227725064, -82.60571963215808 35.56817822771716, -82.60573063217264 35.56809522770137, -82.60572463219836 35.56792122766539, -82.60567363220882 35.56779822763505, -82.60556363221407 35.567645227592585, -82.60543063221857 35.56747222754371, -82.60532463222366 35.56732422750267, -82.6052766322403 35.56716422746521, -82.60528663224487 35.56714522746236, -82.60534563227097 35.56703922744679, -82.60551963232447 35.56687922743209, -82.60607263248467 35.5664342273982, -82.6062946325483 35.566260227385555, -82.60652963261298 35.56609322737564, -82.60671563265885 35.565996227374946, -82.60727263277843 35.565820227396244, -82.6075626328355 35.56576222741424, -82.60807263293908 35.56564022744162, -82.6081976329643 35.56561122744854, -82.60904063313663 35.56540122749221, -82.60912563315361 35.56538222749715)))",5714,37,021,001200,370210012004,1367,1367,131,1344,1162,56,6,36,8,76,23,1108,93,1015,1099,972,39,2,25,6,55,9,679,617,62
census_2010_blockgroups_view.fid--2dc29038_13ec899ba8f_-25cf,"MULTIPOLYGON (((-82.41647460771078 35.523153199130654, -82.41677760777111 35.52308619914814, -82.41692060779961 35.523055199156495, -82.41768960795213 35.522890199201974, -82.41787460798867 35.522851199213115, -82.41799560801145 35.52283319922184, -82.418103608032 35.52281619922954, -82.41829360806629 35.522797199245154, -82.41838060808122 35.52279319925331, -82.41848560809926 35.52278919926328, -82.4186586081279 35.52278919928099, -82.41883560815572 35.522798199301086, -82.41905260818805 35.522821199327986, -82.41930460822341 35.522862199362216, -82.41951860825174 35.52290819939357, -82.41953560825398 35.52291219939613, -82.41973660827819 35.52297119942877, -82.41990560829692 35.52303119945829, -82.42011460831853 35.52311519949683, -82.42026060833203 35.52318419952588, -82.42027460833322 35.52319119952874, -82.42046660834829 35.52330019957062, -82.4212566084054 35.523778199748854, -82.4215886084294 35.52397919982382, -82.42161960844088 35.52393819981867, -82.42171260847499 35.52381619980345, -82.42174460848645 35.52377619979862, -82.4221436085414 35.52384819985418, -82.42229660856425 35.52386419987321, -82.42250260860061 35.5238491998913, -82.42269460863663 35.52382119990532, -82.4229476086822 35.5237971999264, -82.42295160868281 35.52379719992683, -82.42326760873772 35.52378019995589, -82.42350960877849 35.523775199979696, -82.42363060880002 35.52376519999015, -82.42387260884585 35.52372720000725, -82.42403660887801 35.52369420001735, -82.42412760889833 35.5236602000198, -82.42417360891415 35.523607200013764, -82.42416960892241 35.5235492000016, -82.42409260894547 35.52331619994634, -82.42403660897165 35.52308519989366, -82.4240236089841 35.52299019987303, -82.42401760899135 35.52293719986167, -82.42401760900297 35.52286119984619, -82.42404160901975 35.522778199831805, -82.42409160903888 35.522707199822506, -82.42415160905708 35.52265319981767, -82.42433060909606 35.522592199823656, -82.42442760911534 35.52257119982938, -82.42452360913367 35.52255519983604, -82.42464060915445 35.52254619984619, -82.42474560917194 35.522545199856786, -82.42486160918911 35.52255819987132, -82.42499060920464 35.52259619989226, -82.42509760921634 35.522635199911235, -82.42521660923032 35.52267219993092, -82.42533460924538 35.52270119994898, -82.42546560925997 35.522747199971754, -82.42566860928238 35.52282020000749, -82.42599660932119 35.52292020006147, -82.4260946093351 35.522935200074635, -82.42630760936859 35.522946200098666, -82.42652560940549 35.52294120012003, -82.4266516094258 35.52294420013366, -82.42688360946468 35.522941200156836, -82.42699160948331 35.52293620016691, -82.42748860956847 35.522917200214124, -82.42761560958978 35.522915200226784, -82.42773460960785 35.522925200241026, -82.42801460965363 35.522929200270575, -82.42831160970192 35.52293420030208, -82.42835560970934 35.522933200306426, -82.42842960972185 35.522931200313636, -82.4284646097276 35.5229322003174, -82.42875060977242 35.52294820035004, -82.4287936097798 35.52294620035408, -82.42890360979833 35.52294420036493, -82.42897160981538 35.5229062003642, -82.42902960982937 35.522877200364256, -82.42942060992442 35.52268020036444, -82.42985561003148 35.5224512003626, -82.43039661016421 35.522170200361025, -82.43079561026181 35.52196420036019, -82.43115661034768 35.52179420036271, -82.43141061040662 35.52168420036643, -82.43155761044277 35.521607200365864, -82.43168561047789 35.521516200360615, -82.43198261056408 35.52127520034209, -82.43202061057497 35.521245200339905, -82.43214761060716 35.52117220033815, -82.43228361063737 35.52112220034191, -82.43243061066732 35.52108520034945, -82.43254861068871 35.52107320035917, -82.43310961078612 35.521043200410716, -82.43339461083374 35.52104020043941, -82.43346861084602 35.521040200447, -82.43364361087384 35.52104720046636, -82.43388361091047 35.521067200495054, -82.4346686110248 35.52116820059624, -82.43494761106801 35.52118720062876, -82.4351046110941 35.52118620064468, -82.43528961112693 35.521172200660835, -82.43545161115753 35.52114720067242, -82.43565661119959 35.521094200682676, -82.43584761124224 35.52102220068763, -82.4358976112548 35.52099420068706, -82.43600261128107 35.52093620068611, -82.43613461131815 35.52083720067951, -82.4362806113646 35.520692200665096, -82.43641061140403 35.52057520065462, -82.4365526114449 35.52046220064625, -82.4366866114803 35.52037620064252, -82.43683161151577 35.520301200642194, -82.43687761152738 35.52027520064162, -82.43692461153857 35.52025320064196, -82.43694861154447 35.52024020064186, -82.43711761158582 35.520153200641545, -82.43734561164398 35.52002020063793, -82.4374856116836 35.51991320063054, -82.43764261173196 35.519767200617046, -82.4377656117757 35.519615200598764, -82.43786261181181 35.519484200582056, -82.43793161184026 35.51937420056679, -82.43794561184731 35.51934320056197, -82.4380016118736 35.51923220054511, -82.43811061193955 35.518920200492936, -82.43813561195493 35.518847200480685, -82.438215611995 35.51867220045336, -82.43823461200276 35.51864220044917, -82.43830661203047 35.51853920043564, -82.43843361207169 35.51840820042212, -82.43861061212255 35.51826720041158, -82.43892561220746 35.518054200400634, -82.43904461223941 35.51797420039658, -82.43917461227569 35.51787820039041, -82.43951861232323 35.517939200438164, -82.43958661233614 35.517928200442896, -82.43968061235844 35.51788420044365, -82.43985561241092 35.51773120043051, -82.44021861250815 35.51748920041871, -82.44042661255872 35.5173842004186, -82.44069561262003 35.51727420042385, -82.44075161263115 35.51726220042719, -82.44103161268582 35.517208200445054, -82.44163561277985 35.51724620051477, -82.44164961278196 35.517247200516394, -82.44186461282273 35.51721420053175, -82.44206661286958 35.51712620053463, -82.44218761290144 35.51704920053142, -82.44241661294944 35.51698320054148, -82.44272561300477 35.51695620056769, -82.44273861300519 35.5169672005713, -82.4429136130276 35.517010200598065, -82.44302161303357 35.517087200624786, -82.44307461303048 35.51716420064582, -82.44310161299781 35.5174062006978, -82.44314861298365 35.51754920073166, -82.44320261298074 35.517626200752865, -82.44337761298597 35.51778020080212, -82.44348461297496 35.517967200851146, -82.443646612974 35.51814820090456, -82.4440426129939 35.51844520100555, -82.44413761300277 35.51848920102428, -82.444526613052 35.518588201084334, -82.4446886130662 35.51867020111759, -82.44494361307798 35.51886820118404, -82.4450426130727 35.51900920122283, -82.44509161307033 35.519077201241714, -82.44523961307961 35.51917620127701, -82.44532061308801 35.519208201291825, -82.44552861308611 35.51944520136141, -82.44568961309412 35.51956620140253, -82.44581061310228 35.51964320143054, -82.44610661313115 35.519774201487586, -82.44630861315785 35.51981820151731, -82.4465416131967 35.51981620154074, -82.44689961325636 35.519813201576945, -82.44703661327583 35.51983420159525, -82.44711461328693 35.51984620160575, -82.44734361331297 35.519923201644914, -82.44758561334963 35.51994520167422, -82.44805661340817 35.520071201748195, -82.44842561344046 35.520258201824035, -82.44845261344359 35.52026720182869, -82.4485876134589 35.5203132018519, -82.44884261347664 35.52047220191036, -82.44888261347745 35.52051020192225, -82.44892361347826 35.52054920193432, -82.44899061344536 35.52083520199934, -82.44905761343614 35.520967202033056, -82.44911161343836 35.521011202047504, -82.44934161345904 35.52112420209417, -82.44940061346435 35.5211532021061, -82.44956261346408 35.521329202158505, -82.44965661344833 35.52153320220958, -82.44968261343583 35.52164220223442, -82.44967661336227 35.52211520232998, -82.44973061331875 35.52245620240477, -82.44987861330095 35.52273120247584, -82.44994561330375 35.52278520249375, -82.45008661328654 35.52304920256189, -82.4501676132847 35.523148202590285, -82.45031761329228 35.52326020262848, -82.4505436133039 35.52342820268581, -82.45057061328981 35.52354920271317, -82.45049661323871 35.523802202757004, -82.45049661321835 35.52393420278386, -82.45050561321656 35.523956202789215, -82.45056461320428 35.524099202824345, -82.4506316131985 35.52420920285358, -82.4506586131894 35.52429720287425, -82.45088061318239 35.52458220295497, -82.45118961319298 35.52484620304031, -82.45119461319332 35.52484920304143, -82.45133761320392 35.52493420307343, -82.4514586132046 35.525060203111515, -82.45158661319539 35.525258203164846, -82.4516336131878 35.525357203189856, -82.45169361318604 35.52543420321165, -82.45189561319077 35.52562120327032, -82.45216461320474 35.52581920333825, -82.45233961320841 35.52598420338972, -82.45249361318744 35.52628620346692, -82.452709613171 35.526626203558266, -82.45273661316358 35.5267032035766, -82.45274961316409 35.526714203580205, -82.4528036131527 35.526846203612656, -82.45284361312721 35.527055203659174, -82.45293161312999 35.527132203683834, -82.45315961314405 35.52728620373858, -82.45322661313995 35.52738520376559, -82.45330861314334 35.527451203787436, -82.45332161314374 35.527462203790954, -82.45342861315399 35.52751120381192, -82.4534686131538 35.52755520382502, -82.4535766131294 35.52783020389191, -82.4535966131091 35.52798420392527, -82.45365061310281 35.52808320395099, -82.4539326131075 35.52835620403542, -82.45401361310896 35.52843420405965, -82.4541486131025 35.52862120411148, -82.45410861306712 35.52880820414539, -82.45415461306636 35.52886320416129, -82.45415561305808 35.52891820417255, -82.45428961304559 35.52914320423205, -82.45446461304921 35.52930820428354, -82.45458561304564 35.529462204327295, -82.45465261303305 35.52961620436546, -82.45469961300718 35.52983520441481, -82.45486261298451 35.53015820449719, -82.45488861298097 35.53020920451024, -82.45525861297884 35.53062120463202, -82.4553926129757 35.53078620467926, -82.45567461298181 35.53105020476193, -82.45580961297374 35.531248204815995, -82.45597761295087 35.53157720490009, -82.45613861295223 35.53174220495017, -82.45626061296147 35.53181320497719, -82.45647561299349 35.53183620500396, -82.45659661300527 35.53189020502731, -82.45669061300894 35.531967205052595, -82.45673061300545 35.53203320507018, -82.45675761297446 35.532264205119866, -82.45681861295914 35.53242920515963, -82.45685861296076 35.53246220517049, -82.45689861295206 35.532561205194696, -82.45701961294341 35.532748205245134, -82.4573496129347 35.53316020536279, -82.45736261292834 35.53321520537531, -82.45741661292719 35.53328120539426, -82.45748461290988 35.533467205439116, -82.45753861288149 35.53370920549382, -82.45760561286558 35.53388520553646, -82.45770561285853 35.53403920557805, -82.45785361285932 35.53419320562458, -82.45819061288054 35.53441820570488, -82.45839261289699 35.534528205748, -82.45862061292124 35.53461620578931, -82.45872161292705 35.53468720581412, -82.45879861292748 35.534767205838286, -82.45882261292782 35.53479120584559, -82.45888261291068 35.53496720588755, -82.45888361289397 35.53507720591, -82.45895061285093 35.53542920598846, -82.45905761284078 35.535610206036196, -82.45923961284383 35.535786206090684, -82.45965661287237 35.5360502061872, -82.45997961289031 35.53628120626732, -82.46004261289521 35.536317206281126, -82.45996761286247 35.536449206300176, -82.45986661281789 35.53663020632665, -82.45977061278921 35.536713206333644, -82.45970561276235 35.53681820634832, -82.45962761272935 35.536949206366906, -82.45946661264335 35.53733520642885, -82.45937061260116 35.53750620645379, -82.45920961252956 35.537798206496596, -82.45895261243037 35.53816720654523, -82.4586646123234 35.53855220659385, -82.45848761225862 35.53878320662269, -82.45845061220834 35.53907020667719, -82.45837361210185 35.53968020679329, -82.45827361207019 35.53977820680289, -82.4579736119752 35.54007320683207, -82.45787461194358 35.54017220684205, -82.45750461187014 35.54025120682006, -82.45653061161777 35.54084420684049, -82.45565461139047 35.541379206859325, -82.45497061110899 35.54247320701144, -82.45428661066774 35.54460620737471, -82.45382361036853 35.546053207621206, -82.4537956103513 35.54613520763503, -82.45374461031963 35.54628620766045, -82.45377161030908 35.54638420768317, -82.45379561030005 35.54646820770268, -82.45379261029632 35.546489207706685, -82.45378461028501 35.54655420771904, -82.45378261028127 35.546576207723376, -82.45378661027947 35.54659220772699, -82.45380061027412 35.546642207738586, -82.45380561027233 35.546659207742586, -82.45381161027208 35.54666720774479, -82.45383061027154 35.54669120775168, -82.45383761027146 35.54669920775396, -82.4538486102707 35.54671620775858, -82.45388461026884 35.54676720777264, -82.45389661026802 35.546785207777575, -82.454143610208 35.54744120793628, -82.45418861019719 35.54756020796505, -82.45433561016253 35.54794320805802, -82.45439761010374 35.54839220815563, -82.45438861002846 35.5488722082523, -82.45443760997468 35.549274208339064, -82.45446660994446 35.54950220838835, -82.45447360993715 35.54955720840027, -82.45426460980836 35.55016920850316, -82.45430560977364 35.550439208562274, -82.45436360971787 35.55086420865464, -82.45442260966186 35.551291208747536, -82.45446260962436 35.55157820880992, -82.45434460948317 35.55236920895855, -82.45426560944928 35.55250420897789, -82.45391160933126 35.55289020901999, -82.4535776092286 35.55319820904827, -82.45330260911201 35.5536602091139, -82.4530296089777 35.55423920920355, -82.45294860893763 35.55441220923043, -82.45246060873265 35.555219209344315, -82.45239760868502 35.55546120938701, -82.45234260864224 35.55568020942588, -82.45221160854221 35.55618920951584, -82.45215060849468 35.55643220955899, -82.45174660840742 35.5565642095443, -82.45053560814559 35.556963209500935, -82.45013260805841 35.55709620948661, -82.44971860796893 35.557232209471685, -82.449684607961 35.557247209471214, -82.44900860780496 35.557534209460066, -82.4487426077434 35.557648209455934, -82.44739860733857 35.55883220955844, -82.446016607005 35.55951320955475, -82.44493460674356 35.560048209552356, -82.44405460657329 35.56020820949438, -82.44337760645935 35.5602202094272, -82.44237460629027 35.560240209328164, -82.4388056058549 35.55923120875627, -82.43729460567052 35.55880420851415, -82.43723060566269 35.558786208503896, -82.4371096056479 35.558752208484584, -82.43703960563496 35.55876120847922, -82.43697460562264 35.55877120847458, -82.43373360501535 35.55923220823509, -82.43165360493965 35.55748820766681, -82.42690160402526 35.55832020734731, -82.42337060306863 35.56073820747563, -82.42042060253891 35.56100920722745, -82.41893260219173 35.561665207207746, -82.41875760215984 35.56168420719358, -82.41762060195275 35.56180720710168, -82.41621660160416 35.56256220711066, -82.41462960120832 35.56342820712342, -82.4145586011825 35.56351920713461, -82.4133486008966 35.564076207123335, -82.41196260055965 35.56477520712287, -82.41058760022995 35.565439207116306, -82.40966659990767 35.566542207245654, -82.40819159957057 35.567146207216645, -82.40688859927484 35.56766720718845, -82.40590059906657 35.567958207145956, -82.40474359887962 35.5679292070211, -82.40369259870673 35.567923206911715, -82.4038515988277 35.56730920680334, -82.4052965999189 35.56177720582815, -82.40540360018515 35.560163205511216, -82.40509860022115 35.55960220536592, -82.40525360077555 35.55616920468444, -82.40520260079074 35.55601520464797, -82.40513260080756 35.555831204603344, -82.40526060089829 35.55537920452473, -82.40539060094247 35.555232204508215, -82.40543660096681 35.55512320449076, -82.40539860098748 35.55494820445129, -82.40539960100388 35.55484320443014, -82.40539860102982 35.55467320439545, -82.40529160104916 35.554433204335666, -82.40523860105036 35.55436820431704, -82.40503960103813 35.55423420426935, -82.40481860103372 35.55402520420417, -82.40471160104087 35.55386420416048, -82.40465860105189 35.55373520412881, -82.40458960105242 35.55365820410603, -82.40436360103483 35.55352920405665, -82.40430760103453 35.55347120403907, -82.40431460106139 35.553304204005926, -82.40437560108336 35.55322720399655, -82.40449760111696 35.55314020399136, -82.40455160113586 35.55307520398372, -82.40458160116434 35.55292220395574, -82.40465060120273 35.55274720392729, -82.40471960123293 35.55262520390964, -82.4048636012789 35.55248120389518, -82.40497760133235 35.552256203861155, -82.40536760146797 35.551794203807376, -82.405394601481 35.551739203799016, -82.40539460149454 35.55165120378114, -82.40530760149703 35.55154120374984, -82.4052666015038 35.551453203727746, -82.40526760152247 35.551333203703486, -82.4053206015448 35.55124520369105, -82.40536160157698 35.55108020366171, -82.4053346015844 35.551003203643354, -82.40525360158284 35.55092620361934, -82.40515960157569 35.550871203598504, -82.40514660158205 35.550816203585995, -82.40515960159941 35.55071720356725, -82.4052606016534 35.55047520352846, -82.40524760165968 35.550420203515976, -82.40517960166031 35.550343203493284, -82.40504560164327 35.55031020347286, -82.4050996016876 35.55008020343168, -82.40510360168963 35.55007120343026, -82.40519360173018 35.54990420340558, -82.40537560182801 35.549464203334914, -82.40537560183948 35.5493902033199, -82.40537560184497 35.54935420331254, -82.40527260185617 35.54917120326477, -82.40528960186188 35.549152203262686, -82.40534360187891 35.549099203257484, -82.40536160188468 35.54908120325566, -82.40535060189039 35.54903220324454, -82.40547760196117 35.54870920319206, -82.40553960200084 35.54851820315963, -82.40568960209535 35.54806520308299, -82.4057406021358 35.54785720304599, -82.4057406021589 35.547707203015506, -82.40568860217371 35.547555202979275, -82.40562260218648 35.54740120294121, -82.40559860221201 35.54720920289976, -82.40562660224865 35.547001202860336, -82.40569260229204 35.54679020282433, -82.40571160230436 35.5467312028143, -82.40574360234535 35.546499202770384, -82.40574660237847 35.54628720272767, -82.40573460239017 35.54619820270836, -82.40572960239422 35.54616620270138, -82.40572660239751 35.54614220269613, -82.40570960240522 35.54607320268041, -82.40570260240872 35.54604320267355, -82.40569460241258 35.546009202665836, -82.40569360241277 35.54600720266533, -82.40564760242073 35.545906202640104, -82.40563260242325 35.54587320263185, -82.40550260244397 35.545599202562784, -82.40544660246489 35.54540320251731, -82.40541660250318 35.54512220245713, -82.40541560250581 35.54510420245334, -82.40538560258557 35.544553202338285, -82.40536660266685 35.54400520222505, -82.40537860271186 35.54372520216944, -82.40545460284378 35.54295020201976, -82.40547060287578 35.542759201982655, -82.40551260295676 35.542278201889225, -82.40551760299415 35.54204020184139, -82.4055106030035 35.54197220182686, -82.40550560301095 35.54191820181539, -82.40548460302351 35.541814201792064, -82.40548360302363 35.54181220179162, -82.40544260303767 35.54167720175992, -82.40536060305489 35.54147720171088, -82.4053166030662 35.54135620168179, -82.40530560306934 35.541324201674136, -82.40527360308297 35.5412012016459, -82.40525060309285 35.5411122016254, -82.40524760309434 35.54109920162252, -82.4052016031225 35.540867201570606, -82.40518860313185 35.54079220155405, -82.40517160314486 35.540689201531386, -82.40514860316229 35.54055120150097, -82.40514560316554 35.54052720149582, -82.40513360317978 35.540421201473045, -82.40513560319077 35.54035220145921, -82.40516460320592 35.54028520144863, -82.40520360322222 35.54022120143963, -82.40528560325309 35.540108201425134, -82.40530460325935 35.54008820142298, -82.40541960329615 35.539972201411224, -82.40552260330956 35.53999620142673, -82.40594960336783 35.54007620148682, -82.40602160337744 35.54009120149731, -82.40612560339099 35.540115201512855, -82.40626560340733 35.54015920153617, -82.40641760342339 35.540218201563775, -82.40659160344063 35.54029320159692, -82.40685560346472 35.54042020164989, -82.40708960348827 35.54051820169385, -82.407310603513 35.5405952017322, -82.40750960353712 35.54065220176422, -82.40769760356218 35.54069120179144, -82.40775360357074 35.54069620179825, -82.4079496035999 35.54071720182262, -82.40836660366791 35.540723201866676, -82.40849260368825 35.540726201880304, -82.4086556037145 35.540731201898105, -82.40887060375009 35.540731201920174, -82.40891160375669 35.540732201924605, -82.40899660377255 35.54072020193083, -82.40907260378663 35.54071020193663, -82.40913560379958 35.54069420193993, -82.40923460381961 35.5406702019452, -82.40938960385658 35.54059620194609, -82.40941960386539 35.54057120194406, -82.40950760389124 35.54049820193829, -82.40961760392327 35.540408201931335, -82.40963360392789 35.54039520193029, -82.40975660397356 35.540230201909445, -82.4098066039956 35.54014120189649, -82.40989660403453 35.539985201874096, -82.40998060406743 35.53986120185748, -82.41008060410155 35.539747201844655, -82.41020360413813 35.539641201835714, -82.4104826042146 35.53944420182436, -82.41064760425976 35.53932820181778, -82.4107446042883 35.539246201811075, -82.41079360430514 35.53919020180473, -82.41081860431335 35.53916320180184, -82.4108416043212 35.539137201798894, -82.41092060435206 35.53902120178347, -82.41092660435491 35.53900920178163, -82.41096160437093 35.53894320177185, -82.41099660438694 35.53887620176186, -82.41105360441811 35.53873520173906, -82.41105560441909 35.53873120173845, -82.41112960445597 35.53857120171359, -82.41122360449327 35.53842920169438, -82.41134060453051 35.53831320168284, -82.41148060456761 35.53822220167876, -82.4114906045702 35.538216201678544, -82.41165860460849 35.538148201682056, -82.41169260461518 35.538141201684105, -82.41166860462054 35.53808020166919, -82.41164260462322 35.538035201657415, -82.41157160462703 35.53793420162961, -82.41142960462984 35.5377632015802, -82.41141160463013 35.53774220157415, -82.41115860462995 35.5374712014931, -82.41096460462727 35.53728020143434, -82.41078660462317 35.53711520138249, -82.41058160461591 35.536942201326276, -82.41041560460738 35.5368192012842, -82.41035460460418 35.53677420126882, -82.41002860458225 35.53656620119305, -82.41000760458098 35.536552201188044, -82.40996960457875 35.53652620117888, -82.40990560457477 35.536483201163556, -82.40981960457233 35.53640620113907, -82.40980760457239 35.53639320113525, -82.40976160457272 35.536341201119974, -82.40970460457544 35.53626220109803, -82.40969060457752 35.53623420109085, -82.40965760458218 35.5361682010741, -82.40961460459228 35.53605620104697, -82.40956660461266 35.5358722010046, -82.40953460462626 35.53574920097634, -82.40950060464273 35.53560620094379, -82.40931160470589 35.53499220079963, -82.4092226047315 35.53473020073727, -82.40918760474152 35.53462720071272, -82.40908360475669 35.53441720065943, -82.40898260476114 35.534279200620965, -82.40888360476205 35.534167200588016, -82.40867760475074 35.53401920053687, -82.40846860473786 35.533878200486676, -82.40837160473347 35.53380220046126, -82.40823260472884 35.53368320042285, -82.40810860472881 35.53355020038304, -82.4079946047347 35.53338920033865, -82.4078666047475 35.533168200280606, -82.40778560475583 35.53302720024359, -82.40769660476052 35.53290120020891, -82.40758960476434 35.53276120016946, -82.40745560476299 35.532626200128256, -82.40715560475473 35.53235720004279, -82.40714260475426 35.532346200039285, -82.40696560475114 35.53217619998646, -82.40687060475256 35.53206519995415, -82.40680560475566 35.53197519992923, -82.40675860476195 35.531883199905714, -82.40674160476718 35.531831199893375, -82.40672460477218 35.53178019988126, -82.4067016047858 35.531667199855946, -82.40667960481248 35.53147019981365, -82.40667860481533 35.53145019980953, -82.40666860483736 35.53129619977723, -82.40665460487044 35.53106619972904, -82.40665660490616 35.53083619968255, -82.40665760490666 35.530834199682204, -82.40664960492846 35.53068319965077, -82.40663160494215 35.53057519962691, -82.40659960495593 35.53045119959843, -82.40654560496885 35.53030919956407, -82.40645660497904 35.53014719952202, -82.40616360500641 35.52965419939175, -82.40610460501362 35.52954419936337, -82.40607060501766 35.52948119934707, -82.4059986050274 35.52934019931102, -82.40588160504396 35.52910719925171, -82.405777605055 35.52892319920362, -82.40565560506425 35.52873219915227, -82.40540360507629 35.52838319905553, -82.40493360509127 35.527780198884685, -82.40476660509287 35.52759019882894, -82.4044096050925 35.527209198714885, -82.40425760509335 35.52704019866492, -82.404154605098 35.52689919862568, -82.40409660510514 35.52679019859756, -82.40405160511307 35.52669019857267, -82.40401560512753 35.526557198541944, -82.40398560514447 35.526415198510016, -82.40397660514954 35.52637219850041, -82.40392660519345 35.52603319842632, -82.4039166052164 35.5258731983928, -82.40392060523826 35.52573519836519, -82.4039426052613 35.525609198341854, -82.40398960529353 35.525450198314445, -82.40406960533548 35.525263198284655, -82.40411160535456 35.52518419827294, -82.4041566053749 35.525100198260525, -82.40417460538185 35.525074198257094, -82.4042586054132 35.5249611982427, -82.40438360545353 35.52483319822961, -82.4044286054669 35.52479419822625, -82.40452660549566 35.52471319821991, -82.40457660551004 35.52467319821689, -82.4047266055527 35.524557198208825, -82.40477760556695 35.52451919820628, -82.40482960558174 35.5244791982035, -82.40495060561754 35.52437619819499, -82.40506660565428 35.524262198183756, -82.40522160570771 35.52408119816293, -82.40535460575595 35.523910198141856, -82.40538760576858 35.52386319813568, -82.40548560580561 35.523728198118384, -82.40551560581824 35.52367819811133, -82.40559560584309 35.52360219810408, -82.40566260586202 35.52355119810063, -82.4056756058647 35.52354819810131, -82.40579660588877 35.52352119810827, -82.40593260591321 35.5235091981198, -82.40618260595336 35.52351619814693, -82.40629560597321 35.52350919815709, -82.40635160598276 35.52350719816241, -82.40650160601187 35.523479198172176, -82.40685160606276 35.52352419821729, -82.40790460621596 35.52366019835307, -82.40825560626685 35.52370619839849, -82.4083676062832 35.523720198412846, -82.40870560633219 35.52376519845668, -82.4088186063486 35.52378019847145, -82.4088976063601 35.52379019848155, -82.40913560639473 35.523821198512294, -82.40921560640626 35.52383219852275, -82.40927760641523 35.523840198530756, -82.40938260643044 35.523854198544406, -82.40946360644233 35.52386419855475, -82.40952660645152 35.523872198562856, -82.40958460645997 35.52387919857024, -82.40975860648561 35.523900198592315, -82.40981760649406 35.523908198600004, -82.41008860653365 35.52394219863482, -82.41063160661291 35.52401019870439, -82.4109036066529 35.52404319873904, -82.4109216066554 35.52404619874153, -82.41117660669333 35.52407319877319, -82.4112646067065 35.52408219878405, -82.41127460670822 35.52408219878506, -82.4115696067536 35.524104198819906, -82.41157660675462 35.52410519882081, -82.41166860676965 35.524106198830495, -82.41170460677561 35.52410619883418, -82.41181260679339 35.52410619884522, -82.41184860679921 35.52410719884918, -82.41212260684773 35.52408619887309, -82.41239060689789 35.524048198892814, -82.41250760692081 35.52402519890016, -82.41268460695532 35.523991198911496, -82.4127056069599 35.523984198912224, -82.41386160719036 35.52372819897894, -82.4144556073087 35.52359719901337, -82.41510560743811 35.523454199051166, -82.41537860749267 35.52339319906675, -82.41620060765624 35.52321319911466, -82.41647460771078 35.523153199130654)))",6301,37,021,003203,370210032031,2446,2446,106,2400,2291,39,19,13,0,38,46,1888,59,1829,1868,1794,28,17,7,0,22,20,1098,987,111
census_2010_blockgroups_view.fid--2dc29038_13ec899ba8f_-25ce,"MULTIPOLYGON (((-82.29963357360624 35.61912520658969, -82.29966857362334 35.61905220657848, -82.29970757364163 35.61897520656688, -82.29980557365803 35.61897420657683, -82.30010257370783 35.61896920660646, -82.3002145737265 35.61896820661776, -82.30029157373968 35.61896520662509, -82.30100157385729 35.61896220669775, -82.30129057390425 35.61896720672855, -82.30168657396823 35.618976206771244, -82.30195657401023 35.618993206802536, -82.30201357401899 35.61899720680922, -82.30233757406818 35.61902520684828, -82.30273857412791 35.61906720689824, -82.30299357416534 35.61909720693055, -82.3031075741822 35.61911020694496, -82.30332057421329 35.619136206972236, -82.30372857427345 35.619183207023795, -82.30420757434365 35.61924020708481, -82.30460857440464 35.619274207133024, -82.30495657445951 35.61929120717237, -82.30500157446639 35.619294207177596, -82.30528557451285 35.619297207207566, -82.30536857452708 35.61929420721551, -82.30543357453821 35.619291207221565, -82.30554957455789 35.61928820723287, -82.30562857457164 35.61928320724007, -82.30569457458314 35.61927920724602, -82.30574257456996 35.61941620727879, -82.3057595745656 35.61946220728986, -82.30578357456235 35.61950920730192, -82.30578457456173 35.619514207303006, -82.30632457464968 35.61952220736034, -82.30668857470978 35.619522207397914, -82.3075825748569 35.61952520749064, -82.30902757509286 35.61954220764311, -82.30940157515343 35.61955020768334, -82.30947657516548 35.61955220769143, -82.30990657523361 35.61957120773969, -82.31030557529516 35.619599207786564, -82.31048957532347 35.61961220780808, -82.31065157534793 35.6196272078279, -82.31138657545864 35.61969620791767, -82.31168957550379 35.619728207955404, -82.31203557555517 35.61976520799859, -82.31225857558834 35.61978920802647, -82.31251857562707 35.61981620805878, -82.31396857584232 35.61997220823987, -82.31432657589549 35.62001120828472, -82.31445257591409 35.620025208300596, -82.31448157591848 35.62002820830418, -82.31456957593159 35.620037208315054, -82.31459957593589 35.620041208318995, -82.31462957593037 35.620109208335876, -82.31464657592747 35.62014620834517, -82.31466957592752 35.620170208352356, -82.31468757592886 35.620181208356485, -82.31469857592725 35.6202032083621, -82.31484057593029 35.62033520840355, -82.31486357593157 35.620351208409176, -82.31533857595636 35.62069820852852, -82.31549457595835 35.62085220857586, -82.3156625759394 35.62115420865449, -82.31573957594324 35.62121120867405, -82.31581057594674 35.62126420869208, -82.3159985759669 35.621335208725895, -82.3161195759804 35.621377208746914, -82.31628157599829 35.62143420877516, -82.31660157603116 35.62156320883432, -82.31662457603363 35.6215722088386, -82.31698157607816 35.62166520889423, -82.31720357608933 35.62183020895065, -82.31730457608484 35.62196720898882, -82.31734557604396 35.62227520905561, -82.31733157597948 35.62267720913578, -82.31733157597532 35.62270420914123, -82.31734457592046 35.62307220921727, -82.3173265758988 35.62319320923999, -82.3173205758926 35.623227209246274, -82.31730457587386 35.62333120926566, -82.31729957586761 35.62336620927232, -82.31729657586398 35.62338620927608, -82.31728657585295 35.62344720928742, -82.31728457584938 35.62346820929138, -82.31719657579657 35.623715209332566, -82.31714457578038 35.6237642093371, -82.3171225757734 35.623786209339315, -82.31690757572251 35.623885209337224, -82.31678557569283 35.62394720933727, -82.31676157568646 35.62396220933781, -82.31669557567086 35.623993209337264, -82.31658457564373 35.62405020933742, -82.31635557557428 35.62425420935515, -82.3163185755601 35.62430620936192, -82.31626857554042 35.62438020937176, -82.31622157551152 35.62451720939478, -82.3162065754938 35.62461520941303, -82.31619457548052 35.624688209426665, -82.31619557547535 35.62472320943383, -82.31620157545113 35.62488620946761, -82.31624757543376 35.62504720950499, -82.31626857542653 35.62511620952123, -82.31629357542627 35.62514520952966, -82.31636057542256 35.6252402095558, -82.31636757542154 35.625254209559365, -82.31656557529945 35.62625520978302, -82.31649957525855 35.62644920981558, -82.31641357522385 35.62658120983352, -82.31629057517374 35.62677420985999, -82.31620957512717 35.62698820989503, -82.31608857502046 35.62754920999642, -82.31609557501272 35.62760621000876, -82.31612957498051 35.627851210062, -82.31618157497293 35.62795521008845, -82.31623757498113 35.62796221009562, -82.31628457498833 35.62796621010125, -82.31649757502052 35.627985210127115, -82.3165975750363 35.62799021013848, -82.31670257505255 35.627997210150745, -82.3168815750811 35.628003210170384, -82.31704157510667 35.62800921018815, -82.31734357515406 35.6280252102225, -82.31741757516598 35.62802721023051, -82.31759757519497 35.62803221025018, -82.31772357521518 35.62803621026389, -82.31777857522395 35.62803821026999, -82.31832157530945 35.6280652103315, -82.31841657532439 35.62807021034232, -82.31844857532877 35.6280762103468, -82.31848157533173 35.628092210353564, -82.31849457533204 35.6281042103572, -82.31854257532767 35.628183210378225, -82.31854857532826 35.62818621037941, -82.31857257532556 35.62822921039063, -82.31865857532932 35.62829621041308, -82.31867057533027 35.628303210415744, -82.31911457536229 35.6285702105158, -82.319262575373 35.62865921054912, -82.31944357538679 35.62876321058889, -82.31963557540152 35.62887321063098, -82.31998557542681 35.62908321070978, -82.32016557543979 35.62919121075022, -82.3199855753789 35.629393210772676, -82.31957557523964 35.62985521082411, -82.31944957519627 35.63000121084082, -82.31942557518774 35.630030210844176, -82.3192695751353 35.630203210863236, -82.31913557508992 35.63035321087983, -82.31873657495451 35.630802210929815, -82.31860357490916 35.63095321094681, -82.31854457488902 35.63102021095431, -82.31852857488381 35.63103721095605, -82.31830557480748 35.63129221098491, -82.31823157478203 35.63137721099447, -82.31818757477596 35.63137021098852, -82.31813857476783 35.63137021098349, -82.31802857475134 35.63135921096985, -82.31786157472621 35.63134321094951, -82.31742057465695 35.63132021089926, -82.31721757462492 35.631310210876265, -82.31684257456537 35.631295210834594, -82.31617657445932 35.63126921076056, -82.31593357442118 35.63125621073291, -82.31571757438677 35.63124821070897, -82.31552557435599 35.631242210687944, -82.31534357432716 35.631234210667564, -82.31524457431141 35.63123021065655, -82.3149475742642 35.631218210623565, -82.3149215742601 35.6312172106206, -82.31484957424799 35.63121821061333, -82.31413457413194 35.63120521053699, -82.31407957412351 35.631201210530534, -82.31386157408949 35.63118821050539, -82.31357057404547 35.631162210470045, -82.31349357403465 35.6311492104595, -82.31343857402891 35.631128210449546, -82.31339757402598 35.631103210440315, -82.31336257402438 35.6310762104312, -82.31328657402621 35.63098321040449, -82.31319457402678 35.63088121037431, -82.31307157402537 35.6307592103368, -82.31292857401874 35.630649210299765, -82.3128045740104 35.63057121027109, -82.31269757399933 35.63052821025134, -82.3125845739853 35.63049821023364, -82.31248857397173 35.63048321022068, -82.31237457395478 35.6304712102065, -82.3121225739151 35.630459210178024, -82.31202057389976 35.63044921016553, -82.31200757389807 35.63044621016354, -82.31193057388732 35.63043321015292, -82.31184657387857 35.630400210137644, -82.3117855738733 35.630369210125, -82.31172857387018 35.63032821011081, -82.31168257386904 35.63028721009775, -82.31164657386923 35.63024721008592, -82.31159257386977 35.630186210068004, -82.31154957387258 35.6301222100505, -82.3115075738791 35.630035210028566, -82.31147557388715 35.62994921000777, -82.31145857388952 35.629915209999105, -82.3114075738969 35.62981320997313, -82.31139157389951 35.62977920996461, -82.31133657390781 35.62966720993619, -82.31127157391761 35.62953420990255, -82.31117657392929 35.62935720985683, -82.31116257393022 35.62933620985115, -82.31109557393528 35.62923220982309, -82.31103457394008 35.62913620979726, -82.31085457395447 35.62885120972087, -82.31084257395536 35.62883220971578, -82.31080257396117 35.62875220969539, -82.31079557396157 35.62874220969271, -82.31076657397725 35.62861020966296, -82.31076257398617 35.62854820964987, -82.31078357400986 35.62841720962543, -82.31084057405486 35.62818720958473, -82.31092157411867 35.6278612095268, -82.31103957420413 35.627435209452635, -82.31106057422132 35.62734620943665, -82.3110695742365 35.627258209419736, -82.3110755742575 35.62712820939395, -82.3110525742857 35.62692220934981, -82.3110065743444 35.62649320925793, -82.3109945743683 35.62632620922286, -82.31098457439063 35.62617120919033, -82.31097657442328 35.62595120914488, -82.31098157444038 35.62584620912405, -82.31098657444431 35.62582620912056, -82.31100357445567 35.62577120911114, -82.31103757447136 35.62570620910144, -82.31106457447936 35.625683209099556, -82.31101757447558 35.62565720908942, -82.31097157446962 35.6256462090825, -82.31087557445537 35.625636209070535, -82.31039857437956 35.6256172090175, -82.31006157432589 35.62560420898006, -82.3093115742087 35.62556120889396, -82.30922657419545 35.6255562088842, -82.30897957415459 35.62555620885875, -82.3088115741221 35.6255872088477, -82.30869957409595 35.62563620884607, -82.30862357407618 35.62568320884776, -82.3085875740667 35.62570620884872, -82.30847057403214 35.625804208856664, -82.30845457402702 35.625820208858144, -82.30829157397402 35.62598920887568, -82.30805357389227 35.626263208906764, -82.30800457387511 35.62632220891365, -82.30761357373719 35.62679620896949, -82.30701657353723 35.62745120904086, -82.30671157343188 35.627806209081456, -82.30653757337193 35.628008209104536, -82.30645957334465 35.62810120911533, -82.30623857326685 35.62836820914671, -82.30609757321463 35.62855520917013, -82.3059895731681 35.62874020919655, -82.30580357307072 35.629171209264875, -82.30562057297507 35.62959420933185, -82.30546357288534 35.63000620939925, -82.30542057285592 35.63015020942403, -82.30538157281293 35.63038620946788, -82.30538057279578 35.63049620949016, -82.3054085726893 35.63121420963874, -82.30539557266698 35.63134420966378, -82.30539457266379 35.63136420966768, -82.30538657265781 35.63139420967299, -82.3053635726395 35.631488209689685, -82.30533157262195 35.63156720970249, -82.30528957260515 35.631631209711095, -82.30523657258848 35.63168220971599, -82.30518157257491 35.63171120971614, -82.30510457255934 35.63172920971185, -82.30500657254593 35.63171120969807, -82.30491457253656 35.63167420968116, -82.30477957252404 35.631611209654416, -82.30471557251755 35.6315842096423, -82.3046185725053 35.63156020962741, -82.30452357249084 35.63155220961604, -82.30444957247836 35.631554209608765, -82.30430057244715 35.63159620960196, -82.30412457240956 35.63165120959495, -82.3040455723933 35.631672209591024, -82.3039585723775 35.63168120958391, -82.30386157236151 35.6316812095739, -82.30370857233908 35.63166320955447, -82.30367757233518 35.63165520954964, -82.3035475723187 35.63162320952977, -82.30335757229423 35.631578209501036, -82.3030705722554 35.631523209460234, -82.302727572209 35.63145720941145, -82.3025615721893 35.63140720938421, -82.30240657217294 35.631347209356015, -82.30229157216156 35.631298209334254, -82.30217757215188 35.63123920931048, -82.30208157214648 35.63117120928684, -82.30199357214558 35.63108320925984, -82.30193757215262 35.630978209232744, -82.30193057215786 35.6309362092235, -82.3019245721613 35.63090820921719, -82.3019205721645 35.63088320921176, -82.30191357217214 35.63082620919941, -82.30191157217601 35.63079920919378, -82.30190457218623 35.630726209178185, -82.30190457219032 35.630699209172775, -82.30190757221497 35.63054320914137, -82.30191557223468 35.63042420911803, -82.30191657223892 35.63039820911292, -82.30192157224765 35.63034720910309, -82.30193757225737 35.63030120909539, -82.30183957222113 35.63043120911165, -82.30164557215357 35.630660209138114, -82.30152257211071 35.63080620915503, -82.3012355720081 35.6311632091979, -82.30096657191041 35.63150720923994, -82.30084957186446 35.63167920926274, -82.30078757184289 35.63175220927119, -82.30076657183545 35.63177820927428, -82.30066957180578 35.63186620928219, -82.30053057176798 35.631962209287316, -82.30042157173888 35.63203420929064, -82.3003795717277 35.63206120929184, -82.30031857171141 35.63210120929362, -82.30026157169426 35.632151209297945, -82.30022557168306 35.63218520930108, -82.30017357166705 35.63223320930547, -82.29985857157493 35.63249220932558, -82.29972857153723 35.632597209333404, -82.2993825714333 35.632899209359024, -82.29926257139391 35.63302620937243, -82.29917957135382 35.63319620939836, -82.29912057131085 35.633411209435884, -82.29907757127611 35.63358920946766, -82.29906457126819 35.63362720947392, -82.29904857125746 35.63367920948287, -82.29897357122728 35.63379420949845, -82.29874557116271 35.633968209510236, -82.29870157115943 35.63394220950045, -82.29863757115368 35.63391120948749, -82.29862057115209 35.633903209484174, -82.29853157114172 35.6338752094693, -82.29838157112098 35.63384920944849, -82.29828057110558 35.63384120943649, -82.2981935710921 35.633835209426344, -82.2981595710856 35.633841209424006, -82.29803457106155 35.633863209415566, -82.29799957105472 35.63387020941338, -82.2978845710304 35.63390420940837, -82.2977985710102 35.6339432094075, -82.29766857098602 35.6339602093975, -82.29754357096269 35.63397820938823, -82.29734657092689 35.633999209372206, -82.29726057090735 35.63403320937018, -82.29723457090003 35.634053209371594, -82.29717657088298 35.63410120937532, -82.29709257085729 35.63417820938228, -82.29690457080679 35.63430320938828, -82.29686657079269 35.63435420939468, -82.29682757077651 35.63441720940348, -82.29670157071342 35.63469020944587, -82.29659157070218 35.63464520942534, -82.29654457069739 35.63462620941668, -82.29630357066885 35.634553209376996, -82.29628357066547 35.63455420937517, -82.2962255706556 35.634556209369535, -82.29615157064423 35.63455020936075, -82.29604757062707 35.634550209349996, -82.29595657061432 35.63453520933756, -82.2959095706114 35.63450420932637, -82.29588057061395 35.634457209313844, -82.29587057061491 35.634440209309396, -82.29587357062648 35.63436820929509, -82.29591257065248 35.634242209273545, -82.29598257068774 35.634089209249694, -82.29611957074908 35.633839209213185, -82.29623357081141 35.633558209167866, -82.29631557084176 35.633449209154215, -82.29646057088704 35.6333112091412, -82.29660157093089 35.633178209128715, -82.29671057096769 35.6330572091154, -82.29677057098644 35.63300020911004, -82.29680657099928 35.63295520910457, -82.29682757100665 35.63293020910176, -82.29685957101937 35.63288220909523, -82.29689457103237 35.63283520908937, -82.29690857103735 35.63281820908733, -82.2969475710503 35.632776209082834, -82.2969085710504 35.63273420907024, -82.29689257105281 35.63270120906194, -82.29689057106138 35.63264420905019, -82.2968935710728 35.63257320903604, -82.2968935710764 35.63255020903135, -82.29689557108735 35.632481209017584, -82.29690657110594 35.632373208996825, -82.29691257112663 35.63224620897165, -82.29691257114565 35.63212320894676, -82.29695257119944 35.631818208888944, -82.29696157121005 35.631759208877924, -82.29703657124867 35.63159020885135, -82.29720857131898 35.631319208814034, -82.29725857133914 35.63124220880365, -82.29734657137283 35.63111820878754, -82.29743457140242 35.631021208776914, -82.29749857142625 35.63093520876605, -82.29752857144119 35.630870208755994, -82.29754657145506 35.63080020874363, -82.29754557146825 35.630714208726104, -82.29753057147909 35.630628208707144, -82.29749457148641 35.63054220868593, -82.2974625714905 35.630482208670486, -82.29746257149105 35.63047820866968, -82.29746357150111 35.63041420865672, -82.29753257154354 35.63021420862329, -82.29754057155161 35.63017020861513, -82.29754757155925 35.630128208607374, -82.29755157156279 35.630109208603926, -82.29755357157981 35.630002208582376, -82.29755457158211 35.629988208579675, -82.29755657158678 35.62996020857419, -82.29756557160606 35.6298452085518, -82.29763957165403 35.62961420851253, -82.29765857166595 35.62955720850294, -82.29772057168951 35.629471208491935, -82.29785857173849 35.629302208471806, -82.29792057176032 35.62922720846305, -82.2979935717913 35.629105208445836, -82.29811457183739 35.62893620842392, -82.29819957187568 35.628779208400836, -82.2982615719072 35.62864220837947, -82.29826657192633 35.62852320835587, -82.29825057194431 35.628390208327176, -82.29817657198363 35.62805720825197, -82.29817057199493 35.62797820823532, -82.29819857200984 35.62791120822466, -82.29830157204003 35.627826208217996, -82.29840457206562 35.62777120821753, -82.29854457209412 35.62773620822483, -82.29869357212323 35.62770720823432, -82.29883057215801 35.627628208232416, -82.29888457217177 35.62759720823168, -82.2992345722707 35.62733120821378, -82.29938757231545 35.627205208204046, -82.29941257232488 35.6271712081997, -82.29949957235698 35.62705620818529, -82.2995285723696 35.62700620817814, -82.29955657239003 35.626903208160144, -82.29960557241908 35.626768208137854, -82.29962157243646 35.626673208120195, -82.29965557247178 35.62648120808475, -82.29965957249516 35.626334208055276, -82.2996375725141 35.62618820802337, -82.29958157253898 35.625968207972974, -82.2995655725544 35.62585120794764, -82.29956957256914 35.62576020792957, -82.29951757257899 35.62564120790003, -82.29942357258061 35.62553020786784, -82.29934957257817 35.62546720784742, -82.29924657256915 35.62541520782623, -82.29913357255522 35.62538520780847, -82.29902057253621 35.62538720779721, -82.2987705724939 35.62539420777286, -82.29855757244894 35.625457207763695, -82.29849057243275 35.62549020776349, -82.29823957239714 35.62545220772985, -82.29748657229035 35.62533920762924, -82.29723657225475 35.6253022075959, -82.29715657223751 35.625328207592965, -82.29713057223401 35.62532320758928, -82.29704357222184 35.6253092075775, -82.29693257220508 35.62529920756395, -82.29681157218188 35.625320207555724, -82.29680557218059 35.62532220755557, -82.2967035721577 35.62536120755294, -82.29660257213514 35.62539920755023, -82.29656757212716 35.625413207549464, -82.29645357210647 35.625425207540104, -82.29636457209469 35.62540620752709, -82.29629057208656 35.625380207514155, -82.2961895720751 35.62534620749686, -82.29605457205997 35.62530020747364, -82.29602657205642 35.62529320746933, -82.29584857203301 35.62525420744307, -82.29568557200741 35.6252462074246, -82.29552157197679 35.62526920741238, -82.29549457197156 35.625274207410534, -82.29536257194152 35.62532720740773, -82.29535457193975 35.62533020740753, -82.29522557190812 35.625397207407815, -82.2951725718931 35.62543720741043, -82.29507657186562 35.625512207415774, -82.29489157180639 35.625698207434404, -82.2948145717709 35.625845207456315, -82.29477157174817 35.625946207472325, -82.29472557172303 35.626059207490556, -82.29466557170122 35.62613620749999, -82.29466957171907 35.62602520747784, -82.29472357175815 35.62583020744385, -82.29476057177808 35.625741207429655, -82.29480857180319 35.62563020741204, -82.29495457186415 35.62539220737885, -82.29512457192571 35.62517520735236, -82.29518857194681 35.62510720734512, -82.29528157197613 35.62501720733642, -82.29534857199991 35.62493520732672, -82.29546457204917 35.624740207299084, -82.29551257206936 35.624661207288, -82.29557057209576 35.62455220727195, -82.29560657211464 35.624469207258755, -82.29566157213716 35.624382207246775, -82.29572857216137 35.62429720723649, -82.2957685721734 35.624262207233436, -82.29581057218573 35.62422720723073, -82.29589257220664 35.62417920722946, -82.2960375722365 35.62414120723669, -82.29621857227212 35.624104207247846, -82.29627957228404 35.624092207251685, -82.29637757230267 35.624076207258575, -82.29634557230229 35.62404420724874, -82.29630557230409 35.62399020723367, -82.29624157230714 35.623902207209184, -82.29612657230672 35.623782207173065, -82.29609157230851 35.62373320715947, -82.29607057230952 35.623704207151405, -82.29604357231595 35.62363420713445, -82.29603357231848 35.62360720712792, -82.29601957233075 35.62351320710739, -82.29601857234442 35.623423207089, -82.29603557236322 35.623320207069895, -82.29607057238462 35.623219207053026, -82.29613457241172 35.62311220703788, -82.29628457246824 35.622907207011764, -82.2964125725245 35.622680206978856, -82.29646357255116 35.622562206960225, -82.29649157256536 35.62250020695052, -82.296610572616 35.622299206922015, -82.29674957266933 35.62210320689654, -82.29686057270997 35.6219592068788, -82.29701257276133 35.62178920685994, -82.29717857281385 35.62162720684423, -82.29736657286897 35.621471206831956, -82.29745957289485 35.62140320682773, -82.29754657291669 35.62135520682698, -82.29761757293325 35.621324206828, -82.29806757302619 35.621203206849856, -82.2982095730577 35.621151206853945, -82.29848057311935 35.6210422068598, -82.2985675731421 35.620988206857774, -82.29862857315948 35.620940206854364, -82.29873257319822 35.6208012068369, -82.29878757321957 35.62072220682653, -82.29891857326623 35.62056020680716, -82.29902757329948 35.620461206798346, -82.29914857333186 35.62038120679455, -82.29921657334972 35.6203382067929, -82.2994465734097 35.620196206787725, -82.29995857354578 35.61986320677299, -82.30014557359785 35.61972620676449, -82.30037557366366 35.619546206751686, -82.3003815736637 35.61955220675354, -82.30040057367174 35.619520206749, -82.3004155736776 35.61949820674603, -82.30042457368768 35.619443206735795, -82.30042357369197 35.61941420672984, -82.30042357369753 35.61937820672252, -82.30024657366862 35.619376206703855, -82.2997175735822 35.61937020664809, -82.29970257357972 35.619370206646565, -82.29954157355303 35.61937120663015, -82.29956657356993 35.6192882066159, -82.29958957358518 35.619214206603225, -82.29963357360624 35.61912520658969)))",6378,37,021,003102,370210031023,1196,1196,32,1163,1076,65,3,2,0,17,33,971,19,952,951,890,47,3,0,0,11,20,619,541,78
census_2010_blockgroups_view.fid--2dc29038_13ec899ba8f_-25cd,"MULTIPOLYGON (((-82.30273457944782 35.584641199911864, -82.30271757944804 35.584622199906256, -82.3026685794487 35.58456519988967, -82.30265257944903 35.58454619988419, -82.30264657945216 35.58451919987807, -82.30262857946158 35.58443919985996, -82.30262257946455 35.5844131998541, -82.3025855794821 35.584260199819234, -82.30254457949648 35.58412319978721, -82.30249857951812 35.58393419974409, -82.3024775795325 35.583818199718486, -82.30241557957662 35.583466199640604, -82.30236957960331 35.583244199590816, -82.30231857962472 35.58305119954636, -82.30230157963862 35.58294319952273, -82.30230057965078 35.58286319950637, -82.30231557966151 35.58281019949718, -82.30235357967672 35.58275219948929, -82.30241657969275 35.58271519948831, -82.30250357971195 35.582684199491005, -82.3026905797454 35.58266719950682, -82.30298657979306 35.58267519953893, -82.30307457980834 35.58267019954703, -82.30321757983306 35.5826631995603, -82.30368557990465 35.5826991996158, -82.30380257992273 35.58270719962952, -82.30394757994216 35.58273619965028, -82.30411057996267 35.582778199675666, -82.30419257997339 35.58279619968777, -82.30435857999494 35.58283419971252, -82.30456458002689 35.58284719973644, -82.3046935800478 35.58285019975035, -82.30486058007641 35.58284319976612, -82.30502758010678 35.58282519977965, -82.30512158012645 35.582798199783866, -82.3053235801786 35.58267619977996, -82.30553458022743 35.58258519978322, -82.30566958025966 35.582521199784104, -82.30569458026541 35.58251019978452, -82.30583958030887 35.58238419977385, -82.30597558035248 35.58224719976003, -82.30604158037599 35.58216519975018, -82.30625458039552 35.58226619979268, -82.3062835803982 35.58228019979851, -82.30651858044516 35.58222719981193, -82.30667558050202 35.58202719978755, -82.3066525805259 35.58184719974862, -82.30663958053995 35.58174219972599, -82.30666258056354 35.58161419970244, -82.30716758067382 35.5814401997192, -82.30753358076265 35.58125619971951, -82.30780358083251 35.581092199714014, -82.3078095808354 35.58108019971222, -82.30792058088626 35.58086919968086, -82.30808058093592 35.58071819966667, -82.3082945810113 35.5804591996362, -82.30845458109191 35.580108199581375, -82.3084945810991 35.580104199584696, -82.30853158111148 35.58006319958018, -82.30855858112379 35.580012199572664, -82.3086045811483 35.57990319955524, -82.30863058116105 35.57984819954682, -82.30865858117443 35.579791199538164, -82.3087135812011 35.57967719952064, -82.3087355812133 35.579622199511775, -82.30876758123532 35.579513199492936, -82.30879058124874 35.57945119948278, -82.30882158126313 35.57939119947379, -82.30889058129304 35.579271199456436, -82.30892758130874 35.579209199447774, -82.30896858132462 35.57915019943998, -82.30906258135734 35.57903819942693, -82.30910758137301 35.578985199420835, -82.30919958140436 35.57888019940896, -82.30924758142045 35.57882719940315, -82.30929558143654 35.578774199397365, -82.30934158145273 35.57871919939092, -82.30938258146796 35.57866419938399, -82.30946058149686 35.578560199370955, -82.30950058151114 35.57851019936491, -82.30956758153778 35.57840919935135, -82.30959658154944 35.578365199345384, -82.30961758156027 35.57831719933777, -82.30963758157021 35.57827419933114, -82.30966758158695 35.57819819931881, -82.30975458161004 35.578141199316214, -82.30981158162018 35.57813619932105, -82.30987858162652 35.578167199334246, -82.30990958162685 35.578198199343724, -82.3099245816236 35.57823519935284, -82.30992258161051 35.57831819936942, -82.3099095815963 35.57839619938396, -82.30990358158155 35.57848519940132, -82.30994458156552 35.578633199435586, -82.31001358152469 35.57897119951133, -82.31002158151392 35.579049199527994, -82.30999058149378 35.57914719954469, -82.30997958147756 35.57924019956241, -82.31015658150982 35.57922019957656, -82.31028658154796 35.57911219956804, -82.3104535816114 35.57888019953822, -82.31053058163675 35.57879819952951, -82.3105665816499 35.57875119952359, -82.31063058167199 35.57867719951523, -82.31066258168373 35.57863519951002, -82.31070058169719 35.578588199504416, -82.3107405817114 35.578539199498536, -82.31078658172667 35.5784891994931, -82.31082858174105 35.578441199487706, -82.31092658177182 35.578346199478524, -82.3109695817855 35.57830419947445, -82.31100858179971 35.57825319946812, -82.31104658181296 35.57820819946289, -82.3110855818267 35.57816119945744, -82.31114658184688 35.57809519945032, -82.31119458186554 35.578026199441226, -82.31130858189849 35.57793419943426, -82.31136158191606 35.57787719942821, -82.31139758192406 35.57786419942928, -82.31139458193218 35.577808199417575, -82.31136058194231 35.57770619939333, -82.31134358194703 35.57765719938169, -82.31129958196388 35.57750119934552, -82.31126758197946 35.577366199314845, -82.31124758199805 35.57722419928393, -82.3112435820057 35.57717019927256, -82.31128658202402 35.57709719926219, -82.31139258206886 35.57692019923719, -82.31141358207873 35.576879199231, -82.31145258209658 35.576805199220026, -82.31137658212859 35.57651619915355, -82.31136558213306 35.57647519914411, -82.31117058214926 35.57616219906047, -82.31086658215682 35.57578819895328, -82.31067958216155 35.57555719888711, -82.31085458218787 35.57557419890864, -82.31094758220583 35.57555719891474, -82.31111358224214 35.57549919892002, -82.31113658224723 35.57549119892085, -82.31133158227767 35.57550219894319, -82.31155258230801 35.57554219897399, -82.31185658234983 35.57559619901626, -82.3120255823756 35.57561019903652, -82.31204858237935 35.57561019903886, -82.31225958241352 35.575614199061434, -82.31248058244816 35.575626199086635, -82.31257958246333 35.57563419909848, -82.31263358247257 35.57563219910357, -82.31280158250101 35.57562719911994, -82.31302658254195 35.57560219913804, -82.31321258256945 35.57562319916146, -82.31344958260505 35.57564619919055, -82.31355158262109 35.57565119920209, -82.31371958264526 35.57567419922399, -82.31390658267232 35.57569919924835, -82.31407658269683 35.57572219927054, -82.31422458270933 35.57579919930139, -82.31433258271464 35.57588019932894, -82.31451558272374 35.57601719937563, -82.31462758272932 35.57610119940426, -82.31588458281897 35.57686419968854, -82.31617558283975 35.57704119975443, -82.31647758285652 35.57725519982896, -82.31667258282516 35.57766719993271, -82.31684358283057 35.57781519998034, -82.31653958265524 35.57862620011357, -82.31562958212946 35.58105920051362, -82.31547958204271 35.58146020057952, -82.31543658201839 35.58157220059786, -82.31532558195406 35.581870200646854, -82.31591258204104 35.58193420072034, -82.31612758207267 35.581959200747555, -82.317342582302 35.58177320083506, -82.31766958236305 35.58172720085936, -82.31825758247219 35.58164920090402, -82.32053658276622 35.58218220124699, -82.321394582877 35.58238220137595, -82.32220158304516 35.582156201413284, -82.32343158326947 35.58201820151197, -82.3250865835493 35.581976201673896, -82.32562858366596 35.581800201694, -82.32619058378803 35.58161020171334, -82.32704158404326 35.5808672016502, -82.32713258406984 35.58079220164431, -82.32784758427731 35.580213201600515, -82.32824858447995 35.57932920146232, -82.32854358458124 35.57898820142352, -82.32961958495048 35.57774720128242, -82.33042358517551 35.57714920124389, -82.33077858527456 35.57688720122724, -82.33123258544725 35.57625420114552, -82.33163158554716 35.57603320114172, -82.33182158560132 35.575886201131475, -82.33213858570811 35.57553320109246, -82.33236558579554 35.575209201050036, -82.33270258594318 35.57461320096384, -82.33302958608236 35.57406120088539, -82.33354558622648 35.573679200861, -82.33433258637791 35.573540200913875, -82.33510958651411 35.573489200983516, -82.33568858664029 35.57329120100294, -82.33625158685881 35.572477200895705, -82.33647858694674 35.57215020085268, -82.33661558706692 35.571517200738334, -82.33665358711875 35.571222200682314, -82.33700858731486 35.57033120053802, -82.33723558739183 35.570075200509464, -82.33754358749617 35.5697282004707, -82.3376345875211 35.56966420046707, -82.33777058755805 35.56957020046202, -82.33810358764836 35.56934120044982, -82.33819558767307 35.5692792004467, -82.33913958786572 35.56904120049558, -82.34047458814558 35.568656200554855, -82.34100758820392 35.568848200648766, -82.34138258824832 35.5689622007104, -82.34153958826668 35.56901120073655, -82.34198258831364 35.56918120081666, -82.34248858839706 35.569182200869, -82.34276758841122 35.56938920093971, -82.34300258842606 35.56954420099538, -82.34324658844311 35.56969520105114, -82.34359758846747 35.56991320113158, -82.3441205884834 35.570370201278216, -82.34459858849742 35.570791201412874, -82.3452835885456 35.571212201568834, -82.34546858856324 35.57129620160491, -82.3457985885942 35.57144820166975, -82.34630558864353 35.57167220176747, -82.3465835886704 35.5717952018211, -82.3475315887791 35.572106201981796, -82.34801258882904 35.572297202070054, -82.34837058886627 35.57243920213578, -82.34902058891801 35.5728002022759, -82.34926358891948 35.57305120235195, -82.34987558887829 35.573973202602126, -82.35015358881857 35.57465820276985, -82.35062258881077 35.575211202930454, -82.35108158881481 35.57567620307206, -82.35170258885096 35.576107203223486, -82.35191158886312 35.57625220327446, -82.35287658892581 35.57687920350109, -82.35326358896683 35.57702820357127, -82.35345958896363 35.57725920363827, -82.35375458897343 35.5775112037198, -82.35404958900699 35.57760920377014, -82.35413358901724 35.57763320378363, -82.35519058914417 35.577942203955146, -82.35594858926682 35.577959204036674, -82.35611658929398 35.57796320405475, -82.35696258947493 35.577696204087665, -82.35728658955051 35.57755320409197, -82.35757258961706 35.57742820409602, -82.35770958965051 35.577358204095916, -82.35820058979105 35.57697320406831, -82.35836658983943 35.576837204057796, -82.35886758998487 35.57643120402695, -82.35903459003327 35.57629620401669, -82.35912659004879 35.57629420402575, -82.35985359023394 35.57587220401492, -82.36048659038116 35.5755962040241, -82.36060159040767 35.575547204025945, -82.36132959053356 35.57551120409353, -82.36179159060727 35.575528204144575, -82.36189959062452 35.57553220415655, -82.36243059071492 35.575515204207754, -82.36279759077394 35.575525204247526, -82.36287159078594 35.57552720425559, -82.3632175908416 35.57553720429325, -82.36424059100403 35.575580204407245, -82.36451559105332 35.57555520443043, -82.36506659115196 35.5755062044772, -82.36522459116598 35.57558420450939, -82.36532359118205 35.57558620452001, -82.366129591312 35.57560720460719, -82.36687659145306 35.57549320466089, -82.36693859146348 35.575492204667086, -82.36733959153085 35.57548520470689, -82.36759959157436 35.5754812047329, -82.36768259159236 35.575453204735744, -82.36784059162659 35.575401204741475, -82.36797859164642 35.57542020475952, -82.36815559168447 35.57536320476616, -82.3684915917619 35.575221204771886, -82.36886259184698 35.57506720477884, -82.36953259201249 35.57471220477571, -82.36985159208535 35.57458120478195, -82.37046959222606 35.57433120479479, -82.37109959236552 35.57410220481311, -82.37154059246006 35.573961204829835, -82.37159459247495 35.57392320482773, -82.37221859262111 35.57364420483527, -82.37297759275653 35.573579204900184, -82.37316359278957 35.573564204916316, -82.37378159286763 35.573720205011576, -82.37403959289367 35.57382820506012, -82.37401159286112 35.57400920509392, -82.37400259284969 35.57407420510618, -82.37382959276195 35.574457205166226, -82.37380159274811 35.574517205175525, -82.37372659270983 35.57468520520194, -82.37337359255406 35.57531720529394, -82.373141592451 35.5757362053551, -82.37234259208846 35.57723120557654, -82.37222559203566 35.57744820560849, -82.37218559201698 35.577526205620266, -82.3720015919335 35.57787020567118, -82.37195859191841 35.57792220567727, -82.37183259187343 35.57807820569598, -82.3717905918584 35.578131205702434, -82.371631591802 35.578326205725695, -82.37128259170024 35.57861220574781, -82.37120159167068 35.57871720576081, -82.37059559149756 35.57919020579445, -82.37058359149385 35.57920120579551, -82.37041559142969 35.579437205826146, -82.37028159136338 35.57972320587039, -82.3699575912495 35.58011420591643, -82.36974359117438 35.58037220594679, -82.3693195910381 35.58080120599032, -82.36930759103257 35.58082420599374, -82.36925059101159 35.58089920600312, -82.36920159098425 35.5810242060234, -82.36914559095858 35.58113020603921, -82.36912159093599 35.58125120606133, -82.36909859091348 35.581372206083515, -82.36915259089587 35.58154420612402, -82.36919959088026 35.58169620615966, -82.36922659082185 35.58210320624512, -82.36913259073005 35.58259820633598, -82.3691195906609 35.583032206422764, -82.3690665906301 35.58317520644633, -82.36894259056997 35.58343220648583, -82.36886459053147 35.583598206511475, -82.36858259040503 35.584115206587384, -82.36836059027596 35.58471420668622, -82.36821959023224 35.58484620669847, -82.36822959022678 35.584892206708815, -82.36826159021068 35.585031206740375, -82.36827259020527 35.58507820675105, -82.36830059019053 35.585203206779354, -82.3682735901463 35.5854612068289, -82.36820259011422 35.585593206848436, -82.36815359009157 35.585687206862424, -82.36808559006339 35.58579720687781, -82.36758158991137 35.58624220691632, -82.36713858975402 35.58678720698133, -82.36713158975138 35.586797206982645, -82.36705658972262 35.58690320699654, -82.36689658966064 35.58713320702674, -82.36686558963848 35.58724420704607, -82.36672858954051 35.587732207131005, -82.36652058945856 35.58804020717217, -82.3663135893526 35.58850520724529, -82.36629158934109 35.588556207253404, -82.36613058925431 35.588946207315956, -82.36582858908729 35.589705207439046, -82.3658085890432 35.589969207490626, -82.36584958901433 35.59020020754171, -82.36611858895196 35.59089220770994, -82.36615958893252 35.59106220774866, -82.36634058889882 35.59147420785095, -82.36665758887659 35.59195820798195, -82.36696058889196 35.59218320805879, -82.36700158889609 35.5922002080665, -82.36749258894588 35.59240320815827, -82.36790958898351 35.59260620824244, -82.36815158901179 35.59268220828277, -82.36828958903214 35.59269820830025, -82.36825958901733 35.59276220831022, -82.36824858901174 35.592786208313946, -82.3681715889729 35.59295520834031, -82.36814358895826 35.59302020835059, -82.36804658890897 35.59323620838453, -82.36801558889435 35.59329720839372, -82.36773658875981 35.5938702084813, -82.36764958871214 35.59408620851619, -82.36763558870281 35.59413120852394, -82.36754958864319 35.59442520857481, -82.36752958863009 35.59448920858571, -82.36747958858778 35.59470920862526, -82.36746958857555 35.59477820863823, -82.36741758850715 35.59516520871151, -82.36741858845974 35.59547320877415, -82.36739658842681 35.5956632088104, -82.36732658839581 35.595789208828855, -82.36729158838325 35.59583320883409, -82.36724858836733 35.59589020884131, -82.3671165883311 35.59598320884658, -82.36699958830286 35.5960412088463, -82.36694658829009 35.59606720884616, -82.3666755882298 35.59616720883852, -82.36648358818682 35.5962402088336, -82.36614758810954 35.596381208827594, -82.36588858804541 35.596519208829015, -82.36574358800532 35.59662320883516, -82.36561858797064 35.59671420884072, -82.36549158793208 35.596828208850795, -82.36547958792731 35.59684620885325, -82.36545758791871 35.59687820885749, -82.36541758790273 35.59693920886575, -82.3654065878942 35.59698220887335, -82.36539858788696 35.597020208880224, -82.36538958787952 35.59705920888734, -82.36542558785273 35.59727120893406, -82.36546758784071 35.59739420896331, -82.36554558781826 35.59762320901786, -82.36571058777963 35.59805020912154, -82.3658695877395 35.59848020922524, -82.36589158773404 35.59853920923953, -82.36601558770833 35.59883820931298, -82.36605858769937 35.598942209338546, -82.36615258768 35.599168209394136, -82.36619258767341 35.59925420941573, -82.3662405876654 35.59935720944155, -82.36627058766067 35.59942020945741, -82.36636258764631 35.59961120950572, -82.36639358764162 35.59967520952193, -82.36641458763815 35.59972020953322, -82.36645058763267 35.5997942095519, -82.36647858762771 35.599856209567385, -82.36649958762409 35.59990220957889, -82.36654958761505 35.600014209606826, -82.36670258758821 35.6003522096912, -82.36675358757917 35.60046520971943, -82.36682058756715 35.60061420975659, -82.3669355875468 35.6008692098202, -82.36701358752941 35.60106520986803, -82.36703958752373 35.60113020988391, -82.36707758751673 35.60121620990533, -82.36712758750784 35.601327209933, -82.36714358750572 35.601358209940905, -82.36723958749353 35.601540209987796, -82.36738158748184 35.60176721004852, -82.36746558747505 35.60190121008438, -82.36748658747337 35.601935210093416, -82.36749758747234 35.6019532100982, -82.3675545874693 35.6020342101206, -82.36757858746813 35.6020672101297, -82.36704958734519 35.60229721012193, -82.3660505871128 35.60273221010737, -82.36546258697612 35.6029882100988, -82.3649345868532 35.60321921009132, -82.36419758668227 35.60353721008004, -82.36355658653271 35.6038192100712, -82.36321358645311 35.603967210065946, -82.36244858627556 35.60429821005436, -82.3623015862412 35.60436321005243, -82.36177058611763 35.60459421004468, -82.36061558584876 35.60509921002815, -82.36017458574815 35.60527921001928, -82.35986858567787 35.60540621001366, -82.35963558562658 35.60548921000641, -82.35945558558693 35.605553210000906, -82.35918658552741 35.60565020999284, -82.35891358546856 35.605739209982794, -82.3588935854642 35.605746209982215, -82.35873058542988 35.60579420997513, -82.35868458542024 35.60580720997308, -82.35854558539087 35.605848209967085, -82.35850058538136 35.60586220996523, -82.35811658530137 35.60596920994744, -82.35751858517959 35.60611720991589, -82.35748658517335 35.60612320991383, -82.35611258490061 35.60641920983237, -82.35441558456519 35.60677420972959, -82.35339158436281 35.606989209667695, -82.3530265842907 35.607065209645555, -82.35225358413811 35.60722620959862, -82.35193258407448 35.60729420957936, -82.3515685840025 35.607371209557556, -82.35116058392194 35.60745620953276, -82.3499375836804 35.60771120945846, -82.34953058359979 35.60779720943402, -82.34920758353609 35.607864209414345, -82.34823858334452 35.60806720935569, -82.3479165832807 35.608136209336536, -82.34781358326046 35.60815720933015, -82.34750458319951 35.608221209311274, -82.3474025831792 35.60824320930532, -82.34687358307458 35.6083542092733, -82.34651258300343 35.60842920925138, -82.34412258253066 35.608932209107195, -82.34384558247608 35.608989209090225, -82.34295658230079 35.609173209035994, -82.3428145822728 35.60920220902726, -82.3425385822184 35.60925920901036, -82.34128758197157 35.609519208934266, -82.34087158188932 35.609606208909035, -82.34046058180765 35.60969520888476, -82.33995858170927 35.609795208853285, -82.33955758163 35.60987920882899, -82.33825658137253 35.61015420875081, -82.33561658085092 35.610707208590966, -82.33430358059131 35.61098320851168, -82.3340465805407 35.611036208495946, -82.33327458038808 35.611198208449224, -82.33301858033728 35.61125320843399, -82.33275758028554 35.611309208418504, -82.33246658022752 35.61137320840152, -82.33214658016303 35.61144820838375, -82.33197858012882 35.61149020837497, -82.331877580108 35.61151720836999, -82.33172258007535 35.61156220836314, -82.33151958003263 35.6116222083544, -82.3313195799901 35.61168320834618, -82.33096457991235 35.61180720833477, -82.33091857990212 35.611824208333545, -82.33072057985794 35.61189820832811, -82.33042357978972 35.61202220832269, -82.33023757974634 35.61210420832013, -82.33006057970466 35.61218420831812, -82.32978357963775 35.6123212083174, -82.32948357956359 35.61248020831871, -82.32884457940256 35.61283920832579, -82.32854257932624 35.61301020832936, -82.32838757928704 35.6130982083312, -82.32834257927571 35.61312320833167, -82.32820957924234 35.61319720833295, -82.32816557923101 35.613223208333736, -82.32794557917553 35.613347208336236, -82.32794257917472 35.613349208336295, -82.32755557908052 35.61354520833623, -82.32726457901214 35.61367620833283, -82.3271865789937 35.61371220833206, -82.3270315789587 35.61377320832849, -82.32681557890947 35.613860208323885, -82.32645157882985 35.61398620831191, -82.32637657881415 35.61400820830863, -82.32612657876074 35.61408620829867, -82.32540057861073 35.61428120826344, -82.32503457853603 35.614373208244416, -82.32435857839731 35.614548208210245, -82.32401257832622 35.614638208192794, -82.32368957825744 35.61473820817981, -82.32361757824212 35.614760208176854, -82.3232785781673 35.61488220816669, -82.32318357814617 35.614917208164044, -82.32291157808486 35.61502320815749, -82.32271557803932 35.61510820815454, -82.32256857800357 35.61518220815441, -82.32236457794983 35.6153122081598, -82.32218857789708 35.615465208172644, -82.32215057788419 35.61550820817743, -82.32206357785411 35.61560920818897, -82.32194657780902 35.61577620821082, -82.32189657778777 35.615860208222685, -82.32186357777407 35.61591320823009, -82.3218465777665 35.61594420823461, -82.32176857773682 35.616053208248765, -82.32175857773282 35.61606820825077, -82.32172557771896 35.616122208258275, -82.32161957767492 35.6162942082823, -82.32154657764431 35.61641420829907, -82.32129457754218 35.6168052083525, -82.32118657749793 35.61697620837602, -82.32115157748353 35.61703220838379, -82.32104857744032 35.61720120840752, -82.3210145774259 35.617258208415514, -82.3209655774051 35.61734020842713, -82.32095557740134 35.61735420842896, -82.32077157732714 35.61763720846741, -82.32071057730242 35.6177322084804, -82.32066857728586 35.61779420848869, -82.32066757728523 35.61779720848918, -82.32061357728115 35.6177662084773, -82.32055557727806 35.61772420846281, -82.32036957727549 35.617542208406775, -82.32022557727363 35.61740020836304, -82.32010857727609 35.61725920832236, -82.31994057728252 35.61703820826018, -82.31976157729115 35.61679120819159, -82.31963357729634 35.61662120814392, -82.31939657730553 35.61630820805591, -82.31937257730651 35.616276208046955, -82.31932757730844 35.616216208030146, -82.31930357730981 35.6161812080205, -82.3192825773113 35.616149208011855, -82.31926057731263 35.61611720800308, -82.3192455773134 35.61609620799734, -82.319201577318 35.61601920797719, -82.31918257731984 35.61598720796868, -82.31911457732717 35.615867207937356, -82.31907657733589 35.615770207913734, -82.31899957735376 35.61557220786557, -82.31896557736766 35.61544620783646, -82.31893857739352 35.61525020779399, -82.31893057742029 35.61506820775621, -82.31892057745597 35.61482720770623, -82.31891257748043 35.614660207671534, -82.31888957755407 35.614159207567475, -82.31888257757878 35.61399220753278, -82.31887757759381 35.6138892075114, -82.31886557763966 35.613580207447455, -82.31886157765479 35.613478207426375, -82.31886057765865 35.613452207421005, -82.31885757766965 35.613377207405456, -82.31885657767337 35.61335220740021, -82.31885357768445 35.613277207384755, -82.31884657771091 35.6130992073479, -82.31882457780536 35.61246420721676, -82.31882457782378 35.612345207192526, -82.31882457782464 35.61234020719154, -82.31882457786347 35.61208820714044, -82.31882457788443 35.611953207113, -82.31881457790783 35.611791207079044, -82.31877757800397 35.61112920694089, -82.31876757803762 35.610901206893594, -82.3187555780814 35.6106052068323, -82.31875357808529 35.610578206826595, -82.31875057809678 35.610500206810414, -82.31874957810062 35.61047420680503, -82.31874557811796 35.61035820678113, -82.31872357815679 35.610083206723026, -82.31872157818476 35.6099002066857, -82.31872157820163 35.60979120666361, -82.3187305782444 35.60952420661029, -82.31876257830783 35.6091482065373, -82.31880157834985 35.60891820649457, -82.31887657840835 35.60861920644161, -82.31898957848486 35.60824520637741, -82.31900157849236 35.60820920637128, -82.3191285785675 35.60785920631335, -82.31921757861028 35.60767720628561, -82.31909557859362 35.60765520626857, -82.31888157856545 35.60760820623693, -82.31882857855656 35.60760920623181, -82.31863057852297 35.60761520621251, -82.3184565784874 35.60765920620347, -82.31835157846253 35.60770820620262, -82.31824057843332 35.607778206205396, -82.31814457840618 35.607851206210285, -82.31803857837274 35.60795420622033, -82.31796957834888 35.60803520622961, -82.31788457831439 35.608167206247636, -82.31787257830807 35.60819520625207, -82.31781257827576 35.608340206275344, -82.3177985782657 35.60839020628403, -82.31780257825679 35.60845220629706, -82.31779157824111 35.608542206314205, -82.31779257823598 35.60857620632116, -82.31770357822711 35.60853820630433, -82.31743357819879 35.6084332062552, -82.31693957813717 35.608304206178026, -82.31663557809922 35.6082252061307, -82.31531257792997 35.60790620592952, -82.31461057784179 35.60772720582085, -82.31433157780741 35.6076512057767, -82.31431057780473 35.607646205773506, -82.31418257779237 35.607589205748745, -82.31408057778746 35.607512205722564, -82.31400357778685 35.60743320569865, -82.31392557778968 35.607332205670076, -82.3137325778039 35.607034205589656, -82.31372257780366 35.60702520558681, -82.31362257780127 35.60693320555787, -82.31345057779025 35.60682120551745, -82.31331457777887 35.60674920548874, -82.31292457774661 35.60654120540634, -82.31281457774381 35.60644220537488, -82.3127655777468 35.60637020535529, -82.3127355777541 35.60629120533613, -82.31272157777236 35.60615820530771, -82.31275457780654 35.60597220527335, -82.31281757785699 35.60571320522726, -82.31283957788058 35.605584205203364, -82.3128925779355 35.605285205148185, -82.31288757795197 35.60517320512489, -82.31287857795454 35.60514720511867, -82.31286257795935 35.60509920510729, -82.31283957795945 35.60507320509969, -82.31280757796013 35.60503520508866, -82.31276557795816 35.60500320507784, -82.31273857795676 35.60498320507093, -82.31271557795571 35.604965205064936, -82.31266457795178 35.604936205053804, -82.3125325779417 35.60486020502481, -82.31243557793343 35.60481020500461, -82.31235857792687 35.604770204988576, -82.31220757791424 35.60469120495696, -82.3121775779116 35.6046762049508, -82.31189557788893 35.60452120489032, -82.3117705778819 35.60443320485956, -82.3117125778785 35.604393204845515, -82.31163657787559 35.60433120482503, -82.31160357787418 35.604305204816335, -82.31154257787367 35.60424320479744, -82.31150757787341 35.60420720478656, -82.31143857787474 35.60412520476281, -82.31136957788034 35.60401520473342, -82.3113265778867 35.603928204711316, -82.31132557788679 35.60392620471082, -82.31129057789951 35.603806204682826, -82.31126557791121 35.603704204659564, -82.31125357792807 35.60358220463357, -82.31125157793163 35.60355720462828, -82.31125157794905 35.60344420460537, -82.31126457797218 35.603308204579044, -82.31134057804641 35.60290920450597, -82.31136657807146 35.6027752044815, -82.31138757808834 35.60268820446591, -82.31143557812615 35.60249520443171, -82.31149157816964 35.60227320439246, -82.31156357822017 35.60202320434916, -82.31159757824126 35.60192320433234, -82.31166357828106 35.60173620430119, -82.31168757829488 35.60167220429068, -82.3117525783243 35.60155120427278, -82.3117945783392 35.60150020426683, -82.31183857835448 35.601448204260755, -82.31185657836069 35.60142720425834, -82.31193057838142 35.60137220425483, -82.31203157840937 35.601299204250445, -82.31223757846102 35.60118520424856, -82.31225657846564 35.60117520424845, -82.31234457848711 35.60113020424843, -82.31271257857614 35.60094720424915, -82.31341957874935 35.60058220424795, -82.31374157882942 35.600408204245845, -82.31399457889218 35.600272204244284, -82.31407657891066 35.600240204246326, -82.3139385788995 35.60016520421679, -82.3135265788662 35.59994020412866, -82.31338957885504 35.599866204099534, -82.31290757881573 35.59960520399692, -82.31204257874539 35.59913620381259, -82.31146357869811 35.59882320368935, -82.31104957866438 35.598599203601246, -82.31098257865887 35.5985632035871, -82.3109655786577 35.5985532035833, -82.31091457865342 35.598526203572575, -82.31089857865211 35.59851720356909, -82.31083357864696 35.59848120355504, -82.31077357864281 35.59844420354139, -82.31071557863865 35.59840920352825, -82.31065357863524 35.598365203512955, -82.31059457863411 35.59830920349555, -82.31055357863524 35.59825820348098, -82.31052357863803 35.59820820346773, -82.31049357864474 35.598132203449225, -82.31048857864613 35.59811820344582, -82.31047357866298 35.59799320341893, -82.31050357869213 35.59783620339016, -82.31051957870069 35.59779820338408, -82.31054957871562 35.59773320337394, -82.31058757872951 35.59768420336796, -82.31063357874422 35.59763820336333, -82.31068657875944 35.597596203360325, -82.31079357878592 35.59753920335973, -82.31084757879775 35.59752020336145, -82.31090557880911 35.59750920336526, -82.31096657882135 35.597495203368645, -82.31103257883353 35.59748620337366, -82.31108557884211 35.59748720337929, -82.31119157885907 35.597491203391044, -82.31133957887963 35.59751620341133, -82.31162257891602 35.5975832034541, -82.3118005789387 35.59762620348119, -82.31224857899613 35.59773320354904, -82.31233257900743 35.59775020356122, -82.31243057902219 35.597759203573155, -82.31249157903366 35.59775020357757, -82.31249657903484 35.59774820357766, -82.31256857905011 35.597726203580635, -82.31263057906762 35.597679203577556, -82.31266957908171 35.597629203571344, -82.3127735791313 35.59742020353969, -82.3128245791506 35.59734920353052, -82.31287857916715 35.59730020352614, -82.3129275791795 35.597272203525506, -82.31297957919044 35.59725720352784, -82.313016579197 35.59725420353105, -82.31306457920442 35.597257203536635, -82.31310157920939 35.597264203541826, -82.31314357921326 35.59728420355018, -82.313192579216 35.59731920356241, -82.31324057921778 35.597359203575465, -82.31328057921604 35.5974132035905, -82.31338157921165 35.597549203628525, -82.31347157921022 35.597655203659265, -82.31356157921051 35.59774920368763, -82.3136595792145 35.597828203713796, -82.31386357922669 35.59796720376301, -82.31406557923887 35.59810420381168, -82.31408957924037 35.598120203817395, -82.31422257925038 35.59819720384669, -82.31430457925822 35.59823420386269, -82.31439157926876 35.598259203876694, -82.31447357928063 35.59827020388739, -82.31461557930515 35.598263203900615, -82.31471957932433 35.598250203908655, -82.31473857932825 35.59824520390966, -82.31494157936896 35.59819820392105, -82.3151165794062 35.59814420392807, -82.31521457942956 35.59809820392882, -82.31529257944945 35.59805220392753, -82.31532157945796 35.59802820392563, -82.31535757946813 35.59800120392388, -82.3154015794823 35.59795620391933, -82.31544657949807 35.59790220391296, -82.31548057951221 35.59784720390533, -82.31551657953581 35.597733203885916, -82.31552557954919 35.597656203871196, -82.31551057957506 35.597472203832304, -82.31541257965081 35.59687720370141, -82.3153925796699 35.59673220366997, -82.31537057967792 35.59665720365251, -82.31532457968547 35.59655920362785, -82.31525357968572 35.59648120360469, -82.31507357967533 35.59635620356082, -82.31505057967405 35.596340203555165, -82.31462457964447 35.596076203457656, -82.31453657963678 35.59603220343965, -82.31450457963393 35.596016203433145, -82.31444157962817 35.59598620342049, -82.31441057962503 35.59597320341468, -82.31437857962179 35.595960203408815, -82.314242579608 35.59590420338338, -82.31400657958245 35.59581720334142, -82.3139875795804 35.59581020333802, -82.31379557955846 35.59574720330542, -82.31365757954059 35.59571520328482, -82.31355957952645 35.59570220327202, -82.31346357951074 35.595701203261896, -82.31338657949645 35.59571120325603, -82.3132955794784 35.59573120325068, -82.31323557946553 35.59575020324836, -82.31316457944916 35.595780203247166, -82.31313257944159 35.59579520324687, -82.31250957928319 35.59615420325555, -82.31238457925346 35.59621320325462, -82.31228057923055 35.59625020325142, -82.31211257919871 35.59627720323963, -82.31201857918336 35.59627620322971, -82.31192257916965 35.596262203216924, -82.31182857915813 35.596236203202, -82.31173857914949 35.59619620318465, -82.31163957914298 35.596132203161424, -82.31152957913852 35.59604320313204, -82.31143657913834 35.59594520310257, -82.31129157914471 35.59574920304782, -82.31120957914695 35.5956472030187, -82.31114357914501 35.59558920300011, -82.31106357913998 35.595536202981116, -82.31098757913287 35.59550120296616, -82.31083257911422 35.595456202941094, -82.3107175791008 35.59542020292187, -82.31063957909377 35.595382202906166, -82.31054857909112 35.59530220288048, -82.31048057909705 35.59519120285101, -82.3103805791567 35.59469820274063, -82.31036057916597 35.59461620272195, -82.3102145792375 35.593997202581264, -82.31015157927719 35.59367320250907, -82.31012057928986 35.59355820248254, -82.310094579297 35.59348420246483, -82.310041579302 35.593395202441236, -82.31000057930592 35.59332620242309, -82.30986757930353 35.59319920238358, -82.30968157929262 35.593071202338436, -82.3095055792801 35.59296420229856, -82.3094385792736 35.59293420228554, -82.30933557926019 35.592911202270336, -82.30928557925274 35.59290620226416, -82.30922957924346 35.59290620225839, -82.30917557923327 35.5929142022545, -82.30911257922011 35.59293220225161, -82.3090515792045 35.59296820225255, -82.30898857918616 35.59301920225642, -82.30885957914535 35.59314620226888, -82.3088075791312 35.593182202270896, -82.3087625791199 35.593207202271294, -82.30870757910849 35.59322220226868, -82.30863757909651 35.59322520226211, -82.30858457908936 35.59321420225436, -82.30855057908792 35.59318720224544, -82.30852057908781 35.59315620223607, -82.30849657908976 35.593118202225874, -82.30849357910311 35.59302820220722, -82.30851857911577 35.59297320219871, -82.3085885791403 35.592889202188864, -82.30862757915125 35.592860202186976, -82.3086725791636 35.5928282021851, -82.30879457919265 35.59277020218595, -82.30891657921805 35.59273620219159, -82.30916857926489 35.592702202210624, -82.30926757928253 35.59269420221927, -82.30935957929702 35.592698202229535, -82.30943557930838 35.59270620223905, -82.30952757932067 35.59272520225236, -82.3096955793402 35.592778202280364, -82.30973357934413 35.592793202287375, -82.31023657939122 35.59302620238648, -82.31034357939998 35.59308320240909, -82.31042757940449 35.593144202430146, -82.31048857940212 35.593224202452646, -82.31051957939727 35.593289202469, -82.31054957938989 35.59336920248832, -82.31058057936782 35.59354520252723, -82.31061857935168 35.59369020256061, -82.31068657934046 35.593835202597035, -82.31074057933708 35.59391520261885, -82.31085457933646 35.59404120265621, -82.31094657934042 35.59411320268024, -82.31106857934698 35.59420120271069, -82.31120557935314 35.59430820274658, -82.3113045793554 35.59439920277518, -82.31145757935472 35.59456720282507, -82.31151857935643 35.59462120284227, -82.31159457936245 35.594663202858605, -82.31166357937087 35.59468220286959, -82.31172457938106 35.59468220287593, -82.3117555793867 35.59467820287826, -82.31180057939778 35.594655202878215, -82.31182357940445 35.59463620287679, -82.31184657941307 35.59460520287287, -82.31185457942257 35.59455220286295, -82.3118475794256 35.59452520285677, -82.31183157943008 35.59447920284577, -82.31180857942965 35.5944572028389, -82.3117325794278 35.594388202817065, -82.31158757941736 35.59430020278428, -82.31130457939771 35.59412520271957, -82.31112157938763 35.59399520267436, -82.31105357938642 35.59393020265412, -82.31095357938935 35.59380420261825, -82.31091557939314 35.59373920260111, -82.31087057941109 35.59357520256323, -82.31084657942685 35.59344720253479, -82.31080157946221 35.59317020247391, -82.31078657946978 35.59310520245924, -82.31074657947677 35.59301720243722, -82.31071157948041 35.59295620242123, -82.31066757948251 35.5928952024043, -82.31062157948304 35.592843202389055, -82.31062057948297 35.59284220238873, -82.31045957947957 35.592692202341695, -82.31043157947991 35.592660202332304, -82.31038557948044 35.592607202316835, -82.31035457948468 35.59254720230147, -82.31033257949038 35.59248620228676, -82.31031757949965 35.59241020226988, -82.31032957952226 35.59227720224404, -82.31034457953518 35.5922092022318, -82.31036257955995 35.5920682022051, -82.31036057956952 35.592004202191895, -82.3103515795763 35.591950202179966, -82.31033757958012 35.59191120217061, -82.31030257958945 35.59181320214715, -82.31020257959179 35.59169120211212, -82.31017557959255 35.59165720210237, -82.31011657959085 35.59160520208578, -82.31007157958959 35.59156520207299, -82.30984757957937 35.591392202014774, -82.30965357957184 35.591233201962574, -82.30951757956905 35.59110620192277, -82.30946657956956 35.59104820190576, -82.3094275795727 35.590986201889145, -82.30939057957809 35.59091220187027, -82.30938457958015 35.5908922018656, -82.30936457958813 35.59081920184876, -82.3093615796083 35.59068520182126, -82.30941557966176 35.59039720176837, -82.30941957967748 35.59029920174892, -82.30939857968782 35.590210201728695, -82.30936157969546 35.59012120170681, -82.30930357969632 35.59005320168704, -82.30925357969535 35.59000620167229, -82.30918457968973 35.58996920165766, -82.30910457968163 35.58993620164276, -82.30900957966973 35.58991120162793, -82.30891057965624 35.589893201614004, -82.3088205796418 35.58989020160418, -82.30870657962161 35.5898992015942, -82.30861057960234 35.589921201588794, -82.30850557957841 35.58996420158674, -82.3082055795027 35.59013320159014, -82.30808657947559 35.590182201587815, -82.30800557945919 35.59020120158329, -82.30791757944316 35.590211201576224, -82.30782457942746 35.59021320156703, -82.30768657940799 35.59019220154854, -82.30760557939827 35.590168201535384, -82.30750857938786 35.5901322015181, -82.30742157938049 35.59008720149999, -82.30735457937658 35.590040201483504, -82.30730957937638 35.58999420146953, -82.30726957937728 35.589945201455535, -82.30725657938017 35.58991220144745, -82.3072455793859 35.58986320143642, -82.30724457939294 35.58981720142696, -82.30725157940273 35.589761201416394, -82.30732357943896 35.58960320139171, -82.30732557943993 35.58959920139107, -82.3073695794571 35.589535201382574, -82.30740457947259 35.58947220137343, -82.3074315794883 35.58939920136134, -82.3074415795003 35.589332201348824, -82.30744257951038 35.58926820133597, -82.30743257951805 35.589208201322734, -82.30741057952343 35.58914920130849, -82.30732457953246 35.5889992012692, -82.30725357953435 35.588911201243995, -82.30702757954556 35.588597201156965, -82.30684757955407 35.58834920108819, -82.30679457955354 35.5882962010719, -82.30672757954942 35.58825120105592, -82.30660657953595 35.588209201034864, -82.30657557953134 35.588206201031056, -82.30651057952154 35.58820020102319, -82.30632757949067 35.588204201005084, -82.30625457947943 35.58819920099658, -82.30618757946989 35.58818920098764, -82.30610057945857 35.58816920097469, -82.30601057945331 35.58810720095278, -82.30596457945335 35.58805820093807, -82.30593857945469 35.58802120092789, -82.30590957945905 35.587962200912976, -82.30570657952374 35.58732620076297, -82.3056435795398 35.5871552007218, -82.30555357955136 35.58698420067776, -82.30552257955264 35.586942200666115, -82.30547857955465 35.586882200649356, -82.30539257955527 35.586786200621056, -82.30530757955228 35.5867152005979, -82.30520357954404 35.586657200575445, -82.30502757952443 35.58659620054484, -82.30488057950787 35.58654620051959, -82.30478157949835 35.58650220050043, -82.3046915794897 35.58646220048307, -82.30458757948297 35.58639420045853, -82.30448057947865 35.5863082004301, -82.30416957947325 35.586010200337526, -82.30397957946988 35.58582920028126, -82.30373157946605 35.58558920020701, -82.30365457946495 35.585514200183844, -82.3031545794551 35.585043200036694, -82.30302657945185 35.584927200000024, -82.3029795794511 35.584882199986055, -82.30276457944746 35.58467619992213, -82.30273457944782 35.584641199911864)))",6388,37,021,003103,370210031031,1879,1879,21,1849,1767,72,2,4,0,4,30,1451,13,1438,1434,1383,45,1,2,0,3,17,970,782,188
census_2010_blockgroups_view.fid--2dc29038_13ec899ba8f_-25cc,"MULTIPOLYGON (((-82.57293761610629 35.63705323837611, -82.5731796161468 35.63705123840055, -82.57333261617238 35.63705023841617, -82.5735666162104 35.63705623844143, -82.5737506162388 35.63707023846318, -82.57393761626616 35.6370942384873, -82.57401261627629 35.63710923849807, -82.57446361632923 35.637252238573545, -82.57474961636039 35.63735823862452, -82.57491461637441 35.637445238659176, -82.5751346163892 35.6375862387105, -82.575377616401 35.6377712387732, -82.57545161640219 35.63784323879542, -82.57544261638238 35.63796223881878, -82.57544261638073 35.63797223882073, -82.57538861632423 35.63828123887815, -82.57537461631657 35.638315238883656, -82.575331616292 35.63842823890222, -82.57524561625517 35.63857423892309, -82.57515761622328 35.638686238936906, -82.57493861615286 35.6389072389594, -82.57480761611313 35.63902323896954, -82.57478161610508 35.639047238971685, -82.5745986160519 35.63919523898306, -82.57441661600201 35.63932223899019, -82.5736266157651 35.64000723904844, -82.57322761564245 35.64037223908174, -82.57304361558211 35.64056523910218, -82.5730076155709 35.64059923910536, -82.57288761553255 35.64071823911726, -82.57279261550383 35.64080223912461, -82.57268961547743 35.6408622391262, -82.57257561545104 35.64091023912431, -82.57232861539802 35.6409882391148, -82.5721056153511 35.64105223910491, -82.57194961531809 35.641098239098234, -82.57143361521115 35.64123523907304, -82.57130461518435 35.641270239066884, -82.57121161516432 35.64130023906349, -82.5713056151672 35.64138223908985, -82.57141661517593 35.64144523911404, -82.5716106151912 35.64155523915642, -82.57176661520202 35.641653239192415, -82.57184861520439 35.64172623921566, -82.57193561520863 35.641792239238065, -82.57203161521056 35.64188323926646, -82.57206161521114 35.64191223927546, -82.57209961520947 35.64196323928977, -82.57212161520853 35.6419932392981, -82.57216861520072 35.64209423932353, -82.57222961519041 35.642227239356906, -82.5722446151879 35.64225923936494, -82.57225461518641 35.64228023937023, -82.57232761518783 35.64234923939177, -82.57237061518282 35.6424282394123, -82.57237961517191 35.64250823942949, -82.57237261515742 35.64259523944652, -82.57235161514089 35.64267923946149, -82.57231961512454 35.64275123947279, -82.57231661512276 35.642759239474145, -82.5722566151043 35.6428142394792, -82.57221861509571 35.642829239478296, -82.57216661508656 35.642832239473606, -82.5721196150815 35.64281423946515, -82.57198861507207 35.64273423943532, -82.57194561506898 35.64270823942562, -82.57188861506486 35.64267323941262, -82.57179061505978 35.64260123938795, -82.57175261505769 35.642573239378294, -82.57170761506096 35.6425042393596, -82.57169361506323 35.642474239352055, -82.57168061506572 35.64244423934465, -82.57164561506573 35.642406239333326, -82.57159661506238 35.642375239321915, -82.5715156150546 35.6423382393061, -82.57125661502825 35.642230239257394, -82.57121361502378 35.64221323924957, -82.57105261500526 35.64215923922199, -82.57094061499397 35.64211223920088, -82.57086461498794 35.64206923918438, -82.57081261499096 35.641993239163526, -82.57080561499292 35.641973239158794, -82.57076761500437 35.64185823913144, -82.57074861502093 35.64173023910335, -82.57076261503845 35.64163223908491, -82.57061561499945 35.641726239088904, -82.57041661494374 35.64187323909835, -82.57031661491494 35.6419522391042, -82.57024061488902 35.64203823911386, -82.57021261488006 35.6420662391167, -82.57016361486423 35.642116239121904, -82.57010161484754 35.64215723912382, -82.57003661483226 35.64218623912305, -82.5699496148154 35.64220223911732, -82.56985461479849 35.64220923910902, -82.56977961478707 35.642202239099895, -82.56970261477716 35.64218423908829, -82.56961961476867 35.642149239072644, -82.56953061476288 35.64209123905172, -82.56942661475733 35.64201523902553, -82.56930361475197 35.64191723899292, -82.56916061474163 35.64183023896047, -82.56908161473439 35.64179223894465, -82.5690026147253 35.641766238931176, -82.56894361471684 35.641757238923326, -82.56882461469584 35.64176523891266, -82.5682716145921 35.64184223887154, -82.56803561454774 35.64187523885395, -82.56796361453598 35.64187423884635, -82.56789461452587 35.64186523883744, -82.56782661451761 35.64184523882635, -82.56759061449215 35.64175623878395, -82.56746061443913 35.641960238812175, -82.56706961427953 35.64257323889679, -82.56694061422648 35.642778238925295, -82.56683161418228 35.642947238948416, -82.5667786141607 35.643030238959845, -82.56672961414345 35.64308923896687, -82.5666376141181 35.64315423897067, -82.56648161407794 35.64324623897333, -82.56636261404817 35.643311238974334, -82.56622361401293 35.643390238976146, -82.56618361400473 35.643400238973996, -82.56622161399525 35.643502238998714, -82.56623861398744 35.64357123901449, -82.5662416139742 35.6436602390329, -82.56623361396113 35.64373623904761, -82.56623261395947 35.643746239049506, -82.56621261393765 35.64386623907188, -82.56615161388349 35.64415123912365, -82.56610461384584 35.644344239158116, -82.56597661376364 35.644739239225444, -82.56594061373991 35.64485423924513, -82.56591161372636 35.644911239253766, -82.56584661370889 35.64495423925586, -82.56581261370233 35.64496023925348, -82.56576461369296 35.64496923925038, -82.56574961369128 35.644964239247884, -82.56570561368596 35.64495123924069, -82.5656916136842 35.6449472392384, -82.56566661368109 35.6449402392344, -82.56557761367688 35.6448722392114, -82.56554961367944 35.644825239198994, -82.56546861369081 35.644664239157905, -82.56544561369641 35.64460323914308, -82.56542361371395 35.644466239112916, -82.56540161372062 35.64439923909703, -82.5653606137243 35.64433123907896, -82.56531061372661 35.64426223905976, -82.56525561372423 35.644218239045195, -82.56525061372409 35.644214239043805, -82.56516961371706 35.644172239026936, -82.5650866137071 35.64414723901335, -82.5650156136977 35.64413223900297, -82.56492561368394 35.64412423899213, -82.56480661366373 35.64412723898049, -82.56470661364737 35.64412523896976, -82.5646236136358 35.6441112389584, -82.56455761362852 35.64408723894671, -82.56448861362364 35.644044238930874, -82.56432261361805 35.643902238884905, -82.56423761361096 35.643856238866775, -82.56416061360316 35.643824238852375, -82.56406361359008 35.64380423883826, -82.56396961357561 35.64379723882721, -82.56385361355628 35.64379723881531, -82.56375161353732 35.64381023880743, -82.56367061352114 35.64382823880277, -82.56357061349756 35.64387323880165, -82.56313361338466 35.644134238809805, -82.56297361334434 35.64422323881151, -82.56287661331835 35.64428723881457, -82.562850613312 35.644300238814594, -82.56277061329163 35.64434623881571, -82.56268961327328 35.64437823881386, -82.56259561325363 35.64440423880948, -82.56250961323683 35.644420238803875, -82.56242361322117 35.64442923879688, -82.56230961320281 35.6444252387844, -82.56226561319612 35.64442123877899, -82.56221661318891 35.64441523877275, -82.56211361317648 35.64438523875609, -82.56200561316463 35.644345238736776, -82.56188761315279 35.644295238714534, -82.56176961313967 35.64425323869379, -82.5616916131299 35.64423223868154, -82.56161761311948 35.644220238671465, -82.56151361310279 35.64421623865993, -82.56103861301466 35.64427623862335, -82.5609836130045 35.6442832386191, -82.5606116129345 35.64433623859162, -82.56052361291616 35.644360238587424, -82.56037961288513 35.64440623858199, -82.56028261286558 35.6444282385765, -82.56020061285183 35.64442923856829, -82.56011861284126 35.644409238555745, -82.5600326128327 35.644372238539376, -82.55996561282959 35.64432023852196, -82.55990261283337 35.64422823849674, -82.55980761284228 35.6440682384544, -82.55975561284455 35.64399723843457, -82.55970961284423 35.64395023842029, -82.559632612839 35.64390123840244, -82.55956361283152 35.643875238390024, -82.55946361281768 35.643857238376064, -82.55937161280174 35.643861238367364, -82.55927661278275 35.64388223836192, -82.55902761272822 35.64396723835362, -82.5589546127135 35.64398423834953, -82.55887061269797 35.643994238342984, -82.55877261268387 35.64398023833, -82.55847761264567 35.64391023828542, -82.55839761263398 35.64389923827497, -82.55835261262659 35.64389923827033, -82.5583116126196 35.64390023826639, -82.558234612605 35.64391223826084, -82.55817561259195 35.643933238259045, -82.55802761255258 35.644029238263336, -82.55773461247118 35.64424123827645, -82.55763261244928 35.64427323827244, -82.55750761242687 35.6442842382618, -82.55746861242113 35.64427923825682, -82.55739261240991 35.64427023824718, -82.55730261239982 35.644238238231345, -82.55728361239818 35.64422823822732, -82.55721061239218 35.644189238211936, -82.55684061237368 35.64391023811706, -82.55681061237075 35.64389723811132, -82.55671961236166 35.64385823809405, -82.55663061235092 35.643832238079625, -82.55657161231858 35.643978238103244, -82.55655761230716 35.64403723811382, -82.55652261227813 35.6441872381408, -82.55634961222455 35.64434823815584, -82.55621761216716 35.64457823818897, -82.55620361216076 35.64460423819285, -82.55626261214283 35.644784238235594, -82.55618961212386 35.64482823823699, -82.55616861211703 35.64485023823935, -82.55610361209537 35.644920238246925, -82.55605161207166 35.64501823826152, -82.55603061205174 35.64512423828092, -82.55603061204685 35.64515623828747, -82.5560316120418 35.645190238294425, -82.55601661202674 35.645271238309405, -82.55599261201196 35.64534123832117, -82.55595861199508 35.64541423833258, -82.55589761197425 35.64548323834034, -82.55589061197173 35.64549223834144, -82.55565161190717 35.64565323834961, -82.55558961188568 35.6457252383579, -82.55554461186671 35.64580023836861, -82.55545361181409 35.6460432384087, -82.55541561179149 35.64614823842613, -82.55540161177504 35.64624023844343, -82.5554016117683 35.64628323845221, -82.5552526117206 35.64643223846718, -82.55496461162771 35.64672423849701, -82.5548826116025 35.6467992385038, -82.55480461157755 35.64687723851167, -82.55479061157273 35.646893238513485, -82.55466961153002 35.647039238530844, -82.55474661153154 35.64711223855358, -82.55484961153606 35.64719423858091, -82.55493761154075 35.647258238602994, -82.55504461154793 35.647327238627994, -82.55531861157539 35.647444238680016, -82.55537661158117 35.6474692386911, -82.55549361158772 35.64755223872002, -82.55556061159069 35.64760523873768, -82.5556126115918 35.64765423875303, -82.5556116115833 35.647708238763904, -82.55558761157 35.647768238773665, -82.5555166115448 35.64785523878401, -82.55546761152866 35.647907238789536, -82.55539661150709 35.64797023879516, -82.5553276114887 35.64801523879717, -82.55528261147349 35.64806523880275, -82.5552466114598 35.64811523880924, -82.55521961144588 35.64817623881889, -82.55522061143756 35.64823123883016, -82.55524761143216 35.648295238845925, -82.55539561141974 35.64853523891003, -82.55543061141228 35.648621238931185, -82.55543061140311 35.64868023894318, -82.55543061140087 35.64869523894622, -82.5554106113895 35.648747238954726, -82.55536861137598 35.64878923895895, -82.55528161135766 35.64881423895509, -82.55517061133723 35.64882723894631, -82.55492361129548 35.64883223892191, -82.55482961127817 35.64884323891451, -82.55478261126898 35.64885223891151, -82.5547636112652 35.648856238910405, -82.55455261121882 35.6489292389035, -82.55440161118152 35.64900823890409, -82.55426261114646 35.64908623890564, -82.55415161111628 35.64916223890968, -82.5540896111027 35.64918323890762, -82.55402961115108 35.64880523882451, -82.5539846111736 35.64861123878037, -82.55396961118186 35.64854123876456, -82.5538746112084 35.64826723869905, -82.5537676112422 35.64793323862001, -82.55375761125333 35.64785023860211, -82.5537616112645 35.64778223858864, -82.55377561127831 35.64770823857506, -82.55382961130503 35.64759323855717, -82.55392761134567 35.64743523853512, -82.55395961136082 35.64737123852534, -82.55397561137016 35.64732823851827, -82.55398961137911 35.647285238510975, -82.55399761138709 35.64724223850303, -82.55399261140212 35.64713923848154, -82.55396961142625 35.64695823844231, -82.55395461144265 35.646836238415915, -82.55392561145814 35.64670423838607, -82.55391861147464 35.646590238362236, -82.55392561149105 35.646491238342705, -82.55395361151206 35.64638523832404, -82.55396661152538 35.64631323831071, -82.55396561154372 35.64619323828616, -82.55395961155632 35.646105238267594, -82.5539406115659 35.646022238248804, -82.55393861156739 35.646011238246345, -82.55389461157962 35.64588423821596, -82.55384461158968 35.64576523818657, -82.5538316115968 35.645705238173, -82.55385661161162 35.64563623816154, -82.55392161163276 35.64556923815468, -82.55401861166055 35.64549323814912, -82.55408361168156 35.64542723814237, -82.55411761169633 35.64536823813381, -82.55415661172148 35.64524723811321, -82.55417261174401 35.64511823808859, -82.55418061175347 35.645066238078805, -82.55421061178643 35.64488423804487, -82.55423961180736 35.644780238026684, -82.55427361182306 35.64471523801699, -82.55428061182617 35.644702238015036, -82.55435861185202 35.644619238006136, -82.5544016118647 35.644583238003285, -82.55459461192062 35.644428237991534, -82.55471761196104 35.64429923797797, -82.5548136119902 35.64421323797035, -82.55495261203207 35.64409123795973, -82.55499361207971 35.643827237910216, -82.55499161208895 35.643765237897384, -82.55499061209974 35.643694237882876, -82.5547936121998 35.64283423768749, -82.55478461220336 35.6428012376799, -82.554756612215 35.64269523765539, -82.55472861223235 35.642553237623574, -82.55471861224211 35.64247923760752, -82.55463261228363 35.642117237525, -82.55459161230355 35.64194423748553, -82.55454161232038 35.64178123744721, -82.55450461232797 35.64169223742532, -82.5544666123327 35.6416212374069, -82.55440961233619 35.64153723738393, -82.55434761233626 35.641469237363786, -82.55404961232662 35.641211237280594, -82.5538826123213 35.64106623723387, -82.55380261232301 35.64096923720588, -82.55379161232439 35.64094823720051, -82.55367061226725 35.64118823723695, -82.55359161224256 35.641263237244104, -82.55344961220828 35.64133223724347, -82.55326161216618 35.64140323723864, -82.55308661212885 35.64145623723141, -82.55288661208984 35.641494237218566, -82.55275461206726 35.64149823720586, -82.55265161205304 35.641479237191376, -82.5525516120442 35.64142923717087, -82.55246561204028 35.64136223714841, -82.55243761203882 35.641341237141226, -82.55222361203697 35.641123237074844, -82.5520686120425 35.640920237017575, -82.55193961205042 35.640730236965645, -82.551790612064 35.64048223689986, -82.55129361210298 35.63969423668835, -82.5512136121071 35.63958123665706, -82.55109461211767 35.639385236604994, -82.55104261212531 35.63927923657801, -82.55097761213936 35.639118236538536, -82.55081461217962 35.638682236433006, -82.55060761222259 35.63818123630976, -82.55058061223332 35.638082236286905, -82.55056661224258 35.638007236270184, -82.55056561225615 35.6379182362519, -82.55061261230468 35.63765423620302, -82.55061961231623 35.63758723619009, -82.55060861232494 35.637519236175166, -82.5505816123307 35.63745223615868, -82.55055061233473 35.637393236143495, -82.55048261233586 35.637312236120025, -82.55040161233391 35.63723823609664, -82.55037261233328 35.637211236088156, -82.55025661232472 35.63714123606197, -82.55012661231152 35.63708723603763, -82.55000761229553 35.637062236020284, -82.54988561227532 35.63706223600774, -82.54975461225094 35.637079235997724, -82.5495996122203 35.637111235988264, -82.5493346121644 35.63718823597674, -82.54914061212442 35.637238235966926, -82.54889961207238 35.63731623595802, -82.54869361202724 35.63738723595136, -82.548329611947 35.63751523593994, -82.54808561189603 35.63758323592871, -82.5480726118935 35.63758523592778, -82.54799561187859 35.63759923592271, -82.54796461187269 35.63760423592054, -82.54785861185307 35.63761723591225, -82.54780761186854 35.6374622358755, -82.54765461191434 35.63700023576572, -82.54763261192107 35.636933235749844, -82.54761461193189 35.63684323572962, -82.54759261193803 35.63678023571451, -82.5475916119382 35.63677823571401, -82.54755661195682 35.63661923567804, -82.54755061196221 35.636578235669134, -82.5475416119711 35.636511235654524, -82.54756161197714 35.63649323565294, -82.54762261199521 35.63644223564881, -82.54764361200132 35.63642523564753, -82.5478146120519 35.6362812356358, -82.54833061220428 35.63584923560092, -82.54850261225481 35.63570623558954, -82.54866161230177 35.635573235578796, -82.54902161240784 35.63527323555478, -82.54913861244259 35.63517423554665, -82.5491866124566 35.63513523554359, -82.54929761248965 35.63504023553568, -82.54934261250334 35.6350002355322, -82.54947861254377 35.63488423552251, -82.54952461255742 35.63484523551931, -82.54972061261486 35.63468423550672, -82.5498846126649 35.634536235493414, -82.55001961270582 35.63441623548285, -82.550161612751 35.63427623546899, -82.55036061281808 35.63405623544464, -82.55060261290731 35.63373823540481, -82.55075061296873 35.63349923537146, -82.55078161298323 35.6334382353622, -82.55084061301041 35.63332623534541, -82.55090561304313 35.63318423532323, -82.5509486130668 35.63307723530582, -82.55097261308197 35.63300423529349, -82.55097961308591 35.63298623529052, -82.55099661310231 35.63289823527438, -82.55099861311258 35.63283423526153, -82.55097761313668 35.63265523522296, -82.55095961314339 35.63259223520825, -82.55092761314813 35.63252723519174, -82.55086061315797 35.63239123515719, -82.5507636131685 35.632218235112035, -82.55067461317655 35.63207023507266, -82.5505926131856 35.63192323503432, -82.55054361319388 35.63181723500771, -82.55050761320224 35.6317242349851, -82.55048861321363 35.63163023496404, -82.5504826132263 35.631541234945274, -82.55048961324073 35.63145523492851, -82.55050761325981 35.63135123490917, -82.55054361328224 35.63124423489106, -82.55057261329723 35.631178234880615, -82.55077561339971 35.630732234810694, -82.55084961343609 35.6305762347866, -82.55090261346025 35.63047723477182, -82.55091361346508 35.63045723476892, -82.55098061349116 35.630360234756075, -82.55105861351805 35.630270234745765, -82.55113061354122 35.630197234738255, -82.55124161357345 35.6301082347316, -82.55140361361761 35.629996234725475, -82.55152961365164 35.62991123472112, -82.55176761371538 35.62975423471361, -82.55195761376719 35.629623234706514, -82.55253061392231 35.629234234686194, -82.55272161397409 35.62910423467937, -82.55272761400391 35.62891723464196, -82.5527316140203 35.62881523462157, -82.55273561406898 35.62850423455869, -82.5527306140906 35.62835823452844, -82.55272861410465 35.62826523450934, -82.55273461412004 35.62817223449102, -82.55274261413963 35.628053234467565, -82.55276761416437 35.62792023444305, -82.55278761418373 35.627816234424046, -82.55281961420481 35.627714234406504, -82.5528696142339 35.62757923438416, -82.55302561430881 35.627261234335506, -82.55304961431989 35.62721523432855, -82.55317061437454 35.626991234295424, -82.5532296144018 35.62687823427848, -82.55340861448364 35.626540234228024, -82.55346861451088 35.62642823421141, -82.55355561455147 35.62625823418577, -82.55382061467377 35.62575123410986, -82.55382861467736 35.625736234107606, -82.55392361471552 35.6255912340878, -82.55407461474041 35.6255922341035, -82.55409261474325 35.625593234105665, -82.55436061478515 35.62561023413661, -82.55452861481255 35.625613234154514, -82.55468061483738 35.625616234170764, -82.55470061479974 35.625882234226935, -82.55471861476735 35.6261112342754, -82.5547996147012 35.626627234388764, -82.55481161469581 35.62667523439976, -82.55487761466729 35.62693123445869, -82.55488161466795 35.62693123445908, -82.55491761465254 35.62707023449108, -82.55502561460595 35.62748823458731, -82.55506261459055 35.6276282346196, -82.55514861458217 35.62777523465839, -82.55518961457646 35.627856234679086, -82.55520661457126 35.62790823469144, -82.55525261455841 35.62804123472318, -82.55553361448827 35.62879823490622, -82.55564361446078 35.62909523497796, -82.55569261444825 35.629229235010236, -82.55583961441013 35.62963423510786, -82.55588961439761 35.629769235140465, -82.555949614384 35.6299222351778, -82.5560516143613 35.63017923524057, -82.55613761434452 35.63038123529059, -82.55620261433185 35.63053323532813, -82.55629461431519 35.63074023537977, -82.55643361429027 35.63105123545737, -82.55654161428107 35.63122723550426, -82.55661861427717 35.63133523553419, -82.5566696142746 35.63140723555413, -82.55676161427387 35.631511235584725, -82.55681361427509 35.63155923559983, -82.55686261427626 35.631604235614056, -82.55698061428151 35.631697235645085, -82.55703761428404 35.631742235660106, -82.55707561428589 35.63177123566995, -82.5572526142995 35.63187323570888, -82.55745861431953 35.63196523574887, -82.55765061434113 35.63203223578217, -82.5576836143447 35.632044235788086, -82.55792261437539 35.632103235824665, -82.55815761440866 35.63214023585632, -82.55847561445881 35.6321572358925, -82.5595256146279 35.632192236007555, -82.55968361465291 35.63220023602545, -82.55977761466778 35.632205236036086, -82.5599866146986 35.632230236062746, -82.56022661473013 35.63228423609831, -82.56035261474472 35.63232523611972, -82.56054461476707 35.63238723615206, -82.56070761478423 35.632451236181836, -82.5616626148844 35.63283023635715, -82.56176261489676 35.63285823637312, -82.56197961492303 35.632921236408244, -82.56212861494336 35.63295023642953, -82.56225061495981 35.6329742364469, -82.56257161500739 35.63301223648767, -82.56272461503168 35.633019236504786, -82.5628386150517 35.633012236515114, -82.56295261507604 35.63297723651966, -82.56296861507917 35.63297423652075, -82.56311361511514 35.63289723651991, -82.56319761513794 35.63284023651696, -82.56341861520205 35.63266223650348, -82.56348661522067 35.6326152365009, -82.56367761527822 35.63244723648633, -82.56413561541041 35.63208423645951, -82.56425261544321 35.63199723645388, -82.56439161548182 35.631896236447595, -82.56462161554005 35.631767236444915, -82.56464161554486 35.63175723644492, -82.56475461557122 35.63170823644655, -82.56479661556732 35.631778236465124, -82.56490861555116 35.63200423652273, -82.56497161553936 35.63214823655854, -82.56500061553541 35.63220523657309, -82.56505661552784 35.632314236601005, -82.56512361551421 35.63247523664067, -82.56526961549314 35.63276923671558, -82.56534161549055 35.632863236742075, -82.56544461549066 35.63297323677505, -82.56554161548843 35.63309223680929, -82.56576061549015 35.63331723687757, -82.565846615497 35.63336523689622, -82.56595561550708 35.633417236918014, -82.56603761551776 35.63343623693033, -82.56610461552633 35.633453236940674, -82.56635261556454 35.63347223697, -82.56659061560345 35.63347623699532, -82.566642615612 35.63347723700086, -82.5668446156428 35.63349523702532, -82.5671576156904 35.633523237063166, -82.56748761574158 35.633547237101936, -82.56760761576152 35.63354723711433, -82.56774861578462 35.63354923712918, -82.56786061580715 35.63352423713565, -82.568038615843 35.63348323714557, -82.5682046158763 35.63344623715517, -82.56853761594152 35.63338223717631, -82.56857861594891 35.63337823717969, -82.56876161598127 35.633365237195925, -82.56874061593867 35.63361923724547, -82.56875161590514 35.63384823729324, -82.56875261590349 35.6338602372958, -82.56878361586529 35.634141237356125, -82.56882361583402 35.63438723741033, -82.56901061578563 35.634902237534455, -82.56907161577233 35.635053237571434, -82.569163615766 35.635194237609554, -82.56918661576694 35.63521323761584, -82.5693566157737 35.63535223766158, -82.56950261577661 35.63549023770472, -82.56956061578194 35.63551823771638, -82.5694346157427 35.63563723772769, -82.56927061569176 35.63579023774199, -82.56887461556849 35.63616323777715, -82.56876761553929 35.636237237781245, -82.56875761553641 35.63624523778187, -82.56857161548977 35.636347237783546, -82.56885861552661 35.63641723782729, -82.56904161554904 35.636469237856716, -82.56914261556132 35.63649823787295, -82.56971861562968 35.63667523796821, -82.56973661563181 35.63668123797131, -82.57043261571292 35.63690523808846, -82.57052861572406 35.63693623810466, -82.57063161573654 35.636966238121325, -82.57084261576217 35.63702723815544, -82.57090061577026 35.637037238163416, -82.57103761579013 35.6370562381814, -82.57114861580702 35.637066238194855, -82.57167761589548 35.637062238248426, -82.57211661596897 35.63705923829291, -82.57293761610629 35.63705323837611)))",5708,37,021,001600,370210016001,1140,1140,21,1136,1105,9,0,16,0,6,4,905,12,893,903,882,8,0,10,0,3,2,557,488,69
census_2010_blockgroups_view.fid--2dc29038_13ec899ba8f_-25cb,"MULTIPOLYGON (((-82.31109557393528 35.62923220982309, -82.31116257393022 35.62933620985115, -82.31117657392929 35.62935720985683, -82.31127157391761 35.62953420990255, -82.31133657390781 35.62966720993619, -82.31139157389951 35.62977920996461, -82.3114075738969 35.62981320997313, -82.31145857388952 35.629915209999105, -82.31147557388715 35.62994921000777, -82.3115075738791 35.630035210028566, -82.31154957387258 35.6301222100505, -82.31159257386977 35.630186210068004, -82.31164657386923 35.63024721008592, -82.31168257386904 35.63028721009775, -82.31172857387018 35.63032821011081, -82.3117855738733 35.630369210125, -82.31184657387857 35.630400210137644, -82.31193057388732 35.63043321015292, -82.31200757389807 35.63044621016354, -82.31202057389976 35.63044921016553, -82.3121225739151 35.630459210178024, -82.31237457395478 35.6304712102065, -82.31248857397173 35.63048321022068, -82.3125845739853 35.63049821023364, -82.31269757399933 35.63052821025134, -82.3128045740104 35.63057121027109, -82.31292857401874 35.630649210299765, -82.31307157402537 35.6307592103368, -82.31319457402678 35.63088121037431, -82.31328657402621 35.63098321040449, -82.31336257402438 35.6310762104312, -82.31339757402598 35.631103210440315, -82.31343857402891 35.631128210449546, -82.31349357403465 35.6311492104595, -82.31357057404547 35.631162210470045, -82.31386157408949 35.63118821050539, -82.31407957412351 35.631201210530534, -82.31413457413194 35.63120521053699, -82.31484957424799 35.63121821061333, -82.3149215742601 35.6312172106206, -82.3149475742642 35.631218210623565, -82.31524457431141 35.63123021065655, -82.31534357432716 35.631234210667564, -82.31552557435599 35.631242210687944, -82.31571757438677 35.63124821070897, -82.31593357442118 35.63125621073291, -82.31617657445932 35.63126921076056, -82.31684257456537 35.631295210834594, -82.31721757462492 35.631310210876265, -82.31742057465695 35.63132021089926, -82.31786157472621 35.63134321094951, -82.31802857475134 35.63135921096985, -82.31813857476783 35.63137021098349, -82.31818757477596 35.63137021098852, -82.31823157478203 35.63137721099447, -82.31830557480748 35.63129221098491, -82.31852857488381 35.63103721095605, -82.31854457488902 35.63102021095431, -82.31860357490916 35.63095321094681, -82.31873657495451 35.630802210929815, -82.31913557508992 35.63035321087983, -82.3192695751353 35.630203210863236, -82.31942557518774 35.630030210844176, -82.31944957519627 35.63000121084082, -82.31957557523964 35.62985521082411, -82.3199855753789 35.629393210772676, -82.32016557543979 35.62919121075022, -82.32029957548465 35.62904521073437, -82.32043957553124 35.62889321071802, -82.32066857560869 35.62863721068966, -82.32069757561868 35.62860321068576, -82.32083057566344 35.62845621066961, -82.3208335756646 35.62845221066906, -82.32084357566792 35.62844121066791, -82.32084757566899 35.628438210667696, -82.3209915757188 35.62827021064847, -82.32116057577662 35.628077210626685, -82.32117157578072 35.62806221062477, -82.32125457581171 35.62795021061063, -82.32125957581401 35.62794121060933, -82.32133457584716 35.62780721058982, -82.32136457586431 35.627728210576905, -82.3213895758779 35.62766721056711, -82.32142657590482 35.62753221054347, -82.32142857590746 35.62751721054068, -82.32144857593057 35.62738921051678, -82.32144857593305 35.62737321051355, -82.32145357594659 35.62729121049739, -82.32146457597304 35.62713221046621, -82.32148757600622 35.62694221043006, -82.32149357601337 35.62690221042254, -82.32149657602997 35.626798210401695, -82.32150657604832 35.62669021038082, -82.3215155760778 35.62650921034501, -82.32151457610229 35.62635021031263, -82.32150557611763 35.626241210289585, -82.32144257614682 35.625985210231164, -82.32139257615654 35.6258692102024, -82.32135157616464 35.62577321017877, -82.321359576165 35.625779210180774, -82.32138457616604 35.625799210187424, -82.32139357616643 35.62580621018974, -82.32202457619759 35.6262782103506, -82.32211757620233 35.626347210374185, -82.32266957622774 35.62677221051741, -82.32303257624541 35.62704621061047, -82.3231945762542 35.62716221065073, -82.32336157626445 35.62727421069063, -82.3235255762773 35.627366210726265, -82.32374157629609 35.627475210770626, -82.32398857632238 35.62756921081521, -82.32399257632294 35.62757021081586, -82.32419357634805 35.627622210847136, -82.32445357638318 35.627673210884325, -82.32468357641702 35.62770021091348, -82.32476857643039 35.62770421092303, -82.32486557644583 35.62770821093387, -82.32501857647203 35.627702210948414, -82.32508357648321 35.62769921095453, -82.32516557649701 35.62769721096255, -82.32545957654882 35.62767621098867, -82.3256585765841 35.627661211006135, -82.3257695766037 35.62765321101591, -82.3260205766477 35.62763621103833, -82.32608357665883 35.62763221104402, -82.32621957668137 35.627631211057874, -82.32627657669087 35.62763121106377, -82.32649557672168 35.62766521109322, -82.32654757672908 35.627673211100216, -82.3267995767565 35.627765211144855, -82.32681957675854 35.62777321114856, -82.32697957677277 35.627852211181136, -82.32706257678034 35.6278922111978, -82.32706757678069 35.62789521119892, -82.3271655767884 35.627949211219985, -82.32727057679514 35.62801821124485, -82.3272985767965 35.62803921125194, -82.32737257680016 35.62809521127097, -82.3274195768025 35.628130211282894, -82.32746957680311 35.62817921129804, -82.32752857680406 35.628236211315624, -82.32771957680099 35.628460211380876, -82.32772857680133 35.628467211383196, -82.3278075768046 35.62853121140431, -82.3278325768067 35.62854421140957, -82.32783457680671 35.62854621141016, -82.32793057681513 35.62859421142985, -82.32825957685137 35.628711211487484, -82.32843257687198 35.62876321151588, -82.32854857688703 35.62878921153308, -82.32864457690168 35.6287972115446, -82.32878857692599 35.62879421155883, -82.328893576947 35.6287702115648, -82.3289775769646 35.628746211568625, -82.3291355769978 35.62870021157562, -82.32922657701691 35.62867421157967, -82.32932257703597 35.6286532115853, -82.32943357705685 35.62863721159354, -82.32957757708142 35.62863221160735, -82.32962257708776 35.628639211613425, -82.32974457710455 35.628661211630536, -82.32978457710911 35.62867421163726, -82.32990657712303 35.62871421165798, -82.3299085771232 35.62871521165834, -82.33027957716365 35.62885021172401, -82.33040357717704 35.62889621174615, -82.33048657718626 35.62892521176055, -82.33073657721361 35.62901521180459, -82.33082057722284 35.62904521181935, -82.33093357723537 35.629085211839175, -82.33127557727283 35.629208211899325, -82.33138957728538 35.629249211919465, -82.33165657731413 35.62934821196709, -82.33170657731951 35.62936721197611, -82.33246557740377 35.629633212108395, -82.33255157741334 35.62966321212338, -82.33273757743456 35.629724212154855, -82.33282957744517 35.629754212170496, -82.33293057745445 35.629802212190604, -82.33296657745765 35.62982021219803, -82.33309057746551 35.62990121222723, -82.33317557746648 35.629986212253286, -82.33323557746226 35.63007721227791, -82.33331657744597 35.63026921232523, -82.33332857744375 35.630296212332, -82.33339157742806 35.63046521237274, -82.33351957739845 35.63079321245255, -82.3336125773775 35.63102821250987, -82.33373657735903 35.63128021257381, -82.33384957735225 35.631444212618746, -82.33405257734654 35.63169821269123, -82.33416657734335 35.6318402127318, -82.33427757734148 35.63197121276991, -82.3342945773413 35.63199021277549, -82.3343215773406 35.63202421278517, -82.33445157733678 35.63218721283174, -82.33449557733556 35.63224221284737, -82.33456857733337 35.63233421287362, -82.33478957732724 35.63261021295241, -82.33486357732524 35.63270221297878, -82.33490957732369 35.63276121299542, -82.33505057731962 35.63293821304594, -82.33506657731935 35.63295721305139, -82.3350985773184 35.63299721306287, -82.3352135773147 35.63314421310461, -82.3355605773038 35.63358521322986, -82.33567657730023 35.63373221327164, -82.33574057729881 35.63380921329388, -82.3358545772987 35.63393221333065, -82.33594757729978 35.634024213358906, -82.3360185773006 35.63409521338067, -82.33615157730237 35.6342252134208, -82.336185577303 35.63425821343097, -82.33639957730722 35.63445921349385, -82.33656657731316 35.634599213539474, -82.33671057731841 35.634719213578656, -82.3368715773269 35.634836213619046, -82.3369275773309 35.63487021363172, -82.3371975773497 35.635037213693536, -82.33732957736052 35.63510821372147, -82.33761057738073 35.63527721378483, -82.33770457738744 35.635334213806104, -82.3378315773945 35.63542421383748, -82.33786257739648 35.63544521384492, -82.33795557740177 35.63551021386769, -82.33798657740344 35.63553221387536, -82.33800857740465 35.63554821388088, -82.33802457740556 35.63555921388475, -82.33807557740815 35.635597213897704, -82.33809857740927 35.63561421390355, -82.33816057741245 35.635660213919294, -82.33824557741669 35.63572321394089, -82.33834557742117 35.63580121396699, -82.33840757742401 35.635849213983114, -82.3385585774309 35.63596621402247, -82.33876657743645 35.63615221408165, -82.33887757743624 35.63627221411749, -82.33896457743623 35.63636521414531, -82.33904957743604 35.63645721417277, -82.33909057743496 35.63650821418741, -82.33909457743485 35.636513214188795, -82.33910557743434 35.63652821419301, -82.33911057743438 35.636533214194486, -82.33911357743423 35.636537214195656, -82.3391255774339 35.63655221419992, -82.33913057743398 35.636557214201446, -82.33913557743388 35.636563214203186, -82.33915057743354 35.6365812142084, -82.33915257743352 35.63658321420899, -82.33915857743347 35.636590214211004, -82.33922057743258 35.636662214232025, -82.33932557743108 35.63678421426759, -82.33941257743102 35.636877214295474, -82.33943657743106 35.636902214303014, -82.33948257743216 35.6369442143163, -82.3394775774271 35.636972214321524, -82.3394635774116 35.6370572143373, -82.33945957740647 35.63708621434274, -82.33941657735778 35.637355214393004, -82.33932957725843 35.637904214495464, -82.3393885772389 35.63809321453994, -82.33942057723524 35.638151214554945, -82.33955557722068 35.638389214617256, -82.33959257721662 35.63845521463446, -82.33970557720465 35.638653214686336, -82.33974357720055 35.63872021470388, -82.33983257719079 35.63887821474513, -82.33986757718698 35.63894021476125, -82.33997557713367 35.63940021486582, -82.34001757711322 35.639577214906126, -82.3400955770747 35.63990921498156, -82.34011857704411 35.64013121502901, -82.34014357701318 35.6403582150777, -82.34006257685752 35.641277215256, -82.34012657678457 35.641817215372164, -82.34017357673089 35.64221421545762, -82.34016957671676 35.642301215474866, -82.3401505767018 35.6423772154883, -82.3401265766763 35.642516215514135, -82.34004357662795 35.64274021555097, -82.33997457658978 35.64291321557899, -82.33992257656074 35.643045215600445, -82.33986957652878 35.643195215625404, -82.33985157651466 35.64326721563824, -82.33982057648876 35.643401215662244, -82.33979857645724 35.643581215696464, -82.33980457643895 35.64370621572247, -82.3398185764171 35.64386221575564, -82.33983557640461 35.64396121577745, -82.33983957640194 35.6439822157821, -82.33989457637917 35.64418821582967, -82.33992957636481 35.644318215859634, -82.33997557635578 35.64442621588638, -82.3400665763384 35.64463521593815, -82.34013957632001 35.64483221598568, -82.3402145762841 35.64514421605676, -82.34021957628161 35.64516521606151, -82.34024157625839 35.645339216099174, -82.340237576249 35.64539521611007, -82.34022657622535 35.64553621613764, -82.34018957619665 35.64568221616346, -82.34018657619389 35.64569721616618, -82.34012757616057 35.645849216190946, -82.34008157612705 35.64601621622009, -82.34006557609638 35.64619721625525, -82.34006357607007 35.64636521628909, -82.34006857604385 35.646540216325185, -82.340069576042 35.64655321632789, -82.34008957600214 35.64683221638661, -82.34010257597483 35.64702221642654, -82.34011557586548 35.64774221657406, -82.34010057580547 35.648114216648054, -82.34009557575612 35.64842721671118, -82.34011357573496 35.648583216744655, -82.34012857572564 35.64865921676164, -82.34014457571763 35.648728216777265, -82.34019757570687 35.64885421680829, -82.34026657569707 35.64899121684327, -82.3404725756791 35.64932721693272, -82.34054057566792 35.64947221696919, -82.34058657565011 35.649636217007235, -82.340601575639 35.64972421702669, -82.34059457562836 35.649785217038364, -82.34058657561941 35.64983421704741, -82.34056357560918 35.64987621705365, -82.34055157560546 35.649887217054605, -82.34051957559569 35.64991621705717, -82.34048957558859 35.64993021705691, -82.34043557557757 35.64994321705401, -82.34033057555764 35.64996021704663, -82.34021857553864 35.64996321703568, -82.339857575482 35.6499432169944, -82.33949057542429 35.649924216952684, -82.33877257531098 35.64988921687146, -82.33772757514802 35.649826216750945, -82.337560575122 35.649816216731615, -82.3373495750867 35.649819216710476, -82.33721357505986 35.649847216702156, -82.33710557503562 35.6498882166994, -82.33704857501799 35.64994121670424, -82.33701057500649 35.64997521670714, -82.33700557500491 35.649980216707675, -82.3369645749834 35.65007521672274, -82.33696457498246 35.650081216724, -82.33696057497616 35.650117216730884, -82.33695857497028 35.65015321673792, -82.33696057496834 35.65016821674123, -82.33697257496065 35.65023021675508, -82.33704157494297 35.65041821680038, -82.33709557492921 35.65056521683573, -82.3372555748807 35.651049216950504, -82.33728757486756 35.651168216977965, -82.33734957484255 35.65139521703052, -82.33735157483846 35.65142421703658, -82.33735957482338 35.65153021705893, -82.33735757480532 35.651644217081845, -82.33735757479757 35.65169421709203, -82.33730157472564 35.65209921716852, -82.3373015747083 35.65221121719117, -82.33730957470114 35.65226621720325, -82.33732257469813 35.65229921721128, -82.33732457469767 35.65230421721244, -82.33734457469576 35.65233821722142, -82.33739957469523 35.65240021723965, -82.3374315746962 35.65242821724867, -82.33747657469978 35.65245321725845, -82.33751257470247 35.65247421726639, -82.33762557471401 35.652520217287496, -82.3377165747231 35.652558217304474, -82.33803857476155 35.6526542173572, -82.33809457476738 35.652676217367414, -82.33820657477875 35.65272221738834, -82.33824657478229 35.65274221739648, -82.33835357479163 35.65279621741858, -82.33838457479303 35.65282021742658, -82.33847057479683 35.65288721744904, -82.33853557479523 35.65296721747205, -82.33858157478237 35.65309921750356, -82.33859857476567 35.65322521753089, -82.33860757475682 35.65329221754547, -82.33860957474269 35.65338521756448, -82.33860957474128 35.65339421756644, -82.33860957473664 35.65342421757244, -82.33861057473533 35.65343421757457, -82.33861857465311 35.653973217684815, -82.33862557463823 35.65407721770668, -82.33864857458528 35.65444321778335, -82.33869457454209 35.65477121785475, -82.33870957451512 35.65496121789488, -82.33874757448707 35.655183217943865, -82.33874757446998 35.65529321796619, -82.33874057445941 35.655354217977866, -82.33871757444666 35.65541221798724, -82.33864857442225 35.65549621799719, -82.33858757440578 35.655537217999225, -82.33845757437537 35.655595217997586, -82.33838957435816 35.6556332179983, -82.33831357433739 35.65568621800116, -82.3382825743257 35.65572821800653, -82.33826757431447 35.65578521801663, -82.338267574312 35.65580121801985, -82.33826757430667 35.65583521802666, -82.33828257430149 35.655885218038385, -82.33831357429543 35.65595721805626, -82.33837457428541 35.65608721808899, -82.33838957427317 35.65618221810976, -82.3383965742619 35.656262218126706, -82.33838957425012 35.65633121814007, -82.33836657422151 35.656491218170096, -82.33828257417743 35.65668621820106, -82.33789357404103 35.657151218255336, -82.33783257400029 35.65734921828919, -82.33792357396561 35.65767021836381, -82.33801557396063 35.65780021839969, -82.33824457397604 35.65794521845275, -82.3382905739807 35.6579642184614, -82.3386485740199 35.658093218524535, -82.33886257404296 35.658173218562894, -82.33905357405969 35.65826921860202, -82.33916757406843 35.65833421862695, -82.33922857407032 35.658387218644044, -82.33929757407041 35.65846021866601, -82.33943457405415 35.6587112187311, -82.33948057405227 35.65877221874825, -82.33953657405705 35.6588012187599, -82.33956357405934 35.65881521876551, -82.3397185740751 35.65887921879457, -82.34037057415223 35.65907721890201, -82.34079957420505 35.65919421896999, -82.34116657425315 35.65927521902436, -82.34156657430715 35.65935321908144, -82.34169457432651 35.65936521909712, -82.34183157435089 35.659354219108984, -82.34187457435874 35.659349219112435, -82.3420865744029 35.65929021912232, -82.34226557444104 35.65923521912957, -82.342385574464 35.65921521913793, -82.34252757448995 35.65919921914938, -82.34307857458775 35.65915621919743, -82.34326157462291 35.659124219209865, -82.34363457470029 35.65902321922785, -82.34403257478122 35.658925219248914, -82.34417957480964 35.65889921925882, -82.34480857493325 35.65877221929792, -82.34512057499624 35.65869821931512, -82.34542057505787 35.65862121933043, -82.34566057510254 35.65858921934872, -82.34581457512813 35.65858821936445, -82.3459535751468 35.65861621938439, -82.3460705751579 35.658669219407244, -82.34618057516585 35.658735219431954, -82.34626657516833 35.658811219456354, -82.34634857516498 35.658920219486866, -82.34643257515505 35.65907421952689, -82.34647557514559 35.65918121955299, -82.34648757513109 35.65928721957576, -82.34648657511279 35.65940421959942, -82.34643057501806 35.65995621970573, -82.34640757497463 35.66021221975537, -82.34637557494163 35.66039021978823, -82.34624557483967 35.66091021988035, -82.34618357478111 35.661222219937386, -82.34615057472452 35.66155222000098, -82.34614157471154 35.661626220015044, -82.34592857468509 35.66157021998169, -82.3452925746056 35.66140421988237, -82.34508057457903 35.66134921984937, -82.34504557457475 35.66133921984373, -82.34494157456182 35.66131221982746, -82.34490757455738 35.66130421982233, -82.34468257451543 35.66133521980544, -82.34446357447132 35.66138621979317, -82.34340957422822 35.6618302197746, -82.34204857391927 35.66237121974398, -82.34114657366995 35.663018219782344, -82.3411135736578 35.663061219787686, -82.34060057346706 35.66374521987361, -82.34052357343847 35.66384721988635, -82.34023957328542 35.66453221999616, -82.3388155727803 35.66627222020259, -82.33742357221324 35.66844622050029, -82.33654557173318 35.67060622084826, -82.33633357158578 35.6713312209737, -82.33599457135004 35.67249022117404, -82.3358565712834 35.6727732212172, -82.33562157116933 35.67325822129144, -82.33538557105508 35.67374322136561, -82.33531257101991 35.673892221388314, -82.33520857096478 35.674137221427344, -82.33499657085142 35.67464222150795, -82.33457057069859 35.67517322157187, -82.33393657049643 35.67580122163386, -82.3335545703446 35.67637322171063, -82.33354057032415 35.67649022173292, -82.33345557020303 35.677180221864226, -82.33374057016788 35.67771122200151, -82.33376857016684 35.677747222011725, -82.33378757016621 35.67777222201871, -82.33382957015756 35.67787222204339, -82.33384857015407 35.67791522205412, -82.33388157011271 35.678217222118796, -82.33394957009244 35.67842022216701, -82.3342735700463 35.679063222331045, -82.33434057000376 35.6794092224082, -82.33429456998213 35.67949922242174, -82.3342465699591 35.67959722243674, -82.33416556993221 35.679684222446, -82.33399756988813 35.679789222450005, -82.3334245697841 35.67984922240297, -82.33318256972863 35.67994822239812, -82.33303456968785 35.68005322240417, -82.33262956954759 35.680526222458376, -82.33254956950547 35.68071222248792, -82.33247556946507 35.680894222517246, -82.33238156938386 35.68131722259341, -82.3323945693631 35.68146522262484, -82.33263756919776 35.6827902229189, -82.33265156911666 35.683328223029626, -82.332674569099 35.68346622306003, -82.33275856903623 35.683960223168995, -82.33274556900591 35.6841422232046, -82.33268456896855 35.684318223234044, -82.33247656882587 35.685016223354296, -82.33248356881256 35.68510922337386, -82.33246956880267 35.68515822338246, -82.3324695687685 35.68537822342715, -82.33257156872983 35.685736223510375, -82.33259156870429 35.68592222355015, -82.33256456868621 35.68601022356526, -82.33243356863352 35.686210223592276, -82.33219456853705 35.6865772236422, -82.33207356846334 35.68692322369994, -82.33206656843657 35.687088223732694, -82.3319445683576 35.687467223797036, -82.33187756833044 35.68757122381127, -82.33168956827886 35.68770322381865, -82.33152756824602 35.68774222380985, -82.33127156819947 35.68776922378886, -82.330988568139 35.68785722377753, -82.33077956807793 35.68802822379067, -82.33032856792333 35.688544223848886, -82.33028756790479 35.68862022386012, -82.33012656783087 35.688924223905225, -82.32987756773353 35.68928622395302, -82.32975656765805 35.68964422401317, -82.32974256765242 35.689665224015975, -82.3297495676263 35.689841224052486, -82.32982456759508 35.69012222411727, -82.32982956755264 35.69040122417439, -82.32983056754752 35.690435224181485, -82.32979056751617 35.690594224209654, -82.329703567477 35.69075422423312, -82.32957456743443 35.69089122424761, -82.32937256737713 35.69104522425801, -82.32909656731098 35.69117722425633, -82.3282005671143 35.691490224227266, -82.32800356706086 35.69162422423421, -82.32795856704864 35.69165522423583, -82.32777656698268 35.69188622426388, -82.32764156689812 35.69228722433147, -82.32773656688047 35.692502224384825, -82.32788456680518 35.6931452245307, -82.32791156676274 35.69344722459483, -82.32773656663058 35.69411222471183, -82.32780456661288 35.69429922475678, -82.32801956662388 35.69445722481112, -82.32814056663005 35.69454622484167, -82.32855156663312 35.69496422496898, -82.32874056663118 35.69517822503192, -82.3288615666214 35.69537022508343, -82.32893556659687 35.69560722513919, -82.32892256655553 35.695859225189025, -82.32889556652212 35.6960462252242, -82.32874056642817 35.69648622529753, -82.3286195663186 35.69706322540222, -82.32861356625703 35.697453225480736, -82.32868756621556 35.69779922555867, -82.32866756617892 35.69801422560027, -82.32863356615621 35.698124225619075, -82.3285395661185 35.69826722563838, -82.32825656603079 35.69853022566255, -82.3281015659547 35.6988552257126, -82.32808156591815 35.69906922575394, -82.32811556588801 35.69930022580436, -82.32827056584374 35.69975022591178, -82.3284795658295 35.70006422599712, -82.32863456582625 35.70025022605086, -82.328728565806 35.700481226107534, -82.32875456576744 35.70075722616624, -82.32877656573706 35.700976226213, -82.32878256572268 35.70107522623369, -82.32888256572237 35.701184226266136, -82.32889256570722 35.701292226289084, -82.32891156568003 35.7014872263307, -82.32922056562548 35.70216822650091, -82.32953056558787 35.70274022664908, -82.32959856557275 35.7029102266906, -82.3295775654848 35.703454226798925, -82.32962556545004 35.70372922685972, -82.32976056542626 35.70402622693402, -82.32994956541236 35.70431722701259, -82.33000556541379 35.704367227028484, -82.33021256541994 35.70454822708667, -82.33042156542717 35.70472422714406, -82.33048156542341 35.704812227168084, -82.33057656540005 35.70506422722903, -82.33065056534055 35.7055262273305, -82.33063056528178 35.705883227400975, -82.33051556520293 35.70626822746723, -82.33033356513279 35.70652622750078, -82.33021256509744 35.706625227508376, -82.32955956491426 35.70710922753926, -82.32947156488014 35.7072352275557, -82.32941856482427 35.70753822761183, -82.32945856480276 35.707719227652646, -82.32957956478445 35.70796622771534, -82.32983056478588 35.70822422779366, -82.33009856478749 35.70849922787722, -82.33050956476421 35.70908722803907, -82.33074556477666 35.70925822809821, -82.33088056478037 35.709378228136494, -82.33092756475992 35.70956022817829, -82.33090156467372 35.71008722828262, -82.33092756461133 35.71051622837245, -82.33093456459464 35.71063122839653, -82.33096856457036 35.71082422843921, -82.33109656450351 35.71139022856739, -82.3310905644403 35.71179122864813, -82.3310025643634 35.71219222872055, -82.33096256428429 35.71265922881126, -82.3309895642648 35.712813228845285, -82.3310435642506 35.71296222888112, -82.33125856420847 35.713462229004904, -82.3313295641578 35.713864229093865, -82.33133356415514 35.713885229098494, -82.33129956408294 35.714314229182136, -82.3312255640408 35.71450622921349, -82.33118556400689 35.71468222924502, -82.3311585639545 35.71499022930483, -82.33117156393715 35.715116229331755, -82.33134056388823 35.71561122944976, -82.33143556383914 35.71602822954429, -82.33146256379227 35.71635822961406, -82.33143556374259 35.71664922967039, -82.33142856368163 35.717034229747874, -82.33137456361216 35.71742422982145, -82.33142856358435 35.71766022987493, -82.33166456354047 35.71819423000783, -82.33190756352347 35.718562230107615, -82.33221156346866 35.719238230276325, -82.3324205634163 35.71979823041164, -82.33280456339527 35.72034223056182, -82.33295056337323 35.72063923063719, -82.33302056336264 35.72078223067347, -82.33320956334613 35.72108923075535, -82.33355956329808 35.72177123093006, -82.33369556326097 35.72215523102205, -82.33387056319246 35.72278223116752, -82.33391056314959 35.7231002312362, -82.33408556311265 35.72352423134041, -82.33424156309934 35.72377623140774, -82.3344705630935 35.724057231488494, -82.33455156308051 35.72422723153133, -82.33458556301527 35.724683231627445, -82.33467256300496 35.72484223166876, -82.33478756300173 35.72498523170964, -82.33508456301327 35.7252272317895, -82.33565756301759 35.725809231966956, -82.33586556301607 35.72604023203534, -82.33595356299914 35.726243232085686, -82.33596056296611 35.72646323213109, -82.33594056293967 35.72661223215926, -82.33567156272505 35.727706232353626, -82.3356985627065 35.72785423238655, -82.33585356268769 35.72814023246057, -82.33585356267666 35.72821123247505, -82.33590056265876 35.72837623251341, -82.33609656264946 35.72864523258826, -82.33659556266105 35.72910123273248, -82.33685156265724 35.72939823281925, -82.33698656264295 35.72963423288114, -82.33693256258955 35.729920232933665, -82.33674356250525 35.73026123298336, -82.33669656246518 35.73046923302077, -82.33661656238257 35.730915233103026, -82.33658956232432 35.731261233170535, -82.33654256227636 35.73151923321807, -82.3365555622563 35.73166223324844, -82.33664356223322 35.731904233306686, -82.33669756220628 35.73213523335923, -82.33677856218982 35.73232723340661, -82.33689356213532 35.73280023351463, -82.33697456206329 35.733349233634414, -82.33700156204043 35.73352523367299, -82.33696056197554 35.73389923374471, -82.33687356191416 35.734201233797, -82.33677256186586 35.73440423382783, -82.33668556181637 35.734630233864664, -82.33657756174982 35.73494323391712, -82.33653056164886 35.735542234033886, -82.33644956160204 35.735757234069204, -82.33626756146157 35.736466234194374, -82.33622756137049 35.73701023430076, -82.33623056133747 35.737225234344756, -82.33623456131271 35.737389234378526, -82.33619456123267 35.73786123447015, -82.33599956110363 35.738483234576314, -82.33591756106355 35.73865323460238, -82.33583056103137 35.73876823461677, -82.33552756093061 35.7390932346514, -82.3353995608566 35.73943323470726, -82.33538556082769 35.739604234740575, -82.33539256074936 35.740115234845106, -82.33531856063365 35.740780234972455, -82.33510356048355 35.74151623509972, -82.33514456045789 35.741725235146355, -82.33519156040394 35.74212123523171, -82.33525856038185 35.74233523528209, -82.33521156031513 35.74271423535424, -82.33525956028016 35.74298923541502, -82.33525556027367 35.743027235422346, -82.33573256036928 35.742920235449915, -82.33590656039702 35.742927235469274, -82.33627356045508 35.742944235510734, -82.33654456046351 35.743178235586285, -82.33680956050769 35.74317623561326, -82.3370415605621 35.743073235616365, -82.3372355605776 35.743180235658144, -82.33715356052491 35.7434312357007, -82.33734856053604 35.74356723574839, -82.33737056054093 35.74355923574907, -82.3376525606012 35.74347223576054, -82.33790556065046 35.743424235776985, -82.33801656066747 35.7434332357903, -82.33806556067461 35.743439235796565, -82.3381255606832 35.74344823580459, -82.33821556069654 35.74345823581586, -82.33826656070403 35.743464235822366, -82.33831756068506 35.74364023586339, -82.33841456066143 35.74389523592518, -82.338490560632 35.74416523598797, -82.33883756052275 35.745237236241564, -82.33891656049781 35.745481236299256, -82.33927656038999 35.74655723655501, -82.33946556033645 35.7471022366853, -82.33954456030554 35.74738523675094, -82.33955556028135 35.74755223678603, -82.33955556026925 35.74763023680184, -82.33953656025321 35.74771323681674, -82.33948256022302 35.747849236838796, -82.33942856020072 35.747935236850644, -82.33936856017993 35.748005236858674, -82.33928856015497 35.74808023686565, -82.3391835601261 35.74815423686981, -82.33907856010065 35.748206236869486, -82.3389365600706 35.74824823686337, -82.33862856000891 35.74831723684549, -82.33815755991881 35.74839523681272, -82.33774755983815 35.748477236786954, -82.33736055975749 35.74858423676865, -82.33693755966489 35.74872923675431, -82.33685055964443 35.74876823675331, -82.33645155954942 35.74895423674981, -82.33596355942832 35.749213236751935, -82.3356225593484 35.74936423674735, -82.33545855931163 35.74942623674304, -82.33533055928636 35.74945223673506, -82.33517155925857 35.74946223672066, -82.33513955925372 35.74945923671665, -82.3351415592827 35.749275236679544, -82.33514255929114 35.74922223666886, -82.33512455932578 35.74898023661788, -82.33498855933675 35.74876523656016, -82.33495055933994 35.74870423654384, -82.3348595593346 35.74864123652162, -82.33440355930787 35.74832823641084, -82.33409855927175 35.74823623636066, -82.33397255924991 35.748242236348815, -82.33390155923759 35.74824623634236, -82.33389555923657 35.74824623634168, -82.33360455918576 35.74826323631504, -82.33201155889694 35.748425236183216, -82.33154755882589 35.74838823612772, -82.33034055870205 35.74790023590374, -82.32946555861642 35.74752023573615, -82.32854855847864 35.74743023562299, -82.32729555827719 35.74739323548588, -82.32673355819625 35.74731523541191, -82.3263335581847 35.746964235299316, -82.32572955827663 35.74573123498641, -82.32541255832264 35.74509823482516, -82.32514655838573 35.74441023465786, -82.32474855839077 35.74395423452416, -82.32435055839983 35.7434732343853, -82.32364655845878 35.74234523408344, -82.32288255850447 35.7412392337798, -82.32220355852631 35.74037723353458, -82.32159955850769 35.73985423336589, -82.32031555840263 35.739164233093035, -82.31892755831586 35.738246232763096, -82.31849755829683 35.73791123265059, -82.31795555832106 35.73717923244587, -82.31705755828062 35.7364842322119, -82.31368755812278 35.73391523134185, -82.31299355807293 35.73349823118536, -82.31257955802137 35.733389231120434, -82.3117505578882 35.73336423102969, -82.31117755779044 35.733383230974226, -82.3095245575749 35.73301123072783, -82.30861755743646 35.73293723061897, -82.30775655727913 35.733033230549424, -82.30679755710698 35.73312023046793, -82.30602755697959 35.733120230388295, -82.30509355686422 35.73286923024078, -82.30396255672812 35.732542230057426, -82.30288855657726 35.73237022991145, -82.30191655647461 35.73199722973516, -82.29868855614573 35.73068022913405, -82.29802055607266 35.73044022901626, -82.29658355588765 35.730102228799, -82.29518655570416 35.72979722859261, -82.29366455543871 35.729886228453296, -82.29157055508588 35.72992922824542, -82.29127255503222 35.72995722822024, -82.29126455503079 35.72995822821969, -82.29091255501588 35.729680228126874, -82.29076055504734 35.72931622803724, -82.29059055510366 35.72877322790946, -82.2904845551084 35.72863022786938, -82.29033955511528 35.72843222781423, -82.2898005550709 35.72814422770004, -82.28878655494272 35.727891227543815, -82.28812855487394 35.72763422742364, -82.28743555482579 35.727207227265254, -82.28706255479989 35.72697722718005, -82.28648355476585 35.726581227039745, -82.2864655547649 35.72656822703522, -82.28641155476153 35.72653222702235, -82.28639355476042 35.7265202270181, -82.28627255475334 35.72643722698869, -82.28582255471208 35.72622422689897, -82.28516655466127 35.72585422675604, -82.28483055464555 35.72559822666924, -82.28454855463329 35.72537722659525, -82.28403755465503 35.724694226403784, -82.28325955468485 35.72367622611669, -82.28259555473062 35.7226762258451, -82.28159655472736 35.721635225530534, -82.2807495547293 35.72072322525788, -82.28051855473672 35.72043022517444, -82.2801545549137 35.71890522482725, -82.2795735549433 35.718097224603234, -82.27923855496016 35.71763322447444, -82.27901755497693 35.71729022438205, -82.27900455497885 35.717264224375384, -82.27862555500934 35.71666522421459, -82.27829655500689 35.71633122411276, -82.27796555499796 35.716037224018955, -82.27688155491464 35.71542122378178, -82.27639655490394 35.7149742236409, -82.27581755492838 35.714202223424394, -82.27553855504178 35.71317622318733, -82.2752265552237 35.71167422285026, -82.27519755532398 35.71099822271009, -82.27518355537813 35.71063522263492, -82.27526255547858 35.710073222529154, -82.27558755572713 35.708819222308186, -82.27585355587935 35.70812222219427, -82.27599655603417 35.70727822203779, -82.27587155615264 35.70638322184325, -82.27563855624607 35.70553422164691, -82.2753815563768 35.70442022139431, -82.27613055662809 35.703599221305076, -82.27617055663917 35.7035702213033, -82.2771065568429 35.70325422133594, -82.27795755702326 35.70299822137198, -82.27875755718581 35.70280222141491, -82.28012355749618 35.70225722144547, -82.28132655779932 35.70158522143351, -82.28180955798041 35.70093322135109, -82.28247955821767 35.70011822125493, -82.28312555847431 35.69915322112583, -82.28381955869118 35.69849522106403, -82.28411755875645 35.69839222107396, -82.28429555880108 35.69829422107241, -82.28481055891821 35.698088221083886, -82.28566355912056 35.69769222109172, -82.28668455936182 35.69722522110241, -82.28735855952489 35.69689222110452, -82.28857755980378 35.6963932211292, -82.28888455987784 35.696243221130516, -82.28903455992747 35.69608322111356, -82.28910655997815 35.695833221070195, -82.28907156004009 35.695397220978116, -82.289006560211 35.69422722073392, -82.28905856025581 35.693994220691984, -82.28939856037552 35.69358522064411, -82.28973756047607 35.69329822062095, -82.29001656056569 35.69301822059294, -82.29016856063933 35.692705220545044, -82.29040356078691 35.69200522042735, -82.29056756089645 35.6914742203365, -82.29085856101045 35.69104922028029, -82.29124756114189 35.69061722023283, -82.29198556137678 35.689889220161355, -82.2923945615065 35.6894892201224, -82.29264656161672 35.68904722005872, -82.29281956171512 35.68859721998529, -82.29314356187226 35.68793021988337, -82.29342856199077 35.68747021981946, -82.29351256200786 35.68744921982388, -82.29428856245721 35.68538021948418, -82.29468856270087 35.68423621929325, -82.29454956273393 35.68387521920558, -82.2944195627379 35.683711219158894, -82.2942685627384 35.68354721910999, -82.29387056269591 35.68339721903846, -82.29344756266568 35.68314121894277, -82.29329956264067 35.68314521892835, -82.29306656261069 35.68309021889305, -82.29283456257608 35.68306621886424, -82.29260156254615 35.68301121882904, -82.29195456243666 35.68302821876564, -82.29175756241743 35.682942218727796, -82.29156056239358 35.6828862186961, -82.29133256237873 35.68273921864271, -82.29117056237027 35.68262121860209, -82.29094256238481 35.68228521851028, -82.29078556238788 35.682098218456126, -82.2906375623983 35.68187321839515, -82.29054056239973 35.681761218362404, -82.29029256238137 35.681615218307144, -82.29015256236372 35.681580218285646, -82.29014756238048 35.68146621826197, -82.2896895623786 35.680991218118265, -82.28902956240907 35.68009221786759, -82.28843656242269 35.67937321766042, -82.28833956242494 35.67925521762648, -82.28664956231528 35.67816321723026, -82.28537456222169 35.67740921694553, -82.28566056227649 35.67736021696515, -82.28581456230259 35.6773562169803, -82.28704756250978 35.677333217102984, -82.28714256253106 35.677297217105505, -82.28742756259433 35.677193217113825, -82.28742156261536 35.67705121708433, -82.28721856259591 35.676960217044865, -82.28710356259059 35.676872217015195, -82.2869755625797 35.67680621698857, -82.28644356255153 35.676421216855466, -82.28631656254329 35.67633921682577, -82.28594556251875 35.6761022167393, -82.28567556252953 35.675745216639015, -82.28531856252431 35.67539921653185, -82.28491556252088 35.67499221640766, -82.28456556254922 35.67443721625889, -82.28434256258824 35.673948216136594, -82.2842085626037 35.67370621607363, -82.28395956262227 35.673321215969835, -82.28392756262622 35.673261215954334, -82.28387156263325 35.67315621592729, -82.28368256262765 35.67299121587423, -82.28336656261307 35.67274921579255, -82.2829785626095 35.67235921567331, -82.282814562608 35.672194215622895, -82.2825525626286 35.67178221551218, -82.2824775626504 35.6715622154598, -82.28245156270317 35.671194215382414, -82.2825855628243 35.67055621526675, -82.28258756282646 35.67054421526456, -82.28267356291876 35.67004021517119, -82.2827885629881 35.66971621511731, -82.28307156312087 35.66916121503388, -82.28319956317708 35.66893521500132, -82.28408156352562 35.6676272148269, -82.28429056359063 35.667430214808604, -82.28442556366076 35.66712221476002, -82.28459456372966 35.66685821472394, -82.28505256388527 35.66634221466646, -82.2852815639564 35.66612721464649, -82.28563856404857 35.665913214639865, -82.28588956411113 35.66577721463825, -82.2860155641423 35.66571021463765, -82.28650056427021 35.66540221462528, -82.28672956432672 35.665281214624386, -82.28691156438244 35.66511621460967, -82.28698356440314 35.66505921460551, -82.28705656442402 35.665002214601515, -82.28706456443867 35.66491621458486, -82.28707256445335 35.66483021456823, -82.28720156450856 35.66461121453715, -82.28729556454293 35.66449021452234, -82.28742956459155 35.66431921450138, -82.28757456463872 35.66416921448599, -82.28795556476258 35.66377621444558, -82.2884745649277 35.66326421439526, -82.2884745649279 35.66326321439508, -82.288636564991 35.6630282143641, -82.28873256502284 35.66292521435313, -82.2887825650397 35.66287021434706, -82.28879056504209 35.6628632143465, -82.28897456508852 35.66275921434438, -82.28903956510487 35.66272321434379, -82.28918156514061 35.66264421434241, -82.28987556529538 35.662385214361535, -82.29002356532567 35.662347214369056, -82.29031556539455 35.66221421437224, -82.29054256544802 35.662111214374754, -82.29131656562188 35.66181421439441, -82.29150556566674 35.66172621439611, -82.29178856574076 35.661550214389635, -82.2924215658912 35.66125421439486, -82.29285856598729 35.66110021440875, -82.29342456612672 35.66080321440698, -82.29356156617052 35.66066721439347, -82.2937875662421 35.66044621437191, -82.29390556628671 35.66028421435126, -82.29411856636668 35.65999521431456, -82.2942865664132 35.65987421430741, -82.2944685664534 35.659808214312804, -82.29501456655889 35.65971021434929, -82.29507656657034 35.65970221435406, -82.29510556657574 35.65969821435622, -82.29519456659214 35.659687214363224, -82.29522456659755 35.65968421436565, -82.29529656661097 35.65967421437102, -82.29550556664945 35.659649214387635, -82.29551256665111 35.65964521438745, -82.2955795666667 35.65961621438849, -82.29558256666041 35.659660214397746, -82.29590356672335 35.65959621441796, -82.2960915667721 35.659482214414176, -82.29629556682487 35.659359214410266, -82.29635956684245 35.65931321440751, -82.29648256687652 35.65922521440243, -82.29655156689653 35.65916921439812, -82.29661556691491 35.65911921439459, -82.29709256705198 35.65874321436757, -82.29726556710845 35.65856321434887, -82.2973975671605 35.658368214322955, -82.2974325671892 35.65822021429644, -82.2974385672461 35.6578592142239, -82.29752356727832 35.65774221420888, -82.29783556737077 35.65747821418757, -82.2979775674164 35.657335214173166, -82.298140567465 35.65719521416157, -82.29832656752023 35.657037214148744, -82.29846056756698 35.656878214130266, -82.29852956760409 35.65671221410368, -82.29859656764883 35.65649521406655, -82.29863956767838 35.6563502140416, -82.29864256768009 35.6563422140403, -82.29872956772333 35.65615621401148, -82.29876656776256 35.655942213971855, -82.29875856776984 35.655887213959915, -82.29874756778135 35.6558012139413, -82.2987155677861 35.65573621392478, -82.29869756778852 35.655701213915926, -82.29861156778999 35.65560021388652, -82.2985765677906 35.65555921387456, -82.29842156778847 35.65540721382772, -82.29823556778226 35.6552492137765, -82.29821856778163 35.65523521377185, -82.29810956777932 35.65513421374012, -82.29804456777799 35.65507321372098, -82.29796656778429 35.65494921368782, -82.29773056780357 35.65457321358711, -82.29764356782071 35.65437021353697, -82.29763756782556 35.65433221352856, -82.29761456784858 35.65415921349111, -82.2976155678579 35.654100213479246, -82.29761556786472 35.65405621347036, -82.29761856788522 35.653927213444454, -82.297619567892 35.65388421343585, -82.297634567928 35.65366821339352, -82.2976595679828 35.65334121332974, -82.29765856801471 35.65313421328765, -82.29761556802356 35.65303121326228, -82.29753356804089 35.65283221321347, -82.29744256805684 35.65263221316344, -82.29740256806262 35.652552213143125, -82.29734256807097 35.65243421311293, -82.297107568089 35.65206721301428, -82.2969705681039 35.65182521295099, -82.29695256811289 35.65174821293354, -82.29693256812305 35.65166121291375, -82.29693756815301 35.6514732128761, -82.29694256815846 35.651443212870596, -82.29694756816411 35.65141221286473, -82.29696356818098 35.65132021284779, -82.29696956818661 35.65129021284225, -82.29697756819542 35.651242212833374, -82.29705756823792 35.6510532128033, -82.29722456829924 35.65083521277626, -82.29726756831477 35.65078121276976, -82.29738756835715 35.65063521275248, -82.29750956840289 35.65047021273161, -82.29770356847831 35.65019021269484, -82.29783656853377 35.64997421266467, -82.29793156857858 35.64978621263635, -82.29799156861186 35.64963521261191, -82.29800956864192 35.649460212578234, -82.29799556867931 35.64920421252485, -82.29799156869225 35.64911621250657, -82.29802456873283 35.648889212463935, -82.298101568776 35.64869321243205, -82.29815056879168 35.64864421242722, -82.29839556886913 35.64840521240404, -82.29842256887741 35.64838021240167, -82.29857456893062 35.648199212380675, -82.29867956897293 35.648038212358784, -82.29896856909541 35.6475552122906, -82.29901756911605 35.64747421227922, -82.29913456915433 35.64735221226655, -82.2991955691721 35.64730221226266, -82.29933956921361 35.64718821225444, -82.29975556933312 35.64686021223074, -82.29977056933787 35.64684521222932, -82.2999035693794 35.6467192122174, -82.29995856939637 35.64666821221274, -82.29998056940413 35.646641212209616, -82.30014956946246 35.64644521218727, -82.30019756947807 35.646395212182036, -82.3002745695027 35.64631821217431, -82.30035556952905 35.64623521216588, -82.30041256954709 35.64617921216041, -82.30058756959738 35.64604121215043, -82.30062356960765 35.646013212148425, -82.30071756963387 35.64594421214413, -82.30077456964978 35.6459022121415, -82.30099956971044 35.6457502121339, -82.30100556971193 35.64574721213395, -82.30143456982323 35.64548621212521, -82.30155356985699 35.64539521211903, -82.30166756989304 35.64528421210831, -82.30180956994046 35.6451292120915, -82.30182156994428 35.6451172120903, -82.30194456998657 35.64497521207416, -82.30204457001787 35.64488021206516, -82.30214257004877 35.64478521205598, -82.30221457007113 35.64471721204967, -82.30242957013485 35.64453521203492, -82.30245357014161 35.6445172120337, -82.30256557017236 35.64443821202928, -82.30260457018314 35.64441021202759, -82.30267557020264 35.64436021202473, -82.30272457021488 35.644333212024264, -82.30276757022536 35.644311212024306, -82.30304757029437 35.64416421202334, -82.30316457032303 35.64410421202326, -82.30343657038672 35.64398321202677, -82.30373457045405 35.64386621203374, -82.30392357049432 35.64380721204129, -82.30400557051168 35.643783212044895, -82.30422957055742 35.64372621205646, -82.30470657065138 35.643628212085815, -82.30485357068034 35.64359821209487, -82.30511357073352 35.64353221210831, -82.3053645707881 35.643447212116946, -82.30560957084272 35.643356212123756, -82.30583357089594 35.64325121212555, -82.30600557094112 35.643143212121394, -82.30605857095587 35.64310421211897, -82.30627357101537 35.642949212109656, -82.30645057106558 35.64281421210056, -82.30645957106823 35.642806212099806, -82.30648957107681 35.642783212098294, -82.30650057107971 35.642776212098006, -82.30672057114191 35.64260921208679, -82.30691157120361 35.64241421206693, -82.30697857122522 35.64234621206003, -82.3072995713343 35.641984212019686, -82.30739857136322 35.64190321201347, -82.30751257139379 35.64182721200979, -82.30767957143628 35.64173121200753, -82.30783657147224 35.64166621201054, -82.30825757156194 35.64153621202759, -82.30839757159153 35.64149421203352, -82.30878357167363 35.641376212049366, -82.30899457171861 35.64131021205774, -82.30922457176976 35.641225212064214, -82.30952957184327 35.64107621206548, -82.30955657184951 35.641064212065785, -82.30981957191533 35.64092021206368, -82.30998557195852 35.64081821206009, -82.31011757199431 35.6407282120555, -82.31032057205279 35.6405672120438, -82.31056957212877 35.64034221202382, -82.3106675721602 35.64024321201381, -82.31085457222306 35.64003721199123, -82.31106857229649 35.6397912119634, -82.31124457236285 35.63955021193267, -82.31129657238453 35.6394652119208, -82.31141557243393 35.63927321189412, -82.31165357253762 35.63885721183417, -82.31169857255905 35.63876721182055, -82.31170557256267 35.63875121181804, -82.31172957257408 35.63870321181081, -82.31173757257773 35.638688211808606, -82.31177857259671 35.638609211796755, -82.31180457260912 35.6385572117889, -82.31193457266941 35.63830621175141, -82.31202757270489 35.63817621173461, -82.31207957272429 35.638106211725734, -82.31211957273787 35.63806121172072, -82.31212157273869 35.638058211720306, -82.31212857274124 35.63804921171922, -82.31213157274198 35.63804721171911, -82.31215857275082 35.6380192117162, -82.31224057277682 35.63793921170845, -82.31226857278554 35.63791221170582, -82.31222957278379 35.637882211695704, -82.31221857278442 35.63786621169134, -82.3122035727841 35.63785221168693, -82.31200657277944 35.63767221163008, -82.31194157277783 35.63761321161144, -82.31189257277649 35.6375692115974, -82.31178257276756 35.63751021157415, -82.31165057276388 35.637393211536754, -82.31161757276719 35.63733621152176, -82.31162757277566 35.63729221151388, -82.31168657280632 35.637157211492536, -82.31174957283235 35.63705621147853, -82.31180957286266 35.636924211457966, -82.31193057291037 35.63674521143408, -82.31194657293167 35.6366252114114, -82.31194257293902 35.636573211400425, -82.31194157294361 35.63654221139405, -82.31189357295756 35.636401211360464, -82.31188257297043 35.63630621134006, -82.31189257298628 35.63621421132242, -82.31195157300614 35.636149211315285, -82.31223357307769 35.63598821131171, -82.31232557310689 35.63589721130274, -82.31236357312216 35.63583921129492, -82.31241357314502 35.63574521128097, -82.31244857317027 35.63561921125901, -82.31245757318625 35.63552521124084, -82.31243257319545 35.635439211220834, -82.31237657319645 35.63537321120168, -82.31231857319212 35.63533921118878, -82.31225257318204 35.63533421118091, -82.3121765731693 35.635335211173235, -82.3120605731481 35.63534821116404, -82.31190757311789 35.63538021115469, -82.31175257308527 35.63542521114783, -82.31152457303362 35.635516211142765, -82.31145357301996 35.63552821113789, -82.31140057301137 35.63552721113225, -82.31135657300696 35.63550921112406, -82.31129757300616 35.63545121110617, -82.31127757300739 35.63542221109828, -82.31127557302143 35.6353292110791, -82.31129857303088 35.63529221107404, -82.31149657308173 35.63517521107067, -82.31162457311693 35.63508421106539, -82.31169357314032 35.63500721105693, -82.31173257315929 35.6349262110445, -82.31182257318636 35.634847211037695, -82.31192057321805 35.63474721102754, -82.31199757324892 35.63463021101177, -82.31201957325989 35.63458221100428, -82.31206257328112 35.63449121099024, -82.31209957330226 35.63439421097433, -82.31212657333117 35.63423621094512, -82.31217757335989 35.63410521092376, -82.31220957338051 35.63400621090697, -82.31224657340928 35.6338592108809, -82.31227357343883 35.63369721085088, -82.31229657345287 35.633631210839845, -82.31236457349785 35.633413210802566, -82.31237657350802 35.633360210793086, -82.31241057353634 35.633213210766755, -82.3124255735652 35.633043210733746, -82.31239857359758 35.63280521068268, -82.31238457360143 35.63276521067312, -82.31236957361753 35.632645210647226, -82.31238057363 35.63257621063433, -82.31238257364093 35.63250821062076, -82.31238357364215 35.63250121061942, -82.31237857365383 35.63242021060246, -82.31234457366072 35.632339210582515, -82.31226757366036 35.63225921055839, -82.31218957365604 35.632204210539115, -82.31209757364684 35.63216521052176, -82.31198757363379 35.63213221050374, -82.31182857361235 35.63210121048101, -82.31171257359543 35.632087210466175, -82.31157757357107 35.632100210454944, -82.31143257354326 35.63212521044497, -82.31134957352911 35.63212821043705, -82.31123757351155 35.63212221042426, -82.31113057349633 35.632106210410036, -82.31095457347946 35.63202721037577, -82.31074757345033 35.631994210347784, -82.31054157341337 35.63201321033041, -82.31021857334275 35.63212521031976, -82.31013757332825 35.632132210312825, -82.31005457331422 35.632134210304706, -82.31004657331276 35.632135210304085, -82.30996057329607 35.63215121029846, -82.30987657327879 35.63217321029425, -82.30978557326107 35.63219121028849, -82.30971657324929 35.63219321028183, -82.30968457324605 35.63218021027586, -82.30960057325369 35.63204121023898, -82.30953257325342 35.63197021021753, -82.30943857324611 35.631917210197095, -82.30933157323238 35.631891210180775, -82.30931957323065 35.63189021017936, -82.30919657321247 35.631876210163824, -82.30917457320945 35.63187221016073, -82.30893157317468 35.63183721012859, -82.30874257314616 35.63182021010559, -82.3086995731395 35.63181721010055, -82.30865457313365 35.63180721009393, -82.30861557313162 35.63177821008404, -82.30861257313212 35.63177221008251, -82.30858757313476 35.63172821007095, -82.30857257314233 35.631663210056246, -82.30857257314528 35.63164421005238, -82.30857657315616 35.63157821003938, -82.3086345731806 35.63148221002591, -82.30874857321916 35.63135421001171, -82.30879457323175 35.63132221000991, -82.30888457325594 35.63126221000708, -82.30891157326137 35.63125621000859, -82.30899457327796 35.63123721001333, -82.30921057331692 35.63121621003134, -82.30955457338071 35.6311712100577, -82.31006857347148 35.631133210102945, -82.31021357349994 35.63110421011204, -82.31043657363793 35.63045021000235, -82.31066057372959 35.63009720995377, -82.31069757375195 35.62999220993627, -82.31078357378996 35.62983820991388, -82.31081257380427 35.62977720990452, -82.31082957381588 35.62972020989468, -82.31082057384111 35.62954720985866, -82.31077757388184 35.62923820979148, -82.31074157390064 35.62907820975529, -82.31073057393445 35.628848209707506, -82.3107385739422 35.62880620969976, -82.31075157394777 35.628784209696676, -82.31076657395255 35.62876920969518, -82.31080257396117 35.62875220969539, -82.31084257395536 35.62883220971578, -82.31085457395447 35.62885120972087, -82.31103457394008 35.62913620979726, -82.31109557393528 35.62923220982309)))",6384,37,021,003102,370210031021,1633,1633,45,1600,1515,70,2,5,0,8,33,1344,27,1317,1324,1260,54,2,4,0,4,20,1107,749,358
census_2010_blockgroups_view.fid--2dc29038_13ec899ba8f_-25ca,"MULTIPOLYGON (((-82.49243860645572 35.61299022520128, -82.49250960649212 35.61283022517606, -82.4925506065195 35.61269722515321, -82.4925516065207 35.61269022515186, -82.49257260654065 35.61258322513228, -82.49258960656867 35.6124202251009, -82.49259260659984 35.61222122506071, -82.492578606625 35.61204322502306, -82.4925586066596 35.611797224970985, -82.49255760666964 35.61173122495745, -82.49255660668284 35.61164422493968, -82.49257760672226 35.611411224894425, -82.49260960674899 35.611272224869495, -82.49264760677507 35.6111442248473, -82.49270760680665 35.611004224825024, -82.49278360683942 35.61087322480615, -82.49287460687651 35.61073022478648, -82.49301360692864 35.61054222476249, -82.49333060704303 35.61014122471363, -82.49344960708561 35.60999322469567, -82.49382260722358 35.60949922463354, -82.49388260724977 35.60939422461838, -82.49397260729248 35.609214224590986, -82.49400560731351 35.6091132245739, -82.49403160733418 35.60900722455495, -82.49405560736678 35.608821224519644, -82.49405460738217 35.60872022449896, -82.49404260739813 35.608604224474085, -82.49398760743506 35.608305224407665, -82.49384860748403 35.60783822429834, -82.49381360749834 35.607708224268336, -82.49370160752878 35.60739022419215, -82.4935866075481 35.60714122412971, -82.49350960755335 35.607024224097934, -82.49343760755606 35.60692922407122, -82.49332760755598 35.60681122403587, -82.49318560754996 35.606698223998336, -82.49307560754357 35.60662122397135, -82.49295360753335 35.606556223945574, -82.49283260752226 35.606498223921335, -82.4927006075082 35.60644722389741, -82.49265860750324 35.606434223890396, -82.49229060745907 35.60632522383042, -82.49146560735845 35.60609022369774, -82.49122260732864 35.606022223658925, -82.49071060726587 35.605879223577176, -82.49031860721756 35.60577122351494, -82.49007860719254 35.6056752234707, -82.48984460717149 35.60556022342328, -82.48965860716064 35.60543022337769, -82.48949960715824 35.605275223329826, -82.48939760716132 35.605145223292915, -82.48981360724942 35.60502122331049, -82.49069260743902 35.60473622334286, -82.49117160754244 35.60458122336059, -82.49140060759116 35.60451122337001, -82.49156560762326 35.60448022338058, -82.49161060763198 35.60447222338359, -82.49185660768391 35.60440022339423, -82.49206160772641 35.60434522340411, -82.49221960775337 35.604340223419335, -82.49238860778009 35.60434822343841, -82.49257760780637 35.60438122346454, -82.49274760782731 35.60442822349159, -82.4927616078289 35.604433223494034, -82.49291360784513 35.60449122352146, -82.49311160785528 35.60463822357168, -82.49323460786164 35.60472922360292, -82.49324560786263 35.60473422360497, -82.49328560786606 35.604755223613374, -82.4933396078743 35.60476022361996, -82.49339560788495 35.60475122362389, -82.49348060790952 35.60468322361881, -82.4935766079467 35.60454522360058, -82.49360260796001 35.604487223591526, -82.4936736079947 35.60433822356844, -82.49371060801366 35.604255223555434, -82.4937346080253 35.60420522354769, -82.49383160806732 35.60403722352349, -82.49384560807242 35.60401922352131, -82.49390360809271 35.60395022351323, -82.49395960811212 35.6038842235055, -82.49410360815897 35.60373522349006, -82.49441460824478 35.60351322347687, -82.49446460825965 35.60347022347323, -82.49452060827608 35.6034242234697, -82.49460660830633 35.603320223457324, -82.49466560833078 35.603225223444085, -82.49469560834982 35.60313422342867, -82.4947036083698 35.60301322340487, -82.49471660838687 35.60291622338648, -82.49475260840319 35.6028492233766, -82.49482360842386 35.602791223372044, -82.49490260844253 35.602755223372874, -82.4950676084739 35.602729223384586, -82.49537660852505 35.60273022341653, -82.49582360860082 35.60271922346026, -82.49620960866754 35.60270122349629, -82.49623860867271 35.60269922349884, -82.49644360870866 35.60268622351727, -82.49680860877294 35.602662223549935, -82.49697860880485 35.602638223562515, -82.49710960882935 35.60262022357233, -82.49745160889537 35.60255922359507, -82.4975816089214 35.60253022360256, -82.49790660898591 35.60246122362192, -82.49813360903069 35.6024152236359, -82.49845460909692 35.60233122365181, -82.49874560915329 35.60227822367095, -82.49903760920638 35.602248223694865, -82.49924360924233 35.602236223713625, -82.49939060926748 35.60223122372772, -82.49954260929329 35.602227223742545, -82.49985460934367 35.602236223776465, -82.50000160936465 35.602258223796035, -82.50004960937156 35.602265223802426, -82.50020860939209 35.602303223826524, -82.50024660939673 35.60231322383243, -82.50041960941672 35.60237022386187, -82.50069360944595 35.60247522391138, -82.50081360946227 35.602498223928336, -82.50082160946333 35.60250022392956, -82.5010236094918 35.60253322395712, -82.50103760949376 35.60253522395892, -82.50125660952688 35.60255622398568, -82.50151560956579 35.60258222401763, -82.50159160957917 35.60257722402441, -82.50167060959437 35.60256322402967, -82.50176660961559 35.602529224032665, -82.50188360964512 35.60246322403129, -82.50192760965678 35.602435224030074, -82.50212660970907 35.60231022402512, -82.50245960979443 35.6021142240195, -82.50249060980242 35.60209622401898, -82.5026346098386 35.60201622401757, -82.50281360988913 35.60188122400854, -82.50301660995385 35.601679223988256, -82.50322561002217 35.60146122396536, -82.5034506100872 35.60128122395188, -82.50345261008754 35.6012812239521, -82.50356661011124 35.60125022395755, -82.50371061013816 35.60123022396833, -82.50386761016439 35.60122922398418, -82.50386661016051 35.60125322398894, -82.50387461015168 35.60131922400324, -82.5038906101455 35.60137622401648, -82.50390861013938 35.60143522403034, -82.50401861012573 35.60164222408376, -82.50407861011351 35.60178622411926, -82.50413761010188 35.60192522415354, -82.50435261005998 35.602428224277965, -82.5043866100534 35.602507224297554, -82.50452261003178 35.60279422436992, -82.5046076100155 35.60299122441876, -82.50469160999239 35.60323122447618, -82.50470460998164 35.60331522449458, -82.50471460996529 35.60343222451945, -82.50470860995233 35.60351022453468, -82.50470660993194 35.603640224560905, -82.50472160991475 35.603767224588346, -82.50475360990225 35.60388322461519, -82.50480060989398 35.60398722464121, -82.50486860988207 35.604137224678716, -82.50494860985984 35.604368224733925, -82.50496260984917 35.60445222475242, -82.50496360984098 35.60450622476356, -82.504955609825 35.60460122478203, -82.50493960981343 35.604659224792144, -82.50491460980163 35.60470922479977, -82.50486060978218 35.60477722480806, -82.50475360975008 35.60487022481603, -82.50462560971808 35.60494022481708, -82.5044496096785 35.6050072248126, -82.50424560963056 35.60509922481029, -82.50417760961241 35.605143224812345, -82.50412260959563 35.60519322481688, -82.50405760957375 35.605265224824805, -82.50399260954727 35.60536722483885, -82.5039546095221 35.60548922485976, -82.50391660947359 35.605763224911556, -82.5038866094245 35.60604922496671, -82.50386360939066 35.60624422500398, -82.5038556093763 35.60632822502029, -82.50382560934375 35.60650722505362, -82.50377960924381 35.607106225170746, -82.50375660921183 35.607289225205605, -82.5037416091593 35.60761322526995, -82.50376460909604 35.608048225360804, -82.50381560904731 35.608419225441516, -82.5038306090369 35.608503225460176, -82.50401260895485 35.609231225626935, -82.5040306089453 35.60931222564526, -82.50405160892765 35.60944922567535, -82.5040566089109 35.60956322569904, -82.50405560890793 35.609581225702584, -82.5040546088891 35.60970222572715, -82.50404360886276 35.60986122575832, -82.5039646087804 35.61031022584147, -82.50395460874799 35.6105102258812, -82.50396360873077 35.61063122590672, -82.50396360873015 35.610635225907515, -82.50399460869868 35.610873225959175, -82.50400960868936 35.610949225976135, -82.50400860868356 35.610986225983595, -82.50398860867404 35.611026225989654, -82.50392460866138 35.611039225985685, -82.50380660864172 35.61104022597373, -82.50356860860498 35.61102222594567, -82.50277660848275 35.61096322585221, -82.50217360838748 35.61093222578387, -82.5019996083599 35.61092422576436, -82.50170860831464 35.61090422573036, -82.50164660830536 35.61089822572278, -82.50146060827733 35.61088022570002, -82.50139960826812 35.61087422569256, -82.50141760825595 35.6109722257143, -82.50141060823105 35.61112622574484, -82.50137660819746 35.61130722577816, -82.50137160818892 35.611357225787856, -82.50136360817419 35.61144422580476, -82.50132960812694 35.61171422585617, -82.50133660810947 35.61183522588155, -82.50129560809505 35.61188422588726, -82.5012286080687 35.6119832259005, -82.50119460805291 35.61204922591038, -82.50119460804437 35.61210422592166, -82.50118760803059 35.61218622593757, -82.50127560802392 35.61232422597471, -82.50130860801508 35.61241722599705, -82.50134960801087 35.61248822601565, -82.50136960800143 35.612571226034646, -82.50139660799326 35.6126532260541, -82.50143660799012 35.612716226071015, -82.50145660798869 35.61274722607937, -82.50152460798562 35.6128402261053, -82.50158460796584 35.613033226150684, -82.50159760794732 35.61316722617927, -82.5016006079417 35.61320622618755, -82.50160460793701 35.61324122619509, -82.50159960792355 35.61332322621128, -82.5015986079172 35.61336322621933, -82.50159760791315 35.61338822622424, -82.50159760791288 35.61339022622465, -82.50159960790198 35.613463226239745, -82.50160160789838 35.61348822624498, -82.50160360789347 35.61352222625211, -82.50159760788404 35.613577226262684, -82.50164460786807 35.61373122629889, -82.50167160786582 35.613775226310565, -82.5017116078588 35.613863226332604, -82.50170860785467 35.6138872263372, -82.50167160778697 35.61428622641458, -82.50163060774376 35.61452222645837, -82.50162360771812 35.61468122648998, -82.5016236076764 35.614951226544925, -82.50163660765233 35.6151212265808, -82.50163160764706 35.615150226586195, -82.50161660762863 35.61525322660564, -82.50158260760021 35.61540122663223, -82.50155660757041 35.61556622666309, -82.50155560756947 35.615571226664024, -82.5015356075391 35.61574722669776, -82.50154660751436 35.61591922673389, -82.5015556074974 35.61603922675922, -82.50158860747396 35.616226226800684, -82.50157560745666 35.616324226819316, -82.50153460742855 35.61646222684314, -82.501508607392 35.61667122688294, -82.50149460737804 35.61674722689697, -82.50139560733075 35.61694722692746, -82.50135960731318 35.61702222693906, -82.501211607259 35.617214226962844, -82.50120460725346 35.617243226968064, -82.50119160724383 35.61729122697653, -82.50119160723365 35.61735722698988, -82.50118460722814 35.617385226994955, -82.50117960721998 35.61743322700414, -82.50117760721606 35.61745622700861, -82.50117760720076 35.617555227028824, -82.50117160719377 35.6175942270361, -82.50115060718194 35.61764822704488, -82.50106960714898 35.61777522706238, -82.50101560712133 35.617896227081445, -82.50097960710436 35.61796722709219, -82.50094160708623 35.61804422710398, -82.50088660706278 35.618137227117245, -82.50086760705454 35.61817022712196, -82.5008136070361 35.61823122712883, -82.50069960701474 35.61824722712036, -82.5005886069772 35.61837122713415, -82.50054960696409 35.61841422713892, -82.50047760693971 35.61849522714794, -82.50039660690096 35.61865922717302, -82.50036260688083 35.61875322718856, -82.50036260686821 35.6188352272053, -82.5003756068601 35.618901227220086, -82.50040260685367 35.618972227237315, -82.50045660684901 35.61906022726071, -82.50051760683711 35.619203227296126, -82.5005366068241 35.61930822731944, -82.5005776068131 35.61942322734706, -82.50058360679706 35.61953322737002, -82.50063160679152 35.619621227392884, -82.50068060679386 35.619658227405445, -82.50076360679788 35.619722227427005, -82.50084160680149 35.61978222744727, -82.50084860678272 35.619911227474184, -82.5008526067765 35.61995622748377, -82.50085260677129 35.61998922749049, -82.50087860676935 35.62003022750144, -82.500893606768 35.6200552275081, -82.50094760676697 35.62012022752692, -82.50096660676657 35.62014322753354, -82.50102160676546 35.620209227552564, -82.50107160676465 35.620268227569795, -82.50112860676359 35.62033622758947, -82.50137060677154 35.62054522765682, -82.50139560676367 35.62062322767528, -82.50140460676114 35.620649227681476, -82.50135060673273 35.620775227701586, -82.5012566067072 35.62083922770491, -82.50113160666871 35.620954227715465, -82.5010166066451 35.6209842277098, -82.50120060666802 35.621033227738664, -82.50129460668163 35.621046227750995, -82.5014206067144 35.62096922774825, -82.50151160673833 35.620912227746025, -82.50174260677709 35.62090922776917, -82.502193606844 35.62096022782595, -82.50273960690807 35.62113222791711, -82.50317060694994 35.62132422800051, -82.50361360698929 35.62154522809104, -82.50389360701146 35.62170222815182, -82.5040006070047 35.62186122819514, -82.50421560698405 35.62222622829151, -82.50441660697425 35.622506228369126, -82.50441560697206 35.62251922837162, -82.50444760696513 35.62259822839107, -82.50447860695553 35.622694228413735, -82.50448560690283 35.623043228485436, -82.50447960689765 35.62307022849029, -82.5044216068499 35.62331722853459, -82.50437760684692 35.62328922852441, -82.50416360670586 35.623973228641525, -82.5041746067023 35.62400822864981, -82.50424460668566 35.62419122869418, -82.50413960660062 35.62462922877252, -82.50410860651671 35.62514022887327, -82.50405560646408 35.62542422892566, -82.50397860641918 35.62563222896003, -82.50391260637893 35.62582222899188, -82.5038606063295 35.62608622904023, -82.50387660629143 35.62635022909555, -82.50397360626852 35.62660322915704, -82.50410460625847 35.626809229212434, -82.5042936062566 35.6270242292756, -82.50433560626452 35.62701822927875, -82.50444360629358 35.626946229275184, -82.50447360630568 35.626900229268884, -82.50450660632809 35.626790229249934, -82.50450660634583 35.62667522922655, -82.50452560635729 35.62662122921749, -82.50456660637295 35.62656422921012, -82.50465960639772 35.626503229207295, -82.50489360645132 35.62640722921184, -82.50490060645359 35.626400229211114, -82.50495660647012 35.62635322920734, -82.50507460651701 35.62617622918341, -82.50516560654152 35.6261152291804, -82.50527460656477 35.62608222918484, -82.50544360659599 35.626061229197965, -82.50552260661416 35.6260282291994, -82.50577160667616 35.62589422919774, -82.5058506066901 35.62588922920492, -82.50601160670816 35.625945229232876, -82.50609560672008 35.625958229244155, -82.50614460672864 35.625955229248554, -82.50641860678728 35.62587022925942, -82.50647660679577 35.62587722926686, -82.5065416068027 35.62590222927859, -82.5067616068238 35.62600222932164, -82.50680760683159 35.62600122932607, -82.50690560685295 35.62596822932945, -82.50699360687518 35.625918229328335, -82.50708160690073 35.6258472293229, -82.5071816069393 35.62570522930433, -82.50743960702604 35.625420229272976, -82.50757560706579 35.62530922926429, -82.50791560715645 35.62508722925415, -82.50803960719422 35.62497522924408, -82.50808360721254 35.62490422923418, -82.50809960722333 35.62485122922502, -82.50813160726695 35.624603229177865, -82.50819560731652 35.62435022913295, -82.50823160733367 35.624278229122034, -82.50839460739793 35.62403722908976, -82.50847660743146 35.62390822907194, -82.50853160745561 35.62381022905765, -82.50858560748145 35.62370122904107, -82.5086696075331 35.62345622899981, -82.50870760755103 35.62338122898856, -82.5087336075586 35.62336022898693, -82.50880360757542 35.62332622898718, -82.50882560752046 35.62370622906678, -82.50871960744365 35.624090229133955, -82.50869960741765 35.62423722916181, -82.50870260740025 35.62435322918576, -82.50873360738876 35.624461229210844, -82.50874560737596 35.62455722923166, -82.5087376072983 35.62505122933139, -82.50868260726665 35.625197229355386, -82.50862960724629 35.625272229365194, -82.50845360719057 35.6254442293821, -82.5081456070838 35.62580522942387, -82.50812660707305 35.625854229431845, -82.50813360707025 35.625880229437925, -82.50778460698531 35.62605522943762, -82.50726360685177 35.62636022944607, -82.50722360684085 35.626388229447656, -82.50714760681957 35.626444229451245, -82.50706660680017 35.62648322945085, -82.50699460678602 35.62649722944626, -82.50681860675975 35.626478229424315, -82.50649060669991 35.62651322939765, -82.5060276066109 35.62659222936609, -82.50568160653846 35.62669022935044, -82.50551760650703 35.62671722933916, -82.50535560647265 35.62676622933234, -82.5052236064388 35.62684322933452, -82.50514560641466 35.62691622934124, -82.50511560640282 35.62696022934717, -82.5050106063419 35.62724222939375, -82.50492960631398 35.627336229404484, -82.50478260627028 35.62746122941481, -82.50464960623466 35.627549229419074, -82.50454660621169 35.62758722941618, -82.50453360620871 35.62759222941587, -82.50438460618246 35.62760222940252, -82.50416160614668 35.62759422937799, -82.50365860607364 35.627527229312605, -82.50351060604665 35.62754322930068, -82.5033426060175 35.62755122928495, -82.50314060597555 35.62760622927536, -82.50298060594034 35.62766222927034, -82.50265760587068 35.62776622925823, -82.50255260584476 35.62782122925865, -82.50247160581947 35.62789822926604, -82.50218360570103 35.62835622932952, -82.50212960567198 35.62848622935046, -82.50212560565144 35.62861522937624, -82.50213060562479 35.62879322941301, -82.5020986056012 35.62891122943369, -82.50207860559249 35.62894622943881, -82.50203960557998 35.628985229442705, -82.5019676055635 35.6290152294414, -82.50171460552194 35.629012229414705, -82.50145060548125 35.62899222938353, -82.50130960546363 35.628955229361466, -82.50118360544953 35.62891122933953, -82.5011056054378 35.628903229329936, -82.50107060543105 35.6289092293275, -82.50103560542246 35.62892722932755, -82.50099060540698 35.62897922933353, -82.50094560538327 35.629084229350234, -82.50090760535507 35.62922622937524, -82.50085060532133 35.629383229401284, -82.50078760528974 35.62952022942275, -82.50076960526197 35.6296812294536, -82.50075860523623 35.629836229484, -82.50072960520971 35.6299762295095, -82.50067860518135 35.630105229530486, -82.50056260512484 35.6303472295678, -82.50056660510771 35.630462229591686, -82.500588605093 35.63058122961809, -82.50059460508335 35.63065022963271, -82.50055760506628 35.63072122964335, -82.50050160504911 35.63077222964808, -82.50044260503604 35.630793229646166, -82.50029760500753 35.63082222963715, -82.50018060498218 35.630860229632844, -82.50008260495717 35.63091722963433, -82.49998260492659 35.631008229642624, -82.49987760489275 35.63111422965335, -82.4997756048582 35.63122822966611, -82.4997076048335 35.63131522967675, -82.49962560481036 35.6313772296809, -82.4995536047949 35.63140022967814, -82.49946560478062 35.631398229668704, -82.49935860477163 35.63134122964612, -82.4991846047618 35.63121822960322, -82.49898360474764 35.631093229557116, -82.4987436047233 35.63099322951206, -82.49863760470991 35.630966229495684, -82.49846160468563 35.63093422947107, -82.49825760465414 35.63091922944701, -82.4981046046297 35.63091322943, -82.49794760460316 35.630916229414495, -82.49787860459045 35.630924229409004, -82.49779860457274 35.63095322940666, -82.49778260456766 35.63096922940829, -82.49775460455496 35.63102122941599, -82.49775660454767 35.631070229426165, -82.49776360454442 35.631099229432785, -82.49780560454396 35.63114722944691, -82.49783060454524 35.6311662294533, -82.49790960455567 35.63118322946488, -82.49800360457127 35.63118322947456, -82.4981626045956 35.63119622949357, -82.49830260461468 35.63122322951352, -82.49845760463161 35.63128022954101, -82.49862660464531 35.631373229577314, -82.49879760465036 35.631524229625626, -82.49890860465482 35.631614229655334, -82.49915660467177 35.631771229712875, -82.4993266046879 35.63184922974621, -82.49943660470215 35.631875229762784, -82.4995876047255 35.63188622978062, -82.49967860474105 35.63188322978936, -82.49982560477018 35.63185222979816, -82.49994560480287 35.631769229793605, -82.50017460486094 35.63163922979076, -82.50024460487522 35.6316222297945, -82.50030760488704 35.63161322979912, -82.50032860488813 35.6316292298045, -82.5003816048953 35.63163922981202, -82.50042560490107 35.63164922981854, -82.50052460491617 35.63165822983063, -82.50089260496966 35.631707229878415, -82.50111460500256 35.63173222990643, -82.50116060500821 35.631745229913726, -82.50118560500991 35.631761229919555, -82.50119560500907 35.63177722992379, -82.50119260500605 35.63179322992677, -82.49918860458546 35.63236422983681, -82.4990566045522 35.6324382298382, -82.49898360452798 35.632516229846566, -82.49892060449027 35.632693229876075, -82.49884960431918 35.63372523007877, -82.49881960428863 35.63389023010921, -82.49874060424453 35.634091230142026, -82.4985786041865 35.634293230166406, -82.4976346038792 35.63526923026783, -82.49745760383189 35.635385230273165, -82.4973466038077 35.63542323026949, -82.49689760372418 35.635481230235065, -82.4967506036932 35.63552423022875, -82.49601360350805 35.635931230235634, -82.49580360346025 35.6360152302312, -82.49547160339272 35.63609623021348, -82.49517360333971 35.6361192301875, -82.49456660324087 35.636107230122605, -82.4943916032054 35.63614923011311, -82.49411460314924 35.63621523009809, -82.4939106031129 35.63623123008033, -82.49332560302653 35.63616223000602, -82.49313360299809 35.63614022998186, -82.49273760293212 35.63614222994148, -82.4923146028451 35.63625122992013, -82.49206760278389 35.63638222992135, -82.49193560273811 35.63653722993925, -82.49169660264214 35.63690222998899, -82.49145560254506 35.63727123003924, -82.49135560249101 35.637514230078324, -82.49131160243539 35.63782723013748, -82.49135660242288 35.63795623016832, -82.49144360242221 35.638054230197284, -82.49147660242178 35.63809223020834, -82.49184160244526 35.638332230294736, -82.4920936024645 35.63847823035038, -82.49227160248358 35.638546230382545, -82.49236260249569 35.63856523039583, -82.49237860249774 35.638569230398275, -82.49247160250948 35.63859323041267, -82.4927396025471 35.638637230449206, -82.49288760256671 35.63866923047093, -82.49297860257703 35.63870023048658, -82.49306060258495 35.638737230502606, -82.4931496025911 35.63879323052312, -82.49322960259427 35.63885823054456, -82.49338460259455 35.639023230594134, -82.49404560259221 35.639748230809644, -82.49415860259143 35.639874230846914, -82.49423460258923 35.639970230874205, -82.4943726025803 35.640176230930386, -82.49444060257395 35.64029023096056, -82.49450160256396 35.64042023099323, -82.49458560254841 35.640611231040815, -82.49463960253159 35.640778231080304, -82.49469260251261 35.64095823112237, -82.49471560249401 35.641103231154254, -82.49470760247654 35.64120823117481, -82.49469260246028 35.64129723119141, -82.49465460243968 35.641389231206105, -82.49448660236895 35.64166723124539, -82.49442360233586 35.641813231268614, -82.49441060232897 35.641844231273595, -82.49439360231978 35.64188523128017, -82.49431160227512 35.64208623131262, -82.49422560222627 35.64231023134934, -82.49399860210426 35.64285623143707, -82.49392360206201 35.64304923146861, -82.49389260204005 35.643158231487575, -82.49388260202517 35.64324423150408, -82.49388660201039 35.64334423152484, -82.49394160197443 35.64363623158986, -82.49395460196615 35.64370323160485, -82.49395760195262 35.643794231623616, -82.49394160193732 35.643876231638664, -82.49387560190127 35.644038231664865, -82.4937496018491 35.644241231693194, -82.49366960182172 35.64433223170345, -82.49362460180748 35.64437623170774, -82.49356560179136 35.64441723171, -82.49351560177904 35.64444323171016, -82.49344760176402 35.644467231708106, -82.49329860173424 35.644500231699396, -82.49325860172603 35.64451023169733, -82.49308960169208 35.64454823168771, -82.49297060166565 35.644592231684406, -82.49291960165378 35.64461423168361, -82.49288260164514 35.644630231683045, -82.49279760162356 35.64467823168406, -82.49272360160359 35.644728231686614, -82.49271360160073 35.644736231687205, -82.49265160158212 35.6447902316918, -82.49259460156367 35.64484823169774, -82.49254660154546 35.64491423170629, -82.4923806014763 35.64518423174411, -82.49231460145235 35.6452682317544, -82.49230160144762 35.64528523175652, -82.49216460140107 35.6454392317737, -82.49214960139594 35.645456231775654, -82.49188460131151 35.64571823180169, -82.49188060131002 35.645723231802265, -82.49182960129123 35.64579023181064, -82.49179060127457 35.64585623182007, -82.49173060124471 35.645985231840186, -82.49166260120386 35.646176231871976, -82.491628601187 35.646249231883345, -82.49155060115547 35.646369231899754, -82.49147860112639 35.64648023191488, -82.491418601099 35.646593231931746, -82.4913876010824 35.64666723194363, -82.49135760106142 35.64677123196158, -82.49134160104994 35.646828231971604, -82.49132960103033 35.64694223199356, -82.49132660101452 35.64704123201331, -82.49133460100009 35.647143232034914, -82.49133860099771 35.647163232039446, -82.4913556009883 35.64724223205723, -82.49137860098018 35.647319232075276, -82.49139160097604 35.64736023208497, -82.49155360094328 35.64774623218012, -82.49156060094067 35.64777023218572, -82.49157960093446 35.64783123220009, -82.49158360092477 35.64789823221412, -82.49157060091814 35.6479272322187, -82.49156260091338 35.64794923222234, -82.4915056008956 35.64800323222744, -82.49146760088738 35.648015232226044, -82.49146460088679 35.6480162322259, -82.4913776008705 35.648028232219346, -82.49127860085449 35.64802523220862, -82.49117960083963 35.6480152321964, -82.49104360081793 35.64801023218137, -82.49097160080625 35.648008232173524, -82.49090560079205 35.64802923217101, -82.49093160079984 35.648006232169, -82.49100460082465 35.64792423215982, -82.49101860082935 35.64790923215823, -82.49106660084912 35.6478322321475, -82.49109460086093 35.647786232141016, -82.49114560088685 35.647673232123296, -82.49118260091448 35.647534232098835, -82.49119360092199 35.64749723209243, -82.49119960093921 35.6473922320717, -82.49120560095444 35.647300232053546, -82.49120160102595 35.64683323195816, -82.49121360105971 35.646627231917556, -82.49123960109297 35.646440231882124, -82.49128860113368 35.64622923184426, -82.49135560117308 35.6460462318139, -82.49136460117823 35.64602223180995, -82.49145060122282 35.645826231779, -82.49154460126469 35.645656231754025, -82.49162760129971 35.6455182317345, -82.4917436013448 35.64535123171252, -82.49189060139963 35.645154231687535, -82.49209360146963 35.64491923166063, -82.49264460165182 35.64433123159777, -82.49278960170469 35.64414523157488, -82.49292860175689 35.64395623155066, -82.49303660180217 35.643779231525826, -82.49312660184319 35.64361023150067, -82.49322060188902 35.64341423147048, -82.4933746019804 35.642988231399706, -82.49343560202449 35.64276823136122, -82.49347360205626 35.642603231331556, -82.49348060206162 35.642576231326764, -82.49355460213478 35.642182231254274, -82.49358160217206 35.64197023121393, -82.49359960220946 35.6417472311704, -82.4936096022468 35.64151623112439, -82.49360860227519 35.64133123108672, -82.49360060228658 35.64124923106918, -82.49359460229645 35.64117823105412, -82.49357460231667 35.64102623102112, -82.49353560233354 35.64087523098641, -82.49348360234633 35.64073623095283, -82.49341960235735 35.64059623091775, -82.49335060236521 35.640471230885225, -82.49328160236902 35.64037223085792, -82.49319060236981 35.64026923082764, -82.49309060236902 35.64016723079657, -82.4929696023655 35.64006023076242, -82.49283060235776 35.639961230727934, -82.49265860234543 35.63985623068887, -82.49249460233182 35.63976823065411, -82.49232460231428 35.63969923062255, -82.49181060225497 35.63953123053542, -82.49141560220804 35.639410230470226, -82.49113060217587 35.639313230421195, -82.49095660215798 35.639242230388824, -82.49081660214674 35.63916423035854, -82.49069060213795 35.63908623032971, -82.49058260213415 35.638994230299815, -82.49054260213384 35.63895323028738, -82.49046160213314 35.63887123026242, -82.4903656021381 35.638736230225, -82.4902786021471 35.638584230185145, -82.49020760216762 35.638375230135274, -82.49017360222 35.6379992300554, -82.4901896022557 35.63778523001344, -82.49026960233435 35.63736222993563, -82.49038260240619 35.63701822987733, -82.49053660248198 35.63669322982704, -82.49075560257285 35.6363392297776, -82.49103560267311 35.635991229735566, -82.4913216027629 35.63571722970932, -82.49158160283872 35.63550522969301, -82.49203960296316 35.635191229676174, -82.49256360309474 35.634902229671326, -82.4928336031591 35.634775229673245, -82.49379860338033 35.63437922969202, -82.49565260379202 35.63370422974553, -82.49597560386911 35.633552229747835, -82.49623060393822 35.63337822973867, -82.4964276040037 35.6331662297158, -82.49658160406875 35.632910229679595, -82.49665660411955 35.63266222963678, -82.4966656041583 35.63242022958849, -82.49661260419413 35.63213122952425, -82.49647960421736 35.63183822945107, -82.49593460425427 35.63101322922709, -82.49578860427874 35.63069822914803, -82.49577360428358 35.63065022913671, -82.49567960431652 35.63033622906314, -82.49550360441418 35.62951422887784, -82.49540460443575 35.62926822881766, -82.49525060444482 35.62904422875618, -82.49506760444272 35.62886122870015, -82.49482260442831 35.628691228640314, -82.49382260434811 35.628136228424566, -82.49354060433551 35.62791522835058, -82.49332660433559 35.62768422828159, -82.49308660435575 35.62729622817798, -82.49286260439432 35.626805228054955, -82.49255360446662 35.62600522786051, -82.49231060454542 35.625233227678436, -82.49224360457677 35.62495822761563, -82.49219160461385 35.62466222755007, -82.49218760461707 35.6246372275446, -82.49216460464652 35.62442122749827, -82.49215360467878 35.62420022745224, -82.49215160471358 35.62397322740581, -82.4921596047409 35.623804227372226, -82.49217760477141 35.62362622733789, -82.49219960480002 35.623464227307224, -82.49222160482776 35.6233082272777, -82.4922606048636 35.62311822724314, -82.49231360489908 35.62294522721334, -82.49237660493276 35.62279422718915, -82.49245660496798 35.622652227168494, -82.49253860500131 35.622524227150834, -82.49268460505242 35.6223502271305, -82.4928836051147 35.622160227112325, -82.49309360517621 35.62198722709876, -82.49341460526817 35.62173622708072, -82.49350560529824 35.62163922707033, -82.49357060532168 35.62155722706034, -82.49362760534545 35.62146422704727, -82.49367360536745 35.62137122703314, -82.49370460538816 35.621270227015756, -82.49371760540701 35.62116222699512, -82.49371160542243 35.62105622697297, -82.4936976054367 35.62094822694955, -82.49365660544815 35.620830226921385, -82.49359860545631 35.62071522689196, -82.49347560546224 35.62054422684454, -82.49312060546784 35.620126226723, -82.49297260547542 35.61991822666546, -82.49292260547983 35.61983622664358, -82.49283960549116 35.61967322660197, -82.49255060554742 35.618998226434925, -82.49242160556531 35.6187432263698, -82.49233460557531 35.61858522632861, -82.49189860560654 35.61791422614738, -82.4917876056179 35.617721226096606, -82.49170060562902 35.617555226054016, -82.49162960564311 35.61738822601268, -82.49157260566244 35.61720122596878, -82.49154360568022 35.61705522593609, -82.49152460569867 35.61691522590564, -82.49151560572196 35.61675422587196, -82.49152860575053 35.61658322583853, -82.49154760577494 35.616445225812434, -82.49159260581344 35.616244225776136, -82.49163860584495 35.61608922574936, -82.49179460594998 35.61557622566109, -82.49183060597723 35.615438225636645, -82.49185060599586 35.61533922561859, -82.49187960603118 35.61514122558136, -82.49188760605193 35.61501522555654, -82.49191260616583 35.61430422541449, -82.49192960619045 35.61416222538737, -82.49195760621815 35.61401322535991, -82.49199760624683 35.61387022533491, -82.49205760627959 35.61372222531105, -82.49243860645572 35.61299022520128)))",6490,37,021,001802,370210018022,933,933,8,921,878,33,2,8,0,0,12,730,6,724,723,694,22,2,5,0,0,7,399,381,18
census_2010_blockgroups_view.fid--2dc29038_13ec899ba8f_-25c9,"MULTIPOLYGON (((-82.69435566430825 35.454443213621424, -82.69511666443476 35.45444321369924, -82.69578866458798 35.45417121371252, -82.69642866474263 35.453855213713446, -82.69682866483909 35.45365921371439, -82.69820466515331 35.453099213740884, -82.699324665364 35.45293921382271, -82.69990066535955 35.4535952140152, -82.70070066541196 35.454123214204564, -82.70089266542684 35.45423521424701, -82.70172466563109 35.453803214243976, -82.70226566572977 35.453746214287655, -82.70265266580009 35.45370721431925, -82.70326066591582 35.4536112143618, -82.70439666613895 35.45338721443219, -82.70443266614643 35.45337721443383, -82.70546166636068 35.45309421448134, -82.70556466638193 35.45306721448634, -82.70620466655673 35.452619214460434, -82.70674866672782 35.4520912144083, -82.70734166690701 35.45156321436133, -82.70799666707573 35.45117121434831, -82.70825366714168 35.4510192143436, -82.70857366723389 35.450763214324105, -82.70885366731494 35.45053721430662, -82.7089126673254 35.450533214311875, -82.7089906673388 35.45053021431915, -82.70908966735615 35.45052421432805, -82.70914966736657 35.45052121433356, -82.71052566770256 35.44981921433108, -82.7107976677917 35.44953121430013, -82.71116566792617 35.44905121423991, -82.7116776680723 35.44865121421067, -82.71236566821602 35.44845921424184, -82.71283766829075 35.44848421429513, -82.71334666837107 35.448512214352846, -82.7136246684094 35.44856421439183, -82.71393966844823 35.4486532144421, -82.7142666684939 35.4487102144871, -82.71449966852731 35.44874521451809, -82.71467466855785 35.44873621453407, -82.71479066857799 35.448730214544725, -82.71490066860407 35.448679214545606, -82.71501366862421 35.44867021455529, -82.71532566871767 35.44839821453166, -82.71538866873523 35.44835121452853, -82.71547166876907 35.448220214510336, -82.71560166881308 35.44807321449373, -82.71570866883957 35.44801621449295, -82.71577466886822 35.447900214476086, -82.71591066891574 35.4477372144567, -82.71605566895603 35.44763121444993, -82.7161386689897 35.447501214431895, -82.71635666905783 35.44729221441155, -82.71651366911556 35.4470852143854, -82.71667566917411 35.44687721435953, -82.7169626692635 35.44660421433319, -82.71704966929292 35.44650621432214, -82.7170226693124 35.44634921428732, -82.7170426693261 35.446281214275565, -82.7175656695153 35.445611214192425, -82.7183816698218 35.444491214047446, -82.71910167009283 35.44349921391871, -82.71983767035188 35.44260321381122, -82.72095767066502 35.441771213755956, -82.72242967105154 35.440842213716905, -82.72257467109146 35.44073821371053, -82.72374167141123 35.43991421366171, -82.72470267179885 35.438420213455274, -82.72489367187602 35.43812221341401, -82.72503767193173 35.43791421338628, -82.72546167204919 35.43760621336677, -82.72550767205851 35.437595213369235, -82.72599767216919 35.437404213380375, -82.72632067223446 35.437328213397855, -82.7266456722999 35.43725321341578, -82.7271846724175 35.43707021343347, -82.7275956725147 35.4368812134369, -82.7282026726571 35.43660921344338, -82.72867767278031 35.436319213432746, -82.72902367286986 35.436109213425304, -82.72942467296886 35.43589721342305, -82.7297946730704 35.43563521340732, -82.73000067312417 35.435507213402246, -82.73013867317061 35.43535321338502, -82.73018567318128 35.43533421338592, -82.73032867322715 35.43518921337097, -82.73044367327445 35.43500421334497, -82.7305146733249 35.43475121330065, -82.73056367335609 35.43460021327482, -82.73054667336474 35.43452421325761, -82.73055067338682 35.43438421322946, -82.73051667339459 35.434296213208114, -82.73058267340465 35.43430221321607, -82.73070567337827 35.434609213291246, -82.7308316733416 35.43498721338115, -82.73089067330159 35.43531421345385, -82.7308616732493 35.43562621351448, -82.73074667317672 35.435976213574065, -82.73053667308119 35.43637421363378, -82.73035767303435 35.436486213638325, -82.73002867295504 35.436647213637535, -82.72973267287868 35.43682521364366, -82.72957167281048 35.4370972136827, -82.72951467277096 35.437294213716996, -82.72935667272893 35.437397213721816, -82.72904867265473 35.437548213721186, -82.7288206725817 35.43777821374479, -82.72861567250604 35.438051213779545, -82.72857467245575 35.43833621383346, -82.72866467242494 35.43863621390383, -82.7285946723914 35.43878021392604, -82.72837667235817 35.43876021389973, -82.72805067230652 35.438743213862885, -82.72783867225388 35.43885721386451, -82.72776867223719 35.43889021386411, -82.72751967217764 35.43900921386293, -82.72722667209236 35.43924921388193, -82.72707567202731 35.43951121391998, -82.7271536719986 35.43978421398355, -82.72728967200158 35.43991321402373, -82.7275636720037 35.44019821410983, -82.72759467197777 35.44040221415458, -82.72735067191704 35.4405342141566, -82.72716267186063 35.440699214171026, -82.72698467180847 35.440847214183016, -82.72698767176429 35.441140214243056, -82.72716167175466 35.44139321431243, -82.72716667170272 35.441739214383475, -82.72695667160984 35.44211921443951, -82.72698367156012 35.442474214514654, -82.72708667152224 35.44283521459873, -82.7274226715445 35.443056214678144, -82.72755467152653 35.443318214744934, -82.72745367141029 35.44397021486759, -82.72738467134148 35.44434621493727, -82.72718267125671 35.44468121498485, -82.7272896712426 35.444891215038666, -82.7274246712143 35.445224215120305, -82.7273706711697 35.44545721516224, -82.72727267111635 35.445700215201825, -82.7272746710748 35.445975215258095, -82.7273606710542 35.44620421531353, -82.72754767104271 35.44648321538955, -82.72753367097795 35.44689221547154, -82.72737767089447 35.447270215532626, -82.72671567074596 35.44752121551618, -82.72651867068238 35.4477232155373, -82.72638867062223 35.447976215575544, -82.72623667055959 35.44822121560995, -82.72608867052216 35.44830521561199, -82.72578867049658 35.44814521554871, -82.72563767050319 35.447937215490896, -82.72532267048602 35.4477062154116, -82.72508267048705 35.4474382153325, -82.72487267049847 35.44713421524904, -82.72475067052372 35.44683521517569, -82.72468267055683 35.446544215109384, -82.72461967061368 35.44610221501288, -82.72455167064687 35.44581021494636, -82.72447667066656 35.445599214895715, -82.72448367071804 35.445270214829314, -82.72438167074938 35.44495321475429, -82.72415967072757 35.44485421471144, -82.72402467068694 35.444973214721976, -82.72373967060962 35.44516921473276, -82.72334467052318 35.44530521472026, -82.72303867047901 35.445261214679974, -82.72286067046198 35.44517821464488, -82.7226836704806 35.444863214562524, -82.72246767047749 35.44464821449669, -82.7221306704199 35.44465821446426, -82.72203767039042 35.44475021447359, -82.7218186703246 35.444943214490586, -82.72170167025973 35.44524021453914, -82.721712670225 35.44548021458922, -82.72179567021352 35.44564621463151, -82.7218656701739 35.44598221470711, -82.72192467013248 35.44631821478168, -82.72180167008716 35.4464812148023, -82.72155367000275 35.446764214834715, -82.72154466998853 35.446847214850685, -82.72153866997843 35.44690721486234, -82.72158366994675 35.44716421491932, -82.72160966990101 35.44749221498883, -82.72155766984615 35.447795215045296, -82.72142966978083 35.44808421509114, -82.72124866973914 35.448160215088144, -82.72102966970967 35.44811421505636, -82.7207966696862 35.448014215012186, -82.72056866964718 35.44802121499033, -82.72048566962204 35.44809521499693, -82.72049366959772 35.44826421503227, -82.72056866957672 35.44848321508456, -82.72066566955789 35.44871221514111, -82.72077866952709 35.44903721521893, -82.72072366948386 35.449261215259, -82.72049866943728 35.44932121524825, -82.72044766941622 35.44940321525972, -82.72058366942063 35.44952321529805, -82.72068966941167 35.449697215344365, -82.72096566944128 35.44980421539437, -82.72127066948926 35.44982221542925, -82.72146166953694 35.44971821542753, -82.72154566959465 35.449431215377544, -82.72156566964009 35.449155215323344, -82.72169066968034 35.44902721531001, -82.72180066969247 35.449068215329596, -82.72191466969292 35.449189215365976, -82.72217466973878 35.44917221538899, -82.72223266977177 35.44901921536378, -82.72237566982874 35.448801215333944, -82.72251266984928 35.44881621535094, -82.7226266698663 35.44882921536525, -82.72302966985656 35.44933221550894, -82.7234186698566 35.449756215635176, -82.72375166985256 35.4501462157486, -82.72409166985926 35.450473215850025, -82.72409066982794 35.45067721589154, -82.7240396697703 35.450999215951946, -82.7240756697318 35.45129121601513, -82.72412066969612 35.45157421607744, -82.72423266966636 35.45189121615348, -82.72444966966007 35.45216921623233, -82.72447566965923 35.45220321624194, -82.72484066969723 35.45235221630958, -82.72521966976603 35.45231421634054, -82.72558066985096 35.45215121634424, -82.72584866991038 35.452054216351804, -82.72599966986698 35.45250321645876, -82.72585066979399 35.45281921650799, -82.72581466972683 35.45322021658604, -82.72594466971515 35.453438216643775, -82.72616966972654 35.453609216701636, -82.7266376697659 35.45386121680081, -82.72681166979305 35.453873216820995, -82.72707066983997 35.45384821684239, -82.72710566984152 35.453876216851675, -82.72711866984142 35.453891216856, -82.72715766984378 35.45391821686554, -82.72733766985529 35.45403921690853, -82.72741666986323 35.45407321692359, -82.72751966987664 35.45409721693901, -82.7276386698945 35.454110216953794, -82.72788566993303 35.45412721698249, -82.72816566997544 35.454154217016566, -82.72825466999073 35.45415121702502, -82.72833267000527 35.454141217031065, -82.72840467002061 35.45411921703382, -82.7284656700362 35.45408321703272, -82.72851567005192 35.454035217028085, -82.72854167006444 35.45398121701973, -82.72854167007283 35.4539262170085, -82.72852067007877 35.45386421699372, -82.72848967008214 35.453808216979134, -82.7284436700842 35.45374421696139, -82.72841267008917 35.45367821694476, -82.72840467010147 35.45358921692588, -82.72841067011576 35.453502216908674, -82.72844367013735 35.453396216890425, -82.72851367016301 35.45330421687879, -82.72861367019387 35.45321121687007, -82.72885967024148 35.453167216886214, -82.72907967028723 35.453107216896406, -82.72916867030654 35.45307821689965, -82.72923567032433 35.4530342168975, -82.7292876703434 35.452966216888925, -82.7292926703578 35.452877216871336, -82.72928667037176 35.45277921685073, -82.72928667038924 35.45266421682727, -82.72931867040388 35.45260321681811, -82.729374670421 35.452552216813444, -82.72944667043528 35.45253721681772, -82.72968567047549 35.45253421684154, -82.72976067048963 35.452523216846934, -82.72982367050457 35.452494216847455, -82.7298746705193 35.45245321684433, -82.72992067053565 35.45239621683743, -82.7299456705523 35.45231421682327, -82.72996167056995 35.45221621680487, -82.73003867063655 35.451863216740804, -82.73008367065775 35.45177321672703, -82.73014767067696 35.45171721672215, -82.73018767068433 35.451713216725445, -82.73023167069235 35.451708216728946, -82.73025867069641 35.45171121673228, -82.73029067070134 35.45171321673594, -82.73036367070823 35.451748216750545, -82.73043467071089 35.45180821677001, -82.73079467071396 35.452180216882674, -82.73087367071554 35.452256216906164, -82.73094867071816 35.45232121692706, -82.73102967072307 35.452377216946765, -82.73112367073185 35.452422216965566, -82.73122967074397 35.45245821698373, -82.7313306707594 35.452467216995906, -82.73144567077875 35.452465217007244, -82.73153167079413 35.45245921701479, -82.73161767080803 35.452461217023924, -82.73171267082172 35.452475217036536, -82.73181167083354 35.452506217052935, -82.73200867085228 35.452598217091854, -82.73210267086404 35.452623217106556, -82.73219767087761 35.4526382171193, -82.73228567089222 35.452638217128246, -82.73236867090732 35.45263021713514, -82.73244567092311 35.45261021713893, -82.7325226709413 35.4525752171397, -82.73258067095823 35.45252721713579, -82.73261267097408 35.452458217124956, -82.73266667102614 35.452176217073, -82.7326706710297 35.45215721706952, -82.73269967104928 35.45206021705268, -82.73275167106912 35.451987217043104, -82.73283167109062 35.4519332170403, -82.73290767110588 35.45191621704459, -82.73306567113507 35.451897217056825, -82.73317167114627 35.4519392170763, -82.73328167116168 35.45195821709134, -82.73345567119341 35.451940217105445, -82.7336196712288 35.451887217111405, -82.73369967124742 35.451852217112396, -82.73382567127283 35.451823217119376, -82.73400167130633 35.45179521713165, -82.73412067132573 35.451798217144415, -82.7343726713576 35.45186421718355, -82.73453767137633 35.45192121721207, -82.7346896713897 35.45199921724345, -82.73486867139994 35.452127217287874, -82.73508467140768 35.45231221734765, -82.73550267141978 35.45268921746724, -82.73560767142463 35.45277221749487, -82.73565567142865 35.45279821750507, -82.7357306714392 35.45281021751516, -82.73580367145355 35.452796217519754, -82.73591867148546 35.452712217514375, -82.73610767154557 35.45252421749532, -82.73616767156017 35.45249421749539, -82.73620567156941 35.45247521749534, -82.73628667158246 35.45247821750419, -82.73633967158482 35.45252021751821, -82.73635467157783 35.45258221753241, -82.7363306715652 35.45263921754156, -82.73615167150408 35.452844217565094, -82.73597967144845 35.45302121758366, -82.73587467142069 35.45308921758674, -82.7358036714064 35.45310521758281, -82.73570967139015 35.45310921757396, -82.73558967137754 35.45306121755191, -82.73541967136428 35.45296221751437, -82.73538767136172 35.45294421750745, -82.73514067133873 35.45282521745794, -82.7347486712998 35.45265321738285, -82.73465067128855 35.45262021736614, -82.73458367127985 35.452604217356026, -82.73452467126965 35.4526062173504, -82.73446167125783 35.452615217345794, -82.7343906712384 35.45266521734872, -82.73434567121657 35.45275921736332, -82.73430267119159 35.45287621738273, -82.73427967116749 35.45300921740753, -82.73424667110262 35.4533982174835, -82.73421767107966 35.45351721750475, -82.7341676710516 35.453646217525986, -82.73412967102806 35.45375921754511, -82.73410567100514 35.45388321756801, -82.73410067098374 35.45401821759497, -82.73411067096637 35.4541432176215, -82.73413267095006 35.45427421765046, -82.7341646709384 35.45438521767635, -82.7342156709277 35.45451121770729, -82.73427167091972 35.454624217735976, -82.73438267090101 35.45486821779714, -82.73442767088923 35.45499421782735, -82.73443967088072 35.45506321784266, -82.73442767086773 35.45513521785611, -82.73439067084892 35.4552182178693, -82.73433067082571 35.45530521788087, -82.73419067077492 35.4554852179033, -82.73414067075365 35.45557021791549, -82.73410667073465 35.45565721792982, -82.734099670727 35.455700217937846, -82.73409467072054 35.455737217944844, -82.73404467062723 35.456294218053394, -82.7340376706033 35.45644321808302, -82.73400867056263 35.45667821812794, -82.73397767050562 35.457018218194186, -82.73398367049256 35.45711021821344, -82.73399367048876 35.45714621822182, -82.73400567048341 35.457194218232836, -82.7340526704807 35.45726321825174, -82.73415967048341 35.45736221828287, -82.73416367048361 35.45736521828384, -82.73426967049105 35.457432218308405, -82.73487967053796 35.45779021844363, -82.73502067054876 35.45787321847496, -82.73511967055578 35.45793521849775, -82.73518267056025 35.457974218512106, -82.735330670577 35.45802621853787, -82.73538867058528 35.45803521854562, -82.73552367060424 35.458058218564084, -82.73603267068864 35.45806021861647, -82.73616167070836 35.458071218631915, -82.73624967071741 35.458108218648384, -82.73637067072963 35.45816021867145, -82.73651267074212 35.45823321870074, -82.73654967074533 35.45825221870845, -82.73657267074715 35.458265218713414, -82.73668267075591 35.45832821873754, -82.73674267075775 35.45838121875441, -82.73676567075837 35.45840221876109, -82.73678667075706 35.45843421876973, -82.73683967075075 35.458533218795274, -82.73684267074945 35.45854521879807, -82.73692767071671 35.45885221886935, -82.73693967071 35.45890921888219, -82.73696567069561 35.45903221890997, -82.73697267069142 35.459067218917774, -82.73699167067537 35.45919321894546, -82.73699867066982 35.459237218955124, -82.73700767064608 35.45940221898972, -82.73699967062232 35.45954921901887, -82.73696567059423 35.45969621904537, -82.73691667055958 35.45987021907584, -82.73690867055582 35.459886219078285, -82.73683567051752 35.460057219105686, -82.7367046704565 35.46031421914468, -82.73641467032462 35.46086221922679, -82.73601567014077 35.46163221934305, -82.7359346701009 35.46180521937009, -82.73591567008813 35.46186821938095, -82.73589467007392 35.46193821939307, -82.73587267005286 35.46205221941409, -82.73585967003517 35.4621542194336, -82.73587367002237 35.46225321945515, -82.73588467001316 35.462325219471026, -82.73594666999675 35.46250021951305, -82.73607666998461 35.46272221957155, -82.73626266996928 35.46302521965234, -82.73643466995517 35.463305219726976, -82.73658066994335 35.46354221979029, -82.73660166994175 35.4635752197991, -82.73695266991334 35.46414421995105, -82.73712566989944 35.464424220025734, -82.73714166989791 35.46445122003294, -82.73719166989395 35.46453222005456, -82.73720866989264 35.464559220061766, -82.7372476698895 35.46462222007858, -82.73736466987978 35.464813220129514, -82.73740466987668 35.464877220146654, -82.73769266985211 35.46535222027299, -82.73770966985063 35.465380220280394, -82.73824266980857 35.46623722050954, -82.73863766977607 35.46688122068124, -82.73894666975087 35.46738322081514, -82.73899166974707 35.46745722083487, -82.73902366974464 35.46750822084851, -82.73912866973593 35.467679220894105, -82.73917466973236 35.467753220913906, -82.73923666972726 35.46785422094079, -82.73942466971181 35.46816022102243, -82.73948766970676 35.46826222104967, -82.73956366970006 35.468389221083356, -82.73959566969722 35.46844222109745, -82.73980266968194 35.46876822118506, -82.73982566968031 35.46880422119473, -82.73988166967568 35.468895221219036, -82.74001166966485 35.469108221275725, -82.74002366966374 35.469128221281025, -82.74019766964585 35.469435221361415, -82.74032266962536 35.469706221429384, -82.7403446696178 35.46977922144658, -82.74039466960187 35.46993822148409, -82.74041666959317 35.47001922150289, -82.74044866958016 35.47013922153061, -82.74045666957267 35.47019722154328, -82.74047566955552 35.47033022157228, -82.74049466952974 35.470520221612944, -82.74050566949728 35.470744221659785, -82.7405156694711 35.470927221698155, -82.74051966945905 35.47101022171543, -82.74053166942285 35.47126022176763, -82.74053566941073 35.47134422178519, -82.74054366938203 35.471541221826186, -82.74056866929594 35.47213222194928, -82.74057466927923 35.47224822197357, -82.74057866926752 35.472329221990464, -82.74058166925576 35.47240922200712, -82.74059366922113 35.47264922205722, -82.74059766920963 35.47272922207396, -82.74061766914701 35.47316122216411, -82.74062166913235 35.47326122218495, -82.74062966911156 35.47340622221529, -82.74067266897913 35.474320222406114, -82.74067766896293 35.474432222429385, -82.74070266888405 35.47497622254289, -82.74078066864779 35.47660822288367, -82.74078066864608 35.476619222885965, -82.74079466860739 35.47688822294226, -82.74080666856891 35.47715322299747, -82.74082666850506 35.477593223089286, -82.74088866831333 35.478916223365445, -82.74090966824947 35.47935722345748, -82.74091466823151 35.47948022348309, -82.74092266820809 35.479642223516905, -82.74092366820626 35.479655223519714, -82.74092366820413 35.47966922352252, -82.74093266817772 35.479852223560734, -82.74093866815971 35.47997622358663, -82.74093966815522 35.480007223593056, -82.740945668142 35.48010022361272, -82.74094766813745 35.480132223619464, -82.74095066812902 35.48019022363152, -82.7409596681037 35.48036622366834, -82.74096266809521 35.48042522368072, -82.7409686680791 35.48053722370414, -82.74097966802061 35.48093222378584, -82.7409836680012 35.48106322381294, -82.74097466793455 35.481490223899094, -82.7409576678686 35.48190322398159, -82.74095566786033 35.48195522399195, -82.74091266777697 35.482454224089366, -82.74091266777535 35.48246422409141, -82.74085866769784 35.48291322417747, -82.74085166768963 35.4829592241861, -82.74082566766116 35.483117224215654, -82.74078666761683 35.4833652242623, -82.74074366757495 35.48359222430417, -82.74071466754596 35.48375022433342, -82.74071366754463 35.48375822433495, -82.74065666749716 35.484006224379655, -82.7406036674524 35.48424222442246, -82.74050066737584 35.48463122449124, -82.74045866734753 35.48477022451522, -82.74038466729665 35.48502322455929, -82.7403496672732 35.48513822457914, -82.74024666720291 35.485486224639594, -82.74022566718811 35.48556022465257, -82.74021366717972 35.485602224659885, -82.7401576671422 35.48578622469166, -82.74012266711917 35.48589922471116, -82.73999166703017 35.48633922478754, -82.73993666699275 35.48652422481961, -82.73981066690817 35.48694022489155, -82.73972666685191 35.48721722493947, -82.73943466665466 35.488189225107874, -82.73933066658407 35.48853822516837, -82.7393116665706 35.48860622518032, -82.73928766655466 35.4886842251938, -82.73921566650702 35.48891722523392, -82.7391926664911 35.48899622524769, -82.73914966646261 35.489136225271885, -82.73906966640898 35.48940022531754, -82.73902366637711 35.48955822534508, -82.73898366634882 35.48970022536989, -82.73896366633568 35.48976422538086, -82.7389056662967 35.48995622541418, -82.73888666628356 35.49002122542544, -82.73877666620953 35.490386225488635, -82.73844666598733 35.49148022567797, -82.73833766591329 35.49184622574148, -82.73828066587458 35.4920372257746, -82.73811066575874 35.49261022587407, -82.73805966572363 35.49278422590443, -82.73805366571992 35.492802225907454, -82.73801666569621 35.492917225927116, -82.73798466567523 35.493019225944636, -82.73795166565705 35.493102225958225, -82.73787966562213 35.49325222598146, -82.7378276655969 35.493361225998335, -82.73778266557602 35.49344822601145, -82.73770466554241 35.493583226031014, -82.73765566552352 35.4936532260403, -82.73759466549969 35.49374322605249, -82.73747466545603 35.493898226071764, -82.73731666540269 35.49407522609172, -82.73715966535144 35.49423922610911, -82.73698566529544 35.494416226127406, -82.73683066524515 35.49457622614415, -82.73675066521882 35.49466122615336, -82.73667666519471 35.4947382261615, -82.73665066518618 35.494766226164494, -82.73645066512243 35.49496522618464, -82.7363756650983 35.495041226192534, -82.73563766486005 35.495796226271, -82.73518966471532 35.49625522631881, -82.7346546645439 35.49679422637402, -82.73441766446591 35.497045226401006, -82.73342366414552 35.49805922650621, -82.73311266404494 35.498378226539465, -82.73295166399168 35.498551226558305, -82.73280166393756 35.49874222658182, -82.73273366390904 35.49885422659772, -82.73266666387664 35.49899322661923, -82.73262666385106 35.499117226640436, -82.73259766382817 35.499235226661526, -82.73258866381934 35.49928322667042, -82.73257966380956 35.49933722668052, -82.732569663791 35.499447226701925, -82.73256966377784 35.4995342267196, -82.73258366373744 35.499813226778, -82.73265066362138 35.500645226954504, -82.73268866355828 35.50109922705096, -82.73268866355724 35.501106227052375, -82.73269066355407 35.50112922705727, -82.73269166355298 35.50113722705898, -82.73269266354977 35.50115922706359, -82.73269866354079 35.501225227077654, -82.73270066353756 35.50124822708255, -82.73272166350021 35.50151522713918, -82.73278666338811 35.50231922730977, -82.73279566337351 35.50242422733208, -82.73280866335082 35.50258722736665, -82.73281866333161 35.502723227395435, -82.73283066330967 35.502880227428676, -82.73280366327323 35.50308922746852, -82.7327906632648 35.503130227475566, -82.73275166323823 35.50326122749827, -82.73273866323 35.50330122750515, -82.7327026632056 35.50342122752587, -82.7326906631974 35.503462227532985, -82.73255566314076 35.503685227564695, -82.73251566312712 35.503731227569986, -82.73239166308363 35.50388022758769, -82.73212866299792 35.50415422761665, -82.7318646629098 35.50444322764865, -82.73181466289307 35.5044982276547, -82.73164366283726 35.50467722767376, -82.731462662778 35.50486722769395, -82.7311526626765 35.50519322772874, -82.73091266260019 35.505431227752744, -82.73072666254089 35.50561622777145, -82.730560662488 35.5057812277881, -82.73012466235501 35.50617622782412, -82.73010266234853 35.5061952278257, -82.72911266204925 35.50707422790364, -82.72877166194763 35.50736722792865, -82.72836666182359 35.50773722796258, -82.72818066177108 35.50787822797233, -82.72815266176305 35.507900227973934, -82.72793666170702 35.508031227978606, -82.72785766168793 35.50807022797843, -82.7277676616671 35.50810822797703, -82.72758666162736 35.50817122797134, -82.72747766160488 35.50819922796588, -82.72740566159077 35.50821322796142, -82.72730866162411 35.5078902278856, -82.72722166165421 35.50759822781718, -82.72696666166472 35.507252227720585, -82.72675266165585 35.50707722766296, -82.72671766165428 35.5070492276537, -82.72666366165876 35.50696122763018, -82.72665666167103 35.50687322761151, -82.72666066168699 35.50677322759155, -82.72663766168316 35.50677322758918, -82.72657066167177 35.5067752275828, -82.72654866166795 35.50677622758073, -82.72648466165693 35.50677822757469, -82.7263296616361 35.50674622755226, -82.72618666162353 35.50667222752247, -82.72600966161798 35.50651622747256, -82.72600766161797 35.506514227471946, -82.72581466163457 35.506195227387195, -82.7256006616562 35.50582122728906, -82.72510766167348 35.50517122710605, -82.72493466166807 35.50501822705719, -82.72459466165736 35.5047182269613, -82.72446566165151 35.5046162269272, -82.72441866164937 35.5045792269149, -82.72414466162836 35.504418226854035, -82.72407066162258 35.50437522683775, -82.72380166160518 35.50419622677368, -82.7233446615796 35.50386622665971, -82.72321966157318 35.503772226627696, -82.7230976615668 35.50368122659673, -82.7229656615725 35.50350022654632, -82.72281466157905 35.50329322648861, -82.72279666159658 35.50315922645953, -82.72277666162731 35.50293622641193, -82.72276766164369 35.5028192263872, -82.72271166164573 35.50274522636641, -82.72258166163827 35.50265222633415, -82.7222366616066 35.50248422626453, -82.7220196615975 35.50230722620636, -82.7217726616436 35.50173722606481, -82.72166766164875 35.50158922602388, -82.72165966164816 35.50158422602204, -82.72140566163031 35.50142422596355, -82.7213226616187 35.50141022595214, -82.72122966160028 35.50142922594659, -82.72114166156983 35.501532225958464, -82.72101766152677 35.501679225975835, -82.72088466149009 35.501774225981585, -82.72065966142753 35.50193822599198, -82.72055266139061 35.50206322600652, -82.72053266129834 35.50264522612314, -82.72052666129119 35.50268522613068, -82.72050866126682 35.502824226157195, -82.7204346612361 35.50294522617428, -82.72037366121955 35.50298722617666, -82.72028866119649 35.50304522617977, -82.71979866109263 35.503191226159394, -82.71955166104203 35.50325322614683, -82.71933366099746 35.50330722613556, -82.71888666090263 35.50344122611717, -82.7185026608211 35.503556226101324, -82.71822666075758 35.5036712260965, -82.71738166055938 35.50404722608677, -82.71718566051335 35.50413522608463, -82.71693466046194 35.50419822607187, -82.71666766041609 35.50420722604638, -82.71646866037743 35.50424322603336, -82.7163436603493 35.50429122603035, -82.7147276599798 35.50494822599899, -82.71442265991668 35.50502922598442, -82.71417265987003 35.505062225965524, -82.71389365982614 35.505045225933486, -82.71341765976885 35.50490222585565, -82.71318165975221 35.504754225801356, -82.71294865973074 35.504641225754476, -82.71260065968578 35.50455622570155, -82.71229565964633 35.504482225655295, -82.71193565960556 35.504357225592926, -82.71175665959399 35.504238225550374, -82.71159865959356 35.5040692254998, -82.71116565964081 35.50328922529648, -82.71105665963967 35.50317822526262, -82.71093765962952 35.503115225237664, -82.71031265955015 35.502954225140904, -82.7101606595363 35.50287922511012, -82.70985465952697 35.502607225023375, -82.70934565952251 35.50208222486424, -82.709174659514 35.501952224820215, -82.7085226594812 35.50145722465266, -82.70822265946006 35.501269224583645, -82.70801065943353 35.50121222455031, -82.7077766593936 35.5012182245276, -82.70758465936487 35.501197224503684, -82.70743965935239 35.50112122447336, -82.7065686593338 35.50029522421588, -82.70655365933347 35.500281224211484, -82.70652665933294 35.50025522420344, -82.70650865933189 35.50024222419898, -82.7064936593313 35.50023022419497, -82.70642765932155 35.5002222241866, -82.70641065931889 35.50022122418468, -82.70632765930641 35.500212224174305, -82.70629565930174 35.50020822417025, -82.7062326592926 35.500199224161996, -82.7061686592833 35.50019022415356, -82.70606465926835 35.500175224139866, -82.70590665924293 35.500169224122494, -82.7058436592314 35.50017622411745, -82.7057836592189 35.50019222411462, -82.70577665921738 35.500195224114535, -82.70570065919831 35.50023622411509, -82.70562465917325 35.50031822412404, -82.70553865914121 35.50043422413891, -82.70513965897472 35.50108822423142, -82.70511165896399 35.501128224236645, -82.70503365893366 35.50124122425172, -82.70497365891316 35.501310224259676, -82.70485465887698 35.5014172242693, -82.7048306588755 35.501401224263574, -82.7047926588728 35.50137722425483, -82.70475865887053 35.50135522424685, -82.7047346588688 35.50134022424133, -82.70471065889222 35.501161224202384, -82.70470265889269 35.50114922419919, -82.70456065885543 35.50123822420272, -82.70457565886555 35.50118822419412, -82.70456965887179 35.50114122418393, -82.70452565888833 35.50098522414762, -82.70448365890059 35.50085922411761, -82.70441565890994 35.500724224083164, -82.70433465891118 35.500628224055305, -82.70430865891005 35.500607224048295, -82.70423765890662 35.50055222402987, -82.70411565889565 35.50049122400491, -82.70391765887217 35.50042922397206, -82.70361265883416 35.50034622392393, -82.70338565880803 35.500270223885266, -82.70323365879388 35.50019722385481, -82.7029496587737 35.50002022378971, -82.70281465876639 35.49992122375573, -82.70258465875582 35.499740223695255, -82.70246265875123 35.499637223661814, -82.70239565874873 35.49958122364354, -82.70223765874725 35.4994182235941, -82.70211665875121 35.499261223549766, -82.70200665875674 35.49910522350671, -82.70197965875808 35.49906722349625, -82.70184965876184 35.49890122344904, -82.7017296587587 35.4987912234144, -82.70160665874957 35.49871722338674, -82.70146065873567 35.49864922335791, -82.70133865872153 35.49860922333726, -82.70096965867843 35.49848922327505, -82.70069465864582 35.49840322322944, -82.70040665861389 35.49829922317876, -82.70018465859147 35.49820422313665, -82.69996665857188 35.498095223092164, -82.69974865855515 35.49796722304379, -82.69918765851587 35.497614222914436, -82.69903665850374 35.49752922288165, -82.69859165846775 35.497280222785385, -82.69828265843884 35.49713322272383, -82.69826165843688 35.49712322271966, -82.69805865841673 35.49703422268073, -82.6979066584041 35.49695122264824, -82.69763165838789 35.49675822258084, -82.69746865837925 35.49663722253952, -82.6973296583696 35.49654922250732, -82.69714765835032 35.49647722247396, -82.69688265831917 35.49639322242981, -82.69682765831199 35.49638022242147, -82.69675665830246 35.49636522241123, -82.69652965827046 35.49632722238025, -82.69636765824443 35.49632122236245, -82.69622065821652 35.4963442223521, -82.69602965817604 35.496401222344154, -82.6958186581226 35.496521222347056, -82.69563465807376 35.49664022235253, -82.69551565804335 35.49670922235438, -82.69538965801387 35.49676522235294, -82.69523965798325 35.496802222345174, -82.69504365794613 35.49683222233118, -82.69424965780115 35.496916222267075, -82.69354865767679 35.496967222205726, -82.69304165758939 35.496987222157955, -82.69200065741413 35.49700122205435, -82.69158565734415 35.49700722201312, -82.69095765723921 35.49701022194945, -82.69050265716491 35.4970012219011, -82.69035265714365 35.49697722188089, -82.69032765714003 35.49697322187756, -82.69022365713093 35.49692022185604, -82.69018365712733 35.49690022184791, -82.69004565712486 35.49676622180646, -82.68990665712084 35.49664122176673, -82.68989265712051 35.496628221762734, -82.68979865711664 35.49655122173741, -82.68974965711463 35.496511221724234, -82.68958965710509 35.496399221684996, -82.68941865709277 35.4962942216461, -82.68933865708662 35.496247221628366, -82.68903665706316 35.49607222156183, -82.68889065704944 35.496003221532824, -82.68893865706679 35.495942221525304, -82.68903365710078 35.495823221510726, -82.68931865720297 35.495465221466944, -82.68951065729557 35.49506822140568, -82.68959565733003 35.494935221387216, -82.68963965734764 35.494868221378084, -82.68980465741605 35.49460022134038, -82.68991565746558 35.49439722131031, -82.69002765751368 35.49420422128243, -82.6901186575611 35.49399322124874, -82.69018665759887 35.493820221220446, -82.69024065763585 35.49363722118872, -82.69028765768418 35.49337222113951, -82.690326657737 35.49306922108169, -82.6903986578253 35.492570220987346, -82.69045665785856 35.492415220961696, -82.69054465789044 35.492303220947896, -82.6906916579347 35.492173220936465, -82.69078265796381 35.49208222092722, -82.69085065798514 35.49201622092071, -82.69111465807741 35.491700220883274, -82.69119865810931 35.49158322086806, -82.69127465813766 35.49148022085481, -82.69141665819772 35.49124222082083, -82.69153265824684 35.491047220792986, -82.69172365832722 35.490729220747696, -82.69182665837324 35.49054022071971, -82.69186165839272 35.4904502207049, -82.69194665843908 35.49024022067082, -82.69195965844612 35.49020822066565, -82.69203965849591 35.4899692206251, -82.6921206585529 35.489685220575545, -82.6921236585648 35.4896102205605, -82.69213565861226 35.489313220501266, -82.69209965865181 35.48901522043681, -82.69203365868711 35.48871222036833, -82.69193865872076 35.48838922029272, -82.691848658757 35.488054220215204, -82.69180365879771 35.48773922014642, -82.691797658806 35.48767822013342, -82.69177465884174 35.48741922007829, -82.69177565888184 35.48715822002521, -82.69178465890397 35.487023219998605, -82.69179365892703 35.486882219970745, -82.69179665895578 35.48669721993337, -82.69180265899887 35.48642221987791, -82.69177765901365 35.486298219850106, -82.69171665901936 35.48619421982265, -82.69167865902007 35.48614821980941, -82.69163965902064 35.48610221979606, -82.69144165900991 35.48595721974629, -82.69136665900474 35.485909219728796, -82.69134965900349 35.48589921972505, -82.69125265899467 35.48585121970526, -82.69107165897644 35.485773219670875, -82.69085365891881 35.485913219677165, -82.69083865891446 35.485925219678045, -82.69039865878308 35.48630621971067, -82.69027165874952 35.48638721971419, -82.69018465873063 35.486416219711266, -82.69017265872884 35.48641521970985, -82.69005065870866 35.48641421969713, -82.68996165869653 35.48639721968454, -82.6899016586903 35.486372219673285, -82.68973565867317 35.48630421964248, -82.68961565866054 35.48625621962046, -82.68945565863935 35.486220219596696, -82.68928065860985 35.48622321957946, -82.68921465859702 35.486235219575185, -82.68903965856293 35.48626821956398, -82.68902665856037 35.48627021956305, -82.68883765852114 35.48632121955412, -82.68870565849356 35.486358219548215, -82.68858565846641 35.48640521954548, -82.6884136584273 35.48647421954203, -82.6882596583891 35.48655621954294, -82.68820965837654 35.486584219543545, -82.68811365834267 35.48670121955751, -82.68807465834035 35.48667421954807, -82.68803965833818 35.48665021953952, -82.6879746583384 35.48657821951824, -82.68794365833843 35.48654421950816, -82.68791365833862 35.48651021949817, -82.68791265833873 35.48650821949765, -82.68785565834088 35.486432219476335, -82.68783065834246 35.486395219466246, -82.68780465834388 35.486357219455755, -82.68779965834415 35.48635021945389, -82.68776865835733 35.48623021942625, -82.68772465836868 35.486108219396854, -82.68763965838423 35.485914219348686, -82.68762465838591 35.485886219341396, -82.68757765839179 35.48579721931849, -82.68746965840973 35.48556221925956, -82.68742765842099 35.485443219230945, -82.6874086584346 35.48533321920665, -82.6874066584526 35.48521321918193, -82.68741765847253 35.48509521915903, -82.68746765850217 35.48495521913567, -82.68751565852679 35.48484621911837, -82.68761265858383 35.484579219073844, -82.6876556586033 35.48449821906173, -82.68765365860875 35.48446021905378, -82.68765065861889 35.48439121903946, -82.68765365865988 35.484126218985665, -82.68762765868134 35.48395721894856, -82.68760965869639 35.483839218922746, -82.68755465872326 35.483604218869196, -82.68754565874329 35.48346321883956, -82.687548658746 35.483448218836784, -82.68754565884736 35.48278221870078, -82.68762365890953 35.48246021864306, -82.68774465900444 35.48197121855584, -82.68800865918351 35.48108621840248, -82.68819765934687 35.4802232182459, -82.6880966594596 35.479376218062974, -82.68768465951526 35.4785632178552, -82.68690665953699 35.47757521757426, -82.68651165952883 35.47719821745704, -82.68578165951432 35.47649921723989, -82.68426465941782 35.475480216877095, -82.68384565938258 35.47525521678847, -82.68372365939193 35.475061216736464, -82.68357765944207 35.47457421662223, -82.68352265951411 35.474042216508245, -82.68349165955426 35.473746216444766, -82.68345265965885 35.47301921629265, -82.68316465965005 35.47276321621099, -82.68313265968877 35.47247521614902, -82.68358065987566 35.47173921604492, -82.68342165982513 35.47189721606084, -82.68334865983392 35.47176021602541, -82.6831536598493 35.47144721594172, -82.68284465985344 35.471084215836164, -82.68268365986603 35.47082621576714, -82.68266865987094 35.47077821575582, -82.68264265987948 35.470694215736074, -82.6826026598853 35.4706122157152, -82.68260965990248 35.47050721569452, -82.68263665992451 35.470392215673876, -82.68272365997183 35.47017721563894, -82.68279765999671 35.4700952156298, -82.68285766002272 35.46999021561453, -82.68289766004357 35.469897215599666, -82.68293866007384 35.46974321557246, -82.68301266011478 35.46955621554198, -82.68306566015127 35.46937521551043, -82.68310666017656 35.46925421549001, -82.68316666020496 35.4691332154715, -82.6832136602229 35.469067215462815, -82.68328066024661 35.46898521545301, -82.68335566026573 35.46894121545172, -82.6834486602913 35.46887521544771, -82.68360366033964 35.468727215433404, -82.68375166038274 35.46860621542392, -82.68391866042825 35.468490215417354, -82.68412766049813 35.468260215391865, -82.68422166053392 35.46812821537455, -82.68426866055773 35.4680232153579, -82.6843086605711 35.46797921535306, -82.68434966059135 35.46789121533933, -82.68440266061536 35.467792215324586, -82.68445666067545 35.46745721526187, -82.68448566069361 35.467370215247136, -82.68454366072845 35.467205215219394, -82.6845906607498 35.46711621520603, -82.68463766076847 35.467045215196364, -82.68487966085489 35.46674321515966, -82.684993660899 35.466578215137595, -82.68508166093044 35.46646821512424, -82.68520166096724 35.466358215114, -82.68526866099008 35.466281215105205, -82.68524866099682 35.46621521508974, -82.68522266101346 35.466078215059184, -82.68518166102923 35.46593021502481, -82.68505466109622 35.46535321489421, -82.68499366110885 35.46520421485764, -82.68489966112253 35.46501221480888, -82.6847926611324 35.46483121476105, -82.68470466114556 35.46464921471497, -82.68461066116427 35.46442421465947, -82.68436266118363 35.46402821455348, -82.6841776611916 35.46377421448281, -82.68417466119168 35.46377021448166, -82.68403366120022 35.463561214424665, -82.68389866120464 35.463385214375066, -82.68364366120504 35.46310521429188, -82.68346266119677 35.4629622142442, -82.68326066119009 35.46278621418773, -82.6831806611943 35.462671214156146, -82.68304566120459 35.4624572140987, -82.68297166122008 35.46227521405404, -82.68284466123404 35.46204521399419, -82.68274366124747 35.46184721394351, -82.682635661285 35.46148421385849, -82.68256866132762 35.46113221377992, -82.6825146613496 35.46092921373305, -82.68238766138737 35.46054421364168, -82.68234066140381 35.460385213604454, -82.68226666141832 35.46020921356099, -82.68218666144531 35.459945213499054, -82.68209866147014 35.45968721343747, -82.68195766151798 35.45922021332792, -82.68194466153345 35.45910521330313, -82.68197166157071 35.45889021326209, -82.68196466158271 35.45880321324357, -82.68196466160134 35.45868221321901, -82.68193066162175 35.458511213180685, -82.68191766166983 35.4581822131123, -82.68187766168255 35.45805521308234, -82.68185066170072 35.45790721304946, -82.68181666173459 35.45764821299317, -82.68180966175773 35.45748921296003, -82.6817696617653 35.45739621293699, -82.6817566617774 35.45730221291655, -82.68171566177982 35.45724221290009, -82.68163566178158 35.45714321287171, -82.68154766179218 35.45697821282915, -82.68148766179641 35.456885212804046, -82.68142766180661 35.45675321277102, -82.68135966181279 35.45663821274068, -82.68134666181913 35.45658321272814, -82.68115766183134 35.45629721265049, -82.68105266183797 35.45613921260764, -82.68047666187414 35.4552752123727, -82.68020466191197 35.454731212234016, -82.68018866205104 35.45380321204334, -82.68105266219214 35.453819212134846, -82.68185266229337 35.45402721225901, -82.68209266229904 35.454251212329154, -82.68265266236283 35.4544432124255, -82.68273766237985 35.45442421243034, -82.68484466280047 35.453963212551784, -82.68578866303548 35.453451212543854, -82.68646066320092 35.45309921254085, -82.6875966633898 35.45309921265696, -82.68892466356657 35.45338721285131, -82.68988466371152 35.453483212968955, -82.69053166381542 35.45350721303999, -82.69071666384491 35.4535152130605, -82.69212466410345 35.45335521317179, -82.69255666415079 35.45351521324855, -82.69305266420886 35.45367521333181, -82.69315866421945 35.45372121335204, -82.6933976642372 35.45386521340584, -82.69411566429041 35.45429821356741, -82.69435566430825 35.454443213621424)))",6568,37,021,002402,370210024023,1013,1013,11,999,976,10,4,1,0,8,14,806,10,796,798,782,6,4,1,0,5,8,477,414,63
census_2010_blockgroups_view.fid--2dc29038_13ec899ba8f_-25c8,"MULTIPOLYGON (((-82.54238462144953 35.569431221471966, -82.54255262148527 35.56938022147881, -82.54277662153459 35.56930122148577, -82.54279462153833 35.56929622148658, -82.54309462160116 35.56921122150011, -82.54337962165793 35.569150221516914, -82.54378662173603 35.569081221544685, -82.54399162177407 35.56905522156043, -82.54440262184973 35.569006221592666, -82.54438662185355 35.56896422158246, -82.54435062186236 35.568868221559235, -82.54433962186495 35.56883922155221, -82.54432462186881 35.56879822154239, -82.54459362192313 35.56873522155712, -82.54482362196947 35.56868222157001, -82.54513562204507 35.568527221570434, -82.54529762208898 35.568416221564476, -82.54532562209963 35.56837722155947, -82.54539262212498 35.56828522154757, -82.54548762216093 35.568153221530444, -82.54555762218753 35.56805622151787, -82.54576762226714 35.56776522148027, -82.54583762229369 35.56766822146774, -82.54590162229977 35.56769722148018, -82.5459646223058 35.56772622149258, -82.54603062231216 35.5677562215054, -82.5466106223678 35.56802022161869, -82.54680462238638 35.56810822165654, -82.54686662239243 35.56813622166862, -82.5470556224105 35.568222221705525, -82.54711862241648 35.56825122171785, -82.54733262243711 35.56834822175955, -82.54797462249876 35.568640221884884, -82.54818962251933 35.56873822192695, -82.54873562257193 35.56898522203325, -82.5492206226186 35.56920522212779, -82.54974462267094 35.56943022222746, -82.55012562270551 35.56961622230443, -82.55016962270946 35.569638222313415, -82.55035962272267 35.56975722235716, -82.55044762272873 35.56981322237754, -82.55061062273026 35.56997922242805, -82.5506886227224 35.57011422246358, -82.55072262271237 35.57021622248788, -82.55073362270896 35.57025022249583, -82.55074162269871 35.57032522251193, -82.5507486226904 35.570387222525284, -82.5507426226662 35.57053822255544, -82.55072462264455 35.57065922257821, -82.55070962262505 35.57077022259919, -82.55067362258059 35.57102022264641, -82.5505686224476 35.571771222788435, -82.55053462240343 35.57202222283601, -82.55050162236166 35.572258222880684, -82.55045462230186 35.572596222944675, -82.5504446222786 35.57273622297214, -82.5504446222586 35.57286622299856, -82.55045462224427 35.5729702230208, -82.55047862221167 35.57320822307172, -82.5504936221945 35.57333622309927, -82.55053962214303 35.573720223182185, -82.55055562212586 35.57384922321005, -82.55061562204803 35.57442022333243, -82.55065562200144 35.57476622340692, -82.55079762183725 35.57598622366983, -82.55081762182165 35.57610922369691, -82.55084762180861 35.57622622372378, -82.55089762179598 35.57636222375662, -82.55099562177952 35.57657522381, -82.55142562172564 35.5773892240199, -82.55130262166647 35.577641224058475, -82.55115762159882 35.57792422410118, -82.55115162157627 35.57806422412909, -82.5511596215678 35.578128224142965, -82.55118862155211 35.57826122417304, -82.55122462153845 35.57838922420275, -82.55123262152469 35.57848722422352, -82.55122162150748 35.57858722424275, -82.55119462148963 35.5786742242577, -82.55110062144553 35.57885922428564, -82.55102162141796 35.578953224296676, -82.55091362138488 35.579051224305594, -82.55077562134981 35.579130224307484, -82.55063162131731 35.579186224304074, -82.55057262130386 35.579210224302855, -82.55020362122173 35.57934622429264, -82.55019862122073 35.57934722429231, -82.55005362118904 35.57939722428771, -82.54998762119251 35.57930322426172, -82.54988962119461 35.57918322422726, -82.54988762119463 35.57918122422668, -82.54960962119159 35.57890122414106, -82.54928862117727 35.57864822405665, -82.54908762116824 35.57849022400382, -82.54907662116742 35.578483224001324, -82.5490086211637 35.57843422398431, -82.5488096211528 35.57829022393458, -82.54880662115265 35.578288223933846, -82.54874162114977 35.57823722391684, -82.5486886211474 35.578195223902824, -82.54852962114012 35.578071223861265, -82.54847662113764 35.578030223847506, -82.54830062110852 35.57802922382923, -82.54826662110351 35.57802522382486, -82.54795662105664 35.577995223786935, -82.54784662103887 35.57799222377501, -82.54771762101348 35.57801822376708, -82.54765362099704 35.578056223768215, -82.54758662097939 35.578098223769906, -82.54752662095946 35.57816322377695, -82.54749362095001 35.578189223778885, -82.54745062093778 35.57822222378122, -82.54737462091965 35.57825822378073, -82.54728262090285 35.578268223773314, -82.54717862088512 35.57827122376324, -82.54703462086182 35.57826722374762, -82.546974620852 35.57826622374128, -82.54671062081376 35.57823022370683, -82.54649662078417 35.5781912236769, -82.54631762076203 35.57814222364858, -82.54610762074296 35.57804022360625, -82.54586962072344 35.57791022355532, -82.54569862071183 35.57780122351563, -82.54565262070864 35.577772223504944, -82.5454636206979 35.57763822345831, -82.54531662069257 35.57751422341794, -82.54483762057427 35.57776622342005, -82.54473662055081 35.57781022341862, -82.54467862053546 35.57784722342025, -82.54463562052 35.57790122342677, -82.54463562051706 35.577920223430674, -82.54463562051292 35.57794722343617, -82.54466462050706 35.57801622345313, -82.54496762049976 35.57839122356058, -82.54506662049361 35.57853722360042, -82.54510762048756 35.578621223621774, -82.54514262047917 35.57871322364407, -82.54516162046436 35.57883022366987, -82.54514862042913 35.57904522371229, -82.54514762042605 35.579064223715996, -82.54512262041155 35.57913122372716, -82.54509762040479 35.57914822372803, -82.54508262040083 35.57915822372852, -82.5450256203898 35.57916822372472, -82.54496362038236 35.57914922371446, -82.54487362037332 35.579111223697524, -82.54481362036506 35.57910022368907, -82.54463162033544 35.57909622366953, -82.54435762028967 35.57909822364183, -82.54409462024516 35.57910422361606, -82.54407262024134 35.57910522361401, -82.54365762017282 35.57910222357074, -82.54328662011245 35.579095223531226, -82.54321262015632 35.57873022344934, -82.54319762016536 35.578655223432506, -82.5431976201766 35.578582223417726, -82.54321062018882 35.57851722340585, -82.54324062020312 35.57845622339643, -82.54329162022047 35.5783982233899, -82.54335762023769 35.57835722338832, -82.54343162025326 35.578336223391666, -82.54350462026551 35.57833522339896, -82.54371062029495 35.5783662234264, -82.54378862030885 35.57836022343323, -82.54383462031926 35.57834222343429, -82.5438716203323 35.57829722342891, -82.54387662033622 35.57827722342533, -82.5438836203421 35.57824622341972, -82.54386962034717 35.57819822340854, -82.54385562034902 35.57817122340166, -82.54382162035328 35.57810722338513, -82.54365862036467 35.57785722331752, -82.54355062034304 35.577881223311316, -82.54353662034039 35.57788322331027, -82.54342062031824 35.577902223302225, -82.54341962031788 35.57790322330231, -82.54327462029201 35.57791522328981, -82.54313162026844 35.57791422327497, -82.5430206202492 35.57791922326459, -82.5427496201981 35.57795922324493, -82.54270062018908 35.577965223241115, -82.54254662015997 35.57798822322999, -82.54246162014486 35.577995223222686, -82.54228462011422 35.5780032232061, -82.54223562010638 35.57800122320065, -82.54181362003749 35.57799322315568, -82.541621620007 35.577984223134145, -82.54155861999806 35.57797522312587, -82.54133461996538 35.57794622309689, -82.54119761994563 35.57792622307877, -82.5411746199423 35.57792322307582, -82.54094561990846 35.577896223046764, -82.54069461987069 35.57787122301594, -82.54058361985375 35.57786122300253, -82.540534619846 35.57785922299708, -82.54033061981353 35.57785022297427, -82.53971861971618 35.57782322290596, -82.53951561968367 35.577815222883444, -82.53936161965999 35.577803222865185, -82.53890161958884 35.57776922281102, -82.53874861956524 35.577758222793086, -82.53860561955099 35.57769622276577, -82.53860061955454 35.577667222759366, -82.53856361955677 35.57761322274456, -82.53854261956421 35.577542222727956, -82.53853961956943 35.57750522272019, -82.53852761959267 35.57734122268555, -82.53850661964518 35.576977222609266, -82.53849761967065 35.57680222257276, -82.53849061968697 35.57668822254885, -82.53847261973651 35.57634722247763, -82.53846661975285 35.57623422245401, -82.53846161976335 35.57616122243864, -82.5384536197834 35.57602222240953, -82.53845261979545 35.575942222393174, -82.53845261980662 35.57587022237849, -82.53845161980746 35.57586322237696, -82.53844261983127 35.57569922234266, -82.53841361984392 35.57558522231647, -82.53839161985033 35.57552022230098, -82.53832961986849 35.575335222256996, -82.53821461989608 35.575032222183495, -82.53820161989925 35.57499722217505, -82.53814061991609 35.57482222213317, -82.53809761992653 35.57470822210556, -82.53797161995769 35.574369222023655, -82.53792961996814 35.574256221996315, -82.53785161998645 35.57405322194701, -82.53778162000263 35.57387222190298, -82.53763062004373 35.57344222180001, -82.5375596200634 35.57323822175125, -82.5375516200664 35.57321022174471, -82.53748662007851 35.57306122170773, -82.53748662007865 35.57306022170748, -82.53743762009238 35.57291822167356, -82.53739962009881 35.572835221652774, -82.537206620108 35.57256722157844, -82.53714562011106 35.57248222155487, -82.53712162011547 35.572427221541176, -82.53711562011836 35.57240222153553, -82.53711162012058 35.57238322153126, -82.53714062013091 35.57234722152683, -82.53721362014541 35.572332221531305, -82.53730262015725 35.57235122154431, -82.53738462016808 35.57236922155637, -82.53758762018899 35.572452221594084, -82.53789662021126 35.57264022166409, -82.53792462021512 35.572645221668, -82.53794562021793 35.57265022167118, -82.53800462022704 35.57265422167806, -82.538074620241 35.57263922168218, -82.53814262025868 35.57259722168067, -82.53815362026143 35.57259122168056, -82.5382516202842 35.57254922168205, -82.53830862029429 35.57254522168713, -82.53835562030254 35.572542221691336, -82.53844562031546 35.57255522170325, -82.53854662032377 35.57261022172472, -82.53875062032905 35.572796221783555, -82.5387566203292 35.57280122178523, -82.5388976203381 35.572895221818804, -82.5388926203479 35.57282622180426, -82.53887762035652 35.57275422178807, -82.53884062036505 35.572659221764944, -82.53879562036943 35.57258222174462, -82.53868162037031 35.572453221706674, -82.53864762037085 35.57241322169508, -82.53850662037368 35.572242221645794, -82.53846762037684 35.57218022162911, -82.5384716203862 35.572123221617936, -82.5385656204555 35.5717742215566, -82.53862562050274 35.57153222151348, -82.53865562052016 35.571451221500084, -82.5386916205383 35.57137222148775, -82.53874462056176 35.57127622147366, -82.53882462059292 35.571160221458285, -82.53888762062121 35.57104422144111, -82.53893462064642 35.570931221422974, -82.53894062065234 35.57089922141705, -82.53895362066469 35.570833221404996, -82.53896062068321 35.5707202213827, -82.53894862069939 35.570602221357454, -82.5388976207195 35.57041622131435, -82.53887262072459 35.570356221299576, -82.53910762077865 35.570258221303774, -82.53954862087878 35.570083221313496, -82.53977162092914 35.569996221318654, -82.53993162096309 35.569948221325255, -82.54012362100212 35.569901221335435, -82.5402896210341 35.56987222134657, -82.54145062125446 35.5696922214292, -82.5416216212879 35.56965922144001, -82.54168662130115 35.569643221443414, -82.54175462131472 35.56962822144732, -82.54216862140416 35.569493221462416, -82.54238462144953 35.569431221471966)))",6375,37,021,000800,370210008003,1711,1711,35,1690,1489,166,8,12,0,15,21,1454,27,1427,1438,1270,142,7,10,0,9,16,590,520,70
census_2010_blockgroups_view.fid--2dc29038_13ec899ba8f_-25c7,"MULTIPOLYGON (((-82.52829862435621 35.5353192130854, -82.52843262434234 35.535554213146874, -82.52864362432717 35.53588121323514, -82.52866362432628 35.53590821324262, -82.52900462431116 35.536375213372615, -82.52916262430408 35.53659121343286, -82.52933862429632 35.53683221349986, -82.52964662428612 35.53723121361268, -82.52981062428051 35.53744421367282, -82.5299386242769 35.537606213718874, -82.53032562426598 35.53809521385817, -82.53045462426229 35.53825821390454, -82.53072062425463 35.538595214000395, -82.53136562423629 35.53941121423262, -82.53151362422989 35.539612214288645, -82.5315536242284 35.53966521430353, -82.53164562422234 35.53980421434125, -82.53173562421024 35.5399802143863, -82.53182262419942 35.54014421442858, -82.53183662419777 35.54017021443534, -82.53194162417535 35.54042921449879, -82.53202962415394 35.54066321455542, -82.53209662413822 35.54083821459796, -82.53217562411962 35.541045214648186, -82.53241462406362 35.5416672147992, -82.53249462404494 35.541875214849725, -82.53252362403828 35.541950214868024, -82.53261062401766 35.54217821492333, -82.53264062401094 35.54225421494182, -82.53268562400056 35.54237021497005, -82.53282062396904 35.542721215055344, -82.53286662395874 35.542838215083826, -82.5329356239424 35.54301921512775, -82.53314462389314 35.54356521526032, -82.53320662387884 35.543725215299204, -82.5332156238769 35.54374721530461, -82.53340162383385 35.54422821542151, -82.53344762382335 35.54434621545038, -82.53395162370228 35.54567821577304, -82.53399662369146 35.54579721580188, -82.53412862365697 35.54616421589003, -82.5341686236456 35.54628121591803, -82.53428962361176 35.54663221600179, -82.53433062360043 35.54675021603007, -82.5343556235933 35.54682321604744, -82.53443062357171 35.5470452161003, -82.53445562356441 35.547119216117984, -82.53430662353355 35.54715921611077, -82.53409762348882 35.547225216102724, -82.53384262343377 35.54730821609349, -82.53303962325758 35.547588216068036, -82.53282162320956 35.54766521606133, -82.53268662318048 35.54770921605644, -82.53225162308661 35.547850216040416, -82.53220962307734 35.54786521603916, -82.53164662295384 35.548061216021296, -82.53112062284032 35.54823221600206, -82.53095362280392 35.54828921599653, -82.53079362276866 35.54834621599178, -82.5305526227125 35.54845121598835, -82.53053162270733 35.548462215988444, -82.53038162267046 35.54854021598894, -82.5303416226614 35.548556215988015, -82.53025262264094 35.54859321598644, -82.53011262261384 35.548618215977164, -82.52971562254761 35.54862121593705, -82.52970862254628 35.54862221593648, -82.52950462251096 35.548632215917586, -82.5293356224794 35.54865521590499, -82.52927862246834 35.54866521590112, -82.52860462233834 35.5487842158561, -82.52838062229506 35.548824215841265, -82.52819662226048 35.54885021582777, -82.5280536222347 35.54886421581586, -82.52796762221888 35.548874215809036, -82.52751062214513 35.548861215759516, -82.5272796221089 35.548847215732984, -82.52715362209176 35.548823215715146, -82.52714762209088 35.548822215714395, -82.52707362208277 35.548795215701254, -82.5269806220724 35.548762215684945, -82.52677262205302 35.54866421564372, -82.52652562202799 35.548560215597135, -82.52647862202322 35.548540215588254, -82.5262716219956 35.5484972155583, -82.52606062196564 35.5484642155299, -82.52582762193056 35.54844121550136, -82.5257356219164 35.54843421549046, -82.52546962187506 35.54841621545948, -82.5254556218498 35.54856521548832, -82.5254296217996 35.54886421554652, -82.52541162177378 35.549012215574834, -82.52539362174797 35.54916121560324, -82.52532562173923 35.54914421559279, -82.52526162172961 35.54913821558498, -82.52523362172597 35.5491312155807, -82.52512362171203 35.549103215563704, -82.52485262167913 35.54902521552002, -82.5247646216689 35.54899721550528, -82.52460962165053 35.5489492154796, -82.52416762159598 35.54882721540947, -82.52398962157388 35.54877921538136, -82.52374162154612 35.548692215338214, -82.52350362152096 35.54859921529494, -82.52332062149992 35.54853821526371, -82.5231646214795 35.54850321524057, -82.52300062145616 35.54847821521863, -82.52285062142846 35.54849621520693, -82.52280362141963 35.5485032152035, -82.52261462137679 35.548578215199385, -82.5224296213321 35.548669215198856, -82.52194562121056 35.548938215203975, -82.52182362118072 35.54900021520405, -82.52175062116277 35.549038215204256, -82.52145462108899 35.549199215206606, -82.52128862104655 35.549296215209274, -82.5211746210164 35.549369215212444, -82.52107762098854 35.5494462152182, -82.52099262096 35.54954021522856, -82.52091662092882 35.54966121524537, -82.5208826209062 35.54977121526429, -82.52075162082792 35.55013921532564, -82.52068062078789 35.55032321535585, -82.52058962074072 35.55053221538896, -82.52058562073817 35.55054421539105, -82.52050162069669 35.55072321541878, -82.52040062065143 35.550909215446275, -82.52035362063505 35.550965215452884, -82.5202986206217 35.550992215452695, -82.52023462060869 35.55100821544939, -82.52016662059587 35.5510182154444, -82.52028862066788 35.550681215388416, -82.5206576208843 35.54967121522083, -82.52069462090562 35.54957221520451, -82.52077762095598 35.54933421516455, -82.52080762097431 35.54924721514996, -82.52090762102968 35.548995215109024, -82.52094762105123 35.548898215093324, -82.52128462124938 35.54797221493959, -82.5213286212751 35.54785221491965, -82.52141162132267 35.547632214883464, -82.52145062134501 35.54752921486644, -82.52156762141205 35.5472192148154, -82.52160762143433 35.54711721479877, -82.52163662145092 35.54704021478611, -82.52166962146968 35.54695421477197, -82.52172062150045 35.54680921474781, -82.52174862151693 35.54673221473498, -82.52180262154886 35.54658221470994, -82.52187962160285 35.54631421466334, -82.52189862161569 35.546251214652486, -82.52193962165427 35.54604421461455, -82.52195262169322 35.54580521456734, -82.5219486217314 35.54555221451544, -82.52190862176394 35.54529721445939, -82.52185962179396 35.54504921440393, -82.52185062179755 35.545016214396284, -82.5217876218262 35.54476121433793, -82.5217356218433 35.54459421429864, -82.5216986218551 35.544477214271026, -82.52164962187145 35.544318214233705, -82.52158862189037 35.54412921418896, -82.52155262190203 35.54401421416192, -82.52148562192447 35.5437962141107, -82.521482621926 35.54378321410774, -82.52136362196153 35.5434232140223, -82.52127462198939 35.54314621395677, -82.52120662201138 35.542929213905644, -82.52117562202106 35.542833213882965, -82.52115262202861 35.54275921386549, -82.52109062205122 35.54254521381566, -82.52108262205417 35.54251721380915, -82.52106562206184 35.54244921379354, -82.521000622091 35.542189213733955, -82.52091262213159 35.541830213652005, -82.52082262218153 35.54140821355683, -82.52081862218432 35.54138521355175, -82.52076262221155 35.54114821349776, -82.52071462223559 35.54093921345033, -82.52057062230813 35.540312213307985, -82.52056262231255 35.54027421329948, -82.52052562233276 35.54010321326091, -82.52050162234718 35.539983213234045, -82.52042962239054 35.5396232131534, -82.52040662240515 35.539503213126636, -82.52034362244319 35.53918821305607, -82.52015662255702 35.53824521284504, -82.52012462257656 35.53808321280881, -82.52009362259484 35.53793121277474, -82.52006562261064 35.53779821274489, -82.51997662265218 35.53743121266102, -82.51992462267664 35.537216212611966, -82.51959562281816 35.535940212318586, -82.51946762287311 35.535444212204524, -82.51930562293833 35.53484421206584, -82.51882062313402 35.53304721165061, -82.51872962317115 35.532707211572074, -82.51866862319773 35.532468211517184, -82.51866362319997 35.53244821151265, -82.51865062320549 35.532398211501125, -82.51864862320595 35.53239321149994, -82.51860362322378 35.53222821146172, -82.51858962322981 35.53217421144926, -82.51855862324213 35.532060211422966, -82.51846562327889 35.5317202113442, -82.51843462329118 35.531607211318054, -82.51833362333156 35.53123521123208, -82.51803362345306 35.53012021097445, -82.51793362349345 35.52974921088872, -82.51792162349795 35.52970721087895, -82.51791062350274 35.52966421086904, -82.51789262351231 35.52958221085055, -82.51788462351725 35.529541210841316, -82.51785662353247 35.52941221081229, -82.51785362353455 35.529395210808495, -82.51782362356029 35.529195210764684, -82.51780262359387 35.52895421071353, -82.5178006235974 35.528928210708024, -82.5177966236155 35.5288062106828, -82.51779462362065 35.52877121067552, -82.51779262363148 35.52869821066042, -82.51779262363641 35.52866621065394, -82.5177936236419 35.528631210646935, -82.51779562367527 35.528416210603424, -82.51779862371511 35.52816021055168, -82.51781062377678 35.52777121047379, -82.51781362378814 35.527700210459585, -82.51782362381182 35.52755721043153, -82.51783462384068 35.52738121039683, -82.517836623845 35.52735521039177, -82.51788762389147 35.52710721034655, -82.51794962393635 35.52688221030715, -82.51795362393905 35.526869210304916, -82.51801162397413 35.52670321027719, -82.51803662398963 35.52662921026464, -82.51811362403633 35.52640821022763, -82.5181396240518 35.5263352102154, -82.51815162405947 35.52629821020913, -82.51818962408268 35.526188210190625, -82.51820262409038 35.526152210184634, -82.51827362413376 35.525946210149975, -82.5184866242636 35.525330210046604, -82.51855862430703 35.525125210012305, -82.51858062432049 35.52506121000153, -82.51864562436047 35.524871209969575, -82.51866862437394 35.524808209959076, -82.51875962439271 35.524784209963535, -82.51952962456873 35.52446920997844, -82.51994462466428 35.524294209985435, -82.52010762470175 35.52422620998832, -82.52074262484605 35.52397221000183, -82.5213306249853 35.52370021000686, -82.5218726251151 35.523439210009286, -82.52270862531816 35.52301921000967, -82.52349962550775 35.52263821001328, -82.52367862555356 35.522533210010295, -82.52416262567704 35.522251210002636, -82.52478562583214 35.52191320999774, -82.52488062585574 35.52186220999711, -82.52550462601111 35.52152420999236, -82.52561662603888 35.52146420999166, -82.5262686262079 35.521067209977836, -82.52705362641673 35.52055420995398, -82.52731462648342 35.520401209949554, -82.5277176265862 35.520167209943345, -82.52791562664109 35.520023209934386, -82.52805462667988 35.5199202099276, -82.52837762676934 35.519686209913175, -82.5284646267966 35.51960320990525, -82.52859162683576 35.51948520989425, -82.5285996268327 35.519513209900786, -82.52862662682419 35.51959820992083, -82.52863562682116 35.51962720992764, -82.52864362681825 35.51965520993419, -82.5286706268097 35.51974020995425, -82.52867962680669 35.51976920996102, -82.5287106267963 35.519870209984745, -82.52887162674416 35.52038421010588, -82.52904162668942 35.52092421023321, -82.52913462665671 35.52123821030659, -82.5292266266208 35.52157121038376, -82.52929662658806 35.521860210449674, -82.52937562654134 35.52225021053712, -82.52938662653517 35.52230221054882, -82.52944762648667 35.52268421063281, -82.52947162645928 35.52288821067687, -82.52949462643149 35.5230942107211, -82.52950462642032 35.523178210739204, -82.5295256263808 35.5234582107983, -82.52953862634315 35.52371721085229, -82.52954062633961 35.52374221085761, -82.52954462631222 35.52392521089524, -82.52954662629786 35.52402121091496, -82.52955062626519 35.524238210959545, -82.52953062618589 35.52473321105821, -82.52952662617814 35.5247792110671, -82.52945562603426 35.52564021123494, -82.5293346257971 35.52705421151022, -82.52930562574919 35.52733521156443, -82.5292846257121 35.52755421160687, -82.52925762567952 35.52773721164133, -82.52918562559914 35.52818221172441, -82.52916062557836 35.528291211744055, -82.52910262552939 35.52854721179018, -82.52908362551511 35.52862021180301, -82.52905662549375 35.52873021182266, -82.52896562542477 35.5290812118847, -82.52887562535575 35.52943321194712, -82.5288136253086 35.52967321198962, -82.52869462521785 35.53013621207154, -82.52860462514884 35.53048821213394, -82.52843562502015 35.53114421225006, -82.52792962463398 35.533112212598546, -82.52792962463353 35.53311521259908, -82.52788362458845 35.53335921264404, -82.52786262454907 35.53359321268952, -82.52785862451893 35.53378521272812, -82.52785862449821 35.53392021275561, -82.52787962446136 35.53418221281108, -82.52791162443968 35.5343582128501, -82.52792062443427 35.5344032128602, -82.5279776244107 35.53461821290978, -82.52805362439094 35.53482921296055, -82.52815762437405 35.53505121301636, -82.52829862435621 35.5353192130854)))",6196,37,021,002102,370210021022,2744,2744,577,2617,1656,558,9,38,1,355,127,2159,385,1774,2093,1366,446,9,32,1,239,66,1338,1183,155
census_2010_blockgroups_view.fid--2dc29038_13ec899ba8f_-25c6,"MULTIPOLYGON (((-82.63440462181158 35.666330250658746, -82.63439662181565 35.66629525065082, -82.63437862182472 35.66621725063313, -82.63437562182807 35.666192250627624, -82.6343716218328 35.66615725062009, -82.63436862183559 35.666136250615516, -82.63436062184368 35.66607525060226, -82.63435862184643 35.666055250597985, -82.63439862185722 35.66602825059656, -82.63452262188987 35.665950250593504, -82.63480562197516 35.66570325057222, -82.6350556220456 35.66551625055976, -82.63547962215938 35.66523625054629, -82.63581662223999 35.66507725054852, -82.63638162233242 35.665088250608896, -82.63659762237685 35.665033250619835, -82.63662962238408 35.66502125062072, -82.63677262241528 35.66497325062562, -82.63699462245226 35.66497325064848, -82.637506622512 35.665138250734685, -82.63763462252894 35.66516625075356, -82.63777562255335 35.66516025076678, -82.63801162260368 35.665089250776575, -82.63818662264636 35.66500125077666, -82.6383546226836 35.66494125078169, -82.63852362272699 35.66484225077889, -82.63864462276754 35.66471025076444, -82.63878562281815 35.66453425074305, -82.63888662286627 35.66433125071205, -82.63919762299102 35.66385825064757, -82.63935862306528 35.66355125060158, -82.63951462312684 35.66332025057056, -82.63978362321654 35.66302925053887, -82.64008662333224 35.662606250483805, -82.64040962343604 35.66228225045094, -82.64055862349313 35.66207325042371, -82.64076062355804 35.6618702504031, -82.64094862359788 35.66181525041122, -82.64131962368415 35.66165625041692, -82.64158262375167 35.66150225041252, -82.64171662379017 35.66139725040493, -82.64234362397931 35.66084825035745, -82.64241562400439 35.66076325034753, -82.64252562404263 35.66063425033256, -82.64272062412844 35.660288250282065, -82.64284862418111 35.66008525025387, -82.64325262429513 35.65978225023361, -82.64332062432253 35.659678250219386, -82.64333362433314 35.65962325020953, -82.6434616243739 35.659497250197056, -82.64360962440868 35.659431250198786, -82.64383262445507 35.65937125020944, -82.64396062448753 35.659299250208, -82.64401362450823 35.659222250197686, -82.64407462454297 35.65906325017161, -82.64408162456107 35.65895325014982, -82.64447862462278 35.65898125019637, -82.64466062465651 35.65895925021055, -82.64467962466148 35.65894725021009, -82.64496362473336 35.65878825020692, -82.64506462475265 35.65877225021394, -82.64523262477475 35.65881025023906, -82.64544862480975 35.65881625026241, -82.64557662483355 35.6588002502723, -82.64593262492674 35.65858025026401, -82.64606162495421 35.65854125026938, -82.64624962498968 35.65851425028317, -82.64636462501393 35.65848125028828, -82.64636862501506 35.65847825028807, -82.64656662506876 35.65834425028109, -82.6467146251348 35.658075250241545, -82.64672962514597 35.658019250231604, -82.64679562519419 35.65777825018923, -82.64688962524788 35.657531250148516, -82.64706462530594 35.65734425012845, -82.64708562532813 35.65722325010593, -82.64700462534509 35.65702525005722, -82.6470046253465 35.657016250055435, -82.64701762537183 35.65686625002619, -82.64708562541537 35.65665724999058, -82.64720662545328 35.65654224997958, -82.64737462549233 35.6564702499822, -82.64757762553033 35.6564432499975, -82.6478326255618 35.6565142500382, -82.6484186256075 35.65685025016687, -82.6487886256395 35.657042250244075, -82.64957662570286 35.6574822504147, -82.64972762571979 35.65753525044095, -82.64996662574669 35.65761925048274, -82.65032362579673 35.65768025053177, -82.6505996258434 35.657675250559144, -82.65080862589099 35.657592250563695, -82.65107762596716 35.65738925054997, -82.65120562600958 35.65725225053524, -82.651273626043 35.657109250512974, -82.65130662607484 35.65693825048161, -82.65127962609999 35.656746250439596, -82.65118562611389 35.65655425039085, -82.65101062611873 35.65633425032806, -82.65084262611857 35.65615325027392, -82.65068762611071 35.65603725023431, -82.65044562609835 35.65585625017252, -82.6503446261019 35.65572425013525, -82.65033762612204 35.65558625010643, -82.65041862614734 35.65550925009906, -82.65057362618326 35.6554442501017, -82.65076162622391 35.65538325010861, -82.65117262629482 35.655367250147606, -82.6514356263522 35.65527925015669, -82.65171862642045 35.65514225015778, -82.65213562651628 35.65497125016579, -82.65235762656832 35.65487325016862, -82.65252662661096 35.65477925016687, -82.6527216266561 35.65469725017012, -82.65293062669934 35.65464225018039, -82.65345962678819 35.65463725023373, -82.65354262680204 35.654637250242246, -82.65431062693166 35.654626250318884, -82.6549566270333 35.654664250393026, -82.65548062711105 35.654726250459476, -82.65555662712212 35.65473625046935, -82.65585862717828 35.654698250492665, -82.65593962720365 35.654621250485285, -82.65622962731639 35.65420325042987, -82.65637062735517 35.65410425042418, -82.65653962738504 35.6540932504393, -82.65676162742203 35.65409325046206, -82.6570986274679 35.654159250510176, -82.65717562747955 35.65416725051971, -82.6574426274583 35.65459325063394, -82.6575416274452 35.65478525068325, -82.65766962742819 35.655033250746975, -82.65778762737814 35.65548525085124, -82.65781762734017 35.65576425091121, -82.65774362715332 35.65689525113415, -82.6577136270759 35.657365251226835, -82.65772562704296 35.65759125127415, -82.65773262704073 35.65761325127932, -82.65778862702265 35.65779125132139, -82.6578776270122 35.65795525136398, -82.65801262700754 35.65813125141373, -82.65826862701856 35.65833625148182, -82.65844062703438 35.65841925151635, -82.65871962706726 35.658507251563044, -82.66035662729081 35.65882525179608, -82.6608296273496 35.65895525187113, -82.6611366273829 35.65907025192609, -82.66146462741557 35.65921325198894, -82.66155462742437 35.65925325200631, -82.6617586274446 35.659342252045484, -82.66189162745776 35.659400252070924, -82.66191962746065 35.65941225207624, -82.66201362747026 35.659451252093895, -82.66228862749836 35.65956625214557, -82.6622986274994 35.65957025214741, -82.6623956275098 35.65960725216492, -82.66244262751499 35.65962425217319, -82.66258662753067 35.65967825219901, -82.66260862753293 35.65968725220308, -82.66263462753584 35.65969625220762, -82.66277862755229 35.65974525223237, -82.66305962758395 35.65984325228124, -82.6632126276019 35.65989225230688, -82.66335862761898 35.65993925233151, -82.66340762762471 35.659955252339756, -82.66351362763712 35.65998925235762, -82.66355862764277 35.66000125236469, -82.66360962764888 35.66001625237304, -82.66382762767581 35.66007725240783, -82.66387962768243 35.66009025241584, -82.66469362778588 35.660299252542075, -82.66472562778992 35.66030725254704, -82.664966627821 35.66036625258375, -82.66502362782835 35.660380252592475, -82.6651966278506 35.6604222526188, -82.66525462785802 35.66043725262784, -82.66582762793189 35.66057725271524, -82.66622462798223 35.66067925277683, -82.66652362802122 35.66074925282183, -82.66668162804089 35.660792252846804, -82.66674062804857 35.66080625285571, -82.66693962807415 35.660855252886165, -82.66712762809742 35.66090725291608, -82.66721862810982 35.660925252929125, -82.66735962812722 35.66096525295173, -82.66771062817259 35.66105025300511, -82.66781262818509 35.66107925302155, -82.66794862820291 35.66111025304179, -82.66822962823834 35.66118425308579, -82.66874962830472 35.661315253165974, -82.6690206283354 35.661409253212895, -82.66913962834847 35.661453253234065, -82.66927262836136 35.66151325325997, -82.66942162837461 35.66158825329058, -82.66954462838412 35.66165925331771, -82.66970662839483 35.66176425335577, -82.66983962840204 35.66186125338918, -82.67007862841272 35.66205025345231, -82.67036862842345 35.662294253531805, -82.67055062843156 35.6624382535799, -82.67074462843914 35.662598253632375, -82.6708436284441 35.66267325365788, -82.67084662844414 35.66267625365879, -82.67095062844737 35.66276725368803, -82.67107762845342 35.66286525372111, -82.67128162846127 35.66303525377669, -82.67135262846318 35.66309925379699, -82.67173262848085 35.66339525389639, -82.67188762848703 35.66352225393818, -82.67202362848901 35.663656253979546, -82.67212962848815 35.663776254014856, -82.67219562848466 35.66387025404082, -82.67227862847773 35.66400525407687, -82.6723626284576 35.664226254130554, -82.67239162844163 35.66436125416103, -82.67240362842041 35.66451125419289, -82.67239962839984 35.66464025421875, -82.6723676283628 35.66484625425747, -82.67228662826692 35.665380254358, -82.67227562824459 35.665513254383995, -82.67227662822363 35.66565025441205, -82.67228762820645 35.66577325443829, -82.6723226281913 35.66590925446962, -82.6723776281782 35.66605325450465, -82.67239462817585 35.66608725451329, -82.67243562817042 35.66616625453359, -82.67251162816535 35.6662812545648, -82.67257262816402 35.66635625458646, -82.67275362816612 35.66653825464207, -82.67285562817106 35.666616254668455, -82.6729926281796 35.66670825470134, -82.67309662818722 35.666771254724836, -82.67323162820024 35.666833254751346, -82.67334462821212 35.66687825477221, -82.67346762822625 35.66691925479319, -82.67359562824274 35.66695025481259, -82.67370462825828 35.66696725482731, -82.67383262827795 35.666978254842654, -82.67400162830484 35.66698625486171, -82.67429862835607 35.66697525488997, -82.67468862842613 35.66694225492325, -82.67483362845202 35.66693125493598, -82.67498862847908 35.66692325495027, -82.67512562850195 35.66692225496413, -82.67527462852512 35.66693325498165, -82.67545662855113 35.66696125500608, -82.67558462856772 35.666992255025534, -82.67572362858267 35.667045255050574, -82.67584962859466 35.66710325507538, -82.67594162860152 35.66715825509603, -82.67598262860454 35.66718325510536, -82.67610462861103 35.66727325513621, -82.67619762861275 35.66736225516397, -82.67629562861126 35.66747725519751, -82.6763496286074 35.667561255220114, -82.67640362859923 35.667672255248306, -82.67641062859657 35.66769725525412, -82.67643862858706 35.667789255275814, -82.67646862856922 35.66793725530902, -82.67648262855101 35.668070255337604, -82.67648662854742 35.668097255343525, -82.67651662845404 35.66873525547668, -82.676536628435 35.6688802555083, -82.67654562843047 35.66891925551717, -82.67656662841905 35.669016255539084, -82.67659562840909 35.6691122555617, -82.67668062839428 35.66930025560875, -82.67674262838885 35.669402255635895, -82.67682962838465 35.669523255669475, -82.67693562838406 35.669641255704484, -82.6770226283852 35.66972825573114, -82.67730962838895 35.67001325581871, -82.67740962839211 35.67010125584692, -82.67751162839275 35.67020725587907, -82.67754462839329 35.67023925588903, -82.67772262839634 35.67041125594233, -82.67776562839707 35.67045325595532, -82.6780156283972 35.67072225603585, -82.67821062839099 35.67097325610704, -82.67823562839023 35.67100525611614, -82.67833662838333 35.67115925615798, -82.67834862838204 35.6711802561634, -82.67840462837769 35.671269256187365, -82.67846062837111 35.6713722562141, -82.67853862836017 35.67152725625372, -82.67854662835879 35.67154525625822, -82.67863362834396 35.67173525630586, -82.67871262833103 35.67190425634848, -82.67873162832754 35.67194725635922, -82.67873762832645 35.67196125636266, -82.67877662831934 35.67204925638466, -82.67885462831012 35.672193256421984, -82.67893062829927 35.67234525646079, -82.67900362829216 35.6724702564938, -82.67907762828662 35.67258625652506, -82.6791236282847 35.672648256542445, -82.67915462828337 35.67269025655417, -82.67924462828125 35.67280125658607, -82.67933562828055 35.672904256616434, -82.67939962828275 35.67295925663419, -82.67943062828368 35.67298625664284, -82.67954362828553 35.673096256676935, -82.6795916282874 35.67313625669, -82.67962862828864 35.67316825670032, -82.67966362829002 35.67319725670981, -82.67979262829745 35.67328825674169, -82.67992162830579 35.67337325677222, -82.6803086283355 35.67359925685808, -82.68041862834424 35.67366125688199, -82.68047562834874 35.6736932568944, -82.68060362835823 35.67377025692327, -82.68068862836519 35.67381725694158, -82.68076062837092 35.673857256957106, -82.68086262837797 35.6739222569809, -82.68102762839094 35.67401625701697, -82.68205462847193 35.674600257241615, -82.68216762848077 35.674665257266476, -82.68239862849953 35.674793257316374, -82.68241662850609 35.674770257313426, -82.68247462852632 35.67470125730536, -82.68249362853288 35.674679257302785, -82.6825416285499 35.674621257295875, -82.68268562859875 35.67446025727789, -82.68278162862939 35.67436525726837, -82.68292562867546 35.67422225725406, -82.68313862873397 35.67407325724547, -82.68361162885041 35.67382925724432, -82.68376462888948 35.67374125724211, -82.68390962892828 35.67364625723766, -82.68407762897812 35.67350525722616, -82.68417662901047 35.67340225721531, -82.68432862906587 35.67320725719122, -82.68437462908423 35.67313825718183, -82.68446662912595 35.672967257156415, -82.68451262915494 35.672829257132975, -82.68455762918171 35.67270425711211, -82.6846036292271 35.67245925706689, -82.68463462926579 35.67224225702587, -82.68464962929595 35.67206325699092, -82.68465662930772 35.671994256977534, -82.6846646293201 35.67192325696388, -82.68467362933478 35.671837256947214, -82.68468462934496 35.67178325693732, -82.68469262935503 35.67172625692653, -82.68469362935683 35.67171625692463, -82.68469762936164 35.67168925691951, -82.68469962936332 35.67168025691791, -82.68470162936633 35.671663256914684, -82.68470762937302 35.67162625690769, -82.68471062937523 35.67161525690581, -82.68471662937849 35.67160025690335, -82.6847516294001 35.67149825688612, -82.68479562942004 35.67141625687398, -82.68486062944176 35.67134625686633, -82.68487862944755 35.67132825686451, -82.6849636294732 35.67125325685797, -82.685085629505 35.67117925685539, -82.6852316295392 35.6711152568573, -82.68556762961155 35.671009256870185, -82.6856576296305 35.670983256874216, -82.68594262969029 35.67090425688735, -82.68611062972501 35.67086025689562, -82.68632362977077 35.670794256904095, -82.6865526298183 35.67073325691512, -82.68665062983943 35.67070225691888, -82.68701362991794 35.6705852569323, -82.68721162996223 35.67051225693775, -82.68734962999507 35.67044825693892, -82.68741263001009 35.670419256939475, -82.68757163005014 35.670331256937864, -82.68863663032684 35.66968825691611, -82.68875263035682 35.66961925691397, -82.68898563041927 35.6694662569067, -82.68909363045007 35.669383256900865, -82.68927163050772 35.66920225688228, -82.68934363053336 35.6691132568715, -82.68943263056737 35.668989256855404, -82.68955663061621 35.66880625683075, -82.68968563066753 35.6686132568047, -82.68973963069044 35.66852325679183, -82.69002963080537 35.66809125673355, -82.69034963093392 35.66760425666712, -82.69045363098049 35.66741425663905, -82.69046563098564 35.66739425663623, -82.6905156310101 35.66728925661988, -82.69056063103709 35.66716325659883, -82.6906586311123 35.66678125653104, -82.69076363120357 35.666303256444294, -82.6908136312474 35.66607325640253, -82.69083963126467 35.6659892563881, -82.69086263128177 35.66590325637294, -82.69087463128993 35.665863256365974, -82.69092663132099 35.66571825634173, -82.69095663133581 35.66565425633178, -82.69099463135446 35.665574256319346, -82.69102463136947 35.66550925630924, -82.69104863138124 35.66545925630143, -82.69111863141097 35.665342256284795, -82.69112963141555 35.66532425628222, -82.69116863143115 35.66526525627425, -82.69120163144417 35.66521625626758, -82.69133063149137 35.66505025624705, -82.6913456314966 35.66503225624489, -82.6914206315223 35.66494625623503, -82.69162163158549 35.66475425621653, -82.6918796316609 35.66454425620025, -82.69199063169306 35.66445525619344, -82.69199763169522 35.664449256192924, -82.69209063172084 35.664383256189055, -82.69223263176139 35.66427425618143, -82.69226563177106 35.664247256179245, -82.69236663179967 35.664170256173946, -82.69240063180945 35.66414425617212, -82.69259763186601 35.66399025616097, -82.69267863188978 35.66392325615566, -82.69315463202885 35.66353625612556, -82.69339263210138 35.663323256106565, -82.69347663212783 35.6632422560987, -82.69348763213169 35.66322925609716, -82.6936806321955 35.663024256075204, -82.69372863221233 35.66296725606851, -82.69379863222095 35.66298625607956, -82.69384863222838 35.6629922560859, -82.69388663223492 35.66299125608959, -82.69394363224669 35.66297625609239, -82.69399563225953 35.6629492560923, -82.69403763227362 35.66290325608718, -82.69407963229004 35.66284225607905, -82.694083632292 35.662834256077815, -82.69415963232618 35.66269425605718, -82.69421763234585 35.66262925604975, -82.69458063245466 35.66231625602322, -82.69470663249234 35.662208256014125, -82.69482563252589 35.662119256008204, -82.69489363254256 35.66208425600808, -82.69499563256532 35.66204725601106, -82.69504063257438 35.66203725601358, -82.6950616325785 35.66203325601491, -82.6951436325937 35.66202325602128, -82.69531363262173 35.66202525603918, -82.69546363264531 35.6620342560564, -82.69546863264623 35.66203425605691, -82.69548463264866 35.662035256058736, -82.69549063264955 35.66203625605955, -82.69563063267148 35.6620452560758, -82.69573663268848 35.66204925608747, -82.69583963270479 35.662055256099336, -82.6959436327213 35.662060256111, -82.6960146327324 35.66206525611929, -82.69623563276627 35.6620842561459, -82.69636763278758 35.6620892561605, -82.69646863280525 35.66208325616961, -82.69657963282681 35.6620632561769, -82.69666663284475 35.662041256181354, -82.69673663285998 35.662018256183835, -82.69682263288021 35.661980256185004, -82.69688063289453 35.66195025618477, -82.69697663292015 35.661887256181814, -82.69720663298749 35.66169925616707, -82.69738463304274 35.66153325615154, -82.69740863305023 35.661511256149474, -82.6975126330816 35.66142025614158, -82.69757163309845 35.66137425613831, -82.69761563311128 35.66133925613564, -82.69763363311583 35.661328256135285, -82.69770363313393 35.66128725613407, -82.69784063316756 35.66121725613388, -82.6980216332093 35.66114225613713, -82.69812863323374 35.66109925613945, -82.69824663326114 35.661049256141354, -82.6984336333088 35.660942256138696, -82.69854163333818 35.66086825613469, -82.69870563338239 35.66075925612934, -82.69873663339074 35.66073825612821, -82.69878263340273 35.66071025612719, -82.69889863343259 35.66064225612522, -82.69902063346304 35.66057625612432, -82.69910163348307 35.660534256124095, -82.69926563352394 35.66044625612295, -82.69948163357755 35.660332256121876, -82.69970363363437 35.6602032561184, -82.69975163364725 35.66017225611697, -82.69985263367364 35.66011025611472, -82.69989863368886 35.660061256109444, -82.69995363370744 35.66000025610266, -82.69998463371829 35.65996325609833, -82.70002263373298 35.65990925609121, -82.7000696337474 35.659866256087255, -82.70014463376971 35.659802256081875, -82.7003996338426 35.65960525606787, -82.70069863392744 35.659378256052335, -82.70072263393378 35.65936325605171, -82.70090963398904 35.659207256039124, -82.70105263403487 35.65906425602466, -82.70111863405933 35.65897725601363, -82.70126063411841 35.65874725598133, -82.7016696342958 35.65803925587889, -82.70171363431791 35.65794325586383, -82.70173363433493 35.657854255847795, -82.70172363436073 35.65767625581041, -82.70170463439202 35.65745325576298, -82.70167163442711 35.657189255705795, -82.7016036344757 35.6568012556197, -82.70159763448515 35.65673325560517, -82.7018896345119 35.65687525566412, -82.70212563453333 35.65699125571197, -82.70241563456054 35.657128255769685, -82.7026786345867 35.65724325582014, -82.70277763459768 35.657279255837736, -82.70292563461399 35.65733325586388, -82.70308763463412 35.65737825588971, -82.7032316346519 35.65741825591268, -82.70346463468323 35.657467255946514, -82.70369763471605 35.65750625597846, -82.70394863475384 35.65753225600953, -82.70424463480138 35.65754425604234, -82.704384634825 35.65754225605633, -82.70462463486766 35.65752525607751, -82.70465063487259 35.65752125607933, -82.70493463492608 35.65748125610034, -82.70500163493925 35.65746825610459, -82.70527363499325 35.65741225612105, -82.70538163501556 35.65738425612641, -82.70566063507275 35.657315256141025, -82.70651063524976 35.65708625618157, -82.70652163525189 35.65708425618229, -82.70688863532722 35.656992256201214, -82.70734763542072 35.65688225622592, -82.70744463544028 35.65686025623136, -82.70829463560769 35.65669325628454, -82.70874063569346 35.65661925631532, -82.70920763578329 35.65654225634749, -82.70931663580419 35.65652425635501, -82.70934863581031 35.6565192563573, -82.70964563586635 35.65647625637904, -82.7097556358871 35.65646125638726, -82.70999363593201 35.656427256404726, -82.71048963602671 35.656349256439825, -82.71064663605651 35.65632525645095, -82.71244663639733 35.65606125658197, -82.71269263644429 35.65602325659939, -82.71307063651606 35.65596625662665, -82.71342763658329 35.65591625665303, -82.71356363660921 35.65589525666277, -82.71397263668646 35.65583625669267, -82.71398163668819 35.655835256693415, -82.71410863671254 35.65581425670217, -82.71440763676982 35.65576625672305, -82.7144246367731 35.65576325672424, -82.71498863687877 35.6556882567668, -82.715378636953 35.65562825679459, -82.71542463696177 35.655621256797865, -82.71569663701278 35.65558425681824, -82.71574863702286 35.65557525682174, -82.71585463704305 35.65555925682933, -82.71590463705236 35.65555225683311, -82.71595763706239 35.65554525683708, -82.71644163715312 35.655480256873474, -82.71678963721762 35.655438256900645, -82.71711563727786 35.65540025692639, -82.71784263741078 35.655324256985494, -82.71929363767384 35.655187257106476, -82.71943263769901 35.6551742571181, -82.71973863775438 35.65514625714383, -82.72012963782464 35.65511325717719, -82.72054163789846 35.655080257212774, -82.72058763790662 35.6550772572169, -82.7208166379462 35.655068257238554, -82.72102763798134 35.65506825726025, -82.72133163802957 35.65508425729473, -82.72166563807907 35.65512425733711, -82.72177563809436 35.655144257352475, -82.7221446381454 35.65521225740423, -82.72218263815036 35.655221257409984, -82.72229263816479 35.655247257426595, -82.72237563817542 35.65526725743916, -82.72261963820536 35.6553372574785, -82.72267163821178 35.65535225748688, -82.72272763821805 35.65537225749678, -82.72298063824574 35.655466257541825, -82.72302263824994 35.655484257549865, -82.7233576382835 35.65562925761383, -82.72366663830914 35.65579725767982, -82.7238606383225 35.65592025772478, -82.72393063832729 35.65596525774118, -82.72411963833767 35.656102257788504, -82.7242106383427 35.65616825781137, -82.72436463834813 35.656299257853874, -82.72450763835322 35.6564212578934, -82.72483363835828 35.6567412579922, -82.72504363836042 35.656954258057226, -82.72526463836263 35.657179258125794, -82.72534663836352 35.657262258151114, -82.7255936383659 35.65751425822791, -82.72567663836668 35.65759925825373, -82.72587663836953 35.65779725831465, -82.72595563837051 35.657876258338874, -82.72615763837581 35.65806025839715, -82.7263226383824 35.65819625844186, -82.72646963839179 35.65829425847695, -82.72652963839629 35.65833025849048, -82.72661463840265 35.658381258509515, -82.72669963841017 35.658424258527056, -82.72678063841826 35.65845925854253, -82.72673163840659 35.65848225854217, -82.72670763840087 35.65849325854198, -82.72661363837844 35.658537258541315, -82.72649163835298 35.658570258535484, -82.72647963835053 35.65857325853492, -82.72640263833443 35.65859425853121, -82.72624863830397 35.658625258521745, -82.72599463825358 35.658677258506316, -82.72583263822037 35.65871725849782, -82.72578963821134 35.65872925849587, -82.72563963817942 35.65877425848966, -82.72562063817546 35.658779258488686, -82.7254566381381 35.65884425848515, -82.72533463810896 35.65890125848425, -82.72513763805942 35.659009258486044, -82.72473463795792 35.659232258490164, -82.72457063791714 35.65931925849113, -82.72414663780953 35.65955825849634, -82.72370263769878 35.65979625849934, -82.72367563769248 35.659808258499055, -82.72356763766618 35.6598622584989, -82.72342263763214 35.6599262584971, -82.72331863760647 35.65998025849742, -82.72318163757127 35.66006025849972, -82.7230146375295 35.66015025850093, -82.72293863750899 35.66020125850347, -82.72282063747942 35.66026525850446, -82.72274063745913 35.660310258505454, -82.7226096374254 35.66038725850771, -82.7221916373164 35.660642258516795, -82.72199463726504 35.660762258521046, -82.72179963721452 35.66087925852495, -82.72143763712096 35.6610942585316, -82.72140463711227 35.66111525853248, -82.72121263706278 35.661228258535864, -82.7210046370082 35.66135725854079, -82.72068263692479 35.66155025854713, -82.72038463684672 35.661734258554084, -82.72015563678723 35.66187225855876, -82.720041636757 35.66194525856195, -82.71987763671531 35.66203825856403, -82.71986863671293 35.66204425856435, -82.71934763657757 35.66235825857491, -82.71924963655279 35.66241325857609, -82.7189356364705 35.66260725858342, -82.7180706362479 35.66311525859829, -82.71774163616224 35.66331525860529, -82.71758463612156 35.663409258608354, -82.71735363605896 35.66356525861644, -82.71724063602642 35.66365425862297, -82.71714763599745 35.663741258631205, -82.71703863596191 35.66385425864303, -82.71687863590206 35.66406925867042, -82.71680863587375 35.664177258685285, -82.71673663584164 35.66430725870449, -82.71672663583664 35.664329258707866, -82.71663063578575 35.66455525874417, -82.71659263576204 35.66466825876329, -82.71641863566222 35.66512725883911, -82.71638963564394 35.66521425885382, -82.71625863556895 35.6655592589108, -82.71625563556769 35.665564258911495, -82.71618663552978 35.665735258939264, -82.71617963552308 35.66577125894589, -82.71604363544459 35.666133259005825, -82.7158046353063 35.66677125911142, -82.71575963527867 35.66690225913351, -82.7157136352403 35.667101259169364, -82.71570063521217 35.6672692592023, -82.71569863520614 35.66730625920967, -82.71568663514776 35.66767225928308, -82.71564963510004 35.66794125933421, -82.71561263507276 35.66807825935829, -82.71557363504996 35.66818425937596, -82.71551663502396 35.668291259391886, -82.71539363497325 35.66848725941922, -82.71508563485484 35.66892125947614, -82.7150266348301 35.669018259489874, -82.71494863479286 35.66917525951395, -82.71482263472143 35.66950225956767, -82.7147676346942 35.669619259585915, -82.7146256346366 35.669839259616204, -82.71422063449025 35.67035025967881, -82.71393963439216 35.670682259717715, -82.71385763436074 35.67079725973278, -82.71380663433904 35.67088325974509, -82.71377063431635 35.670991259763404, -82.71376563429871 35.67110025978513, -82.71378363428478 35.67121025980942, -82.71382963427683 35.67131125983469, -82.71388863427082 35.67141425986176, -82.71396863426268 35.67155325989835, -82.71405163424966 35.6717272599424, -82.71409563423511 35.67186925997585, -82.71411763421551 35.672020260008935, -82.71413563419046 35.6722022600479, -82.71413963416362 35.67238026008464, -82.71413263412445 35.67262726013434, -82.71411263409853 35.67277326016207, -82.71408463407707 35.67288226018138, -82.71406063406502 35.67293426018956, -82.71403363405156 35.67299226019861, -82.71403163405029 35.672998260199655, -82.71399363403614 35.67304926020611, -82.71396363402472 35.6730902602114, -82.71391663400897 35.67314226021725, -82.7138746339945 35.67319026022267, -82.71380363397016 35.67327126023187, -82.71373063394199 35.67337526024566, -82.71368063391799 35.6734762602611, -82.71365563389698 35.67358526028078, -82.71365363387741 35.673710260305995, -82.71366463386556 35.673799260325346, -82.7136686338614 35.67383026033205, -82.7138096337777 35.67452526048834, -82.71384263376119 35.6746682605209, -82.71387263375246 35.674757260542144, -82.71391363374588 35.674844260564065, -82.71440263370236 35.675655260779735, -82.71448563369505 35.67579226081619, -82.71454463368325 35.67593226085082, -82.71455963367053 35.67603126087254, -82.71456363365992 35.67610426088782, -82.714538633636 35.67623226091147, -82.71452563362479 35.67629126092212, -82.7145066336136 35.67634326093081, -82.71443263357848 35.676490260953145, -82.71432463353749 35.67663926097249, -82.7141606334813 35.67682626099374, -82.71412363346975 35.67686126099713, -82.71397463342247 35.67700626101138, -82.71366063332698 35.67728626103626, -82.71357663329879 35.6773782610464, -82.71350563327123 35.6774802610599, -82.71331963317364 35.67791126112876, -82.71308063303879 35.678527261229895, -82.71304563301798 35.67862426124605, -82.71280863287612 35.67928726135691, -82.71278063285993 35.67936226136934, -82.7127636328493 35.6794122613778, -82.71270063281163 35.67958826140723, -82.71267463279555 35.67966426142012, -82.71252963271138 35.68005326148451, -82.71247863267868 35.6802102615113, -82.71245663266419 35.68028026152339, -82.71233163259184 35.68061426157862, -82.71222263254123 35.68082426161027, -82.7121536325125 35.68093626162601, -82.71203663246683 35.68110526164848, -82.7118976324176 35.681274261668676, -82.71183163239522 35.68134826167697, -82.71174863236837 35.681432261685664, -82.71152263229932 35.681635261703875, -82.71146463227973 35.68169926171091, -82.71139163225338 35.68179126172221, -82.7113146322232 35.6819032617371, -82.71124663219483 35.68201426175286, -82.7111976321714 35.68211326176791, -82.71115663215184 35.68219526178048, -82.7111386321431 35.68223226178613, -82.7110836321187 35.682331261800755, -82.7110356320934 35.68244326181866, -82.71099963207432 35.68252826183229, -82.71099463207163 35.682540261834205, -82.71097763206046 35.68259426184345, -82.7109546320452 35.6826682618562, -82.71092763202414 35.68277526187528, -82.71092063201989 35.68279526187866, -82.71090163200638 35.68286226189031, -82.7108826319937 35.682924261901114, -82.7108426319657 35.68306226192506, -82.7108236319552 35.683109261932685, -82.71080063194204 35.683170261942834, -82.71078363193291 35.68321126194939, -82.71077763192908 35.68322926195245, -82.71073363190908 35.683311261964626, -82.71071863190437 35.68332526196598, -82.71068763189449 35.68335626196912, -82.7106136318712 35.68342726197596, -82.7104976318396 35.683506261980185, -82.71032063179295 35.68361726198466, -82.71014063174431 35.68373826199082, -82.7099766316984 35.68385826199851, -82.7098136316482 35.68400726201218, -82.70979263164162 35.684027262014034, -82.70976863163439 35.68404826201589, -82.7097586316293 35.68407026201933, -82.70973063161446 35.68413626202993, -82.70973163160092 35.68422526204815, -82.70974763159306 35.68429326206373, -82.70978563158084 35.68441326209204, -82.70984363156789 35.68456026212806, -82.70990763156112 35.6846732621577, -82.70998763155875 35.68477526218663, -82.71013263155821 35.68493526223422, -82.71026663155412 35.68510626228288, -82.71039263154427 35.68530626233658, -82.71048063153341 35.68547226237945, -82.71049963152295 35.68556026239941, -82.71049863151246 35.685627262413, -82.71047363149721 35.685699262425125, -82.71043163147823 35.68577626243652, -82.70986263126143 35.68656626253917, -82.70983363124536 35.686639262551125, -82.70980863122513 35.68674326256977, -82.7098066312104 35.686836262588564, -82.70981663119751 35.686930262608705, -82.70988463117403 35.687156262661844, -82.70989263117147 35.687181262667714, -82.7099116311603 35.68727426268868, -82.70991863113727 35.687431262721425, -82.70988663110197 35.68762526275765, -82.70976963103368 35.68794126281014, -82.7096706309855 35.68814626284175, -82.70961163095967 35.68825026285689, -82.70959963095517 35.688266262858924, -82.70956763094345 35.68830726286401, -82.70947363090825 35.68843326288006, -82.70944363089687 35.68847526288559, -82.70942363088969 35.688500262888596, -82.70938763087612 35.688549262894874, -82.70936363086776 35.688577262898185, -82.70934263086043 35.68860226290111, -82.70929263084281 35.688662262908174, -82.70883063066694 35.68930226299128, -82.708771630645 35.68938026300116, -82.70873163062991 35.6894352630083, -82.70864863059566 35.68956726302669, -82.70858263056304 35.68970726304841, -82.708519630511 35.689976263096796, -82.70848663048763 35.69009226311716, -82.70845563047148 35.6901632631284, -82.70841163045179 35.69024326314023, -82.7083676304343 35.69030926314918, -82.70827463039994 35.690431263164456, -82.70815063035583 35.690583263182745, -82.70801663030626 35.69075926320491, -82.70784063023892 35.69100526323699, -82.70745763010089 35.69148526329555, -82.70737363006893 35.69160126331054, -82.70732163004226 35.69171826332908, -82.70731763003991 35.69172926333092, -82.70728863002255 35.69181026334448, -82.70728763001976 35.69182726334783, -82.70728363000516 35.691917263365795, -82.70728862999489 35.69198926338099, -82.70733962997038 35.69220326342994, -82.70741662994814 35.692430263484106, -82.70750562993693 35.692599263527704, -82.70756562993519 35.692675263549425, -82.70760962993694 35.692711263561215, -82.70765562993985 35.69274226357228, -82.70770462994298 35.692775263584075, -82.70780562995425 35.692811263601826, -82.70782862995682 35.692819263605756, -82.70785962996061 35.69282826361079, -82.70791762996764 35.692845263620185, -82.70809862999198 35.692883263646614, -82.7082306300106 35.69290526366465, -82.70832563002466 35.69291626367662, -82.7085686300606 35.69294626370772, -82.70908263013966 35.69298926376935, -82.70974363024224 35.69303926384743, -82.70974463024233 35.693039263847595, -82.71006163028937 35.69307726388784, -82.71021563031081 35.69310526390945, -82.71038963033655 35.69312626393154, -82.7105696303643 35.69314126395311, -82.71075763039427 35.69315026397427, -82.71106763044536 35.69315426400694, -82.71143163050758 35.693144264042274, -82.71170063055591 35.693122264065416, -82.71177963057 35.69311626407242, -82.71210763062994 35.69308226409908, -82.71228363066174 35.693066264113945, -82.71250463069866 35.6930662641366, -82.71261863071413 35.69308926415307, -82.712702630724 35.6931162641672, -82.71277863073242 35.69314326418054, -82.713287630774 35.69342426429014, -82.71351863079421 35.693543264338125, -82.71369463080764 35.69364626437725, -82.71375563081128 35.69368826439212, -82.71389263081696 35.6937992644288, -82.71403063081762 35.69394426447253, -82.71409163081427 35.69403226449683, -82.71423663080965 35.6942182645496, -82.71430463080516 35.69432126457765, -82.71448763080075 35.69454726464253, -82.71470963079956 35.69479526471592, -82.71496063080204 35.695050264793736, -82.71526663080763 35.695344264885186, -82.71541863080893 35.695500264932626, -82.71552563080671 35.69563026497013, -82.71560163080122 35.695748265001995, -82.71566263079251 35.69587026503317, -82.71569363078241 35.69596926505659, -82.71570163077472 35.69602726506927, -82.71576263075148 35.6962442651198, -82.71579963074845 35.69630326513559, -82.71585663074349 35.6963972651606, -82.71610363075516 35.69658826522497, -82.71627763077153 35.69667026525955, -82.71635263077937 35.69670126527358, -82.71645663078989 35.69674526529327, -82.71672063082197 35.69682226533615, -82.7168106308342 35.69684026534906, -82.71686663084193 35.69685126535703, -82.71689163084515 35.69685726536081, -82.71701963086377 35.69687526537766, -82.7170376308672 35.69687226537892, -82.7170956308778 35.69686626538363, -82.71718463089435 35.69685526539051, -82.71721563090124 35.69684426539145, -82.71727063091346 35.696824265393055, -82.71734863093134 35.696793265394696, -82.71748363096165 35.696742265398164, -82.71804263109489 35.6964832654028, -82.71807563110262 35.696469265403316, -82.71820163113166 35.69641726540563, -82.71830763115507 35.696380265409, -82.71832163115894 35.69637026540839, -82.7184386311735 35.69640226542695, -82.71854363118655 35.696431265443714, -82.71873663120596 35.69651426548043, -82.71877463120796 35.6965422654901, -82.71882863121074 35.696582265503736, -82.71886163120949 35.69662626551611, -82.71889163120822 35.69666726552754, -82.71891363120719 35.696697265535946, -82.71893863119374 35.696811265561756, -82.71895063118808 35.696861265573226, -82.71895763118016 35.69692026558597, -82.71898063115631 35.697099265624864, -82.71898863114838 35.69715926563797, -82.71904863108458 35.69763726574159, -82.71907163106104 35.69781426578005, -82.71908363103611 35.697989265817014, -82.719090631005 35.698198265860405, -82.71910563096903 35.698447265912705, -82.71912663093805 35.6986702659604, -82.71915363091183 35.69886926600374, -82.71919163088637 35.69907526604973, -82.71919663088377 35.69909726605471, -82.71923863086467 35.69926626609348, -82.71931763083698 35.69953126615562, -82.71932063083604 35.69954026615783, -82.71934163083013 35.69960126617239, -82.71940463081314 35.699779266215195, -82.71940663081259 35.69978526621668, -82.71943063080714 35.699846266231525, -82.71943563080599 35.69985926623466, -82.71945063080251 35.69989826624421, -82.71945663080128 35.69991226624769, -82.71949963079138 35.7000232662748, -82.71950363079061 35.700032266276985, -82.71965063076621 35.700349266356774, -82.71966863076364 35.70038526636597, -82.71972663075529 35.70050226639585, -82.71976563074968 35.700580266415734, -82.71987663073628 35.70078726646942, -82.71989963073445 35.700823266479084, -82.7201156307191 35.70115626656924, -82.72016763070854 35.70128126660009, -82.72019463068587 35.70145726663875, -82.72018663066443 35.70158726666445, -82.72016963064426 35.70169926668554, -82.72012963061674 35.70183426670899, -82.72002763054553 35.7021852667701, -82.72002163054148 35.702205266773596, -82.72000563053186 35.70225026678113, -82.71993863049018 35.70244726681446, -82.71991663047635 35.702513266825626, -82.71986063044118 35.70268026685394, -82.71978663039533 35.7028972668906, -82.71959763027313 35.70348426699093, -82.71927463005612 35.70454026717322, -82.71926263004823 35.70457826717978, -82.71914862996424 35.7049992672539, -82.71912062994362 35.70510226727208, -82.71900762986895 35.70546326733409, -82.71891562982054 35.70567726736835, -82.71888962980692 35.70573726737785, -82.71867962970984 35.706139267438346, -82.71848962962778 35.706465267485335, -82.71841062959341 35.70660226750519, -82.7181396294729 35.70708926757663, -82.71798862940948 35.70733626761153, -82.71783562935141 35.707547267638866, -82.71764662929546 35.707705267651626, -82.71748062925167 35.707809267655826, -82.71708362915611 35.7079992676538, -82.71670962906101 35.70821126765858, -82.71660762903652 35.70825926765795, -82.71649462900915 35.708314267657535, -82.71630362896465 35.70839626765465, -82.71614262892949 35.70845026764912, -82.71598862889924 35.70847926763915, -82.71575262886161 35.70846826761267, -82.71491962874246 35.70833926750075, -82.71459562869619 35.70828926745726, -82.71440562866465 35.70828826743753, -82.71430162864746 35.70828726742656, -82.71406662860299 35.70832126740938, -82.71375562853288 35.708439267401516, -82.71349362846257 35.70861126740966, -82.71328362839093 35.7088482674364, -82.71304862828774 35.70926226749669, -82.7129496282392 35.70946926752883, -82.71266162809778 35.71007326762243, -82.71257362806 35.71022326764396, -82.71254462804741 35.71027326765118, -82.71243662800984 35.71039926766576, -82.71234362797713 35.71051126767903, -82.71216262792447 35.71065626769009, -82.71190162785975 35.71079326769118, -82.7118756278533 35.710807267691315, -82.71170162781078 35.71089426769119, -82.71163962779583 35.710924267690984, -82.71151562776522 35.71098826769127, -82.71145762775076 35.71101926769171, -82.7113986277357 35.71105326769254, -82.7112366276949 35.71114226769406, -82.71106762765199 35.71123726769608, -82.71074462757326 35.711398267695714, -82.7106156275416 35.71146326769568, -82.71057962753322 35.71147926769526, -82.71010862742257 35.71168626768905, -82.7101066274219 35.711688267689276, -82.70973362732973 35.71188226769054, -82.70945962725447 35.71207326770125, -82.70924062717873 35.71232726773055, -82.70906862712124 35.7125132677509, -82.70891362707641 35.71263626775998, -82.70885862706028 35.71268126776354, -82.70857062698562 35.712853267769006, -82.7084766269618 35.71290626777016, -82.70812362687242 35.713103267774116, -82.70781762679367 35.7132822677791, -82.70779062678652 35.71329926777976, -82.70760762673085 35.71346226779429, -82.70747162667631 35.7136682678223, -82.70732962659832 35.714019267879316, -82.70719462652067 35.71437626793828, -82.70708062646608 35.71460626797349, -82.70698062643267 35.71471426798524, -82.7068356263915 35.71482426799271, -82.7066226263427 35.714910267988344, -82.70645462630611 35.71496526798234, -82.70577362615758 35.71519126795843, -82.70573362614967 35.71519926795594, -82.70544162609218 35.715256267937505, -82.70543262609026 35.71525826793706, -82.70506162602612 35.71527326790197, -82.70455262595033 35.71521426783756, -82.7045286259466 35.71521226783472, -82.70425862590804 35.7151702677984, -82.70430562590569 35.71523626781671, -82.7044516259016 35.715420267869256, -82.70468362589503 35.71571326795285, -82.70492262589715 35.715957268027175, -82.70509062590034 35.71611826807733, -82.70531862590435 35.71633826814564, -82.70533262590456 35.71635226814992, -82.70564162590186 35.71670326825335, -82.70565962590233 35.716719268258394, -82.7060156259121 35.71704026836049, -82.7063956259364 35.71729326845117, -82.70665162595871 35.71742526850448, -82.7069396259894 35.71753726855688, -82.70694162598964 35.71753826855732, -82.70719962600579 35.71771226861932, -82.70731762600028 35.71787526866474, -82.70733862599928 35.71790426867282, -82.7073866259855 35.718045268706526, -82.707420625976 35.71814326873002, -82.70746662593267 35.718473268802, -82.70748562591793 35.71858926882765, -82.70751762589492 35.718772268868356, -82.70764862579654 35.71955026904049, -82.70775562577218 35.71982326910715, -82.70779462576861 35.71988826912445, -82.70791362575795 35.7200852691769, -82.70802762572967 35.72039126925101, -82.70804862571049 35.720538269283175, -82.70807362568854 35.72070726932022, -82.70811062564727 35.7210142693867, -82.70818962563712 35.721165269425605, -82.70834362564526 35.7212782694645, -82.70857762566969 35.72137326950793, -82.70876162568969 35.72144226954092, -82.70893062569682 35.72157826958609, -82.7091316256858 35.72186626966544, -82.7092966256737 35.72212326973486, -82.70943862564482 35.72246326981878, -82.70958762564058 35.7226512698725, -82.70963062563928 35.7227062698882, -82.70978862564593 35.7228332699303, -82.70993962566126 35.72289726995888, -82.71011062568812 35.72290826997875, -82.71033862574046 35.722815269983165, -82.71051462580036 35.72261826996108, -82.71054062580963 35.72258626995724, -82.71089462593454 35.72216026990672, -82.71108462599423 35.7219792698893, -82.71128262605606 35.72179326987174, -82.71151762613452 35.721539269844094, -82.71162562617054 35.721423269831504, -82.71206262633387 35.72083826975706, -82.71228362642509 35.72048726970826, -82.7125186265375 35.72001326963568, -82.71271362663022 35.719624269576414, -82.71280062666762 35.71947626955506, -82.71285462668439 35.71942626955049, -82.71292862669952 35.7194082695544, -82.71295862670438 35.719409269557715, -82.71298862670922 35.71941026956098, -82.71260062650937 35.720284269699384, -82.71204462624512 35.72139326986853, -82.71173662611146 35.72192526994541, -82.71172262610301 35.72196426995188, -82.71156462600673 35.72241627002786, -82.71129762586281 35.72305927013161, -82.71103862574385 35.72354927020493, -82.71087662567722 35.72380527024048, -82.71076862563285 35.72397527026406, -82.71073262560148 35.72413927029384, -82.71076862558219 35.72430327033098, -82.71086362556169 35.724538270388734, -82.71095762554603 35.7247412704398, -82.7110156255289 35.72491427048106, -82.71099562550434 35.72505127050697, -82.71091362547679 35.7251412705169, -82.71075262544284 35.725187270509764, -82.71046662539291 35.72520127048319, -82.7100006253138 35.72521027043708, -82.70956962523626 35.72524627040013, -82.70914962515413 35.72532427037281, -82.70899062511279 35.72541927037582, -82.70893662508963 35.72551127038909, -82.70890562503973 35.72580027044481, -82.70894662497594 35.72625727054229, -82.70902362495958 35.72644627058875, -82.70921062495812 35.72665727065106, -82.70937962496794 35.72677627069275, -82.70952962497952 35.726863270725936, -82.70978462501779 35.72689027075765, -82.71001562506275 35.726849270773016, -82.71036062514992 35.72665827076951, -82.71057162518723 35.72664427078837, -82.71085862523594 35.7266392708169, -82.710989625258 35.72663827083009, -82.71143262533727 35.72660327086851, -82.71191462541432 35.7266252709226, -82.71219662546042 35.72663127095281, -82.71269062553034 35.72671227102016, -82.71305762557948 35.72679027107381, -82.71334062562012 35.72683327111162, -82.71353462564198 35.72690127114547, -82.71365062564763 35.72699027117555, -82.71376062564782 35.72710727121072, -82.71378562563454 35.72722027123642, -82.7137556256097 35.7273482712594, -82.71342862546442 35.72793527134558, -82.71321562539984 35.72812227136178, -82.71295562533857 35.72823827135871, -82.71254462526235 35.72828727132653, -82.71173562513172 35.728259271237555, -82.71161462511263 35.72825227122371, -82.71120762504789 35.728231271177535, -82.71083662498198 35.72825727114471, -82.71051062491874 35.7283142711228, -82.71022062485243 35.72843027111662, -82.71007462480708 35.72856627112938, -82.71000562476785 35.72874527115884, -82.71000462474612 35.728884271187056, -82.71008362470128 35.72925927127175, -82.71024162466408 35.7296702713718, -82.7104186246418 35.73000527145837, -82.71072662461775 35.73049327158961, -82.71115762459036 35.73113527176488, -82.71132862458485 35.73135527182739, -82.712053624637 35.73180027199279, -82.71225862464495 35.731970272048486, -82.71240462463702 35.732179272106166, -82.71247862460525 35.732464272171924, -82.71245162456565 35.73269127221548, -82.71233262452085 35.73285227223608, -82.71214962447311 35.73296327223988, -82.71184662441651 35.733002272216666, -82.71109062429426 35.73297727213386, -82.7106016242213 35.73292127207207, -82.71028662418234 35.732833272021786, -82.71025562417843 35.73282527201698, -82.70962562411614 35.732548271895574, -82.70911962407327 35.732279271788705, -82.7089126240514 35.732197271750685, -82.70862662401231 35.73214127170991, -82.70818962394306 35.73211827166024, -82.70757762383889 35.73213127159991, -82.7074436238149 35.732141271588176, -82.70732562379386 35.73215027157786, -82.70718062376426 35.7321852715701, -82.707081623744 35.73220927156483, -82.70687662369198 35.732324271567194, -82.70651062358638 35.73261227158833, -82.70640062355442 35.73270027159495, -82.70629362352618 35.73276727159763, -82.70626262351796 35.73278727159854, -82.7060466234608 35.73292327160397, -82.70579962339552 35.73307927161042, -82.70569462336786 35.733144271612936, -82.70535462327773 35.73336027162198, -82.70484162314251 35.7336812716347, -82.70461062309296 35.733752271625484, -82.70452862307684 35.73376827162026, -82.70436662304428 35.733803271610725, -82.7037566229153 35.73397927158394, -82.70310762278348 35.73413127154814, -82.70211162259204 35.73429427147898, -82.7018366225343 35.7343712714664, -82.70138062243369 35.734529271451706, -82.70097762234607 35.73466127143716, -82.70059562226886 35.73474827141567, -82.70037262222759 35.734774271398045, -82.69997862216391 35.73476127135481, -82.69942062207885 35.734709271286825, -82.69870762197118 35.73463627119857, -82.69854362194633 35.734620271178414, -82.69789762184764 35.73456127109997, -82.69760662179876 35.734563271070364, -82.6972996217414 35.734603271046936, -82.69654162157983 35.734829271015144, -82.69650362157186 35.73484027101344, -82.6963926215483 35.73487327100881, -82.69635562154022 35.734885271007414, -82.69627162152231 35.73491027100393, -82.69618762150448 35.734935271000374, -82.69615462149788 35.73494227099834, -82.69607662148222 35.73495927099375, -82.69567862140981 35.73499827096079, -82.69553062138415 35.735004270946824, -82.69532262134797 35.735014270927465, -82.69531762134709 35.73501427092695, -82.69530362134479 35.7350142709255, -82.6952996213439 35.735015270925295, -82.69508562130919 35.73500927090204, -82.69494162128929 35.73498227088172, -82.69479062127196 35.73493127085576, -82.69473662127616 35.734846270832854, -82.69470762129772 35.73467527079503, -82.69469362135125 35.73431427071995, -82.69465162137932 35.73408827066948, -82.69458962138363 35.73399327064378, -82.69451062138009 35.73393127062302, -82.69440862136932 35.733890270604164, -82.6942736213495 35.7338732705868, -82.69402262130635 35.73388127056257, -82.69400862130358 35.733884270561745, -82.69383462126838 35.733924270551974, -82.69360362121569 35.73401527054681, -82.69334762115506 35.734131270544125, -82.69313562111111 35.73418727053376, -82.69292462107808 35.73417327050913, -82.6927016210521 35.734100270471366, -82.69237662102277 35.7339392704051, -82.69197362100343 35.73363027030054, -82.69183662101148 35.73343027024566, -82.69178262103061 35.73324827020299, -82.69180562105689 35.73310327017581, -82.69185562108967 35.73294527014873, -82.69201062114335 35.73276527012799, -82.69209362117894 35.73262527010792, -82.69212962121095 35.732457270077326, -82.69207762123193 35.732265270032876, -82.69178462127672 35.73166026987933, -82.69121262132394 35.73073826963235, -82.69095462132303 35.73046626955035, -82.69070562132057 35.73021326947315, -82.69064862132089 35.73015026945444, -82.69042062132182 35.729898269379525, -82.6900216213057 35.72957226927204, -82.68902062125586 35.728815269014675, -82.68878362124234 35.728647268956024, -82.68859462122843 35.72853326891332, -82.68843662121365 35.728458268881795, -82.68826262119057 35.72842026885608, -82.68805762116057 35.72839326882946, -82.68768362111815 35.72826426876466, -82.68733462108963 35.7280722686896, -82.6866056210383 35.72761826852206, -82.68655562103444 35.72758926851103, -82.68638162102073 35.72749026847294, -82.68567062095674 35.72713726832781, -82.68524762091337 35.726961268248324, -82.68505162088583 35.72692826822145, -82.68475162083425 35.726938268192654, -82.68435262075919 35.726993268162815, -82.68313262051319 35.72726826809338, -82.68278462044894 35.72730826806572, -82.68233762037518 35.72730326801878, -82.68195362031747 35.72726226797082, -82.68044862010908 35.72698726775993, -82.6798446200261 35.72687226767435, -82.67903261990877 35.72675526756693, -82.67844961982222 35.72668626749294, -82.67784161973198 35.72661426741569, -82.67740961966665 35.72657126736245, -82.67620761948105 35.72647526721918, -82.67591961944049 35.72642726717982, -82.67570161941771 35.726339267139394, -82.6757486194517 35.7261702671098, -82.67580761952529 35.7257582670318, -82.67590461956217 35.72562426701445, -82.67607461960233 35.72554826701649, -82.6770926197931 35.72541226709346, -82.67732061984222 35.72534026710221, -82.67751161988431 35.72527426710848, -82.67763861992282 35.72516226709869, -82.67763261994425 35.72501726706847, -82.67756261994387 35.724944267046425, -82.67745261993231 35.72490026702608, -82.67721261989838 35.72486126699346, -82.6769806198623 35.7248442669661, -82.67633761975851 35.72482226689552, -82.6762346197481 35.72477826687589, -82.67621661975683 35.7247022668586, -82.6762426197729 35.724626266845775, -82.67637061981164 35.72451426683606, -82.67742462016531 35.723364266709915, -82.67763762023178 35.723164266691036, -82.67790362030766 35.7229602666769, -82.67812162036165 35.72284626667601, -82.67841162041734 35.72279926669626, -82.67868262045904 35.72282126672864, -82.67978662061101 35.72302926688468, -82.68015962067277 35.72303226692358, -82.6804616207249 35.723020266952204, -82.68059862075381 35.72298126695833, -82.68070062077993 35.722922266956836, -82.68079362080807 35.72284026694965, -82.6808656208593 35.7225872669055, -82.68083462087267 35.72246726687777, -82.68078062087704 35.722381266854725, -82.68069562087115 35.72232726683499, -82.68046262084282 35.72225926679714, -82.68032762082481 35.72223026677729, -82.68008062079164 35.72217826674133, -82.67864562058118 35.721992266555745, -82.67769062045134 35.72180226641879, -82.67734962040912 35.721707266364305, -82.67720662039562 35.72164026633597, -82.6771206203979 35.72153326630526, -82.67711162042424 35.72135326626768, -82.67723362047069 35.72118426624576, -82.6774436205243 35.721064266242855, -82.67776562058589 35.72101326626556, -82.67807762063693 35.72101926629891, -82.67842562068844 35.72106126634326, -82.67881662073712 35.72116826640534, -82.67921662077875 35.721330266479505, -82.67954962081558 35.72145126653837, -82.67976462084724 35.72147826656603, -82.67999062088853 35.72145526658461, -82.68016662092555 35.72140526659253, -82.6802956209635 35.721299266584126, -82.68037862099547 35.72118226656886, -82.6803956210283 35.720988266531016, -82.6803066210383 35.72082726648907, -82.68010862103226 35.72065326643323, -82.67977862100648 35.72046426636064, -82.67899862094309 35.72003326619252, -82.6787736209294 35.719879266138015, -82.67854062092034 35.71968626607463, -82.67839962092407 35.71951026602424, -82.67829962094588 35.719261265963205, -82.67827462096679 35.71909926592759, -82.67828562099385 35.71893626589551, -82.67836362103225 35.71877226587011, -82.67848262106737 35.71867326586208, -82.67864562110432 35.71861026586605, -82.67884962114621 35.71855926587664, -82.67906362118602 35.71853226589313, -82.6793006212228 35.71855026592121, -82.67960362126716 35.7185902659605, -82.67977262128606 35.71865026599013, -82.67992862129437 35.71876426602942, -82.68012062130255 35.71891826608063, -82.6803256213226 35.719010266120435, -82.68053862135203 35.71904926615023, -82.68071862138417 35.71903526616593, -82.68090262142074 35.71899726617711, -82.68105762145824 35.71892226617781, -82.68115462148346 35.718863266175696, -82.68119062149924 35.718800266166575, -82.68116862150937 35.71871126614612, -82.6811026215112 35.71862826612245, -82.68073462150079 35.71829826601729, -82.68032262148725 35.717942265902295, -82.67959162146816 35.71727726569147, -82.67930662145335 35.717066265619145, -82.67906662142468 35.716992265579336, -82.6787626213832 35.716933265536014, -82.67833162131869 35.716885265481956, -82.67796562127378 35.71678126542308, -82.67742962121348 35.71659326532962, -82.67688762114724 35.71643726524199, -82.67657962112004 35.71628126517854, -82.67643262111699 35.71614226513508, -82.6764266211383 35.71599826510512, -82.67651262116928 35.71589026509191, -82.67673862122041 35.71580326509746, -82.67686262124393 35.71578526510649, -82.67733562133319 35.71571826514154, -82.67775962141621 35.715638265168835, -82.67799862146909 35.71555426517628, -82.67812762151145 35.715419265162, -82.6781846215513 35.715223265127946, -82.67822462158816 35.71502726509204, -82.6783656216362 35.71486926507437, -82.67853262168352 35.71474326506578, -82.67871862172369 35.71468326507266, -82.67891362176343 35.714637265083304, -82.67901962177802 35.71465726509829, -82.67929162180216 35.71479426515426, -82.67978462185668 35.71497326524145, -82.68046462195045 35.71510026533727, -82.68084262201201 35.71510926537797, -82.68111762206519 35.715062265396725, -82.68124862209936 35.714982265393864, -82.68128762211656 35.71491326538382, -82.68130562213706 35.71480026536259, -82.68127762214834 35.71469726533869, -82.68116262214657 35.71458426530386, -82.68088062212745 35.714404265238144, -82.68059062211432 35.71417626516182, -82.68040362211562 35.713966265099764, -82.68034562213688 35.71376626505299, -82.68038762216877 35.7136052650245, -82.68056962222659 35.71342726500688, -82.68087862230087 35.71328026500867, -82.68111562237165 35.71307826499189, -82.68113962238904 35.71299126497661, -82.68110562240338 35.71286226494676, -82.681002622401 35.712766264916624, -82.68074262237465 35.71265626486745, -82.68029062231612 35.71254726479877, -82.67983562225596 35.712446264731376, -82.67930462218177 35.71235326465782, -82.6786736220818 35.71231926458592, -82.6781926219976 35.712345264541746, -82.67781962193042 35.71237726450995, -82.67713362179673 35.712502264464895, -82.67690862175276 35.71254426445031, -82.67655962168777 35.71258826442337, -82.676226621634 35.71257726438687, -82.67604662161432 35.71251026435471, -82.6757736215994 35.71231226428627, -82.67549162160296 35.71198526419059, -82.67532362160878 35.71176626412864, -82.67520762162118 35.71156126407486, -82.67518662163049 35.711478264055785, -82.67518162164592 35.71137326403385, -82.67526262167502 35.71127226402163, -82.67540562170778 35.711214264024505, -82.6756196217533 35.71115126403369, -82.67595462180937 35.71114926406771, -82.67636462187653 35.71115726411157, -82.67677762194737 35.711144264151336, -82.67712162201 35.71111026417984, -82.6773946220644 35.711053264196245, -82.67753862210151 35.71096826419372, -82.67762262213144 35.7108652641814, -82.67764562215181 35.710758264161896, -82.67759962215943 35.71065926413693, -82.67747662215176 35.7105762641074, -82.67724062212619 35.71048726406498, -82.67681062207546 35.710351263992976, -82.67587862195612 35.71011826384962, -82.6756466219456 35.70993626378874, -82.67550562195439 35.7097272637316, -82.67548662196792 35.70961926370752, -82.67551362198598 35.70953126369241, -82.6756136220193 35.70942426368088, -82.67576462205447 35.70935926368313, -82.67588762207565 35.709355263695066, -82.6763056221326 35.70943726375466, -82.67683362220927 35.70951126382407, -82.67719362226599 35.70953226386541, -82.67745862231376 35.70950926388796, -82.67759862234725 35.709443263888886, -82.67766362237079 35.7093612638788, -82.67766362238376 35.70927726386173, -82.67762062239171 35.709179263837356, -82.67746262239324 35.70899926378439, -82.6770706223644 35.70876326369591, -82.6766206223151 35.708596263615625, -82.67648462230626 35.70850726358347, -82.67642462230407 35.70845626356687, -82.67634562230147 35.708388263544855, -82.67615462231896 35.70806926346016, -82.67613062232839 35.707982263440016, -82.67614662234539 35.70788926342268, -82.67621962237209 35.70779526341104, -82.67635662240357 35.70773926341362, -82.67656962244288 35.70771526343065, -82.6772206225463 35.70774826350437, -82.67733262257097 35.70770926350798, -82.6774176225967 35.70763426350134, -82.67744862263075 35.707447263466456, -82.67745562268347 35.70711426339926, -82.67747662270723 35.706983263374696, -82.67758962274368 35.706869263363025, -82.67798562286568 35.70650726332993, -82.67808262290075 35.70638526331504, -82.67811162291093 35.706350263310895, -82.67813062292832 35.706258263294096, -82.67810262293729 35.70617026327323, -82.6779656229305 35.70606626323797, -82.67782462291453 35.70601726321345, -82.67764562288919 35.70598826318915, -82.67743162285424 35.70598326316611, -82.67729062283107 35.70598126315118, -82.67720262281561 35.70598626314323, -82.67690562276378 35.70600126311572, -82.67649562268835 35.7060472630829, -82.67615462263184 35.70604526304747, -82.6756186225474 35.70601326298585, -82.67545662252037 35.706013262969215, -82.67520962247924 35.706013262943706, -82.67483162241425 35.70602626290754, -82.67435962232612 35.70608726287139, -82.67380762221941 35.70618226283403, -82.67343862215047 35.706230262805896, -82.67288562205998 35.70621926274677, -82.67277662204934 35.70617026272553, -82.67265862204331 35.70608226269546, -82.67254762204612 35.70594426265594, -82.67242062203981 35.705848262623306, -82.67222762202208 35.70575526258449, -82.67201362199161 35.70572126255554, -82.67186762196576 35.70573126254255, -82.6717046219318 35.70577526253479, -82.67141162186314 35.70590326253071, -82.67123662182989 35.70592926251805, -82.67104062180022 35.70591026249401, -82.6708436217765 35.70585126246174, -82.67050062174377 35.70569326239424, -82.67046862174121 35.70567526238727, -82.67037162173334 35.70562126236624, -82.67021962172106 35.705537262333486, -82.6699856216924 35.70547026229581, -82.66961662164228 35.705396262242786, -82.66943862162553 35.70531326220753, -82.66927462162909 35.70511326214987, -82.66899062162275 35.70484726206642, -82.66898262162256 35.70484026206422, -82.66896062162213 35.70481926205764, -82.6689536216219 35.7048132620557, -82.66889962160926 35.70483726205504, -82.66850962151703 35.70501326205077, -82.66824562145537 35.70512726204688, -82.66801662140183 35.70522626204356, -82.6678096213597 35.705276262032534, -82.66759662132327 35.70528226201176, -82.6674686213053 35.7052602619941, -82.667163621275 35.705127261935615, -82.66712362127203 35.705103261926624, -82.6670856212698 35.70507726191745, -82.66703962126593 35.705052261907646, -82.66692662125767 35.70498426188211, -82.66661962124498 35.70473526179982, -82.66654462124005 35.704686261782086, -82.66645762123142 35.704648261765335, -82.6663566212167 35.70463426175217, -82.6662616211989 35.704647261745, -82.66623762119448 35.704650261743126, -82.66602062114816 35.704715261734044, -82.66575662108077 35.70486726173794, -82.66554262101481 35.70506326175587, -82.66530962093093 35.705354261791236, -82.66506762083915 35.70568726183426, -82.66497162080677 35.70579326184597, -82.6649076207823 35.705882261857596, -82.66442762063245 35.706334261900345, -82.6643466206049 35.70642526191057, -82.66407762051074 35.70674426194796, -82.66402262049147 35.70680926195554, -82.66373362039685 35.707110261987225, -82.66362562036026 35.707230262000536, -82.66310662020616 35.70766726203629, -82.66304762018854 35.707717262040404, -82.66279962011983 35.707895262051224, -82.66264962008616 35.70795126204715, -82.66254762006554 35.70797426204137, -82.66228362001831 35.70799526201847, -82.66211861999096 35.70799426200129, -82.66196561996685 35.70798526198377, -82.66186861995354 35.70796726197009, -82.66177261994414 35.70792426195151, -82.6615276199244 35.70778826189854, -82.66138061990661 35.707744261874446, -82.66123961988635 35.70772326185565, -82.66116861987486 35.70772126184802, -82.661114619866 35.707720261842184, -82.6609456198399 35.707707261822165, -82.66079761982047 35.70767326179996, -82.6603976197707 35.70756426173664, -82.65977561969338 35.70739326163781, -82.65938061964812 35.70726026157005, -82.65920461962966 35.70719026153768, -82.65866461957943 35.70693326142982, -82.6581616195388 35.706654261321106, -82.65799861952661 35.70655726128461, -82.65779461950925 35.706449261241566, -82.65768961950431 35.706368261214294, -82.65762861950897 35.706272261188396, -82.65756861951257 35.70618426116428, -82.65751761951557 35.706110261143934, -82.65748961951833 35.70606226113133, -82.65733461953324 35.70579826106152, -82.65727961954194 35.70568326103245, -82.65723361954919 35.70558626100791, -82.65722261955283 35.705551260999634, -82.6572086195573 35.705507260989236, -82.65718661956431 35.705438260972905, -82.65718661957399 35.70537526096005, -82.6571866195751 35.70536826095862, -82.65719661958236 35.705332260952346, -82.65720961959131 35.70528826094469, -82.65728161962144 35.705171260928275, -82.6573676196535 35.70505626091364, -82.65740161966602 35.70501226090822, -82.6574876196959 35.70491126089644, -82.65754561972116 35.7048102608818, -82.65757261974227 35.704703260862765, -82.65757061975555 35.704615260844626, -82.65753961977045 35.70448526081486, -82.65744161979183 35.70424126075513, -82.65740261979676 35.704167260735964, -82.65730061981009 35.70397126068553, -82.65723961981323 35.70388526066175, -82.6571306198159 35.70375026062303, -82.65706561981746 35.70367026060005, -82.65691761981873 35.703502260550515, -82.65674961980471 35.70341226051496, -82.65659761979184 35.7033312604828, -82.65658261979058 35.703323260479614, -82.65630061976479 35.70318626042261, -82.65620561975733 35.703132260401865, -82.65619561975656 35.70312626039965, -82.65608261975187 35.70303526036941, -82.65599961975856 35.70290226033383, -82.65597361977679 35.70275626030142, -82.65596461984876 35.70228126020363, -82.65598261987765 35.70211326017123, -82.65598961990158 35.70196626014198, -82.65600961991422 35.701906260131764, -82.65611361997777 35.70160726008152, -82.6561246199983 35.70148626005791, -82.65612662000267 35.70146026005284, -82.65613962004922 35.701173259995684, -82.65613262007123 35.70102325996439, -82.65606862008482 35.700866259925796, -82.65600662009788 35.70071425988844, -82.65581262012688 35.70031825978776, -82.65565262014609 35.70002125971074, -82.65529862019731 35.699308259529, -82.65523462020828 35.699168259493845, -82.6552306202086 35.69916225949225, -82.65515562021697 35.69902725945701, -82.65507762022081 35.69891825942669, -82.65500362022043 35.698841259403444, -82.65493162021693 35.698786259384896, -82.65482862020808 35.6987322593632, -82.65479962020429 35.69872525935879, -82.65469662019117 35.69869925934289, -82.65456562017184 35.69868325932615, -82.65452362016482 35.69868325932182, -82.65440162014414 35.698685259309705, -82.65424062011614 35.69869325929483, -82.65408362008627 35.69871725928353, -82.65382262004005 35.69873525926035, -82.65368662001659 35.698740259247394, -82.65340761996814 35.698753259221384, -82.65336461996071 35.69875425921721, -82.65324261994306 35.69873725920115, -82.65323261994149 35.69873625919994, -82.6531116199233 35.69872425918502, -82.65309761992143 35.69872125918293, -82.6529736199042 35.698698259165546, -82.65283461988854 35.69865025914141, -82.65273361988109 35.69858925911859, -82.65269761987838 35.69856825911063, -82.65263561987545 35.69852025909442, -82.65259161987302 35.69848825908345, -82.65256461987411 35.698452259073264, -82.65250061987537 35.69837525905098, -82.65249661987576 35.698368259049204, -82.65241761988287 35.698237259014384, -82.6523546198928 35.69810525898097, -82.65230861990523 35.69797525894971, -82.65230561990764 35.69795625894552, -82.65228361992672 35.69780925891344, -82.65228361992718 35.697806258912706, -82.6522806199752 35.69749225884836, -82.65229361999656 35.69736825882445, -82.65230762002975 35.69716825878514, -82.6523286200789 35.69687325872712, -82.65237762014054 35.69652725866161, -82.65241162017462 35.69634325862766, -82.652486620241 35.69599425856423, -82.65261562033125 35.695549258486686, -82.65270362038414 35.69530225844541, -82.65272862039899 35.69523325843394, -82.6527816204258 35.69511725841574, -82.65290762049327 35.69481625836731, -82.65295562051666 35.69471625835192, -82.65302162054789 35.69458525833196, -82.65309662058036 35.6944562583135, -82.65310662058431 35.694441258311365, -82.65318462062108 35.69428725828804, -82.65328362066376 35.694118258263735, -82.65349562075133 35.69378025821658, -82.65353962077285 35.693688258202364, -82.65356862078683 35.69362925819333, -82.6536846208369 35.6934302581647, -82.65372862085597 35.69335425815377, -82.65374862086706 35.693304258145574, -82.65386062092765 35.69303225810164, -82.65390362095341 35.69291225808158, -82.65390862095605 35.69290025807966, -82.65395562098226 35.69278125806025, -82.65406962104606 35.69249125801282, -82.65410962107248 35.69236325799088, -82.65417862111074 35.69219025796271, -82.65419462111936 35.69215225795658, -82.65426362117516 35.691865257905235, -82.65433362122778 35.691600257858354, -82.6544406212828 35.69135925782027, -82.6545236213161 35.69123325780309, -82.65459462134325 35.69113425779019, -82.65496662146327 35.690758257751796, -82.65506562149407 35.6906662577432, -82.65511762151304 35.690599257734895, -82.6552216215506 35.69046825771888, -82.65525762156757 35.690397257708135, -82.65534962162072 35.690152257667634, -82.65538462164479 35.69003425764721, -82.65540362165834 35.68996725763548, -82.6554616216986 35.68976925760111, -82.65548162171214 35.689703257589684, -82.65552662173998 35.68957125756742, -82.65553262174365 35.689554257564595, -82.65559462177835 35.68939625753874, -82.6556786218192 35.68922225751188, -82.65569562182718 35.689189257506875, -82.65574262184809 35.689104257494364, -82.65577162185758 35.6890742574913, -82.65578462186186 35.689060257489714, -82.65579562186535 35.68905025748888, -82.65581962187497 35.68901325748376, -82.65583062187932 35.68899725748158, -82.65595362192111 35.68885925746618, -82.6559616219239 35.68885025746518, -82.65611362197144 35.688706257451415, -82.65636662205455 35.68844125742342, -82.65637362205767 35.68842825742153, -82.6564376220836 35.688329257407844, -82.6564846221012 35.688266257399846, -82.65654862212484 35.68818225738936, -82.65664362216212 35.68804325737077, -82.65677462221329 35.68785325734543, -82.65697462230766 35.68745825728544, -82.65700862233558 35.68731425725962, -82.65702662234948 35.687243257247026, -82.65708662238903 35.68705225721427, -82.6571296224176 35.6869132571903, -82.65714262242798 35.68686025718084, -82.65728562253506 35.68632125708567, -82.65729362254243 35.686282257078574, -82.65733962258007 35.686088257043714, -82.65726662256206 35.68612625704399, -82.65720062254393 35.68617225704664, -82.65704762250161 35.68628125705306, -82.65680862243445 35.68645825706456, -82.65676962242331 35.68648825706669, -82.65667662239795 35.68655225707018, -82.6565256223566 35.686657257076064, -82.65646262233918 35.68670225707872, -82.65631662229846 35.68680825708537, -82.65583462216718 35.68713825710304, -82.65581962216308 35.68714825710354, -82.65560662210427 35.68729925711244, -82.65549162207273 35.687379257116916, -82.65528162201483 35.68752825712575, -82.65515162197859 35.68762225713149, -82.65505762195231 35.68769125713589, -82.65503862194704 35.68770425713666, -82.654818621887 35.68785625714495, -82.65468762185058 35.68795025715062, -82.65458562182205 35.68802525715547, -82.65419362171986 35.6882642571639, -82.65399962167444 35.6883492571613, -82.65382362163399 35.68842125715785, -82.65365262159555 35.688485257153324, -82.65354162157303 35.68851125714716, -82.65312662148816 35.6886132571253, -82.65307862149082 35.68854425710631, -82.65303962150672 35.68839925707276, -82.65303262152385 35.68828125704798, -82.65303162152414 35.688278257047294, -82.65301062159539 35.68779425694643, -82.65298262161355 35.68764625691341, -82.65292362163174 35.687465256870475, -82.65284762164502 35.687297256828366, -82.65281962164794 35.68724825681548, -82.65274262165613 35.68711225677987, -82.65262962166109 35.686958256736894, -82.652624621661 35.68695325673526, -82.65256262166038 35.68689025671608, -82.6523896216575 35.68672225666409, -82.65216862164753 35.68654925660612, -82.65213362164602 35.6865212565968, -82.6518206216277 35.68630225651998, -82.65125962159937 35.68588025637626, -82.65095362158262 35.68565925629976, -82.65068062156351 35.6854882562368, -82.65067862156334 35.68548725623635, -82.65053662155248 35.68540425620489, -82.65039562154513 35.685300256169135, -82.65023862154007 35.685163256125115, -82.65019762153958 35.685122256112564, -82.65009962153904 35.68502025608167, -82.64997762154128 35.684874256039365, -82.6498826215463 35.68473925600209, -82.64981962154971 35.68464925597727, -82.64962562156163 35.68436325589901, -82.64941362157457 35.68405025581339, -82.64921362158226 35.68378525573878, -82.6491286215903 35.68364125570072, -82.64904362159625 35.68351125566548, -82.64902662159741 35.683485255658425, -82.6488986216085 35.68327525560246, -82.64879062161994 35.68308525555261, -82.64877862162112 35.683064255547144, -82.64871062163063 35.68292925551263, -82.64867562164571 35.68279425548151, -82.64867562164618 35.68279125548091, -82.64865362173792 35.68217325535261, -82.64863862175966 35.68201625531909, -82.64861562178116 35.681852255283246, -82.64860962178746 35.68180525527312, -82.64856362180677 35.68163025523273, -82.64853162181366 35.681551255213314, -82.6484706218264 35.681403255176875, -82.64837262184247 35.68119325512403, -82.64832562185796 35.68104225508833, -82.64830662188031 35.680877255052806, -82.64829662190199 35.680726255021035, -82.64829962191189 35.680665255008826, -82.64830862194042 35.680490254974096, -82.6483496219951 35.68018025491516, -82.64845262209383 35.67965225481809, -82.64847562212083 35.67950225478987, -82.64846862213713 35.67938925476618, -82.64841662214789 35.67926325473506, -82.64827362215523 35.67906125467922, -82.64807662216167 35.67880725460718, -82.64783562216785 35.678507254521264, -82.64767862217573 35.67828725446031, -82.64761562218348 35.678169254429775, -82.64757162218895 35.6780862544083, -82.64750862219974 35.67794825437377, -82.64747262221225 35.6778282543456, -82.64745562222875 35.67770325431836, -82.6474556222305 35.67769225431615, -82.64746062225039 35.67756825429134, -82.64747062226802 35.67746525427133, -82.64745762228247 35.67735725424804, -82.64742862228975 35.67727925422917, -82.64742162229135 35.67726125422478, -82.6474166222913 35.67725625422327, -82.64736662229225 35.67719625420588, -82.6473506222925 35.677177254200295, -82.64719162229507 35.67698925414565, -82.64708762229812 35.67685725410805, -82.64700062230476 35.676720254071235, -82.64693662231379 35.676592254038574, -82.64682462233522 35.676333253974185, -82.64681462233746 35.67630825396812, -82.64669462236438 35.67600425389379, -82.64641562241613 35.67536825373548, -82.64633862242532 35.67522525369839, -82.64622562242255 35.67512125366559, -82.64609062241382 35.67503225363356, -82.64594962240146 35.67496025360439, -82.6457466223768 35.674901253571555, -82.64543962233701 35.67482825352511, -82.64503262228644 35.67471625346042, -82.64488362226963 35.674664253434514, -82.64468962225047 35.67457925339721, -82.64467362224894 35.674572253394174, -82.64449462223297 35.674482253357404, -82.64435262222122 35.67440525332708, -82.64410062219888 35.674278253275325, -82.64392862218214 35.674201253241925, -82.6437886221672 35.67414725321652, -82.64340262211918 35.674041253155266, -82.64339362211824 35.674038253153704, -82.6430816220786 35.67395825310533, -82.64284762205014 35.673890253067476, -82.64266362202909 35.6738282530359, -82.64228762198334 35.67371925297504, -82.64221262197161 35.67371425296627, -82.64219262196842 35.67371325296406, -82.64210162195295 35.673715252955134, -82.64196062192778 35.673726252942835, -82.64183162190179 35.67375525293547, -82.64180862189677 35.67376325293476, -82.6415356218375 35.673852252924775, -82.64149562182864 35.67386725292377, -82.64118162175737 35.67399025291656, -82.64098562171431 35.67405725291011, -82.64080962167652 35.6741122529032, -82.64061362163709 35.67415625289197, -82.64055362162622 35.67416225288703, -82.64029862157928 35.67419125286672, -82.64022562156681 35.67419325285964, -82.64006862154001 35.67419725284427, -82.63976862148485 35.67423125282038, -82.63957562144687 35.674269252808294, -82.63913162135486 35.67438625278653, -82.63876862127603 35.67450525277343, -82.63850862121758 35.67460325276671, -82.63850662121715 35.67460425276672, -82.63826262115468 35.67474525277037, -82.63806462110153 35.67487625277667, -82.63779462102232 35.675098252794136, -82.63764662098298 35.67519325279834, -82.63741362092718 35.67530325279677, -82.63708962085178 35.67544225279183, -82.63675962077774 35.67556625278309, -82.63667462075905 35.67559525278037, -82.63659662074191 35.675622252777835, -82.63656162073578 35.675624252774625, -82.63643762071456 35.67562825276272, -82.63633862070148 35.675606252748054, -82.63626262069587 35.67556025273079, -82.63618662069204 35.675503252711366, -82.63614562069813 35.67541925269009, -82.6361026207152 35.67526225265364, -82.63593262076472 35.67475825253347, -82.63581462079189 35.67445525245961, -82.63574362080388 35.67430125242095, -82.63558962083519 35.67393225232986, -82.63549962086861 35.67361925225679, -82.63545962088996 35.67343725221558, -82.63524962092528 35.67298225210125, -82.63522262092991 35.67292325208653, -82.6351896209434 35.672800252058074, -82.6351526209536 35.67269425203262, -82.63511262095749 35.67262625201464, -82.63508262095849 35.67258725200362, -82.63498562095502 35.6725052519769, -82.63464362093532 35.67226425189265, -82.63449462093148 35.67212825184964, -82.63432362092341 35.67199625180516, -82.63401162090453 35.67178225172947, -82.63400162091986 35.67167225170601, -82.63399362092267 35.671645251699616, -82.63393462094648 35.67142725164922, -82.6338816209655 35.671247251607085, -82.63384262097938 35.671115251576126, -82.63369162103014 35.67062325146034, -82.6336596210394 35.67052925143793, -82.63348062109299 35.66998925130943, -82.63343462110852 35.66983825127396, -82.63341262112651 35.66969825124319, -82.63342662114559 35.66959025122264, -82.63346362116788 35.669485251205, -82.63350762118525 35.669420251196286, -82.6335756212067 35.66935525119002, -82.63365762122802 35.66930525118827, -82.63384962127392 35.669215251189655, -82.63392562129336 35.66917125118853, -82.6339876213112 35.66912225118494, -82.6340486213298 35.66906725117996, -82.63406162133474 35.66904925117761, -82.6341166213552 35.668976251168374, -82.63418162138288 35.66886725115283, -82.6343566214666 35.66851325109875, -82.63439562148551 35.66843325108639, -82.63440962149184 35.66840725108253, -82.63450562154095 35.66819225104864, -82.63450862154244 35.6681862510477, -82.63453762155899 35.66811025103517, -82.63455362156795 35.66806925102845, -82.63458762158969 35.66796525101076, -82.6346336216293 35.66775825097331, -82.63463362162996 35.667754250972465, -82.63466362166764 35.6675422509324, -82.63468162170363 35.6673282508906, -82.63468462172051 35.66722225086933, -82.6346786217393 35.66709425084262, -82.63463962175754 35.66693425080604, -82.63459762176869 35.66681625077763, -82.63453062177919 35.66667625074221, -82.63452762177971 35.666669250740554, -82.63442062180603 35.666383250671174, -82.63440462181158 35.666330250658746)))",6352,37,021,002604,370210026041,3169,3169,85,3118,2977,27,21,54,3,36,51,2490,60,2430,2454,2341,17,16,52,2,26,36,1369,1238,131
census_2010_blockgroups_view.fid--2dc29038_13ec899ba8f_-25c5,"MULTIPOLYGON (((-82.62303263478363 35.56981622982672, -82.62341863489924 35.56948122979802, -82.62384163502908 35.56909322976239, -82.6238566350335 35.56908122976151, -82.6241976351389 35.568764229731855, -82.62465963528233 35.568330229690815, -82.6250306353908 35.568025229666766, -82.62534763548828 35.56773422964, -82.6258106356354 35.56727722959438, -82.62613663574753 35.56690022955104, -82.62616663576337 35.56682922953964, -82.62619663577867 35.56676222952905, -82.6262496358104 35.56661322950416, -82.62629663584386 35.566446229475005, -82.62640063592072 35.56605822940657, -82.62645263597139 35.56578522935634, -82.62651363598978 35.565731229351556, -82.62669863604542 35.56556922933751, -82.62676063606385 35.56551622933306, -82.62688263610055 35.565409229323805, -82.62724863621051 35.56508922929618, -82.62737163624733 35.564983229287165, -82.62756363626171 35.565097229330114, -82.62761763626472 35.565136229343615, -82.62788063627927 35.56532622940925, -82.62824363629711 35.565602229502694, -82.62831663630035 35.56566022952206, -82.62845963630687 35.56577322955973, -82.62854163630938 35.56584522958279, -82.62856563630994 35.56586722958975, -82.62878563631341 35.56608322965632, -82.62879063631375 35.56608622965743, -82.62892263632142 35.56617922968992, -82.62896163631609 35.56625622970957, -82.62911563630715 35.56648122977124, -82.62919263630407 35.56658422980004, -82.62925163630464 35.56664422981834, -82.62943063631369 35.566779229864196, -82.62949463631573 35.56683522988219, -82.6296546363205 35.566977229927524, -82.62976063632543 35.56706022995531, -82.62976163632621 35.56705622995459, -82.62980563633782 35.567028229953365, -82.62987063634937 35.567023229959055, -82.62999363636658 35.56704422997593, -82.62999663636707 35.56704422997623, -82.63064363646146 35.56713023006015, -82.63073863647509 35.56714423007272, -82.6309856365102 35.567183230106075, -82.63119063653919 35.56721623013377, -82.63125163654779 35.56722623014201, -82.63152463658516 35.56727823018062, -82.63159363659513 35.56728823018968, -82.63165263660511 35.56728723019558, -82.63171063661623 35.56727723019954, -82.6318056366365 35.5672482302033, -82.632005636679 35.56718823021161, -82.63212463670291 35.56716123021829, -82.63221463672093 35.56714123022349, -82.63248963677212 35.56710523024434, -82.6325206367778 35.56710223024691, -82.63260963679615 35.56707923025137, -82.63268863681233 35.567059230255445, -82.6326956368136 35.56705823025583, -82.63282563683651 35.56705023026754, -82.63293463685426 35.56705223027917, -82.6329506368568 35.567053230281005, -82.63301663686622 35.56706323028978, -82.6335746369403 35.56718523037185, -82.63419863701223 35.56739223047801, -82.63445663704186 35.56747823052204, -82.63470463706915 35.56756923056596, -82.63481763708057 35.56761723058733, -82.63490963708983 35.56765623060474, -82.63513763711042 35.56776923065114, -82.6353776371293 35.56790623070366, -82.63617063718561 35.56839723088501, -82.63651563721142 35.568603230962374, -82.63666863722548 35.56867723099317, -82.63682363724128 35.56874223102222, -82.6369916372602 35.568801231051516, -82.63718863728351 35.56886223108415, -82.63747163731861 35.56894023112903, -82.6375196373248 35.568952231136485, -82.63774563735342 35.56901023117143, -82.63801063738578 35.56908623121407, -82.63815863740325 35.569133231238794, -82.63827063741465 35.569180231259864, -82.6384056374269 35.56924623128716, -82.63866363744812 35.5693872313424, -82.63887463746575 35.56950123138726, -82.63949163751688 35.56983623151872, -82.63950863751845 35.56984423152211, -82.63972263753693 35.56995523156664, -82.63989763755382 35.57003523160093, -82.64014563757759 35.570148231649405, -82.64042863760584 35.570271231703465, -82.6404446376074 35.57027823170656, -82.64060963762539 35.570340231736054, -82.64070063763522 35.57037423175233, -82.64081963765061 35.57040323177045, -82.64087363765738 35.57041723177882, -82.64104463768336 35.570433231799605, -82.6412956377262 35.57042623182393, -82.64147663776045 35.57039923183702, -82.64154563777348 35.570389231842015, -82.64168763780489 35.570338231846186, -82.64169563780025 35.570377231855, -82.6417196377863 35.570494231881284, -82.64172763778146 35.57053423189022, -82.64174063776645 35.57064623191444, -82.64175163775414 35.5707382319343, -82.6417756377323 35.57090623197097, -82.64178263772168 35.570983231987356, -82.64179463770628 35.5710962320116, -82.64180963766127 35.57140523207612, -82.64182363764047 35.5715562321083, -82.64184163761655 35.57173123214584, -82.64185163759873 35.57185823217268, -82.64187463755748 35.57215123223476, -82.64188763750892 35.57248123230333, -82.64191663746723 35.57278423236801, -82.64192563744541 35.57293623239995, -82.6419346374248 35.57308023243019, -82.6419606373804 35.573397232497484, -82.64198063734544 35.57364623255024, -82.64201463728841 35.57405423263689, -82.6420226372575 35.5742642326805, -82.64203263723886 35.57439623270839, -82.64203663723174 35.57444723271924, -82.6420366372052 35.57461923275425, -82.64203263720032 35.57464723275956, -82.64201863718462 35.57473423277591, -82.6419976371713 35.574798232786684, -82.64195063715341 35.57486323279512, -82.64183763711843 35.57496923280513, -82.64159863705005 35.57515523281849, -82.64145963700665 35.57528723283118, -82.6414166369885 35.575359232841485, -82.64140063697965 35.575399232847985, -82.64138063696761 35.57545523285728, -82.64136863694958 35.575560232877436, -82.641382636925 35.57573523291462, -82.64145963689666 35.5760032329771, -82.64154463687284 35.57625023303614, -82.6415776368544 35.57640623307125, -82.64157763684041 35.57649723308976, -82.64155763682245 35.576592233107085, -82.64152463680358 35.57667923312147, -82.64148263678403 35.57676123313391, -82.64140363675708 35.576851233144076, -82.6412846367244 35.57693523314899, -82.64110863668307 35.577013233146815, -82.64081863662035 35.577107233136246, -82.64066363658847 35.57714723312853, -82.64053063656294 35.57716923311934, -82.64042563654496 35.57717323310938, -82.6403206365288 35.57716423309682, -82.6402006365122 35.57714223308004, -82.64005863649459 35.5771032330575, -82.63997963648642 35.57707123304288, -82.63992763648078 35.57705123303352, -82.6396866364592 35.57693123298429, -82.63959563644974 35.576894232967405, -82.6394916364359 35.57687223295232, -82.63935963641408 35.57687123293858, -82.63926763639641 35.576886232932196, -82.63917263637619 35.57691523292836, -82.63905663634887 35.57696723292704, -82.63903063634227 35.57698223292745, -82.6388006362847 35.57710823292948, -82.63867063625462 35.57716323292733, -82.63857163623346 35.57719323292333, -82.63847163621394 35.57721223291691, -82.63833863619003 35.577224232905714, -82.63820263616756 35.57722323289161, -82.63811963615436 35.57721923288227, -82.63798063613217 35.577213232866804, -82.63780763610616 35.57719523284535, -82.63735663604089 35.57713223278628, -82.63726563602835 35.57711523277349, -82.63717563601749 35.5770882327587, -82.63682763597816 35.576967232698415, -82.63643363593178 35.57684323263268, -82.63628663591537 35.576791232607064, -82.63598763588661 35.5766542325485, -82.6356926358604 35.57650523248781, -82.63549463584711 35.576378232441684, -82.6354116358408 35.57632923242321, -82.63538463583865 35.576314232417324, -82.63526563582641 35.57626523239518, -82.63513363580871 35.576237232375924, -82.63501163578935 35.576231232362176, -82.63486763576124 35.57625823235288, -82.63477163573918 35.57629823235119, -82.63466663571135 35.57636523235405, -82.63454863567337 35.57648523236647, -82.63445363563775 35.57661423238301, -82.63443363563027 35.57664123238642, -82.63431563558417 35.576813232409364, -82.634209635538 35.57699923243643, -82.63415663550614 35.57714923246151, -82.63415563550517 35.57715423246248, -82.63413463548243 35.57727923248578, -82.63412763547174 35.57734123249764, -82.63411063544757 35.57748023252428, -82.63408263537899 35.57789623260614, -82.63407363535605 35.57803623263368, -82.63406663533904 35.578139232653996, -82.63406463533332 35.5781742326609, -82.63402863529976 35.57835323269362, -82.63399663528112 35.57844023270816, -82.63399463527952 35.57844823270952, -82.63394663525877 35.578531232721545, -82.63394263525686 35.57853923272274, -82.63385563522594 35.578646232735636, -82.63368163517352 35.578799232748985, -82.63352263512547 35.57894023276139, -82.63282063491677 35.57953823281125, -82.63253363483125 35.57978423283184, -82.63250763482372 35.57980523283349, -82.6324336348016 35.57986923283897, -82.63240863479405 35.5798912328408, -82.63223263474168 35.58004123285333, -82.63184163462532 35.580375232881366, -82.63170163458487 35.580487232889766, -82.63164263456751 35.58053623289371, -82.63152463453265 35.5806352329017, -82.63132763447439 35.580801232915356, -82.63102763438626 35.58105023293526, -82.63048363422494 35.581511232973455, -82.63025463415887 35.581693232986986, -82.63009163411301 35.581815232995126, -82.62971063400633 35.58209723301355, -82.62930763389473 35.58238723303121, -82.62910963384002 35.58252923303987, -82.62874163373793 35.58279523305627, -82.62865163372628 35.58277323304252, -82.62863163372343 35.58277023303987, -82.62840463369399 35.58271623300561, -82.62836463368879 35.582707232999645, -82.62756063358185 35.58253323288177, -82.62729363354616 35.582476232842765, -82.6269266334955 35.58240923279143, -82.62687263348792 35.58240023278406, -82.6266426334547 35.58236723275374, -82.62628963340272 35.58232323270861, -82.62607363336991 35.582303232682385, -82.62583763333404 35.58228123265369, -82.62581563333072 35.58227923265093, -82.62554463328877 35.58225923261904, -82.62546263327602 35.58225323260943, -82.62544463327337 35.58225123260723, -82.62543063327129 35.58224923260535, -82.62539063326525 35.582245232600386, -82.6253776332633 35.58224423259891, -82.62527163324752 35.582232232585625, -82.62522863324108 35.582227232580145, -82.62510163322371 35.58220323256226, -82.62500363321185 35.582174232546315, -82.62496363320707 35.58216223253971, -82.62491063320051 35.58214723253126, -82.6248646331962 35.582126232522235, -82.62478663318858 35.58209123250707, -82.62477663318764 35.582086232505056, -82.6246846331799 35.582037232485625, -82.62453363317061 35.581934232449214, -82.6244546331658 35.58188023243005, -82.6243406331593 35.58179923240184, -82.6239986331393 35.58155923231787, -82.62388563313273 35.58148023229021, -82.62384463313029 35.58145123228006, -82.62372163312278 35.581367232250315, -82.62368163312047 35.58133923224051, -82.62351563311017 35.5812262322005, -82.62341363310308 35.58116223217702, -82.62336463309938 35.58113323216604, -82.62318463308554 35.58102923212645, -82.62303363307157 35.58095623209604, -82.62268463303805 35.58079723202786, -82.62234263300395 35.580649231962646, -82.62218063298774 35.580579231931765, -82.62199563296886 35.5805022318971, -82.62190363295848 35.580470231881144, -82.62178463294379 35.58043723186216, -82.62174863293872 35.58043123185727, -82.62169463293083 35.58042423185028, -82.6215766329126 35.580415231836355, -82.62143863288932 35.58041723182262, -82.62127163285905 35.58043323180873, -82.62105963281958 35.58046123179271, -82.62098263280507 35.580472231787084, -82.62072963275712 35.58051023176882, -82.62030463267679 35.580573231738015, -82.61998163261573 35.58062123171463, -82.61902963243661 35.580757231644725, -82.61895063242173 35.58076823163885, -82.61860563235675 35.580818231613634, -82.61847963233299 35.580836231604366, -82.61823463228811 35.58086323158475, -82.61810263226378 35.58087923157441, -82.61767963218789 35.58091523153839, -82.61726263211462 35.58094123150087, -82.61711863209008 35.580945231486915, -82.61688763205055 35.58095223146467, -82.6167456320266 35.58095423145052, -82.61655063199474 35.580951231429864, -82.61596763189903 35.58094323136841, -82.6157736318671 35.58094123134807, -82.61568863185316 35.5809402313392, -82.61550863182347 35.580938231320246, -82.61471363169247 35.58093123123729, -82.6144486316487 35.58092923120967, -82.61392863156297 35.580924231155315, -82.61388063155502 35.5809242311504, -82.61337763147255 35.58091723109738, -82.61261663134654 35.5809142310187, -82.61237163130622 35.58091123099289, -82.61185263122064 35.58090723093883, -82.61172963120046 35.58090523092581, -82.61136063113962 35.580902230887325, -82.61133063113462 35.58090223088427, -82.61123863111996 35.58089823087404, -82.61126463124086 35.58014023072228, -82.61126463124438 35.5801172307176, -82.61127863137456 35.57928523054955, -82.6113056314559 35.578785230450535, -82.61138263154757 35.57827223035389, -82.61146063160301 35.57799623030571, -82.6115296316442 35.57780323027352, -82.61155863166107 35.577724230260415, -82.61177263176124 35.57730423019676, -82.61189263181053 35.57711323017018, -82.61219663191807 35.576742230125845, -82.61227163194292 35.57666223011724, -82.61244063199834 35.57648423009829, -82.61266463206658 35.576282230080146, -82.6130116321653 35.57601523006137, -82.6133956322637 35.57579023005492, -82.61368963233829 35.57562323005112, -82.61420363246805 35.575334230044916, -82.61423663247776 35.57530723004287, -82.61465063257901 35.575096230042384, -82.61467163258426 35.57508423004205, -82.61520963271796 35.574796230038565, -82.61607563293353 35.57433023003256, -82.61654363304993 35.574079230029426, -82.61696663315558 35.57384923002588, -82.61823863347284 35.5731602300161, -82.61866263357857 35.57293123001297, -82.6187546336024 35.57287523001098, -82.61932063374257 35.572575230007914, -82.61947863378165 35.572492230007214, -82.62009463394118 35.57212022999465, -82.62057663406861 35.57181222998137, -82.62107763420371 35.571475229964044, -82.62121363424231 35.5713712299569, -82.62180963441082 35.57091922992595, -82.62192463444559 35.57081722991695, -82.62206963448887 35.57069222990638, -82.62226263454988 35.57050422988781, -82.62237363458478 35.570397229877415, -82.62250663462451 35.570282229867644, -82.62251063462557 35.57028022986763, -82.62290063474384 35.56993222983682, -82.62303263478363 35.56981622982672)))",5305,37,021,001300,370210013001,2024,2024,231,1961,1652,148,8,16,19,118,63,1614,170,1444,1582,1368,93,8,13,11,89,32,961,856,105
census_2010_blockgroups_view.fid--2dc29038_13ec899ba8f_-25c4,"MULTIPOLYGON (((-82.5595126185209 35.606925230862466, -82.55974261856797 35.6068672308743, -82.5600116186228 35.606801230888486, -82.56042961871026 35.606684230907646, -82.56053861873303 35.606654230912696, -82.56066061875742 35.6066272309198, -82.56090861880755 35.606569230933424, -82.56165361895789 35.60639623097476, -82.56176661898068 35.60637023098109, -82.56189661901028 35.60631823098384, -82.56196061900978 35.60639023100507, -82.56196861900972 35.60639923100774, -82.56214061900485 35.60661623106955, -82.56219061900349 35.60667923108753, -82.56220061900298 35.60669323109146, -82.56239261899248 35.606968231167144, -82.56263961897463 35.60735023127032, -82.56283461896243 35.60764023134934, -82.56299361895772 35.60784223140684, -82.56306661895667 35.60792723143161, -82.56316461895555 35.60804023146478, -82.56332661895644 35.60820923151571, -82.56361061896474 35.60846123159623, -82.5637986189736 35.608606231645034, -82.56409661899082 35.60881623171837, -82.56426461900045 35.6089342317597, -82.56462261902216 35.6091792318464, -82.5646276190226 35.60918223184753, -82.56482961903255 35.609335231899365, -82.56500461903825 35.60948723194835, -82.5651746190414 35.609650231999, -82.5653216190386 35.6098262320499, -82.56546361903354 35.61001223210238, -82.56558761902383 35.6102092321552, -82.56570061901066 35.61041623220895, -82.56582761899266 35.61067023227378, -82.56595161897505 35.610918232336935, -82.56612361895318 35.611245232421204, -82.56619661894484 35.611378232455785, -82.56623761894244 35.61143823247221, -82.56639561893319 35.6116682325352, -82.56656861893451 35.61184623258925, -82.5667416189398 35.611998232638, -82.56682261894467 35.612054232657734, -82.56695661895246 35.61214823269061, -82.5671636189686 35.61226623273591, -82.56733261898466 35.61234423276915, -82.56752161900515 35.612415232802995, -82.56954561923524 35.61310323315107, -82.56971261925395 35.6131622331802, -82.56984161926819 35.61320923320308, -82.57042161933244 35.61341723330501, -82.57084361937247 35.61361223338808, -82.57115661940426 35.61374323344693, -82.57126961941569 35.61379123346831, -82.57175861946412 35.61400423356187, -82.57209261949785 35.61414523362494, -82.57211561950014 35.61415523362937, -82.5721506195036 35.61417023363597, -82.57240761953025 35.6142742336836, -82.57244461953415 35.61428923369044, -82.5725906195563 35.61430223370806, -82.57260761955892 35.61430423371021, -82.57303361960243 35.614481233790066, -82.5731066196093 35.614515233804454, -82.57321161961934 35.61456323382504, -82.57327661962535 35.61459423383804, -82.57347361964389 35.61468623387699, -82.57445361975711 35.61500823404326, -82.5745146197846 35.61489523402645, -82.57469061982188 35.61484323403398, -82.57478561983561 35.61485623404641, -82.5747076197894 35.61507223408235, -82.57461661972503 35.61539223413814, -82.57473661972139 35.61554523418168, -82.5748446197119 35.615723234229, -82.57486661970994 35.615759234238546, -82.57497861969408 35.61598323429573, -82.57510461967364 35.616251234363205, -82.57522661965173 35.616525234431506, -82.57534961962668 35.616820234504274, -82.5753756196215 35.616882234519544, -82.57538461961956 35.6169042345249, -82.57549761959334 35.617196234596015, -82.57559761957008 35.61745523465903, -82.57570561954118 35.61775923473207, -82.57572261953428 35.617822234746576, -82.57593761944968 35.61860323492773, -82.57609361938474 35.619192235063636, -82.5761626193464 35.61951523513652, -82.57619761931433 35.61976123519019, -82.57623761927974 35.62002923524887, -82.57626461926452 35.620156235277506, -82.57631861924948 35.62031223531482, -82.5763576192417 35.62040523533778, -82.57628361922386 35.62044123533751, -82.57624961921528 35.62046023533784, -82.57605961916676 35.62057023534078, -82.5759396191351 35.6206462353439, -82.57583861910831 35.620711235346725, -82.5755216190255 35.62090623535385, -82.57548661901666 35.62092623535435, -82.57523261895149 35.62107523535863, -82.57510061891429 35.62117423536525, -82.57494961887053 35.621295235374305, -82.57454161873845 35.621712235417306, -82.57447061871531 35.62178623542503, -82.57440361869311 35.621858235432875, -82.57425961864521 35.622013235449586, -82.57407461858425 35.62220923547045, -82.5738856185217 35.62241123549215, -82.5737376184773 35.62254023550329, -82.57362861844987 35.622600235504244, -82.57352561842772 35.62263323550041, -82.57344161841071 35.62265323549581, -82.5734216184072 35.62265423549394, -82.57336761839734 35.62266023548971, -82.57328161838328 35.62265823548041, -82.57318661836955 35.622645235467985, -82.57315461836542 35.62263723546309, -82.5731076183593 35.62262623545598, -82.57295461834329 35.62256523542788, -82.57294261834193 35.62256123542584, -82.57286961833361 35.622536235413286, -82.57279561832368 35.62252123540259, -82.57270161830847 35.62251823539232, -82.57259661828896 35.622532235384405, -82.57249261826843 35.62255323537802, -82.57233561823395 35.62260723537282, -82.57227461822046 35.62262923537101, -82.57213361819053 35.622671235365075, -82.57202261816674 35.622706235360845, -82.57192661814706 35.622730235355824, -82.57182961812947 35.6227402353479, -82.5717636181183 35.62274123534127, -82.5717016181119 35.62271623532982, -82.57166961811132 35.6226852353202, -82.57165661811504 35.622647235311156, -82.57166161812079 35.622615235305176, -82.57166561812512 35.62259123530073, -82.57167761815208 35.6224292352689, -82.57166261815905 35.62236823525501, -82.57159061815928 35.622289235231534, -82.57150961815243 35.62224623521443, -82.57139161813639 35.62222323519764, -82.57123661811079 35.62222223518147, -82.57104261807612 35.62223823516483, -82.57084661803998 35.62226123514939, -82.57076261802668 35.62225723513987, -82.57069061801795 35.62223623512822, -82.57063961801525 35.62219823511522, -82.5706196180211 35.62213923510119, -82.57068861805715 35.621979235075685, -82.57072861807443 35.62191023506578, -82.57073961808098 35.62188023506078, -82.57075361808859 35.621845235055034, -82.57076561809995 35.62178523504408, -82.57076261810847 35.62172623503181, -82.57074661811737 35.621651235014845, -82.57072161812502 35.62157523499686, -82.57068061813217 35.621484234974055, -82.57063861813647 35.6214112349549, -82.57059461813606 35.6213662349412, -82.57057161813594 35.62134223493395, -82.5705666181354 35.621340234933065, -82.57048361812784 35.62130023491638, -82.57046261812417 35.621301234914405, -82.57042561811757 35.62130423491127, -82.57038661811059 35.62130723490785, -82.57030461809225 35.621338234905735, -82.57029061808846 35.621347234906075, -82.57023961807434 35.62138423490839, -82.570185618056 35.621445234915285, -82.57009161801876 35.6215852349341, -82.57003561799372 35.62168723494912, -82.56996861796297 35.62181423496807, -82.56985261791037 35.622030235000196, -82.56979461788632 35.62212423501328, -82.56972861786672 35.62218023501797, -82.56963761784708 35.62220923501453, -82.56955361783427 35.622202235004416, -82.569460617827 35.62214923498406, -82.56942961782646 35.62211923497479, -82.56925561782379 35.62194923492228, -82.56919261782039 35.621903234906476, -82.56911461781448 35.62185723488916, -82.56902961780565 35.62182323487346, -82.56887661778703 35.621779234848695, -82.56828861770104 35.6217032347728, -82.56822561769393 35.621681234761915, -82.5681636176895 35.62164323474781, -82.56811561769145 35.62157923472983, -82.56809361769831 35.62151023471353, -82.56802561775129 35.62109323462167, -82.56800461778491 35.62085323457058, -82.56798861779383 35.62077823455367, -82.56797761779615 35.62075123454703, -82.56795361780148 35.62069023453217, -82.56790861780456 35.62062223451376, -82.56783561780323 35.62055223449193, -82.56775061779743 35.62049823447222, -82.56766061778772 35.62046423445604, -82.56734161774492 35.620398234409784, -82.56724361773115 35.62038123439629, -82.56712361771294 35.62037023438171, -82.56701961769629 35.62036623437026, -82.56698661769057 35.62036723436699, -82.56696161768642 35.62036823436467, -82.56674361764682 35.62039023434673, -82.5664956175942 35.620464234336325, -82.56625161754319 35.62053223432512, -82.5661466175225 35.62055323431856, -82.56594361748431 35.62058223430358, -82.56576961745135 35.62060823429104, -82.56559761741491 35.62065923428371, -82.56539261737088 35.6207242342759, -82.56521461733233 35.620782234269406, -82.56508761730667 35.620812234262495, -82.56498861728824 35.62082523425493, -82.56496661728399 35.62082923425345, -82.56489261727081 35.620834234246914, -82.56482561725915 35.620838234240836, -82.5647606172488 35.62083523423352, -82.56468661723679 35.62083323422551, -82.56456261721621 35.620833234212824, -82.56454661721308 35.620836234211765, -82.56443661719199 35.620854234204096, -82.56430261716429 35.62089023419766, -82.56417961713518 35.620946234196396, -82.56388961706212 35.621107234199414, -82.56387461705876 35.62111323419905, -82.56379161703944 35.62114923419789, -82.5635936169965 35.621214234190724, -82.56330561693946 35.621274234173356, -82.5630276168831 35.62134023415819, -82.56288061684896 35.62140323415596, -82.56277761682242 35.62146423415781, -82.56269861679955 35.62152723416249, -82.5626136167699 35.62162823417431, -82.5625256167371 35.621746234189274, -82.56245561671592 35.621808234194745, -82.56237561669694 35.62184523419404, -82.56226361667274 35.62188123418983, -82.56211761664548 35.62190123417888, -82.56195961661798 35.621909234164306, -82.56190461660886 35.621909234158686, -82.5617646165854 35.62191023414445, -82.56162261656272 35.621904234128635, -82.56153061654946 35.62189123411655, -82.56146761654273 35.62186723410522, -82.56143061654252 35.621828234093414, -82.56139661654564 35.62177223407851, -82.56138161655355 35.621704234063124, -82.5613916165708 35.62160323404365, -82.56139661658055 35.62154523403231, -82.56138661659537 35.621438234009496, -82.56134061661815 35.6212412339647, -82.5613166166237 35.62117923394958, -82.56128761663079 35.62110223393097, -82.5612106166329 35.62100523390335, -82.56112161662645 35.620951233883154, -82.56103561661612 35.62092523386904, -82.56089361659474 35.620911233851565, -82.5606896165584 35.62092723383385, -82.56034661649558 35.62096523380635, -82.56025961648248 35.62095623379559, -82.56020961647977 35.62092023378305, -82.56017461648133 35.62087223376978, -82.56017061648141 35.62086723376833, -82.56016161649502 35.62076923374747, -82.56015861653 35.620539233700285, -82.56014961654358 35.62044123367941, -82.56017861658704 35.62019123363155, -82.56018861659524 35.620148233623794, -82.56021361661473 35.62004923360624, -82.56035861672144 35.619513233512016, -82.56037961674126 35.61940723349256, -82.56041161676463 35.61929023347206, -82.56049161682166 35.61900623342243, -82.5605156168417 35.618902233403695, -82.56055361687223 35.61874523337571, -82.56059461690276 35.6185912333486, -82.56062261692323 35.618488233330474, -82.56064661694141 35.61839623331412, -82.5606706169587 35.61831023329916, -82.56069161697836 35.61820523327994, -82.5607116169928 35.61813323326728, -82.5607166169956 35.61812023326518, -82.56075761701564 35.6180342332519, -82.5608036170364 35.61794923323936, -82.56082861704732 35.61790523323297, -82.56095661709989 35.61770223320473, -82.56100861712105 35.61762123319363, -82.56109961715696 35.61748623317547, -82.5611596171783 35.617412233166554, -82.56121961720181 35.61732423315484, -82.5612726172247 35.61723323314174, -82.56130961724513 35.6171402331266, -82.56131861725204 35.61710523312044, -82.56132861725898 35.61707123311458, -82.5613436172738 35.61699123309976, -82.56135361730269 35.616814233064765, -82.56140261742918 35.61604623291343, -82.56142661747006 35.61580723286724, -82.56143861751454 35.61553123281232, -82.56145261755347 35.61529423276555, -82.5614606175719 35.61518323274375, -82.56148561762076 35.614893232687244, -82.5614956176536 35.61469023264694, -82.56149561765987 35.61465023263882, -82.56149561766168 35.614638232636395, -82.56150661767987 35.614532232615964, -82.56150861768182 35.61452123261395, -82.5615106176865 35.6144932326084, -82.56151261769544 35.61443723259721, -82.56152261772299 35.61426923256403, -82.56152661773214 35.6142142325532, -82.56094161763936 35.614186232487434, -82.56034961754528 35.61415823242089, -82.55921361736455 35.614107232293755, -82.55918961736059 35.6141072322913, -82.55905061733701 35.61411023227765, -82.55890761731025 35.614129232266826, -82.55888561730615 35.61413223226514, -82.5586296172533 35.614199232252474, -82.55861661725032 35.6142052322524, -82.55855361725693 35.614094232223344, -82.55849961725484 35.61404923220861, -82.5584496172484 35.61403723220105, -82.55844861724826 35.614037232200886, -82.55795661717178 35.61400323214346, -82.55770461713139 35.61399423211573, -82.55745661709119 35.61398723208882, -82.5572606170598 35.613980232067206, -82.55716761704737 35.61396023205354, -82.55708161703713 35.61393423203947, -82.55700961703315 35.61388223202148, -82.55698361703676 35.613831232008394, -82.55698061703717 35.613825232006896, -82.55694061705417 35.61367123197146, -82.55691461706205 35.61359223195265, -82.55687661706398 35.613539231937956, -82.55681461705754 35.61351423192653, -82.55670061704079 35.613500231911985, -82.5564626170038 35.61348323188401, -82.55610761694777 35.613464231843714, -82.55582961690462 35.61344523181127, -82.55561761687079 35.61343623178765, -82.55560561686879 35.61343623178646, -82.55520361680662 35.613406231739, -82.55509361679023 35.61339423172523, -82.55509961680326 35.61331623170999, -82.55510461681104 35.61327123170133, -82.55511261682443 35.61319223168606, -82.55513361687265 35.612902231629164, -82.55514261689305 35.612780231605306, -82.55515661692708 35.6125742315648, -82.55516061695715 35.612383231526344, -82.55515761697947 35.612235231495895, -82.55515561700135 35.61209123146635, -82.55514561702941 35.61189823142603, -82.55513261704868 35.61175923139643, -82.55511661705987 35.61166923137647, -82.55506861708365 35.61146323132954, -82.55493461712673 35.611039231229476, -82.55481261716677 35.610648231137404, -82.55476361718262 35.61049223110059, -82.55465061722 35.61012823101484, -82.55454561725448 35.60979123093552, -82.5543426173221 35.609133230780685, -82.55422961735763 35.60878123069745, -82.55412261739154 35.6084462306183, -82.55404561741109 35.60823623056761, -82.55399661742402 35.60809923053467, -82.5538056174672 35.60761323041615, -82.55372461748563 35.607406230365704, -82.55394661752254 35.60740623038847, -82.5546126176328 35.607408230457295, -82.55483461766953 35.6074092304803, -82.555470617774 35.60741623054714, -82.55660161795954 35.6074312306664, -82.55711061805066 35.60738823070996, -82.55737561809775 35.607368230733115, -82.55788661818809 35.60733223077828, -82.55800961821153 35.607313230787035, -82.5582336182563 35.607264230800084, -82.55831161827251 35.60724223080358, -82.55868461835006 35.607141230821355, -82.55897061840867 35.60706923083611, -82.55921161845875 35.60700423084765, -82.5595126185209 35.606925230862466)))",6262,37,021,000400,370210004001,2457,2457,90,2391,2112,215,10,40,0,14,66,2280,84,2196,2228,1994,175,9,37,0,13,52,721,649,72
census_2010_blockgroups_view.fid--2dc29038_13ec899ba8f_-25c3,"MULTIPOLYGON (((-82.5454896356803 35.48006020360607, -82.54582063574242 35.4800122036302, -82.54620663581585 35.47995120365733, -82.54668463590515 35.479885203692824, -82.5468926359421 35.479869203710905, -82.54716663598828 35.479864203737925, -82.54724363600053 35.47986720374644, -82.54740963602664 35.47987620376533, -82.54763363605956 35.47990420379397, -82.54784563608962 35.479937203822416, -82.54801663611167 35.47997820384821, -82.54847163616245 35.48013920392766, -82.54855563617166 35.48017020394255, -82.54905463622622 35.48035420403107, -82.54973363630046 35.48060420415149, -82.54990863631889 35.48067320418346, -82.55016563634678 35.48076920422939, -82.55070263640503 35.48097020432522, -82.55095663643277 35.4810642043704, -82.55108663644698 35.48111220439346, -82.55120263645945 35.48115620441426, -82.55147563648913 35.48125820446305, -82.552078636554 35.48148720457139, -82.55270363662225 35.481718204682444, -82.55272163662409 35.48172520468571, -82.5529676366525 35.48180620472739, -82.55321463668271 35.48187620476693, -82.55326063668866 35.48188720477388, -82.55337463670313 35.48191620479149, -82.55339963670649 35.48192120479497, -82.5534466367126 35.48193220480205, -82.55355163672654 35.48195520481749, -82.55362263673643 35.48196720482723, -82.55372163675028 35.48198420484077, -82.55382763676562 35.48199820485453, -82.5539076367771 35.48201020486517, -82.55412263680911 35.48203420489207, -82.55445363686104 35.48205320492982, -82.55455563687723 35.48205820494132, -82.5549176369375 35.48205620497798, -82.55498563694907 35.482054204984564, -82.55506463696248 35.48205220499221, -82.55537163701803 35.482021205017425, -82.55559563706188 35.481978205031574, -82.55625663719034 35.48185420507404, -82.55626863719287 35.481851205074705, -82.55636863721223 35.48183320508127, -82.55649363723656 35.48180920508917, -82.55680563729769 35.48174820510872, -82.55737463741036 35.48162820514259, -82.55763163746242 35.481566205156305, -82.55786563746398 35.481810205229976, -82.55792463746666 35.48185620524537, -82.55800463746785 35.48193520526959, -82.55810163746918 35.4820312052991, -82.55833763747626 35.4822402053658, -82.55857463748634 35.48243120542895, -82.55867663749652 35.48247520544837, -82.55887063751572 35.48256020548549, -82.55918563753409 35.48278120556273, -82.5595406375606 35.482992205642056, -82.55985463759112 35.48313320570287, -82.56022863763079 35.483279205770955, -82.56074163769412 35.48342120585235, -82.56131263775724 35.483627205952764, -82.56178663778937 35.48393020606298, -82.56219963781595 35.484204206161024, -82.56255463783579 35.48445920624932, -82.56298863785155 35.48482620636846, -82.5633236378457 35.485227206484396, -82.56361963783367 35.48562620659587, -82.56393463782477 35.486025206709314, -82.56430363773116 35.48703620695285, -82.56445963769166 35.487463207055704, -82.56464563756704 35.48847820728137, -82.56477663749462 35.4890932074199, -82.56486263747516 35.48931320747348, -82.56506463742959 35.48982920759922, -82.56561763743845 35.490370207765956, -82.56633463747939 35.490879207943024, -82.56699863753038 35.491265208089594, -82.56803863760987 35.49187220831964, -82.56888963770713 35.4921592084652, -82.56982763782501 35.49240520861137, -82.57090063797648 35.4925782087565, -82.5715456380675 35.49268220884373, -82.57313163829659 35.49290420905143, -82.57324463831272 35.49292120906649, -82.57335763832903 35.49293720908133, -82.57534563863977 35.49306120931023, -82.5763896388447 35.49285420937502, -82.5773706390776 35.49239620938232, -82.57772963916284 35.492228209384855, -82.5788166394645 35.49143620933509, -82.57883263946883 35.491425209334444, -82.57950163961902 35.4911692093509, -82.57970363965921 35.49112520936261, -82.58030163977836 35.4909952093974, -82.58089863989731 35.490865209432116, -82.5812736399719 35.49078420945399, -82.58200564010893 35.490682209508265, -82.58233764017116 35.49063620953286, -82.58238264017845 35.490637209537624, -82.58306664028945 35.49065320961099, -82.58318464030444 35.49068320962921, -82.58430764043187 35.49106720982235, -82.58461464046346 35.49119420987963, -82.5852326405266 35.491451209995255, -82.58662364064672 35.492174210284915, -82.58714464067754 35.49253721041215, -82.58760964067498 35.49305821056583, -82.58775664067424 35.49322221061429, -82.5881116406693 35.493639210735594, -82.58860464062624 35.49445421095189, -82.58964964062876 35.49557021128612, -82.58984764062254 35.495825211358316, -82.59110864068953 35.49675421167662, -82.59201464072498 35.497504211922084, -82.59234164072555 35.49785521202705, -82.59244764072585 35.497968212060876, -82.59243864071283 35.498043212075245, -82.59234964058773 35.498763212212666, -82.59226064046285 35.49948221234995, -82.59221964040562 35.49981121241278, -82.59217964034845 35.50014121247585, -82.59207064032594 35.50017021247054, -82.59206064032382 35.50017321247016, -82.59174364025823 35.500258212454966, -82.59171264025171 35.50026721245368, -82.5916346402358 35.50028621244947, -82.59133664017546 35.500357212433464, -82.59102564011096 35.50044121241871, -82.59003663990838 35.50069221236846, -82.58952163980192 35.50082921234357, -82.58783863945638 35.5012622122593, -82.58719163932645 35.501409212222974, -82.58687863926566 35.50146721220275, -82.58655763920554 35.501511212178826, -82.58610263912384 35.501552212140446, -82.58610063912337 35.50155321214045, -82.58569263905781 35.50153921209584, -82.58530463900352 35.50147321204265, -82.58489563895981 35.50131521196862, -82.58467063894295 35.50118221191849, -82.58447663893322 35.501035211868675, -82.58402363891933 35.50063521174083, -82.58379363890965 35.50044921167944, -82.5835826388964 35.50030721162889, -82.58321163886274 35.500125211553865, -82.58277663880861 35.50000721148528, -82.5824436387595 35.49996721144301, -82.58208863869942 35.4999752114083, -82.58159263860313 35.500066211375945, -82.5812166385207 35.500197211364124, -82.58066163839209 35.50043521135569, -82.58018463828337 35.50062821134611, -82.57995663823473 35.50069921133718, -82.57974163819141 35.50074921132536, -82.57946563814147 35.50077621130255, -82.57921763810108 35.500771211276124, -82.57903563807285 35.50075821125482, -82.57883263804563 35.500716211225516, -82.57855763801378 35.50062621117898, -82.57830363798865 35.50051521113037, -82.57809263797458 35.50037821108084, -82.577464637925 35.50002221094407, -82.57723763790416 35.499912210898415, -82.5770866378871 35.499860210872384, -82.57679663784927 35.49979321082901, -82.5763426377793 35.499758210775354, -82.57591763770911 35.49975621073142, -82.57566463765656 35.49982521071956, -82.57540563761492 35.499816210691186, -82.57519463758283 35.49979721066569, -82.57494363754724 35.49975821063201, -82.57469063751456 35.49969721059371, -82.57446963748909 35.499624210556235, -82.57419663746253 35.499502210503415, -82.57395363744351 35.4993632104502, -82.57365463742482 35.49916121037846, -82.57307163739094 35.498751210235326, -82.57279763737165 35.49858021017239, -82.57252863734846 35.49844021011632, -82.5722136373154 35.498315210058635, -82.57190163727805 35.49822121000754, -82.57149663722161 35.49815120995178, -82.57075963710695 35.49810120986616, -82.57027063702893 35.498081209811964, -82.57007963699839 35.49807420979098, -82.56980663695624 35.49805320975871, -82.56960563692661 35.49802920973325, -82.56934063689172 35.49797020969405, -82.56906163685998 35.49787520964614, -82.56887963684235 35.49779320961075, -82.56866263682595 35.49766520956254, -82.56844663681431 35.497507209508214, -82.56818463680702 35.49727120943337, -82.56765363679588 35.496769209276756, -82.56740863678708 35.49656120920931, -82.56720363677543 35.49641520915859, -82.56696863675565 35.49629020910913, -82.56666863671892 35.496205209061145, -82.56644563668904 35.49615920902893, -82.56624263665697 35.496148209005824, -82.56598063661033 35.4961692089833, -82.5658836365922 35.49618220897599, -82.56520463645235 35.49636020894258, -82.56515463644202 35.496373208940085, -82.56506963642427 35.49639720893635, -82.56502263641455 35.49641020893408, -82.56490963639104 35.496441208928786, -82.56244463587632 35.49713220881696, -82.56230263584659 35.497172208810504, -82.5619736357788 35.497259208794446, -82.56148963568194 35.49736720876689, -82.56115863561372 35.497454208750646, -82.55995663537317 35.49772320868226, -82.55960863530089 35.497818208665954, -82.55935663524703 35.49789720865615, -82.55899463516234 35.498058208651884, -82.55879663511148 35.49817520865533, -82.55848663502309 35.4984172086728, -82.55832563496959 35.498592208691925, -82.55818863491726 35.49878520871713, -82.55806463485698 35.49904420875715, -82.55800863481554 35.49925420879411, -82.55796563476561 35.49953320884651, -82.55796163472712 35.499780208896354, -82.55800963467667 35.50016120897879, -82.55809963463209 35.50054920906695, -82.55832363455279 35.50130920924461, -82.55845663449796 35.50181120936033, -82.55851663445611 35.50214920943531, -82.55853163440004 35.5025312095146, -82.55852563438863 35.502598209527555, -82.55850063433182 35.50294220959504, -82.55843863426382 35.50331920966539, -82.55837263419764 35.50367920973191, -82.55832763413814 35.50401920979651, -82.55832763410268 35.50425020984349, -82.558366634072 35.50449220989668, -82.5585096340087 35.50506021002692, -82.55857063397423 35.505351210092485, -82.55857763396452 35.505422210107604, -82.55858963394546 35.50555921013673, -82.5585676339033 35.505810210185494, -82.55850263385945 35.506026210222785, -82.55838363380474 35.506254210256984, -82.55819863373527 35.50650721028951, -82.55758063351612 35.50726821038108, -82.55741263345135 35.50750921041287, -82.5573066334069 35.50768421043757, -82.55715663333864 35.507967210479805, -82.55698363324649 35.50838121054631, -82.55696663323543 35.5084352105556, -82.55685063315633 35.50882521062306, -82.5567826330787 35.50925821070421, -82.55676763300983 35.50969121079075, -82.55679563293997 35.51017721089256, -82.55681463284233 35.510834211028104, -82.55679163281616 35.510980211055546, -82.55675963279245 35.51110021107665, -82.55671763276906 35.51120721109413, -82.55665663274026 35.51132921111268, -82.5565826327106 35.51144221112811, -82.55648463267565 35.51156421114291, -82.5563656326383 35.51167921115412, -82.55624963260493 35.51177121116094, -82.55612163257072 35.511856211165124, -82.55597963253612 35.511928211165184, -82.5558366325032 35.51198821116275, -82.55571563247717 35.51202721115824, -82.55549863243367 35.51207621114597, -82.55533263240272 35.51209821113346, -82.554997632342 35.51213221110605, -82.55380663212851 35.51223621100511, -82.55315563200857 35.51231421095425, -82.55283163194795 35.51235921093017, -82.55244863187477 35.512422210903736, -82.55168763172644 35.51256621085503, -82.55104863159866 35.51270821081847, -82.54987963136209 35.51298721075531, -82.54948963128267 35.513083210734884, -82.54610263059215 35.51392321055847, -82.54587263054545 35.51397921054628, -82.54552563047459 35.514066210528426, -82.54517963040745 35.514130210505996, -82.54494763036217 35.51417421049109, -82.54480163033384 35.51420121048168, -82.54468763031174 35.51422221047422, -82.54383963013902 35.51443121042978, -82.54325463002073 35.514570210398105, -82.54191462974951 35.514890210325824, -82.54093862956383 35.51504521025723, -82.53974362933768 35.515228210172, -82.53880962916652 35.51533421009776, -82.53811362903565 35.515435210046874, -82.53771062895976 35.51549421001756, -82.53640262873263 35.51556120989706, -82.53638162872869 35.51556420989557, -82.53613862870544 35.51545320984801, -82.53591762868415 35.51535320980501, -82.53570262865767 35.5152932097708, -82.53537062860866 35.51525420972878, -82.53510562856937 35.5152242096955, -82.5367206288708 35.515004209816354, -82.53730162903338 35.51457220978804, -82.53761962913292 35.51426720975863, -82.5377906292076 35.51396520971475, -82.53769962925527 35.513556209622166, -82.53752762937475 35.51259120940816, -82.53748662941081 35.51231220934726, -82.53755162948255 35.511914209272916, -82.53779662957798 35.5115572092254, -82.53754662955433 35.51144120917617, -82.53717762953471 35.51117020908318, -82.53709362954261 35.5110282090457, -82.53705962955783 35.51089220901455, -82.53717462963196 35.51053320895331, -82.5371416297013 35.510045208850656, -82.53692262973446 35.509592208736, -82.53690462977089 35.50933520868189, -82.5372266299574 35.50846720853836, -82.537468630051 35.50811820849214, -82.53773863015505 35.50773220844134, -82.53778563021997 35.507359208370225, -82.53761463024641 35.50700220828011, -82.53742763024881 35.50678420821654, -82.53467762982153 35.506598207896744, -82.53371362966173 35.50659820779794, -82.53334762958252 35.506719207784975, -82.53320062955041 35.50676920778006, -82.53292162945893 35.50706420781149, -82.53256362930892 35.507655207894985, -82.53249362926852 35.50784320792606, -82.53229962915569 35.50836920801319, -82.53226862910289 35.50868020807331, -82.53213062900376 35.5091772081603, -82.53166962889057 35.50941720816182, -82.53158062886861 35.50946420816224, -82.53156162886513 35.50946620816066, -82.53151762885689 35.50947220815744, -82.5313996288378 35.509469208144715, -82.53113962879013 35.50949920812412, -82.53097262876248 35.509499208107016, -82.53068462871468 35.50949920807746, -82.53015362862766 35.50949320802179, -82.52975062856159 35.50948820797942, -82.52974162856006 35.509488207978514, -82.52891162842724 35.509457207887145, -82.52854462836719 35.50945220784846, -82.5281426283014 35.50944720780619, -82.52774162823552 35.50944320776429, -82.52654062803833 35.5094312076387, -82.52646762802623 35.509431207631216, -82.52631862800064 35.50943720761711, -82.52614162796924 35.509450207601645, -82.52607462800044 35.50917420753865, -82.52602262802505 35.50895820748935, -82.52589462807974 35.50846320737555, -82.52586362809191 35.50835020734935, -82.52584662809906 35.50828520733443, -82.5257896281215 35.50807720728623, -82.52574462813591 35.507935207252736, -82.5256386281695 35.507601207173906, -82.52560362817736 35.50751220715224, -82.52555062818976 35.50737420711883, -82.52546662820859 35.50716020706661, -82.52534462823641 35.50684720699043, -82.52521362826441 35.5065232069111, -82.52514662827875 35.5063572068704, -82.52512862828283 35.50631120685923, -82.52510162828916 35.50624120684224, -82.52507262829567 35.5061672068242, -82.52490562833381 35.505738206719826, -82.52485062834658 35.505595206685065, -82.52462062840182 35.50498620653758, -82.52461862840248 35.5049802065362, -82.52443962844318 35.50452120642451, -82.52427762848119 35.504098206321835, -82.52419062849981 35.50388320626917, -82.52412662851555 35.503711206227656, -82.52398762853926 35.50340620615128, -82.52387062855333 35.50318820609496, -82.52377762856477 35.50301320604984, -82.5235386285837 35.50263120594766, -82.52330762860062 35.50227120585078, -82.52316762861038 35.50205620579262, -82.52262162864848 35.50121820556625, -82.52205462869016 35.50033320532807, -82.52179162870962 35.49992220521751, -82.52170462872196 35.49974720517302, -82.52167462872642 35.49968620515747, -82.52159962873264 35.499564205125004, -82.52157062873732 35.499502205109444, -82.52151462874681 35.49938020507889, -82.52134262879231 35.49889720496304, -82.5212966288128 35.49871420492104, -82.52128162881944 35.49865520490754, -82.52124162884542 35.498442204860126, -82.52140662886875 35.49846820488232, -82.52154762888249 35.49853120490958, -82.5216406288876 35.498598204932804, -82.52171562888364 35.49870520496218, -82.52174862887865 35.49877320497939, -82.52183862887652 35.49888420501121, -82.52188462886657 35.498999205039325, -82.52199962885649 35.49918920508974, -82.52211262885446 35.4993242051288, -82.52216662885499 35.49937920514553, -82.52228162885629 35.49949520518095, -82.52245462886867 35.499601205220166, -82.5225406288742 35.49965820524059, -82.52260462887392 35.49972920526159, -82.52272462886573 35.49991220531118, -82.52277862884773 35.50008820535247, -82.52279662884703 35.50011220535923, -82.52297762880627 35.5005732054715, -82.52345962880449 35.501106205629355, -82.52391262881959 35.50149720575535, -82.52455062886548 35.50188720590006, -82.5248936288937 35.502074205973294, -82.5250856289146 35.50214520600741, -82.5251886289257 35.50218420602592, -82.52557162897484 35.50227720608409, -82.52588062902184 35.502305206121484, -82.52631162909996 35.5022612061567, -82.5264366291117 35.50232020618152, -82.5264746291152 35.502338206189066, -82.52653262912048 35.50236620620073, -82.52659462913012 35.502370206207914, -82.52663762913663 35.50237420621317, -82.52685962917081 35.50239120623932, -82.52701062919388 35.50240420625748, -82.5275206292654 35.50248920632704, -82.52774062929598 35.502527206357364, -82.52784362931048 35.502544206371375, -82.52789662931788 35.5025532063786, -82.52812862933803 35.502672206426624, -82.52822262934633 35.502720206446, -82.52824762935421 35.50269520644354, -82.5282956293691 35.50265020643931, -82.52831962937847 35.502615206434655, -82.52834162938642 35.502587206431144, -82.52834262938688 35.50258520643084, -82.52836062939386 35.50255920642746, -82.52836662939623 35.50255020642622, -82.5284316294257 35.50242820640803, -82.52845162944894 35.50229820638367, -82.52845362945037 35.50229120638242, -82.52841862952826 35.501745206267785, -82.52838762956159 35.50149420621357, -82.52838762956206 35.50149120621292, -82.5283986296045 35.50122620616018, -82.52840362963002 35.50106520612789, -82.5284056296359 35.50102920612081, -82.52844962971093 35.5005872060354, -82.5284666297381 35.50042820600484, -82.52846962974951 35.50035720599066, -82.52848162978374 35.500147205949204, -82.52848662979531 35.50007720593551, -82.5284926298059 35.50001420592329, -82.5285116298375 35.4998292058876, -82.5285186298481 35.49976720587572, -82.52853562987617 35.499602205843885, -82.52859462993648 35.499273205782984, -82.52863362996496 35.499129205757654, -82.52866662998869 35.49901020573694, -82.52867662999338 35.498990205733826, -82.52875363004603 35.49873020568889, -82.52881663008162 35.49856620566196, -82.52891063013426 35.49832420562238, -82.52901863019837 35.498023205572174, -82.52915363027302 35.49768220551665, -82.52931963034776 35.497374205471054, -82.5293516303602 35.49732720546474, -82.52938063037132 35.497286205459325, -82.5295176304245 35.497087205432905, -82.52967363047672 35.496915205413956, -82.52976963050492 35.49683520540754, -82.52982063051996 35.496792205403956, -82.52997863056007 35.49670120540175, -82.53014863060022 35.4966232054033, -82.53031063063835 35.49654920540481, -82.5310306307945 35.49630920542978, -82.53129663085362 35.496211205437106, -82.5313756308727 35.496172205437276, -82.5315636309176 35.496082205438256, -82.53176463096769 35.49597320543669, -82.53177763097086 35.495966205436574, -82.53207563104878 35.49578020542933, -82.53210863105686 35.49576320542927, -82.53247063114505 35.49557920542893, -82.53253663116108 35.495546205428944, -82.53350963138419 35.4951422054465, -82.53422363154883 35.49484020545829, -82.53470463166077 35.49463020546488, -82.53536363181367 35.49434520547448, -82.53544563183335 35.494305205474724, -82.5356306318778 35.494215205475356, -82.5356666318869 35.49419520547502, -82.53589563194383 35.49407120547321, -82.53618163201632 35.49390720546912, -82.53629863205035 35.49381220546186, -82.53641563208396 35.49371920545491, -82.53648063210582 35.49364620544674, -82.53663463215806 35.493472205427096, -82.53680563221968 35.49325520540053, -82.53689363225122 35.49314420538696, -82.53730663240249 35.49260420531944, -82.5374326324561 35.492390205288835, -82.5374956324949 35.49220520525758, -82.53752663253978 35.491946205208066, -82.53753663255326 35.49186920519348, -82.53756563262394 35.491439205108954, -82.53757663266003 35.49121520506452, -82.53761063276869 35.4905432049313, -82.53761863279298 35.49039320490162, -82.53762263280485 35.49032020488716, -82.53763063284583 35.49006120483525, -82.53763563286618 35.48993420480999, -82.53766063289204 35.48979220478368, -82.53767163297104 35.489288204682275, -82.53767463298571 35.48919620466384, -82.53768863301323 35.48903120463172, -82.53770663304891 35.488818204590245, -82.53769063306028 35.48872620456982, -82.53769763307552 35.48863420455191, -82.53773563315008 35.488189204465264, -82.53777963321419 35.4878182043943, -82.53784263328167 35.487446204325025, -82.53786163330149 35.487337204304836, -82.53791763335397 35.48705520425322, -82.53792563336106 35.48701720424631, -82.53795663338602 35.486888204223234, -82.53808163348334 35.48638820413433, -82.53808963348897 35.4863602041295, -82.53813163351674 35.486224204106065, -82.53817963354831 35.486070204079624, -82.53822063357373 35.485948204059085, -82.53825063359172 35.485863204044804, -82.53833663364003 35.485641204008495, -82.5384676337097 35.48532820395822, -82.53853763375034 35.48513820392677, -82.53854063375164 35.48513320392607, -82.53855363376256 35.48507620391582, -82.53858863378959 35.48493720389106, -82.53859563380334 35.48485520387515, -82.53860263381671 35.4847752038596, -82.53859863385665 35.484510203805264, -82.53859363393046 35.484023203705654, -82.538588633959 35.48383120366612, -82.5385756339852 35.483646203627124, -82.53855063400674 35.48347820359038, -82.53850463404764 35.48316220352139, -82.53850063405058 35.483138203516084, -82.53859963406552 35.48314720352804, -82.53902263413129 35.48317620357735, -82.53937163418775 35.48318520361489, -82.53953263421563 35.48317720362985, -82.53961963423171 35.48316620363648, -82.53972463425099 35.483154203644766, -82.53989463428391 35.48312320365588, -82.5400356343129 35.48308620366284, -82.54020563434939 35.48303220366922, -82.54035763438438 35.4829682036718, -82.54052663442691 35.48287320366979, -82.54067563446607 35.48277920366595, -82.54086263451912 35.48263520365584, -82.54106663458418 35.48243120363522, -82.54140263469421 35.48207620359739, -82.54183063483251 35.48163620355174, -82.54212163492913 35.48132020351728, -82.54224363496807 35.481198203504974, -82.54230363498706 35.48113920349916, -82.5425836350662 35.48092520348431, -82.54279363512428 35.4807732034749, -82.54299563517571 35.48065620347177, -82.5431676352173 35.48057020347187, -82.54321963522976 35.48054520347212, -82.54335663526095 35.48049020347501, -82.54344763528157 35.48045420347705, -82.54361863531884 35.480395203482516, -82.54394663538639 35.48030920349866, -82.54400863539902 35.48029420350193, -82.54414863542617 35.48026820351097, -82.54431563545856 35.48023720352174, -82.54442163547891 35.480219203528954, -82.5449196355728 35.480145203564916, -82.5454896356803 35.48006020360607)))",6215,37,021,002204,370210022041,3497,3497,89,3439,3166,61,4,199,1,8,58,2590,51,2539,2568,2361,51,3,147,1,5,22,1809,1537,272
census_2010_blockgroups_view.fid--2dc29038_13ec899ba8f_-25c2,"MULTIPOLYGON (((-82.49246861419549 35.562782214992744, -82.49273661425887 35.56265921499523, -82.49286361428994 35.56259421499511, -82.49299161432101 35.56253021499525, -82.49302461432933 35.5625112149947, -82.49307261434171 35.56248221499379, -82.49321961437926 35.562397214991634, -82.49326861439154 35.56237021499111, -82.49353961441993 35.56247721504077, -82.49435561450528 35.562801215190476, -82.49458961452981 35.5628942152334, -82.49462661453299 35.56291321524108, -82.49500961457647 35.563043215306855, -82.4951866145965 35.56310321533717, -82.49613361469856 35.56346021550716, -82.49614961470029 35.56346621551, -82.49652661473989 35.563615215578984, -82.4966586147537 35.563667215603125, -82.49705761479574 35.56382421567613, -82.49719061480965 35.563877215700536, -82.49746361483854 35.563983215750106, -82.49747661483995 35.56398721575228, -82.49825961492603 35.56427221589067, -82.49834061493463 35.56430321590532, -82.49862661496473 35.56441621595765, -82.49870961497352 35.564448215972654, -82.49896061499989 35.564547216018624, -82.49904461500867 35.56458021603395, -82.49914261501915 35.56461821605181, -82.49915961502069 35.564626216055096, -82.49924661502898 35.56466621607225, -82.49936261504001 35.564719216094936, -82.49950261505464 35.564775216120644, -82.49961861506661 35.56482221614216, -82.49965861507079 35.56483821614949, -82.49978161508349 35.56488821617232, -82.4998226150877 35.56490521618, -82.4998656150922 35.56492221618786, -82.49999461510555 35.56497421621171, -82.5000386151101 35.56499221621981, -82.50008261511455 35.565010216228075, -82.50021761512865 35.56506421625291, -82.5002626151332 35.56508321626136, -82.50048961515664 35.565175216303366, -82.50069661517803 35.56525921634179, -82.50117361522737 35.56545221643005, -82.50120561523075 35.5654652164359, -82.50135661524703 35.565522216463094, -82.50140361525185 35.56554121647175, -82.50161361527356 35.56562621651064, -82.50229061534513 35.565890216633846, -82.50248261536518 35.56596721666928, -82.50307361542676 35.56620321677791, -82.50347761546904 35.56636421685221, -82.50381361550563 35.56648821691189, -82.50456561558423 35.56678721704999, -82.50572261570579 35.56724421726184, -82.50578561571234 35.567269217273356, -82.50650061578686 35.56755521740496, -82.50678461580996 35.56771121746584, -82.50689461582135 35.567755217486166, -82.50722761585635 35.567887217547224, -82.5073386158678 35.567932217567716, -82.50747661588154 35.56799121759394, -82.50781161591463 35.568137217658055, -82.50789061592205 35.568174217673686, -82.50802661593448 35.56824021770103, -82.50839361596772 35.56841921777517, -82.50857261598237 35.56851721781343, -82.50872561599478 35.56860121784631, -82.50925361603575 35.56890421796219, -82.50967561606447 35.569172218060004, -82.51006561608801 35.569439218154415, -82.51013361609155 35.56948921817157, -82.51046861610962 35.56973321825561, -82.51062461611642 35.56985721829687, -82.51085861612641 35.570044218358895, -82.51090961612806 35.57008821837314, -82.51174661615605 35.57080821860553, -82.51202661616553 35.571048218683146, -82.51213361616898 35.57114121871307, -82.51224161617233 35.57123621874349, -82.51245261617784 35.571427218804004, -82.5125596161808 35.57152321883456, -82.51282261618779 35.57176121890999, -82.5133056162015 35.5721922190473, -82.51351661620765 35.572380219107146, -82.51555361626671 35.57419121968489, -82.51630361628844 35.574858219897585, -82.5169326163059 35.57542222007698, -82.5174666163209 35.57590022022911, -82.51774661632577 35.57617022031277, -82.51815561632563 35.57661222044468, -82.5185046163176 35.57704022056756, -82.5186676163099 35.5772652206301, -82.51884561630158 35.57751122069847, -82.51907361628213 35.57788322079755, -82.51908661628076 35.57790622080359, -82.51912561627645 35.57797622082181, -82.51924061631506 35.57784922080781, -82.51946361638933 35.57760722078144, -82.51961461643035 35.577503220775874, -82.51964861643961 35.577480220774596, -82.51975861646841 35.57741122077184, -82.5198006164696 35.57744922078397, -82.5198226164701 35.57746922079028, -82.5199916164748 35.577621220838545, -82.5200226164774 35.57763722084493, -82.52010061648404 35.57767822086134, -82.52019061647924 35.57780622089661, -82.52036361647917 35.577993220952486, -82.52040961647913 35.578043220967324, -82.5207336164825 35.57837022106715, -82.52119561649124 35.57881122120436, -82.52124461649169 35.578861221219555, -82.52145061649371 35.579070221283224, -82.52153561649494 35.579153221308864, -82.52157261649562 35.57918922131995, -82.52168561649741 35.579299221354006, -82.52169161649752 35.57930522135582, -82.52172361649787 35.57933722136557, -82.52183761649957 35.57944922140009, -82.52230161651059 35.57987722153485, -82.52258361651361 35.58016122162163, -82.52277461651585 35.58035322168029, -82.523177616522 35.580747221801886, -82.52379861653328 35.581343221986934, -82.5240306165309 35.58160822206461, -82.52469761654699 35.582222222258075, -82.52482561654804 35.58235322229789, -82.52492961654627 35.58247722233383, -82.52512861655002 35.582667222392956, -82.52527361655302 35.58280422243575, -82.52597961656262 35.5835022226502, -82.52598361654884 35.5835962226698, -82.52595461653034 35.58368522268487, -82.52594961651099 35.5838052227088, -82.52595961649376 35.583928222734855, -82.52598761648255 35.58403122275869, -82.5260266164708 35.58414922278674, -82.52618661642825 35.58459822289456, -82.52621461641807 35.58469422291692, -82.52627161641846 35.584753222934786, -82.52601461637448 35.58476222291025, -82.52586161634697 35.584775222897164, -82.52577361633139 35.584782222889494, -82.52550861628389 35.58480522286697, -82.5254216162682 35.58481322285968, -82.5249786161874 35.584861222823896, -82.52455861611045 35.584908222790304, -82.52434261606984 35.58493922277445, -82.52365961593776 35.58506122272907, -82.52340061588755 35.58510822271201, -82.52322261585269 35.58514322270089, -82.52313661583571 35.585160222695485, -82.52310761583006 35.585166222693786, -82.52288161578544 35.5852122226799, -82.52279761576877 35.58523022267487, -82.52272161575381 35.58524522267018, -82.52249261570876 35.58529122265604, -82.52241761569385 35.585307222651565, -82.52236061568269 35.58531822264796, -82.52233761567827 35.58532222264634, -82.52210061563075 35.58537522263287, -82.52202261561501 35.585393222628454, -82.52178361556777 35.5854432226141, -82.52106661542561 35.58559422257118, -82.52082861537825 35.585645222557055, -82.5194146150978 35.58594322247241, -82.51887461499071 35.5860572224401, -82.51857861493147 35.58612322242307, -82.51749861471825 35.58634422235708, -82.51679761458499 35.58645522230767, -82.51605061444602 35.58655322225084, -82.5156916143798 35.58659622222271, -82.51514161428044 35.586649222176966, -82.51482561422304 35.586681222150986, -82.51442661415234 35.586711222116044, -82.5137016140253 35.58675522205057, -82.51354161399732 35.586764222035924, -82.51347061398621 35.586760222027856, -82.51340361397386 35.58676822202258, -82.5131766139342 35.58678122200194, -82.51310161392149 35.586783221994565, -82.51256561383006 35.586799221942755, -82.51231961379082 35.5867892219154, -82.51201461374136 35.586782221882665, -82.51160561367367 35.586781221840425, -82.51129861362381 35.58677422180747, -82.51087661355523 35.58676522176229, -82.5106986135268 35.58675822174258, -82.51059061350965 35.58675322173042, -82.51026861345855 35.58673822169429, -82.5101616134414 35.586734221682455, -82.50978361338164 35.58671522163974, -82.50865161320223 35.58666122151244, -82.5082746131425 35.58664322147004, -82.50798161309613 35.58662922143713, -82.50745461301221 35.5866062213783, -82.5071036129574 35.586584221337695, -82.50706361295106 35.586582221333195, -82.50681161291027 35.58657622130607, -82.50664461288316 35.58657222128808, -82.50649861285926 35.586570221272716, -82.50625161281815 35.586571221247475, -82.5061436127997 35.586575221237275, -82.50597761277085 35.58658322122179, -82.50566361271544 35.58660522119399, -82.50541261266999 35.5866302211733, -82.50540161266792 35.586631221172354, -82.50507061260627 35.58667522114731, -82.50483961256207 35.58671422113152, -82.5043146124583 35.58682222109949, -82.50405961240618 35.586886221086324, -82.5037096123318 35.586992221071895, -82.50354261229623 35.58704322106509, -82.50316461221236 35.58718122105431, -82.50308861219541 35.587209221052234, -82.5030386121841 35.587229221051096, -82.50286561214384 35.587304221048555, -82.50279161212649 35.58733722104776, -82.5028716121736 35.58711722101117, -82.50287261217412 35.58711522101089, -82.502919612199 35.58700422099315, -82.50298361222443 35.58690822098018, -82.50304961224657 35.58683522097214, -82.50314261227399 35.5867572209658, -82.50324261230091 35.58669022096249, -82.5033456123275 35.58662822096042, -82.50334761232816 35.586626220960234, -82.50354461238038 35.58649922095467, -82.50372161242625 35.58639222095109, -82.5037646124372 35.586367220950386, -82.50418761254804 35.58610322094023, -82.50424661256409 35.58606222093789, -82.50441761261021 35.585947220932084, -82.50441961261592 35.58591222092519, -82.5044266126327 35.58581022090519, -82.5044296126385 35.585776220898566, -82.50435761263303 35.58573422088256, -82.50435661263286 35.58573422088245, -82.50417761261609 35.58565022084701, -82.50413561261284 35.58562622083784, -82.50406461260725 35.585586220822336, -82.50398161260057 35.58554022080449, -82.50375261259695 35.58531722073561, -82.50368761259594 35.58525422071613, -82.50357461259668 35.58512722067864, -82.50346061260521 35.5849492206308, -82.5031806126333 35.584465220503496, -82.50308761264688 35.58427722045567, -82.50296061266572 35.58401822038996, -82.50291961267698 35.58390122036195, -82.50291761267749 35.583895220360546, -82.50284461267046 35.583862220346305, -82.50281361266669 35.58385322034133, -82.50269161265162 35.58382022032205, -82.50256061263646 35.583777220299844, -82.5024716126236 35.58376522028825, -82.50240561261393 35.58375722027987, -82.50235461260496 35.58376022027519, -82.50237561261577 35.583712220267635, -82.50250661267444 35.58347222023227, -82.50252361268826 35.58340122021959, -82.50253461270223 35.583322220204586, -82.50249961272452 35.583140220163976, -82.50247461273281 35.58305922014495, -82.50242061274263 35.58293722011459, -82.50232661275079 35.582783220073594, -82.50177461278754 35.58195021984746, -82.50169261278783 35.581860219820705, -82.50164361278628 35.58181721980695, -82.50153361277991 35.58174021977994, -82.50129961276284 35.5815992197273, -82.50111161274909 35.581486219684926, -82.50101961274315 35.58142521966305, -82.50085061273492 35.58129721961968, -82.5007916127339 35.58124021960203, -82.5007666127345 35.58120921959313, -82.50070161273774 35.581118219567905, -82.50046361275744 35.58073421946538, -82.50041561276133 35.58065721944481, -82.50031561277206 35.580480219398524, -82.49993161282325 35.57973421920731, -82.49986061282945 35.57961721917619, -82.49974961282857 35.57950321914161, -82.49968961282434 35.57946621912795, -82.49962061281798 35.579433219114094, -82.49955361281009 35.57941221910297, -82.49951061280407 35.57940521909713, -82.49948961280104 35.57940221909437, -82.4994016127869 35.57939921908476, -82.49931961277132 35.579412219078925, -82.49919461274509 35.57944821907339, -82.49910561272372 35.57949121907303, -82.49898161269267 35.57955921907406, -82.49879761264721 35.57965621907489, -82.49871861262844 35.579693219074365, -82.4986756126179 35.579715219074416, -82.49845861257099 35.57978621906647, -82.49837461255373 35.57980821906242, -82.49826461253396 35.57981821905308, -82.49807161249326 35.579874219044626, -82.49798761247543 35.57990021904128, -82.49793661246369 35.5799212190403, -82.49788761244818 35.5799692190451, -82.49788661244767 35.57997121904537, -82.49785661243506 35.580021219052455, -82.49783561242354 35.58007321906084, -82.49782061241149 35.58013521907188, -82.49778961238945 35.580245219091154, -82.49778861239237 35.58022521908694, -82.49777161239459 35.58019221907849, -82.49775661239659 35.58016321907102, -82.49771461239565 35.58012421905883, -82.49764861239076 35.580084219043925, -82.49759661238582 35.58006121903389, -82.49756261238244 35.58004621902736, -82.497496612375 35.58002321901592, -82.49739361236229 35.57999521899956, -82.49733161235443 35.57997921898996, -82.4972806123493 35.57995821898047, -82.49711361233537 35.579868218944995, -82.49683461231704 35.57968721887949, -82.49665561230508 35.57957221883769, -82.49653761226475 35.579707218852995, -82.49641861222578 35.5798322188662, -82.49623961216503 35.580034218888905, -82.4955916119439 35.58077221897244, -82.4952686118351 35.581131219012214, -82.49522661182057 35.58118021901793, -82.49503161175268 35.58141121904482, -82.49501061174485 35.58143921904834, -82.49488461169663 35.58161721907161, -82.49480661166345 35.58174821909025, -82.4947586116406 35.58184521910504, -82.49473061162553 35.58191321911595, -82.49471161161195 35.58198021912769, -82.49465861160144 35.5819922191247, -82.49444761156086 35.58202821911033, -82.49444261155972 35.58203021911023, -82.49442361155577 35.5820352191093, -82.49413061149538 35.582112219094846, -82.49395561146127 35.582145219083564, -82.49366161140605 35.58218721906187, -82.49339661135627 35.58222521904237, -82.49300761128323 35.58228121901375, -82.49265961121516 35.58234821899163, -82.49249061118412 35.58236821897836, -82.49226961115268 35.58233421894871, -82.49214761113788 35.58229921892901, -82.49191461111805 35.582177218880275, -82.49182361110883 35.58213921886315, -82.49169561109183 35.58211221884452, -82.49123961102835 35.58203321878161, -82.49108461100865 35.581994218757735, -82.49095861099194 35.58196721873932, -82.49084661097936 35.58192821871985, -82.49075361097165 35.581878218700105, -82.490682610965 35.58184521868615, -82.49061461095823 35.581815218673064, -82.4904926109486 35.58174721864668, -82.49044261095072 35.58167921862771, -82.49042761096065 35.58159821860967, -82.49044761098412 35.58146821858532, -82.49044861099024 35.581429218577476, -82.49043261100825 35.581295218548675, -82.49041361101682 35.5812192185312, -82.4903656110327 35.581064218494696, -82.49035761104552 35.580972218475154, -82.49036161106503 35.58085021845078, -82.49038361108823 35.58072321842723, -82.49046161116063 35.58033721835669, -82.49050161121158 35.58004921830228, -82.49051061123016 35.5799382182806, -82.4905086112486 35.57981621825563, -82.4904946112636 35.57970321823123, -82.49046661128111 35.5795602181992, -82.4904396113037 35.57938421816064, -82.4904276113425 35.57911921810552, -82.49044061135628 35.5790442180916, -82.49046861137133 35.57897621808064, -82.49052261139047 35.578910218072785, -82.4905836114086 35.57885821806847, -82.49067561143245 35.57880221806649, -82.49075861145005 35.57877721806995, -82.49086861147062 35.578762218078204, -82.49125861153095 35.57879021812399, -82.49132561154249 35.5787872181303, -82.49140761155948 35.57876521813421, -82.49148161157711 35.578730218134744, -82.49154261159659 35.57866921812855, -82.4916156116218 35.57858421811879, -82.49165161164191 35.578492218103754, -82.49165861165434 35.57841921808966, -82.49163061166125 35.578344218071514, -82.49152861166363 35.57821921803564, -82.49148161166612 35.57815221801711, -82.49143561167016 35.57807621799702, -82.49139261167649 35.57798921797491, -82.4913346116951 35.57780621793172, -82.49125161172779 35.57750421786178, -82.4912006117344 35.57740621783655, -82.49114061173806 35.57731821781252, -82.49105461173929 35.5772172177831, -82.49062961173507 35.57678721765199, -82.49051661173549 35.576663217615156, -82.490255611741 35.576346217523884, -82.490170611742 35.57624821749518, -82.49008961173874 35.57618221747346, -82.48982661172118 35.57601321741209, -82.48967961171442 35.5758982173736, -82.48962161171478 35.57583421735456, -82.48956161171702 35.575755217332365, -82.48951661172566 35.575650217306375, -82.48948461174027 35.575521217276886, -82.48948361175601 35.57541821725581, -82.48950161177552 35.575310217235696, -82.48950461177728 35.57530221723438, -82.48959461181842 35.575132217209074, -82.48976261188213 35.57489921717891, -82.48987561192828 35.57472121715439, -82.48992861195377 35.57461221713767, -82.48995561197503 35.574503217118284, -82.4899686119926 35.57440321709922, -82.48995261200415 35.57431121707895, -82.48992461201212 35.57422921705934, -82.48988761201537 35.57416821704311, -82.4898306120138 35.5741172170269, -82.48975561200669 35.57408221701208, -82.48963861199236 35.57404921699334, -82.48945261196516 35.57402621696953, -82.48921761192913 35.5740072169415, -82.48877461186345 35.57395721688585, -82.48865761184523 35.57394921687222, -82.48854761182572 35.57395721686252, -82.48843961180512 35.57397521685512, -82.48839161179458 35.57399221685356, -82.48833661178249 35.574011216851794, -82.48824761176162 35.574051216850776, -82.48813861173318 35.574118216853236, -82.48793161167649 35.574264216861685, -82.48785161165438 35.57432121686505, -82.48736061152158 35.57465521688244, -82.4872226114856 35.5747402168856, -82.48698961142667 35.57487221688849, -82.48679061137817 35.574973216888594, -82.48662861134241 35.57503121688373, -82.48653661132325 35.57505621687932, -82.48643561130207 35.5750852168749, -82.48630861127936 35.575096216864004, -82.48625061126955 35.57509721685836, -82.48615661125369 35.5750992168491, -82.48600461122864 35.57509821683321, -82.48590961121303 35.5750972168232, -82.48549461114426 35.57509721678062, -82.48543261113387 35.5750982167744, -82.48502461106303 35.57511921673677, -82.48483161102864 35.57513521672017, -82.48446561096131 35.575178216691285, -82.48432961093486 35.57520321668245, -82.4840606108816 35.57526021666635, -82.48398061086542 35.57527921666204, -82.48388761084627 35.57530321665731, -82.48349061076294 35.57541721663972, -82.48309761067593 35.575559216628186, -82.48306861066946 35.57557021662748, -82.48282461061706 35.575648216618255, -82.48258461056344 35.57573821661189, -82.48239061052094 35.575805216605545, -82.48225161049169 35.57584521659945, -82.4821246104661 35.575875216592465, -82.48191661042557 35.57591421657898, -82.48189961042245 35.57591621657766, -82.48175461039546 35.5759352165666, -82.48148461034661 35.5759622165444, -82.48128061030987 35.57598121652727, -82.48103661026302 35.57602321651073, -82.4809626102487 35.576036216505834, -82.48052461015905 35.5761472164833, -82.48020361009219 35.57623621646846, -82.47972260999369 35.576358216443786, -82.47937260992184 35.576448216426094, -82.47928560990371 35.57647221642206, -82.47921960989022 35.57648921641878, -82.47907460985999 35.57652921641197, -82.47902060984953 35.57653921640846, -82.47895460983636 35.576553216404534, -82.47895760984733 35.57648521639103, -82.47896960987912 35.576292216353, -82.47896960988075 35.576281216350786, -82.47897360989197 35.576213216337294, -82.47897760990261 35.57614821632452, -82.47897760990497 35.57613221632128, -82.47898160991328 35.57608321631168, -82.47899160994432 35.57589221627391, -82.47899660995746 35.57581221625814, -82.47900360998007 35.57567321623065, -82.47900560998701 35.575630216222095, -82.4790066099888 35.575619216219955, -82.47902761002885 35.57538221617388, -82.47904961005159 35.57525821615096, -82.47905061005237 35.57525421615023, -82.47906361006498 35.57518621613772, -82.47907661007699 35.5751222161261, -82.4790866100865 35.57507121611674, -82.47909761009605 35.57502121610774, -82.47913361011662 35.57492621609208, -82.47915261012696 35.57487921608457, -82.47918261014401 35.57480121607173, -82.47923361016761 35.57470221605683, -82.47930461019621 35.57459321604196, -82.47932461020403 35.57456421603809, -82.47942861024198 35.574429216021336, -82.47953961027875 35.57431021600851, -82.47968961032446 35.574174215996315, -82.47981561036022 35.574078215989694, -82.48000061041073 35.573949215982516, -82.48001461041453 35.57393921598198, -82.48028361048603 35.573764215974, -82.48028661048703 35.57376121597363, -82.48103961068462 35.573288215954896, -82.4811966107257 35.57319021595113, -82.48145661079636 35.573011215941484, -82.48163761084811 35.57287021593131, -82.48183361090672 35.572700215916946, -82.48210761099686 35.57240921588596, -82.48218561102496 35.57231121587398, -82.48234361108591 35.57208521584431, -82.48243361112512 35.57192721582138, -82.48250361115781 35.571790215800746, -82.48263861122814 35.571479215751346, -82.48271161126969 35.571287215719806, -82.48297361141834 35.57060421560784, -82.48303861145124 35.570460215585236, -82.48306061146221 35.57041221557772, -82.48318161151748 35.570183215543565, -82.48329761156793 35.56998121551447, -82.48371761173524 35.56934621542846, -82.48380161177025 35.569209215409245, -82.48392361182432 35.568989215377044, -82.48403161187697 35.56876321534222, -82.48408961190795 35.568624215319915, -82.48413461193425 35.568502215299695, -82.48417761196264 35.56836421527606, -82.48422561200164 35.56816221523987, -82.48425861202745 35.5680302152165, -82.4843526121066 35.567617215142064, -82.48444261217273 35.56728421508364, -82.48454261223489 35.566988215033774, -82.48461561227472 35.56680821500466, -82.48469061231312 35.56663921497798, -82.48476861235052 35.566480214953636, -82.48487061239724 35.56628621492467, -82.48498161244603 35.566089214896, -82.485182612528 35.5657722148522, -82.48530061257274 35.56560921483125, -82.48544361262324 35.5654352148105, -82.48569661270606 35.565169214782415, -82.48577661273087 35.56509421477536, -82.48587861276208 35.565001214766944, -82.48605361281412 35.564851214754434, -82.48618461285172 35.564748214747, -82.48647161293123 35.56454021473415, -82.48681861302259 35.564320214725086, -82.48715561310664 35.56413721472253, -82.48735061315404 35.5640392147226, -82.48773461324292 35.56387521472862, -82.48794961329118 35.56379321473405, -82.48818261334219 35.563712214741514, -82.48855061341968 35.56360521475759, -82.48876761346425 35.56354921476856, -82.48896861350394 35.5635072147806, -82.48920761355038 35.56346321479618, -82.4894596135981 35.563424214814134, -82.4896566136349 35.563397214828974, -82.49062661381514 35.563270214902715, -82.4910246138907 35.56320821493104, -82.4913336139521 35.56314221494933, -82.49165761401821 35.56306121496617, -82.4919556140816 35.5629702149783, -82.49220061413544 35.56288421498595, -82.49237061417332 35.562821214990656, -82.49241961418399 35.56280421499218, -82.49246861419549 35.562782214992744)))",6246,37,021,001900,370210019002,1494,1494,37,1475,1335,103,5,12,0,20,19,1289,28,1261,1279,1165,85,3,10,0,16,10,908,807,101
census_2010_blockgroups_view.fid--2dc29038_13ec899ba8f_-25c1,"MULTIPOLYGON (((-82.52683961022973 35.625521231288786, -82.52702061028374 35.6253652312757, -82.527563610446 35.62489823123644, -82.52774561050008 35.62474323122366, -82.52777461050893 35.62471723122136, -82.5278646105357 35.62464023121488, -82.52789461054458 35.62461523121286, -82.52797261056094 35.6245932312165, -82.52806961058086 35.624568231221375, -82.52819961061137 35.62451023122295, -82.52822561061741 35.624499231223346, -82.52827461062876 35.62447823122416, -82.52842761066437 35.6244122312264, -82.52851861068254 35.6243922312317, -82.52870961072058 35.62435123124302, -82.52906361078928 35.62428623126615, -82.52925561082786 35.6242432312772, -82.52928361083386 35.62423423127821, -82.52935261084842 35.624214231281215, -82.52942261086571 35.62417723128087, -82.5295116108904 35.62411323127703, -82.5295636109052 35.624073231274274, -82.52967861093741 35.623988231268825, -82.52972261094934 35.62395823126717, -82.52974461095515 35.62394423126661, -82.52977861096367 35.623925231266256, -82.52982661097577 35.6238982312657, -82.52995961100481 35.623853231270196, -82.53012661103965 35.62380723127799, -82.53021061105932 35.62377023127912, -82.53029161107925 35.62372823127894, -82.5303416110929 35.623693231276896, -82.53039061110593 35.623661231275435, -82.53068561118948 35.62343723126018, -82.53078561121443 35.62338323125946, -82.53094261125078 35.62331623126199, -82.53097261125826 35.623300231261844, -82.53100961126857 35.62327323126012, -82.5310366112771 35.62324723125766, -82.53106361128863 35.62320123125104, -82.53117561134705 35.62294323121003, -82.53121761136974 35.622841231193604, -82.53126061139965 35.62269323116796, -82.5312926114314 35.62252223113639, -82.53130361145539 35.62237823110823, -82.53129061146716 35.62228823108854, -82.53127861147892 35.62219923106931, -82.53127561149364 35.62210023104872, -82.53127961150093 35.62205723104045, -82.5312976115132 35.62199723103002, -82.5313216115243 35.6219512310232, -82.53135561153594 35.621912231018754, -82.53144061156205 35.621834231011604, -82.5315066115843 35.62176123100352, -82.53158561157211 35.621925231045054, -82.53161161156858 35.621976231058085, -82.53163061155388 35.6220922310837, -82.53163461155067 35.62211723108916, -82.53165461154325 35.622186231105275, -82.53170161153521 35.622289231131, -82.53174861153055 35.62237023115238, -82.53179061152622 35.622443231171545, -82.53188261152145 35.622573231207454, -82.53195761151592 35.622690231239005, -82.53202361151236 35.6227842312649, -82.5320826115112 35.622855231285435, -82.53214661151296 35.622912231303545, -82.53222661152054 35.62294923131936, -82.53236961153718 35.62299523134339, -82.53237861153819 35.622998231344944, -82.53248261155164 35.62302323136076, -82.5326686115777 35.62305423138614, -82.53272361158552 35.62306323139369, -82.53281261159577 35.62309223140874, -82.5329086116006 35.6231642314332, -82.53295061160264 35.62319623144402, -82.53300861160795 35.62322423145576, -82.53309061161954 35.6232372314668, -82.53334761166685 35.62320723148712, -82.53341561167845 35.62320523149364, -82.53352561169572 35.62321123150624, -82.53361261170728 35.62323023151903, -82.53371661171934 35.62326423153664, -82.53379161172501 35.62330823155335, -82.53383061172141 35.62337323157059, -82.53385761170811 35.62348823159679, -82.5338976116772 35.62373223165052, -82.53389361164263 35.62395223169484, -82.53383761160272 35.62415023172935, -82.53364961151813 35.624496231780526, -82.53362361149351 35.62462823180472, -82.53365561147955 35.62475323183339, -82.53374961146831 35.62492723187847, -82.53378261146432 35.624988231894314, -82.53380161145691 35.625057231910304, -82.53379961139376 35.625464231992915, -82.53388861136794 35.62572723205563, -82.53404061130198 35.62631823219151, -82.53404261129064 35.626394232207204, -82.53401261126989 35.62649623222489, -82.53399861124566 35.62663823225232, -82.53401561121608 35.6268482322968, -82.53404361120467 35.62695223232086, -82.53413561119726 35.627099232360294, -82.53424961120575 35.62716723238578, -82.53433961121881 35.62717923239751, -82.53444861123693 35.627179232408736, -82.53463861127366 35.627145232421306, -82.5348076113161 35.62705223241979, -82.53486161133547 35.626985232411684, -82.53490661137185 35.626797232378074, -82.53491061138854 35.62669323235729, -82.53488361141778 35.626475232310185, -82.5348226114202 35.626393232287164, -82.53477861141803 35.62636023227591, -82.53462661139666 35.626335232255215, -82.5345646113898 35.6263132322444, -82.53452961138733 35.62629123223634, -82.53452061139126 35.626256232228265, -82.53453061139741 35.62622723222341, -82.5345846114116 35.62619323222207, -82.53473561143747 35.62618823223647, -82.53483561144975 35.626216232252496, -82.53498561145983 35.62631223228747, -82.5350616114572 35.626411232315455, -82.53516961143792 35.62665223237555, -82.53522861141457 35.626867232425404, -82.53523661140017 35.626969232446996, -82.53523561137717 35.627117232477005, -82.53518661131409 35.627473232544446, -82.53507661124985 35.6277712325938, -82.53502961123279 35.62783123260111, -82.53480261116951 35.627997232611584, -82.53468161113983 35.62805923261178, -82.53462961113085 35.62806123260679, -82.53450961111575 35.628030232588195, -82.53439261110354 35.627983232566535, -82.53402561107907 35.6277472324808, -82.53377061105235 35.627646232433996, -82.53328361100723 35.627414232336704, -82.5331756109937 35.62738623231994, -82.5329146109485 35.62739823229552, -82.53281361092908 35.62741523228861, -82.53271561090757 35.62744923228542, -82.53269361090203 35.62746123228565, -82.53261961088263 35.62750723228734, -82.5322896107762 35.62784223232167, -82.53201261070357 35.628015232328316, -82.53182461064354 35.62820223234706, -82.53178361063294 35.62822623234772, -82.53174161062499 35.6282332323448, -82.53168361061705 35.628222232336626, -82.53165261061477 35.62820323232964, -82.53159761061843 35.628120232307054, -82.53156961065731 35.62783823224669, -82.53161461069163 35.62766423221597, -82.53154361070597 35.62749523217432, -82.53152761072084 35.627381232149375, -82.5315506107352 35.62731323213799, -82.53174361080146 35.62709123211263, -82.5318256108327 35.62697723209781, -82.5318266108402 35.626929232088195, -82.53180661084258 35.626892232078575, -82.53177761084044 35.62687523207213, -82.53173761083382 35.62687523206801, -82.53169261082354 35.62689323206709, -82.53139061074208 35.627096232077385, -82.53048461049762 35.627706232108245, -82.53018361041619 35.62791023211887, -82.53010261039256 35.62797623212391, -82.52988661033635 35.62810823212864, -82.52972561029692 35.62819023212878, -82.52964461028012 35.62821223212487, -82.52952361025152 35.62826723212365, -82.52932861019029 35.628454232141635, -82.52919361014337 35.628613232160085, -82.52912661010512 35.62878923218906, -82.52897161003523 35.62907523223128, -82.52890361000021 35.629229232255696, -82.52871560992747 35.62949823229107, -82.52863460988951 35.629657232315054, -82.52856760984953 35.62984423234625, -82.52850660980633 35.63005823238346, -82.52844560977435 35.63020023240612, -82.5283486096758 35.63073423250488, -82.5290786097981 35.630727232578494, -82.52940660961892 35.63224123292037, -82.52942160961717 35.632268232927395, -82.52948160960187 35.63243223296695, -82.52951460959366 35.63252123298844, -82.52958260959223 35.63260323301209, -82.52977060959728 35.632773233066104, -82.52984860960659 35.63279623307881, -82.53003360962904 35.63285023310882, -82.53005660963116 35.632861233113395, -82.53039460963274 35.63321423321998, -82.53061360966214 35.63325923325166, -82.53078760968432 35.633303233278525, -82.53091360969917 35.63334223329943, -82.53097860970682 35.633362233310145, -82.53112260971925 35.63343723334029, -82.53125360972416 35.63354623337591, -82.53144260972245 35.63376023343885, -82.53168760972638 35.63399823351254, -82.53177160973343 35.6340432335303, -82.53182160973796 35.63406723354034, -82.53185760974091 35.634087233548115, -82.5318976097446 35.63410623355609, -82.5320026097568 35.634140233573795, -82.53222860978629 35.63419223360765, -82.53275060985423 35.63431323368599, -82.53293460987813 35.634356233713646, -82.53316360990588 35.634423233750844, -82.53352260994926 35.63452823380915, -82.53414261002901 35.63467823390346, -82.53434561005209 35.634747233938334, -82.53439961005793 35.63476723394798, -82.53459561007895 35.6348422339834, -82.53480261010239 35.63491323401911, -82.534878610111 35.63493923403229, -82.53501461012645 35.63498523405562, -82.53510561013508 35.63502723407351, -82.53517661014175 35.635060234087504, -82.53517961014205 35.635061234088006, -82.53521661014562 35.6350782340953, -82.53532661015554 35.635132234117606, -82.53536361015892 35.6351502341251, -82.53569261017942 35.635371234203916, -82.53577061018431 35.63542323422255, -82.53587161019061 35.63549123424676, -82.53649361020715 35.63605323442508, -82.5366096102147 35.63612923445248, -82.53681461022784 35.63626423450103, -82.53695061023984 35.63633323452912, -82.53719561026121 35.63645823457968, -82.53727761026201 35.63654123460503, -82.5374596102642 35.6367232346608, -82.53764661026167 35.63694023472419, -82.53779661026192 35.637100234772284, -82.537896610264 35.63719423480161, -82.53795961026856 35.63723223481585, -82.53802061027716 35.637242234824164, -82.53812661029603 35.63723423483344, -82.5381596103031 35.63722423483478, -82.53831861033639 35.637179234841966, -82.5385306103844 35.63709623484685, -82.53857261039434 35.63707723484731, -82.53869861042337 35.63702423484951, -82.53873461043169 35.63700923485015, -82.53874161043314 35.637007234850515, -82.53879761044529 35.63698923485256, -82.53886261045932 35.636968234854955, -82.53888161046281 35.63696623485653, -82.53901961048764 35.636953234867995, -82.53915561050668 35.63697623488673, -82.53929561052226 35.637026234911275, -82.53930961052369 35.637032234913946, -82.53940761053332 35.637075234932794, -82.53944261053618 35.63709423494025, -82.53951161054155 35.63713323495531, -82.53993661055885 35.63747823506926, -82.54028661057013 35.63778223516716, -82.54053361057517 35.63801523523996, -82.54068961058726 35.638104235274106, -82.54110461061983 35.63834023536482, -82.54115761062373 35.63837223537678, -82.54125461063043 35.63843223539895, -82.54129661062949 35.638484235413834, -82.54138961062701 35.63860023544703, -82.54167161061986 35.63895023554729, -82.54171561061881 35.63900423556278, -82.54176361061677 35.639069235581005, -82.54168961059972 35.63910023557972, -82.54150261055601 35.63918223557713, -82.54146861054802 35.63919723557673, -82.54139561053077 35.639230235575944, -82.54127761050317 35.639282235574356, -82.5409266104207 35.639439235570194, -82.54081161039274 35.63949623557001, -82.54070861036796 35.63954623556954, -82.54055561032737 35.639644235573726, -82.54044261029229 35.63975023558374, -82.54037561026678 35.639843235595706, -82.54034361025451 35.639888235601646, -82.54030161023442 35.639973235614576, -82.54025161019752 35.64015823564709, -82.5402346101668 35.64033923568221, -82.54020961013724 35.640504235713266, -82.54016161010752 35.64064523573703, -82.54009661007657 35.64077523575674, -82.53998861003508 35.64092823577677, -82.5398946100026 35.641037235789334, -82.5397666099587 35.6411842358061, -82.53960860990115 35.641387235831175, -82.53958860989252 35.64142123583602, -82.53947660984385 35.641616235864184, -82.53940760980564 35.641789235892304, -82.53934160976317 35.641993235927025, -82.53929560973685 35.642114235946906, -82.53922860970805 35.642229235963455, -82.53915060967765 35.642342235978376, -82.53905760964795 35.642434235987594, -82.53886860959183 35.642594236000654, -82.53881260957574 35.642638236003855, -82.53857460950636 35.642832236018904, -82.53842260946485 35.6429372360246, -82.5383146094381 35.64299423602516, -82.5382046094149 35.64302623602037, -82.53808660939318 35.643040236011004, -82.53802660938432 35.64303323600342, -82.53793960937124 35.64302423599267, -82.53743060930785 35.642887235912454, -82.53714960927415 35.642803235866396, -82.53695960924954 35.642758235837725, -82.53684560923342 35.6427402358223, -82.53681760922865 35.64274123581966, -82.53674860921652 35.64274523581336, -82.53664360919635 35.64276323580624, -82.53656660917981 35.642787235803176, -82.53642960914488 35.64286623580517, -82.53618760907848 35.64303623581484, -82.53610360905621 35.64309023581722, -82.53602260903686 35.64312823581661, -82.53592360901655 35.643153235811575, -82.53582360899824 35.64316423580345, -82.53578060899163 35.64316123579842, -82.53572460898282 35.64315823579206, -82.53559260896665 35.64312023577074, -82.53535060894426 35.64300523572251, -82.53381560881232 35.64220923540255, -82.5335996087937 35.642097235357554, -82.53321160875906 35.64190423527836, -82.53316260875411 35.64188423526922, -82.53297360873465 35.64180623523394, -82.53295660873277 35.641800235230924, -82.53281560871623 35.641756235207474, -82.53257360868186 35.641718235174785, -82.53242260865902 35.64170423515647, -82.53230360863999 35.64169923514319, -82.53208260860468 35.64169023511866, -82.53192560857909 35.641687235101905, -82.53167160853752 35.641683235074936, -82.53152360851281 35.64168423505994, -82.53145760850187 35.64168423505315, -82.53143460849809 35.6416842350508, -82.53130260847453 35.64169423503922, -82.53112660844286 35.64171023502438, -82.5308166083854 35.6417492350004, -82.52960460815997 35.64190623490766, -82.52936360811513 35.64193723488921, -82.52887960802475 35.642002234852654, -82.52866060798407 35.64203023483575, -82.52825560790855 35.64208423480512, -82.52800660786082 35.64212523478787, -82.52792060784427 35.64214023478201, -82.52779060781819 35.64216923477459, -82.52740660774097 35.64225623475279, -82.526880607635 35.64237723472326, -82.52625660750881 35.642523234688774, -82.52603860746466 35.64257523467694, -82.52587360743155 35.64261223466754, -82.52582560742198 35.6426222346646, -82.5256846073936 35.64265423465661, -82.52563760738397 35.642666234654165, -82.52522360730106 35.64275823463036, -82.52506660726964 35.64279323462138, -82.5247166072007 35.64286323459958, -82.52411760708534 35.64296623455883, -82.52397360705825 35.64298723454834, -82.52355460697913 35.64304923451781, -82.52342760695518 35.64306723450843, -82.52304960688409 35.64312123448056, -82.52292360686035 35.64314023447144, -82.52283660684398 35.643152234465, -82.5226466068081 35.643180234451115, -82.52257860679501 35.64319223444654, -82.52249360677835 35.64320823444111, -82.52245060676995 35.643217234438445, -82.52234560674894 35.64324023443232, -82.52232260674388 35.6432482344316, -82.52228160673472 35.643263234430414, -82.52214060670296 35.643317234426924, -82.52201560667378 35.643372234425186, -82.52191060664786 35.6434272344256, -82.52151860655091 35.643633234427185, -82.52083660638094 35.64400123443191, -82.52055260630988 35.64415623443426, -82.52047960629186 35.644194234434494, -82.52019160622037 35.64434723443595, -82.51954560605975 35.644693234439885, -82.51932460600638 35.64480123443918, -82.51919160597413 35.6448672344389, -82.51903060593577 35.64494223443756, -82.51893460591296 35.64498723443692, -82.5189096059072 35.644997234436325, -82.51854260582238 35.64515223443006, -82.51842060579395 35.645205234428346, -82.51817760573756 35.64530923442451, -82.51807960572205 35.645304234413395, -82.51722860557668 35.645331234331366, -82.51712260555833 35.64533623432142, -82.51600460536426 35.645391234217556, -82.5144636050989 35.64545323407164, -82.51395960501166 35.6454762340244, -82.51360260494978 35.64549323399118, -82.51290560482983 35.64552123392509, -82.5126346047833 35.645531233899284, -82.51217460470434 35.64554823385539, -82.51183260464559 35.64556123382288, -82.51182160464374 35.64556123382173, -82.51155160459523 35.645585233798776, -82.51153860459291 35.64558623379767, -82.5113826045639 35.645606233785635, -82.51128760454675 35.64561523377773, -82.51105060450335 35.64564123375863, -82.51049860440152 35.645708233715496, -82.5102356043529 35.645740233694866, -82.50977760426804 35.645797233659366, -82.50880560408756 35.64592123358455, -82.50860560405012 35.645949233569674, -82.50845060401882 35.645985233561085, -82.5084076040104 35.64599323355824, -82.50818760396693 35.646038233544786, -82.50795760392016 35.64609423353248, -82.50755260383785 35.646192233510796, -82.5069246037087 35.646353233478884, -82.50617660355415 35.64655023344198, -82.50555460342548 35.64671523341152, -82.5052986033743 35.64677123339653, -82.50519160335352 35.646791233389614, -82.50506860333036 35.646809233380644, -82.50481560328535 35.64682823335844, -82.50445160322518 35.64682723332084, -82.5041916031857 35.646803233289155, -82.50374660312099 35.64674423323132, -82.50321860304544 35.64666623316115, -82.50306260302172 35.646652233142255, -82.50295360300423 35.64664823313021, -82.50291160299737 35.646647233125655, -82.50281460298089 35.646650233116276, -82.50272460296372 35.64666423310992, -82.50258760293512 35.6467022331035, -82.50247060290883 35.646747233100626, -82.50169760271272 35.64718623311036, -82.50142960264321 35.64734823311576, -82.50123460259584 35.64744523311544, -82.5011716025812 35.64747223311443, -82.50101660254985 35.64750923310598, -82.5009136025301 35.647526233098844, -82.50083960251578 35.647539233093866, -82.50062860247169 35.64759823308422, -82.50056060245564 35.6476292330835, -82.50047760243247 35.64769023308733, -82.50025160236709 35.64787023310065, -82.5000516023041 35.64806323311937, -82.50000660228648 35.64812923312819, -82.49988560222883 35.64837223316514, -82.49981260219249 35.6485292331896, -82.4997686021614 35.64868323321637, -82.49975260214129 35.648796233237746, -82.49974860213645 35.64882323324282, -82.49975260211232 35.6489832332758, -82.49977760209765 35.649105233303224, -82.4998216020856 35.64923023333316, -82.49988160208166 35.649320233357635, -82.49996860208466 35.6493942333817, -82.50007860209367 35.649454233405194, -82.50020660211075 35.64948123342382, -82.50046160214826 35.64951223345641, -82.50068960218054 35.649548233487174, -82.50071560218393 35.649554233491074, -82.50081060219603 35.649578233505736, -82.50090060220396 35.649623233524174, -82.50094660220017 35.64969723354394, -82.50095560219196 35.64976023355773, -82.50092860217802 35.64982123356729, -82.50087660216303 35.64986223357038, -82.50080260214739 35.64988423356716, -82.50072860213497 35.64988523355979, -82.50064760212642 35.649853233544924, -82.50054060212105 35.64977323351765, -82.50045860211378 35.649732233500906, -82.50038760210414 35.64971823349072, -82.50030160208802 35.64973023348427, -82.50023360206998 35.64977423348622, -82.50017360205119 35.649831233491604, -82.49999460200097 35.64996423350027, -82.4999076019785 35.65001623350188, -82.49984360196297 35.650048233501785, -82.49973260193971 35.65007923349672, -82.49964360192277 35.650093233490374, -82.49955660190759 35.65009823348247, -82.49945660189154 35.65009423347134, -82.49938160188175 35.650077233460166, -82.49928660187274 35.650033233441455, -82.49918060186111 35.649995233422814, -82.49907660184797 35.64996823340659, -82.49896860183257 35.64995223339222, -82.49883360181033 35.64995123337812, -82.49869360178428 35.64996923336734, -82.49844560173482 35.65002323335283, -82.49822960168906 35.65008723334366, -82.4981576016744 35.65010523333989, -82.49809260166313 35.65010823333379, -82.4980366016577 35.65008323332291, -82.49797760165406 35.65004323330867, -82.49790860165417 35.649968233286344, -82.49784760166276 35.64984723325548, -82.49785760167289 35.64979223324535, -82.49789860169177 35.64971423323373, -82.49791660170375 35.64965623322371, -82.49791260171202 35.64959823321154, -82.49789560171682 35.649549233199814, -82.4978256017145 35.64948923318042, -82.49775360170503 35.64947323316971, -82.49773660170261 35.6494702331673, -82.4976196016815 35.64948123315751, -82.49752860166065 35.64951823315568, -82.49744760163414 35.64960323316467, -82.4973736016004 35.64974223318536, -82.49733760156904 35.649906233214956, -82.49733060155326 35.65000123323355, -82.49733960152626 35.65018523327192, -82.49740960148732 35.65051223334569, -82.4974216014737 35.65061323336748, -82.49741460146565 35.650658233375886, -82.49741360146358 35.650670233378214, -82.49737560144848 35.650727233385915, -82.4973006014303 35.65076423338572, -82.49722260141485 35.65078023338097, -82.49714460140339 35.65077123337112, -82.49706360139629 35.65073023335435, -82.49702360139719 35.65068123334033, -82.49699960140526 35.65060323332195, -82.49701060142405 35.65049323330076, -82.49702060143998 35.65040123328304, -82.49702760146447 35.65025023325303, -82.49701960147654 35.650163233234466, -82.49699560148515 35.65008223321557, -82.49693960149193 35.64997823318863, -82.49686860149109 35.64990723316692, -82.49679660148497 35.649869233151755, -82.49669160147253 35.64983723313447, -82.49652960144893 35.64981623311344, -82.49641960143394 35.64979523309784, -82.49634660142829 35.64975323308185, -82.49632460143377 35.64969423306756, -82.49632860144474 35.649627233054346, -82.49635760146317 35.64953923303944, -82.49651360151853 35.64934823301667, -82.49655460154001 35.649253233001524, -82.49658860156862 35.64910523297489, -82.49659460158423 35.649010232956186, -82.49660360160244 35.648902232935164, -82.49658460162071 35.64876323290493, -82.49655560163043 35.648669232882824, -82.49648460163567 35.64855923285316, -82.49639960163951 35.648443232820746, -82.49637960164247 35.64840223281037, -82.49636960164423 35.64838023280489, -82.49636960165171 35.648332232795184, -82.49639560166477 35.64827523278618, -82.49643860167886 35.648230232781486, -82.49651660169705 35.64819623278256, -82.49666360172435 35.648177232793856, -82.49680760175032 35.64816423280603, -82.49690560176977 35.64814323281186, -82.49697160178798 35.648096232809095, -82.49699660179928 35.64805023280228, -82.49700560180781 35.6480042327939, -82.49697960181116 35.64795523278122, -82.49691260180585 35.647917232766595, -82.49681360179063 35.64790923275478, -82.49668660176438 35.64794323274862, -82.49651260172423 35.64801623274554, -82.49632860167765 35.64812023274773, -82.4961776016393 35.64820623274975, -82.49608860161385 35.6482752327546, -82.49607260160774 35.648297232757436, -82.49605660160178 35.64831923276028, -82.4960376015862 35.64839923277457, -82.49604160157841 35.64845423278615, -82.49605960156869 35.64853623280478, -82.49606860155788 35.64861623282188, -82.49606860154505 35.648699232838815, -82.49605860153113 35.648778232853815, -82.49603160151474 35.648855232866694, -82.4959846014965 35.64892323287568, -82.4958686014582 35.649046232888786, -82.49547560133199 35.64944123292871, -82.49534160128752 35.649585232944176, -82.49525060125697 35.64968523295518, -82.4950506011933 35.64988223297468, -82.49495460116191 35.6499822329851, -82.49491160114388 35.65005323299512, -82.49489160113127 35.65011323300525, -82.49490960112432 35.65017723302015, -82.49496260112633 35.65022123303455, -82.49502360113212 35.650249233046544, -82.49527560116478 35.650308233084466, -82.49544360118544 35.65035523311134, -82.4956036012007 35.65042823314267, -82.49571560120786 35.65050223316928, -82.49576860120764 35.65056023318654, -82.4957906012024 35.65061823320055, -82.4957956011924 35.65068823321529, -82.49577560117672 35.650768233229535, -82.49575060116159 35.6508392332414, -82.49565760111263 35.65105623327597, -82.49558060106781 35.651263233310196, -82.49555160104889 35.65135523332593, -82.495546601036 35.65143323334124, -82.4955616010313 35.65147923335216, -82.49559560102897 35.65153123336624, -82.49577060103404 35.6516862334158, -82.49594560102952 35.65190323347791, -82.49592260100502 35.65203723350287, -82.49578060094818 35.65225223353198, -82.49591260094643 35.6524052335767, -82.49643760099721 35.652640233678575, -82.49710560110546 35.652657233750766, -82.49717660109124 35.65282523379223, -82.49702560105358 35.65290723379343, -82.49681360101638 35.65292023377419, -82.49629260095823 35.652737233683354, -82.49561360085107 35.65270123360608, -82.49544860083999 35.65259623356773, -82.49515560085298 35.65219723345648, -82.49513160090665 35.65182423337811, -82.49492160090354 35.6516192333148, -82.4948006008989 35.65151923328191, -82.49475260090186 35.6514482332626, -82.49475260091491 35.65136423324546, -82.49477260092912 35.651293233233076, -82.49478560094153 35.651227233221015, -82.49478660095265 35.65115623320668, -82.49474860095751 35.65108423318807, -82.49467760095514 35.65102323316839, -82.49458060094629 35.65097623314883, -82.49426160090033 35.650931233106824, -82.49388060084159 35.65090223306174, -82.49370560081577 35.65088123303938, -82.493530600788 35.650873233019816, -82.49327160075154 35.6508312329846, -82.4931496007375 35.6507912329639, -82.4930416007265 35.650746232943575, -82.49294660071986 35.65068723292181, -82.49284760071399 35.6506192328978, -82.4927526007117 35.65053223287032, -82.49269760071655 35.65044123284614, -82.49267260072553 35.65035623282633, -82.4926886007366 35.65030223281693, -82.49275660075884 35.650231232809496, -82.49314760086618 35.64995623279377, -82.4933196009176 35.64980823278141, -82.4934146009499 35.64970123276944, -82.49345660097387 35.649591232751426, -82.49348060099608 35.64947323272987, -82.49346960101543 35.64933623270081, -82.49344060103068 35.64920623267137, -82.49337660104197 35.64906423263597, -82.49330160104512 35.64896323260767, -82.49318560104389 35.648847232572145, -82.49301960103581 35.648721232529425, -82.49262160101432 35.648432232429634, -82.49248160100879 35.648318232392086, -82.49237960100348 35.648243232366276, -82.49231960100124 35.64819323234994, -82.49220060099674 35.64809423231757, -82.49207660098658 35.64802723229117, -82.4919626009738 35.64798723227123, -82.49181160095341 35.64795723224958, -82.49177260094767 35.64795223224458, -82.49157060091814 35.6479272322187, -82.49158360092477 35.64789823221412, -82.49157960093446 35.64783123220009, -82.49156060094067 35.64777023218572, -82.49155360094328 35.64774623218012, -82.49139160097604 35.64736023208497, -82.49137860098018 35.647319232075276, -82.4913556009883 35.64724223205723, -82.49133860099771 35.647163232039446, -82.49133460100009 35.647143232034914, -82.49132660101452 35.64704123201331, -82.49132960103033 35.64694223199356, -82.49134160104994 35.646828231971604, -82.49135760106142 35.64677123196158, -82.4913876010824 35.64666723194363, -82.491418601099 35.646593231931746, -82.49147860112639 35.64648023191488, -82.49155060115547 35.646369231899754, -82.491628601187 35.646249231883345, -82.49166260120386 35.646176231871976, -82.49173060124471 35.645985231840186, -82.49179060127457 35.64585623182007, -82.49182960129123 35.64579023181064, -82.49188060131002 35.645723231802265, -82.49188460131151 35.64571823180169, -82.49214960139594 35.645456231775654, -82.49216460140107 35.6454392317737, -82.49230160144762 35.64528523175652, -82.49231460145235 35.6452682317544, -82.4923806014763 35.64518423174411, -82.49254660154546 35.64491423170629, -82.49259460156367 35.64484823169774, -82.49265160158212 35.6447902316918, -82.49271360160073 35.644736231687205, -82.49272360160359 35.644728231686614, -82.49279760162356 35.64467823168406, -82.49288260164514 35.644630231683045, -82.49291960165378 35.64461423168361, -82.49297060166565 35.644592231684406, -82.49308960169208 35.64454823168771, -82.49325860172603 35.64451023169733, -82.49329860173424 35.644500231699396, -82.49344760176402 35.644467231708106, -82.49351560177904 35.64444323171016, -82.49356560179136 35.64441723171, -82.49362460180748 35.64437623170774, -82.49366960182172 35.64433223170345, -82.4937496018491 35.644241231693194, -82.49387560190127 35.644038231664865, -82.49394160193732 35.643876231638664, -82.49395760195262 35.643794231623616, -82.49395460196615 35.64370323160485, -82.49394160197443 35.64363623158986, -82.49388660201039 35.64334423152484, -82.49388260202517 35.64324423150408, -82.49389260204005 35.643158231487575, -82.49392360206201 35.64304923146861, -82.49399860210426 35.64285623143707, -82.49422560222627 35.64231023134934, -82.49431160227512 35.64208623131262, -82.49439360231978 35.64188523128017, -82.49441060232897 35.641844231273595, -82.49442360233586 35.641813231268614, -82.49448660236895 35.64166723124539, -82.49465460243968 35.641389231206105, -82.49469260246028 35.64129723119141, -82.49470760247654 35.64120823117481, -82.49471560249401 35.641103231154254, -82.49469260251261 35.64095823112237, -82.49463960253159 35.640778231080304, -82.49458560254841 35.640611231040815, -82.49450160256396 35.64042023099323, -82.49444060257395 35.64029023096056, -82.4943726025803 35.640176230930386, -82.49423460258923 35.639970230874205, -82.49415860259143 35.639874230846914, -82.49404560259221 35.639748230809644, -82.49338460259455 35.639023230594134, -82.49322960259427 35.63885823054456, -82.4931496025911 35.63879323052312, -82.49306060258495 35.638737230502606, -82.49297860257703 35.63870023048658, -82.49288760256671 35.63866923047093, -82.4927396025471 35.638637230449206, -82.49247160250948 35.63859323041267, -82.49237860249774 35.638569230398275, -82.49236260249569 35.63856523039583, -82.49227160248358 35.638546230382545, -82.4920936024645 35.63847823035038, -82.49184160244526 35.638332230294736, -82.49147660242178 35.63809223020834, -82.49144360242221 35.638054230197284, -82.49135660242288 35.63795623016832, -82.49131160243539 35.63782723013748, -82.49135560249101 35.637514230078324, -82.49145560254506 35.63727123003924, -82.49169660264214 35.63690222998899, -82.49193560273811 35.63653722993925, -82.49206760278389 35.63638222992135, -82.4923146028451 35.63625122992013, -82.49273760293212 35.63614222994148, -82.49313360299809 35.63614022998186, -82.49332560302653 35.63616223000602, -82.4939106031129 35.63623123008033, -82.49411460314924 35.63621523009809, -82.4943916032054 35.63614923011311, -82.49456660324087 35.636107230122605, -82.49517360333971 35.6361192301875, -82.49547160339272 35.63609623021348, -82.49580360346025 35.6360152302312, -82.49601360350805 35.635931230235634, -82.4967506036932 35.63552423022875, -82.49689760372418 35.635481230235065, -82.4973466038077 35.63542323026949, -82.49745760383189 35.635385230273165, -82.4976346038792 35.63526923026783, -82.4985786041865 35.634293230166406, -82.49874060424453 35.634091230142026, -82.49881960428863 35.63389023010921, -82.49884960431918 35.63372523007877, -82.49892060449027 35.632693229876075, -82.49898360452798 35.632516229846566, -82.4990566045522 35.6324382298382, -82.49918860458546 35.63236422983681, -82.50119260500605 35.63179322992677, -82.50141460505972 35.631684229927494, -82.50155960510322 35.63155822991676, -82.50163560513529 35.63143222989896, -82.50168160516219 35.63130722987827, -82.50168860518527 35.63116522985003, -82.50168160522124 35.630925229800546, -82.50168860524177 35.63079922977559, -82.50173460526409 35.630704229761015, -82.501810605288 35.630631229753945, -82.50191760531447 35.63057422975343, -82.50220760537267 35.63050922977003, -82.5029556055185 35.63036822981827, -82.50311160555154 35.630322229824955, -82.50327960559252 35.63023722982502, -82.50341360563097 35.630132229817335, -82.50365260570335 35.629920229798834, -82.50380460574041 35.62984322979878, -82.50398260577562 35.629806229809596, -82.50425760582529 35.62978022983262, -82.5060666061418 35.62967422999718, -82.50651960622157 35.62964423003763, -82.50657160623068 35.62964123004238, -82.50658560623344 35.62963823004323, -82.50673160626198 35.62961023005255, -82.5067796062733 35.629588230052974, -82.50681760628228 35.62957123005346, -82.50683860628804 35.62955623005253, -82.5069416063164 35.62948323004832, -82.50702160634516 35.62938323003617, -82.50705460636422 35.629295230021626, -82.50704160637603 35.62920423000183, -82.5069776063835 35.629087229971496, -82.50679160638687 35.628865229907156, -82.50673660639069 35.62878122988444, -82.50670960639293 35.62873822987291, -82.50666760640337 35.628625229845575, -82.50665560641234 35.62855422982988, -82.50665960642768 35.62845922981098, -82.50669060644888 35.62835522979299, -82.50676060648206 35.628215229771726, -82.50684960651384 35.62810522975847, -82.50696660654867 35.628005229750165, -82.50715960659629 35.62790422974946, -82.50860960693188 35.627288229773356, -82.50872960695766 35.62725022977793, -82.50879760697177 35.6272322297813, -82.50880760697366 35.62723022978192, -82.50886560698444 35.62722322978642, -82.50892660699469 35.62722222979245, -82.50906160701385 35.627243229810624, -82.50914660702405 35.62726822982446, -82.50933460704412 35.62734022985849, -82.50950760706034 35.62742122989272, -82.50969960707681 35.627521229932796, -82.50974360708034 35.627545229942285, -82.50985460709127 35.627594229963684, -82.50996860710396 35.627634229983535, -82.51005860711572 35.62765522999707, -82.51016460713124 35.62766823001058, -82.51027160714976 35.627663230020545, -82.51036660716896 35.627641230025866, -82.51047560719446 35.627593230027294, -82.51051560720526 35.62756623002592, -82.51054760721378 35.62754523002496, -82.5106116072343 35.62748123001851, -82.51065460725158 35.627415230009525, -82.51069560727277 35.62732222999483, -82.5107116072942 35.627200229971656, -82.51070160735628 35.626787229886546, -82.51069660738878 35.626571229842114, -82.51068560742758 35.62630822978749, -82.51069060744493 35.62620122976619, -82.5107066074633 35.62609922974707, -82.51073560748667 35.62597922972569, -82.51081860754202 35.625709229679266, -82.51091060760642 35.62539122962409, -82.51098260766389 35.62509622957147, -82.51101660769804 35.624911229537275, -82.51119560785345 35.62409622938992, -82.51121060787871 35.6239492293615, -82.51119460789313 35.623838229337316, -82.51117060790092 35.623762229319375, -82.51114960790284 35.62372722931012, -82.51105260790678 35.623597229273635, -82.510994607907 35.623533229254676, -82.51097460790882 35.62350022924591, -82.51094960791576 35.62342822922866, -82.51095460792179 35.623394229222285, -82.51098960793658 35.62333622921404, -82.51101960794563 35.62331022921186, -82.51106360795687 35.6232842292111, -82.51113260797223 35.62325922921309, -82.51124160799334 35.62323922922027, -82.51137160801608 35.62323122923199, -82.51184360809634 35.623219229278085, -82.51194260811381 35.62321222928684, -82.51203760813209 35.62319622929336, -82.51216060815692 35.623167229300144, -82.51225260817684 35.62313722930353, -82.5123586082009 35.62309522930588, -82.51246160822542 35.62304722930673, -82.51248560823097 35.623037229307116, -82.51260360825977 35.62297722930704, -82.51278660830305 35.62289322930878, -82.51286460831977 35.62286922931185, -82.51291760832943 35.62286322931616, -82.51300960834351 35.62287122932719, -82.51307360835102 35.622891229337924, -82.51314560835776 35.622925229352205, -82.5132186083612 35.62298122937105, -82.51329660836329 35.62305122939335, -82.5133616083618 35.6231312294163, -82.5134206083573 35.62322322944111, -82.51348160834806 35.62334922947297, -82.5135146083413 35.62342822949252, -82.51356260833607 35.6235142295149, -82.5136196083348 35.62358322953478, -82.51373660833947 35.62367922956635, -82.51383260834562 35.62374222958911, -82.51396660835657 35.62381522961776, -82.51412560837205 35.62388622964847, -82.5142736083891 35.62393522967369, -82.5145036084171 35.62400022971064, -82.51462760843062 35.62404622973274, -82.51470360843696 35.62408722974883, -82.51470960843716 35.624092229750545, -82.51477660844012 35.624145229768196, -82.51490860843651 35.62431022981534, -82.51504260843733 35.62444922985742, -82.51513060844267 35.624509229878626, -82.51525060845472 35.6245602299014, -82.5153686084677 35.624603229922236, -82.51548160847851 35.624654229944284, -82.51559960848667 35.62472822997145, -82.51568160848781 35.62480922999634, -82.51575460848714 35.6248922300208, -82.51590160848015 35.6250952300772, -82.51594960847905 35.62515423009418, -82.51600160848001 35.62520423010961, -82.51605260848324 35.625238230121795, -82.51610560848746 35.62526723013323, -82.51615760849387 35.625282230141565, -82.51620360850033 35.62528923014776, -82.5162776085123 35.62529123015569, -82.51629460851551 35.62528923015707, -82.51635860852659 35.625286230163056, -82.51643260854033 35.62527623016859, -82.51650060855214 35.62527323017498, -82.51655860856118 35.625277230181794, -82.51663360857076 35.625295230193174, -82.51669360857693 35.62532023020441, -82.51675360858192 35.62535223021712, -82.51682060858427 35.6254092302356, -82.5169536085861 35.62554023027591, -82.51701660858811 35.62559523029363, -82.51708560859275 35.625639230309666, -82.5171586086017 35.625659230321226, -82.51723960861268 35.6256752303328, -82.517302608623 35.62567623033955, -82.517315608625 35.62567723034103, -82.51756560867058 35.625651230361434, -82.51765760868629 35.62564823037029, -82.51776060870203 35.62565623038257, -82.51788360871916 35.625678230399664, -82.51798060873088 35.62570623041537, -82.5181826087542 35.625772230449556, -82.51826460876472 35.62579223046201, -82.51834560877697 35.625800230472, -82.51837260878129 35.625801230474984, -82.5184426087923 35.62580523048301, -82.51845460879451 35.62580423048404, -82.51848260879939 35.625802230486485, -82.51854360880999 35.62579923049214, -82.51865560883085 35.625784230500685, -82.51870460884041 35.62577523050381, -82.51917660893086 35.62569623053633, -82.51936760896727 35.62566623054983, -82.51958960900917 35.62563323056593, -82.51965660902202 35.62562223057061, -82.51985860906028 35.625591230585066, -82.51992660907308 35.625581230590015, -82.52090460925857 35.625431230660105, -82.52127560932873 35.62537523068687, -82.52143460936058 35.62534023069608, -82.52155060938445 35.625310230701906, -82.52169560941574 35.6252632307073, -82.52176860943155 35.62523923070986, -82.52244860958835 35.62495423072184, -82.52305360972333 35.62473023073844, -82.52335460978938 35.624626230748305, -82.52371060986604 35.624512230761674, -82.52371960986788 35.6245102307622, -82.52378560988075 35.62449723076632, -82.52385560989313 35.624492230772546, -82.52396560991066 35.6244972307849, -82.52402160991782 35.624511230793445, -82.5240876099254 35.624533230804765, -82.52420560993131 35.624621230834734, -82.52423560993151 35.62465223084416, -82.52426860992982 35.62469923085714, -82.52430660992462 35.624773230876094, -82.5243386099161 35.62486323089771, -82.52438160990107 35.62500723093142, -82.52439160989681 35.62504523094016, -82.52445360987129 35.62527723099375, -82.52451160984758 35.625493231043706, -82.52457360983281 35.625656231083234, -82.52462660982843 35.62574123110599, -82.52468060982679 35.625810231125584, -82.52474660982641 35.625883231147256, -82.52477760982799 35.62590623115507, -82.52484660983164 35.625957231172585, -82.5249496098396 35.62601623119521, -82.52498260984251 35.626033231201966, -82.52505860984913 35.62607223121779, -82.52506560984975 35.62607523121912, -82.52517660986159 35.626118231239296, -82.52529760987721 35.626147231257605, -82.52533560988257 35.62615323126277, -82.52542860989553 35.626169231275526, -82.52544160989731 35.62617123127726, -82.52555960991587 35.626178231290815, -82.52561060992493 35.626174231295316, -82.52576560995222 35.6261642313092, -82.52587860997386 35.626145231316954, -82.52599260999756 35.62611423132236, -82.5260906100196 35.62607723132492, -82.5261416100316 35.62605423132548, -82.52618761004211 35.62603523132631, -82.52626861006256 35.6259902313255, -82.52630261007177 35.62596723132437, -82.52634961008451 35.62593523132261, -82.5264156101031 35.625885231319245, -82.52643761010926 35.62586923131827, -82.52673361019806 35.62561223129644, -82.52683961022973 35.625521231288786)))",6523,37,021,001700,370210017001,1005,1005,21,998,980,10,2,2,3,1,7,871,14,857,865,849,8,2,2,3,1,6,561,479,82
census_2010_blockgroups_view.fid--2dc29038_13ec899ba8f_-25c0,"MULTIPOLYGON (((-82.3361235955627 35.51583718938645, -82.33618659556355 35.51589918940555, -82.33652159560684 35.51597718945584, -82.33665659562419 35.51600918947622, -82.3367845956395 35.51604718949704, -82.33760459570982 35.51647018966725, -82.3377045957218 35.516499189683366, -82.33779359573255 35.51652518969779, -82.33810459576236 35.51666518975826, -82.33819659577112 35.51670618977599, -82.33849959580505 35.516811189828466, -82.33858059581227 35.51685118984487, -82.33948659589284 35.517299190029014, -82.33978259593235 35.5173601900718, -82.33998659595122 35.51745619011226, -82.34029359597949 35.51760219017351, -82.34044459599114 35.51768819020646, -82.34052259599713 35.51773319022363, -82.34060359600787 35.5177501902354, -82.34102659607595 35.517761190281156, -82.34103059607651 35.517762190281715, -82.34131559610934 35.517854190329714, -82.34177259614682 35.518101190426826, -82.3422505962155 35.51816719048942, -82.342751596293 35.51820119054785, -82.3430565963401 35.518222190583465, -82.34334859638115 35.518269190622995, -82.34356759641183 35.51830419065264, -82.34374359643041 35.51837219068452, -82.34395059645225 35.51845219072205, -82.34413959646905 35.51854619076054, -82.34434059649537 35.518590190790135, -82.34471759655356 35.51861719083439, -82.3449265965791 35.518675190867626, -82.3449325965797 35.518677190868694, -82.34506659659253 35.518738190894844, -82.34527259660267 35.51889319094748, -82.3454095966094 35.51899619098249, -82.34546159661396 35.51902219099309, -82.34581959664594 35.519199191065816, -82.34609559667744 35.519290191112674, -82.34631459670254 35.51936219114981, -82.34655259672968 35.5194411911903, -82.3468085967651 35.51948519122555, -82.3470435967941 35.51954919126268, -82.34725159681986 35.51960519129542, -82.34743359683202 35.519721191337794, -82.34763559681214 35.520067191428716, -82.34776959681997 35.52016019146141, -82.34793159683996 35.52020419148698, -82.34806059686495 35.52018019149543, -82.34812759687816 35.52016619149945, -82.34813259687898 35.520166191499996, -82.34824059690278 35.52012719150309, -82.3483255969182 35.52011819151, -82.34839459693065 35.52011119151567, -82.34867159698099 35.52008119153813, -82.34918159707328 35.52002819157974, -82.34948259714083 35.51991219158719, -82.3495715971607 35.519879191589595, -82.34975259719562 35.51984619160153, -82.34987959721444 35.519860191617454, -82.34994059722331 35.51986819162537, -82.35017659724696 35.51996719166972, -82.35022359724732 35.52001519168429, -82.3503135972479 35.52010819171243, -82.35042559724843 35.520225191747684, -82.35050859725524 35.52027019176538, -82.35057959726109 35.52030819178037, -82.35086259729593 35.52038519182507, -82.35113759733548 35.520423191861106, -82.35125459735085 35.520449191878356, -82.3514265973731 35.52048919190418, -82.35150759738642 35.52048919191251, -82.35183059744409 35.52046119194007, -82.35230059751223 35.52052219200076, -82.35261659754433 35.52065319205987, -82.35267059754557 35.52070319207552, -82.35274059752739 35.52089619212191, -82.35281159750973 35.521087192168025, -82.35285259750708 35.521148192184555, -82.35304759751989 35.52127419223016, -82.35337659755317 35.52141119229182, -82.35360559756974 35.52154919234343, -82.35375959757405 35.521686192387016, -82.35392159758564 35.52178519242383, -82.35407659760534 35.521823192447414, -82.35511859775131 35.52199319258912, -82.3554135977949 35.522026192626136, -82.35593159788212 35.52201519267714, -82.35615359792632 35.52196619269003, -82.35652959800714 35.521844192703966, -82.35660559801913 35.52184819271256, -82.35664459802524 35.52185019271693, -82.3567315980354 35.521877192731395, -82.35700059804698 35.52209119280249, -82.35724959807524 35.52217419284495, -82.35777359815177 35.52223919291202, -82.35792859817454 35.52225819293182, -82.35827059822452 35.52230019297547, -82.35901759831489 35.5225141930957, -82.35928659835598 35.52253619312788, -82.35966259841992 35.522524193164124, -82.35984359844129 35.522579193193884, -82.36011359846223 35.52273319325288, -82.36038859847208 35.52296419332806, -82.3605705984844 35.5230791933701, -82.36089359852352 35.523172193422205, -82.36159959861729 35.523320193524796, -82.3620225986567 35.52351819360846, -82.36248059871298 35.52364419368114, -82.36264159873619 35.523666193702184, -82.3629915987947 35.523661193737205, -82.36313859882335 35.523633193746626, -82.36340759888296 35.52353419375421, -82.36356159890937 35.52352819376872, -82.3636295989138 35.52357219378469, -82.36368959890582 35.52368819381439, -82.3637645988819 35.52392419387002, -82.36388559887405 35.52410519391921, -82.36406659887939 35.52426519397032, -82.3642515988957 35.52435719400801, -82.3643295989026 35.524396194023915, -82.36439659891366 35.52439619403084, -82.36449759891762 35.52447919405809, -82.36474659890987 35.524797194148206, -82.36501559892113 35.52501219421953, -82.36527759890707 35.5253851943222, -82.36546659891121 35.52556119437736, -82.36548459891249 35.52557219438146, -82.36559959892138 35.52563819440667, -82.36571459893017 35.525704194431924, -82.3657955989384 35.52573719444692, -82.36596559895722 35.52579819447683, -82.36609159897085 35.52584419449911, -82.36626659899001 35.52590719452988, -82.3664205990105 35.52594019455241, -82.36666959905251 35.525934194576784, -82.3668035990839 35.52587419457841, -82.36694559911673 35.52581319458057, -82.36711959915218 35.52576919458954, -82.36748959921336 35.52576919462756, -82.36790659926112 35.52590619469828, -82.36833659930166 35.526104194782654, -82.3686395993502 35.52611419481584, -82.3689315994083 35.526050194832884, -82.3689415994102 35.52604819483351, -82.3692985994886 35.52592219484458, -82.36948659951888 35.52592719486492, -82.36964659954023 35.52596019488808, -82.36993659957888 35.526020194930155, -82.37010859959943 35.52607119495818, -82.37077059967869 35.52626719506602, -82.37136259976216 35.52636019514573, -82.37150159978557 35.52635719515943, -82.37197759986546 35.526349195206734, -82.37232359992353 35.52634319524112, -82.37232459992366 35.52634319524122, -82.37252559995089 35.52638219526974, -82.37268659996991 35.526431195296276, -82.37313060001203 35.52663419538313, -82.37330260003138 35.526693195412776, -82.37344660004729 35.52674419543798, -82.37364060007579 35.526767195462575, -82.37380960010049 35.526788195484215, -82.3739776001249 35.52681019550597, -82.37438760018998 35.526827195551554, -82.37472360024321 35.52684219558914, -82.37482460025655 35.52686419560401, -82.37519160031007 35.52691019565107, -82.37567660036896 35.527048195728966, -82.37614660043477 35.527125195792856, -82.37636160045842 35.52720219583062, -82.37645560046545 35.52725719585146, -82.37655160046934 35.527335195877235, -82.37668460047456 35.527444195912956, -82.37681860048397 35.52752719594357, -82.37723360054093 35.52760219600148, -82.37745760057176 35.52764219603263, -82.37782660061903 35.527731196088645, -82.37817660065657 35.52786319615142, -82.378324600669 35.527941196182496, -82.37857260068986 35.5280721962346, -82.378666600702 35.528094196248716, -82.37873060070723 35.5281291962624, -82.37874760070866 35.52813819626602, -82.37898960074276 35.528176196298574, -82.37983660089535 35.52809419636899, -82.38042860098284 35.52816119644352, -82.38080460104659 35.52815019647993, -82.3811546011088 35.52812219651018, -82.38166660122862 35.52789319651623, -82.38179360125817 35.52783719651794, -82.38202160130672 35.527766196527, -82.38223660134737 35.52773319654234, -82.38278260142317 35.52782719661765, -82.3828146014276 35.52783219662192, -82.38366860153056 35.52808019676005, -82.3841526015777 35.528294196853295, -82.38467660162027 35.528580196965216, -82.38478760162518 35.52866719699429, -82.38495860163304 35.52880019703885, -82.38516660162595 35.52906919711488, -82.38530160161271 35.52930019717567, -82.38539560158932 35.52955319723667, -82.38550260158505 35.52969619727678, -82.38564360158978 35.52981719731579, -82.38588560160603 35.529971197371985, -82.38610060161037 35.53017419743533, -82.3860876015997 35.53022919744513, -82.3859666015687 35.530301197447315, -82.38587260154812 35.53033419744441, -82.38576460151684 35.530421197450956, -82.38586560149463 35.5306741975127, -82.38601360149028 35.53086119756584, -82.38645660155412 35.53092219762379, -82.38672560158842 35.530988197664854, -82.38681960158868 35.53108719769461, -82.38690060157674 35.5312521977365, -82.38694060157825 35.531285197747266, -82.38698060157056 35.531378197770294, -82.38713560155728 35.53163119783754, -82.38743160157736 35.53181819790601, -82.3876996016098 35.531895197949204, -82.38779360161517 35.53196119797224, -82.3879016016077 35.53212619801684, -82.38795560159122 35.532291198055894, -82.38802860153739 35.53271919815031, -82.38805860153025 35.532798198169516, -82.38809560152215 35.53289019819196, -82.38829760151498 35.533154198266345, -82.3883136015153 35.533169198271, -82.38843860151795 35.53328619830763, -82.38864060153783 35.53337419834629, -82.38897660155943 35.53359419842555, -82.38924560158112 35.533742198483196, -82.38954060159611 35.533962198558186, -82.38989060162848 35.53412719862767, -82.39019660165792 35.53426519868719, -82.39073060170901 35.534506198791064, -82.39075660171224 35.5345131987951, -82.39095960173657 35.53457319882818, -82.39118760177178 35.53458919885485, -82.39145660180617 35.53465519889592, -82.39191360184265 35.53490819899427, -82.39217560185985 35.53507819905575, -82.39238660186444 35.53527519911749, -82.39245760186589 35.53534219913836, -82.39267260185234 35.53566119922525, -82.39271960184311 35.53577119925242, -82.39271360184043 35.53578219925411, -82.3927676018409 35.53583719927075, -82.39294860180473 35.536266199376506, -82.39335160179449 35.53676619951948, -82.39377460180008 35.53718419964785, -82.39434560179727 35.53781619983491, -82.39442660178865 35.53795919987228, -82.39448060178913 35.538014199889076, -82.39457460177077 35.538234199943346, -82.39464160176831 35.538322199968185, -82.39465960176925 35.53833519997256, -82.39478960177577 35.538432200005666, -82.39485660178691 35.538432200012615, -82.39513960184476 35.538360200027064, -82.39524660185734 35.53839320004473, -82.3953136018617 35.53843720006056, -82.39542160187611 35.53845920007613, -82.39560960191066 35.53843720009096, -82.39571760193355 35.538404200095364, -82.39578460195126 35.53836120009352, -82.39586560197814 35.538273200083964, -82.39591960201587 35.53808620005156, -82.39597260203651 35.53800920004135, -82.39612060207614 35.537910200036485, -82.39620160209205 35.53789420004159, -82.39629560210759 35.537894200051255, -82.39640360212027 35.53792720006903, -82.39660560215714 35.53790520008535, -82.3968066022022 35.53782820009033, -82.39712960228778 35.53761920008117, -82.39720360230505 35.53758620008202, -82.39748560235417 35.537570200107744, -82.39784960240921 35.5376032001519, -82.39795660242187 35.537636200169544, -82.39827260244193 35.537845200244476, -82.39844760246832 35.537861200265745, -82.39862260250067 35.53783920027925, -82.39872960252345 35.537806200283555, -82.39907260260708 35.53763120028333, -82.39928760265106 35.537576200294225, -82.39944960267712 35.537581200311884, -82.39981260272529 35.537658200364824, -82.40004060276634 35.537636200383794, -82.40021560281045 35.53753720038168, -82.40036360285684 35.53739520036807, -82.40048460287942 35.53737820037705, -82.401439603033 35.53740620048093, -82.40156060304959 35.53742820049783, -82.4016686030624 35.53746120051559, -82.40176260306272 35.53756020054537, -82.40188360306917 35.53764820057564, -82.40200460308576 35.53767020059262, -82.40215160311014 35.537670200607735, -82.40246160317152 35.53760420062615, -82.40282460324583 35.53751120064465, -82.40299960327646 35.53750020066037, -82.4033216033246 35.53753320070013, -82.40360460335705 35.53762620074808, -82.40363660335991 35.53764220075467, -82.40398060338883 35.537824200826975, -82.40436360340475 35.53813220092894, -82.40483460341406 35.538577201067774, -82.40488860340618 35.53868720109561, -82.40519060341886 35.53892920117581, -82.405378603433 35.53903920121749, -82.40564760345792 35.539166201270916, -82.40632060354396 35.539330201373495, -82.40623960349504 35.53956120141206, -82.4061536034717 35.53962020141516, -82.40609860345648 35.5396602014177, -82.40548660334856 35.53970420136365, -82.40512060328643 35.53971420132808, -82.40494160325599 35.539720201310935, -82.40486060323583 35.53976420131152, -82.40481660321868 35.53982820132, -82.40493660323418 35.539856201338026, -82.40529860328067 35.5399432013929, -82.40541960329615 35.539972201411224, -82.40530460325935 35.54008820142298, -82.40528560325309 35.540108201425134, -82.40520360322222 35.54022120143963, -82.40516460320592 35.54028520144863, -82.40513560319077 35.54035220145921, -82.40513360317978 35.540421201473045, -82.40514560316554 35.54052720149582, -82.40514860316229 35.54055120150097, -82.40517160314486 35.540689201531386, -82.40518860313185 35.54079220155405, -82.4052016031225 35.540867201570606, -82.40524760309434 35.54109920162252, -82.40525060309285 35.5411122016254, -82.40527360308297 35.5412012016459, -82.40530560306934 35.541324201674136, -82.4053166030662 35.54135620168179, -82.40536060305489 35.54147720171088, -82.40544260303767 35.54167720175992, -82.40548360302363 35.54181220179162, -82.40548460302351 35.541814201792064, -82.40550560301095 35.54191820181539, -82.4055106030035 35.54197220182686, -82.40551760299415 35.54204020184139, -82.40551260295676 35.542278201889225, -82.40547060287578 35.542759201982655, -82.40545460284378 35.54295020201976, -82.40537860271186 35.54372520216944, -82.40536660266685 35.54400520222505, -82.40538560258557 35.544553202338285, -82.40541560250581 35.54510420245334, -82.40541660250318 35.54512220245713, -82.40544660246489 35.54540320251731, -82.40550260244397 35.545599202562784, -82.40563260242325 35.54587320263185, -82.40564760242073 35.545906202640104, -82.40569360241277 35.54600720266533, -82.40569460241258 35.546009202665836, -82.40570260240872 35.54604320267355, -82.40570960240522 35.54607320268041, -82.40572660239751 35.54614220269613, -82.40572960239422 35.54616620270138, -82.40573460239017 35.54619820270836, -82.40574660237847 35.54628720272767, -82.40574360234535 35.546499202770384, -82.40571160230436 35.5467312028143, -82.40569260229204 35.54679020282433, -82.40562660224865 35.547001202860336, -82.40559860221201 35.54720920289976, -82.40562260218648 35.54740120294121, -82.40568860217371 35.547555202979275, -82.4057406021589 35.547707203015506, -82.4057406021358 35.54785720304599, -82.40568960209535 35.54806520308299, -82.40553960200084 35.54851820315963, -82.40547760196117 35.54870920319206, -82.40535060189039 35.54903220324454, -82.40536160188468 35.54908120325566, -82.40534360187891 35.549099203257484, -82.40528960186188 35.549152203262686, -82.40527260185617 35.54917120326477, -82.40537560184497 35.54935420331254, -82.40537560183948 35.5493902033199, -82.40537560182801 35.549464203334914, -82.40519360173018 35.54990420340558, -82.40510360168963 35.55007120343026, -82.4050996016876 35.55008020343168, -82.40504560164327 35.55031020347286, -82.40517960166031 35.550343203493284, -82.40524760165968 35.550420203515976, -82.4052606016534 35.55047520352846, -82.40515960159941 35.55071720356725, -82.40514660158205 35.550816203585995, -82.40515960157569 35.550871203598504, -82.40525360158284 35.55092620361934, -82.4053346015844 35.551003203643354, -82.40536160157698 35.55108020366171, -82.4053206015448 35.55124520369105, -82.40526760152247 35.551333203703486, -82.4052666015038 35.551453203727746, -82.40530760149703 35.55154120374984, -82.40539460149454 35.55165120378114, -82.405394601481 35.551739203799016, -82.40536760146797 35.551794203807376, -82.40497760133235 35.552256203861155, -82.4048636012789 35.55248120389518, -82.40471960123293 35.55262520390964, -82.40465060120273 35.55274720392729, -82.40458160116434 35.55292220395574, -82.40455160113586 35.55307520398372, -82.40449760111696 35.55314020399136, -82.40437560108336 35.55322720399655, -82.40431460106139 35.553304204005926, -82.40430760103453 35.55347120403907, -82.40436360103483 35.55352920405665, -82.40458960105242 35.55365820410603, -82.40465860105189 35.55373520412881, -82.40471160104087 35.55386420416048, -82.40481860103372 35.55402520420417, -82.40503960103813 35.55423420426935, -82.40523860105036 35.55436820431704, -82.40529160104916 35.554433204335666, -82.40539860102982 35.55467320439545, -82.40539960100388 35.55484320443014, -82.40539860098748 35.55494820445129, -82.40543660096681 35.55512320449076, -82.40539060094247 35.555232204508215, -82.40526060089829 35.55537920452473, -82.40513260080756 35.555831204603344, -82.40520260079074 35.55601520464797, -82.40525360077555 35.55616920468444, -82.40509860022115 35.55960220536592, -82.40540360018515 35.560163205511216, -82.4052965999189 35.56177720582815, -82.4038515988277 35.56730920680334, -82.40369259870673 35.567923206911715, -82.40474359887962 35.5679292070211, -82.40590059906657 35.567958207145956, -82.40688859927484 35.56766720718845, -82.40819159957057 35.567146207216645, -82.40966659990767 35.566542207245654, -82.41058760022995 35.565439207116306, -82.41196260055965 35.56477520712287, -82.4133486008966 35.564076207123335, -82.4145586011825 35.56351920713461, -82.41346260078264 35.56493820731019, -82.41281460046213 35.56632320752498, -82.4127226004162 35.56652220755594, -82.41267660040528 35.56654420755567, -82.41231060024765 35.56717420764602, -82.41199060012127 35.567651207709964, -82.41150959998883 35.5679942077302, -82.41095259983607 35.56838720775279, -82.41028159966993 35.56874520775652, -82.40953359950088 35.569039207739294, -82.40944459947477 35.56911320774518, -82.40898159934413 35.56946420776888, -82.40864159925859 35.569654207772544, -82.40826659913186 35.570074207819225, -82.4078745990118 35.57043220785163, -82.40741759887311 35.57084220788795, -82.40725559879301 35.57118820794155, -82.40723459878245 35.57123420794875, -82.40688659865887 35.57166220799991, -82.40651259855375 35.5719432080185, -82.40608459847431 35.57199920798589, -82.4055545983778 35.572056207942886, -82.40502359830073 35.57198620787409, -82.40436059817921 35.57206320782155, -82.40390559808284 35.57220020780257, -82.40382159799245 35.57269720789483, -82.40375259793304 35.57300820795098, -82.40296859779056 35.57309120788716, -82.40228659770123 35.572939207786106, -82.40200759766896 35.572849207739125, -82.40183659766213 35.57271020769326, -82.40116059752796 35.57285520765319, -82.4006375974328 35.57291120761076, -82.40011459733984 35.572953207565476, -82.39928459720613 35.57293020747546, -82.3992155971984 35.57290620746347, -82.39797759705957 35.572478207249155, -82.39733159691858 35.57270020722777, -82.39690959681543 35.572916207228246, -82.39648359668153 35.57332820726809, -82.39629459658536 35.573749207334124, -82.39605459646086 35.57429920742123, -82.39602659644527 35.57437020743272, -82.39586359635199 35.574801207503526, -82.39561159622787 35.575335207586065, -82.39524659610016 35.575772207637286, -82.3947165959774 35.576000207629114, -82.39404059587979 35.57590820754079, -82.39351059580446 35.575828207470025, -82.3934315957931 35.57581720745961, -82.39272659569053 35.57572620736861, -82.39237959563265 35.57572920733358, -82.39198559556912 35.575719207291, -82.39087159539842 35.57563120715849, -82.38994859523525 35.57570020707753, -82.38899559507584 35.57571120698168, -82.3881635949801 35.57544020684098, -82.38784359499478 35.57500220671909, -82.38734759496286 35.57467720660205, -82.3868815949222 35.57444120650616, -82.38624359486617 35.57412020637536, -82.38587459483688 35.5739142062955, -82.38528759475159 35.57383820621968, -82.38453559463018 35.57381920613839, -82.38411259454205 35.5739372061189, -82.38354759441688 35.57414320610257, -82.38299859429378 35.57435320608871, -82.38293059427706 35.574388206088805, -82.38258759419732 35.57453820608394, -82.38237459415299 35.574597206074046, -82.38204059407391 35.57475220607113, -82.38186859403912 35.57479320606183, -82.38178459402192 35.57481420605742, -82.3816275939786 35.57492720606419, -82.38135159390195 35.57512820607662, -82.38093959379458 35.575383206086, -82.38070359374122 35.57547620608058, -82.3804285936931 35.57549320605582, -82.3802505936618 35.57550520603982, -82.37988559359798 35.57552820600695, -82.37985159359202 35.575530206003876, -82.37977859357919 35.575535205997355, -82.3797525935753 35.575532205994136, -82.37971959357029 35.57552920599011, -82.3792575935015 35.57548020593264, -82.3791295934824 35.57546720591676, -82.37857959339173 35.575465205859814, -82.37818559333206 35.575430205812104, -82.37793059329042 35.57542620578504, -82.37787059328274 35.575412205776, -82.37741959322447 35.57530620570806, -82.37696659317814 35.57512120562392, -82.3769115931723 35.57510020561397, -82.37631759310845 35.57487720550751, -82.3758265930656 35.57462920540663, -82.37541759302938 35.57442520532308, -82.37513759300461 35.57428620526613, -82.37493659298971 35.57416720522126, -82.37491459298812 35.57415320521608, -82.37484959298395 35.57411120520091, -82.37482859298262 35.57409720519589, -82.37480359297983 35.57408820519154, -82.37478659297784 35.574083205188764, -82.37473159297228 35.57406020517846, -82.37470859296992 35.57405120517417, -82.37457059295234 35.57401720515306, -82.37437759292749 35.573971205123875, -82.37416959290664 35.573883205084634, -82.37403959289367 35.57382820506012, -82.37378159286763 35.573720205011576, -82.37316359278957 35.573564204916316, -82.37297759275653 35.573579204900184, -82.37221859262111 35.57364420483527, -82.37159459247495 35.57392320482773, -82.37154059246006 35.573961204829835, -82.37109959236552 35.57410220481311, -82.37046959222606 35.57433120479479, -82.36985159208535 35.57458120478195, -82.36953259201249 35.57471220477571, -82.36886259184698 35.57506720477884, -82.3684915917619 35.575221204771886, -82.36815559168447 35.57536320476616, -82.36797859164642 35.57542020475952, -82.36784059162659 35.575401204741475, -82.36768259159236 35.575453204735744, -82.36759959157436 35.5754812047329, -82.36733959153085 35.57548520470689, -82.36693859146348 35.575492204667086, -82.36687659145306 35.57549320466089, -82.366129591312 35.57560720460719, -82.36532359118205 35.57558620452001, -82.36522459116598 35.57558420450939, -82.36506659115196 35.5755062044772, -82.36451559105332 35.57555520443043, -82.36424059100403 35.575580204407245, -82.3632175908416 35.57553720429325, -82.36287159078594 35.57552720425559, -82.36279759077394 35.575525204247526, -82.36243059071492 35.575515204207754, -82.36189959062452 35.57553220415655, -82.36179159060727 35.575528204144575, -82.36132959053356 35.57551120409353, -82.36060159040767 35.575547204025945, -82.36048659038116 35.5755962040241, -82.35985359023394 35.57587220401492, -82.35912659004879 35.57629420402575, -82.35903459003327 35.57629620401669, -82.35886758998487 35.57643120402695, -82.35836658983943 35.576837204057796, -82.35820058979105 35.57697320406831, -82.35770958965051 35.577358204095916, -82.35757258961706 35.57742820409602, -82.35728658955051 35.57755320409197, -82.35696258947493 35.577696204087665, -82.35611658929398 35.57796320405475, -82.35594858926682 35.577959204036674, -82.35519058914417 35.577942203955146, -82.35413358901724 35.57763320378363, -82.35404958900699 35.57760920377014, -82.35375458897343 35.5775112037198, -82.35345958896363 35.57725920363827, -82.35326358896683 35.57702820357127, -82.35287658892581 35.57687920350109, -82.35191158886312 35.57625220327446, -82.35170258885096 35.576107203223486, -82.35108158881481 35.57567620307206, -82.35062258881077 35.575211202930454, -82.35015358881857 35.57465820276985, -82.34987558887829 35.573973202602126, -82.34926358891948 35.57305120235195, -82.34902058891801 35.5728002022759, -82.34837058886627 35.57243920213578, -82.34801258882904 35.572297202070054, -82.3475315887791 35.572106201981796, -82.3465835886704 35.5717952018211, -82.34630558864353 35.57167220176747, -82.3457985885942 35.57144820166975, -82.34546858856324 35.57129620160491, -82.3452835885456 35.571212201568834, -82.34459858849742 35.570791201412874, -82.3441205884834 35.570370201278216, -82.34359758846747 35.56991320113158, -82.34324658844311 35.56969520105114, -82.34300258842606 35.56954420099538, -82.34276758841122 35.56938920093971, -82.34248858839706 35.569182200869, -82.34253958841691 35.569108200859205, -82.34269458847639 35.56888820083049, -82.34274658849633 35.56881520082107, -82.34279658851506 35.56874720081249, -82.34314958866797 35.56813320072406, -82.34326658875243 35.56771120065041, -82.34328658880024 35.56742220059388, -82.34312758887212 35.5667862004484, -82.3428705889754 35.565841200230125, -82.34282958909307 35.56503420006204, -82.34281058919674 35.56434119991943, -82.342788589223 35.5641471998778, -82.34282758924701 35.564033199858656, -82.34317258936336 35.56364819981598, -82.34324058938599 35.56357419980795, -82.34388858958458 35.56298019975413, -82.34447658978226 35.562328199682284, -82.34481058987251 35.56210019967039, -82.34068558927233 35.56157419913903, -82.34033458922217 35.561524199092716, -82.33993858918262 35.5613561990179, -82.33975458916211 35.56129219898593, -82.33926658908747 35.56125319892772, -82.33820658891187 35.56125719881946, -82.33688658871634 35.56111219865422, -82.33655058868027 35.56098619859398, -82.3362915886603 35.56083819853729, -82.33542158858495 35.56039519835778, -82.33478058850855 35.56020419825308, -82.33452158848272 35.5600941982041, -82.33393858839756 35.56002219812946, -82.33352958834422 35.559930198068656, -82.33275158823429 35.55981019796423, -82.33256958821275 35.5597551979343, -82.33230058819291 35.559595197874216, -82.33197058816549 35.55942019780472, -82.33183058814713 35.55938919778399, -82.33169558812942 35.559359197764074, -82.3316015881139 35.559359197754354, -82.33102958804056 35.5592221976676, -82.33081458802967 35.559063197613206, -82.33061858803627 35.5588101975417, -82.33044458803552 35.558629197487036, -82.33025558804663 35.558354197411774, -82.33004758807506 35.55794719730775, -82.32995958808165 35.55781019727086, -82.32965758806832 35.55757319719176, -82.32948158807059 35.55737019713234, -82.32925358809207 35.556986197031016, -82.32912558813456 35.556574196934136, -82.32895758817725 35.556117196824175, -82.32863458822982 35.555430196651464, -82.32848658827814 35.55495819654041, -82.32842558828588 35.55484219651058, -82.32829158829854 35.55461719645111, -82.32818358829587 35.55451819641992, -82.32799558828017 35.55441919638051, -82.3276655882594 35.5542001963021, -82.32718758821781 35.55395819620376, -82.32690558818145 35.55389219616137, -82.32671058816017 35.553821196126876, -82.32606458806714 35.553733196042494, -82.3259035880381 35.55374919602921, -82.32533858792283 35.55389219600001, -82.32467258776785 35.55418419599076, -82.32453158774116 35.554206195980726, -82.32430358770866 35.55417319595051, -82.32421658769246 35.55418519594403, -82.32418858768717 35.55418919594196, -82.32361758756824 35.5543491959156, -82.32342258751916 35.554459195917886, -82.32307858743447 35.554640195919184, -82.32285758738948 35.55469519590762, -82.32224558729021 35.5546841958424, -82.32176258720779 35.55470119579613, -82.32135058713732 35.55471719575692, -82.32076558705262 35.554640195681074, -82.3201745869779 35.55449219559018, -82.31971658692436 35.554349195514035, -82.31909758686368 35.55408019539573, -82.31840558681297 35.55366819524088, -82.31808858679801 35.55342619515918, -82.317913586797 35.55324519510443, -82.31771258678414 35.55311319505689, -82.3172285867382 35.55289319496246, -82.31699958672321 35.55274519490885, -82.31623258666284 35.552316194742815, -82.31525158656537 35.551898194557026, -82.31510958655457 35.55181619452578, -82.31487458654293 35.551640194465804, -82.3146455865245 35.55151419441667, -82.31406758644775 35.55139319433263, -82.31380558641908 35.55129919428655, -82.31339458637144 35.55116819421768, -82.3127155862976 35.5509201940975, -82.31244458625115 35.55093119407183, -82.3123845862558 35.55083719404656, -82.31230358626227 35.5507081940121, -82.31222158627355 35.550547193970914, -82.31217158628048 35.550449193945845, -82.31209458629087 35.55029919390755, -82.31185858634593 35.54968919375944, -82.31175358637685 35.54937619368517, -82.31165958640511 35.54909219361787, -82.31149258644533 35.548652193511394, -82.31115958651826 35.54782319330887, -82.31113358654571 35.54761719326443, -82.31131858664013 35.54720219319927, -82.31158058675405 35.54674319313305, -82.31178558684277 35.546387193081934, -82.31188558688443 35.54622419305922, -82.31191658689711 35.54617519305245, -82.31195958694067 35.545938193008766, -82.31193058698224 35.54563719294477, -82.31187958699745 35.54548419290836, -82.3118195870155 35.54530319286548, -82.31176458703578 35.54511219282107, -82.31171258705434 35.54493619278006, -82.31167758706749 35.54481319275148, -82.31158958711667 35.54440019265862, -82.31157958712268 35.54435019264745, -82.31156258713997 35.54422019261927, -82.31154158716163 35.544057192584035, -82.31152858717489 35.543957192562445, -82.31138758720756 35.54359419247431, -82.31138058720944 35.54357419246947, -82.3112945872126 35.54346219243792, -82.31105658722089 35.54315319235066, -82.31094858722376 35.54301919231241, -82.310751587229 35.54277419224241, -82.31035158721762 35.54241919212918, -82.30967058716197 35.54205119198443, -82.30962458716077 35.54201019197145, -82.30937058715323 35.54178719190002, -82.30922758715593 35.54161619185064, -82.30914858715755 35.541521191823186, -82.30901558717487 35.541266191757764, -82.30900758717834 35.5412351917506, -82.30900358718247 35.541204191743944, -82.30899458718467 35.5411801917381, -82.30898758718641 35.54116119173357, -82.30895358720086 35.54103119170371, -82.30894658725698 35.540659191627505, -82.30890758730027 35.54033719155818, -82.30868758733469 35.5398781914424, -82.30866158734835 35.539761191416034, -82.30865758735085 35.53974119141145, -82.30858958738877 35.53942219133974, -82.30856558741108 35.53925119130258, -82.30854058743462 35.53907219126372, -82.30851358749744 35.538635191172226, -82.30851158750929 35.53855619115604, -82.3085015875738 35.538127191067964, -82.30826158774414 35.536764190766725, -82.30818458777235 35.53649819070486, -82.30812858779329 35.53630219065927, -82.30809358782376 35.53606719060802, -82.30803458785223 35.53581919055162, -82.30801158786598 35.535705190526095, -82.30800258787443 35.53564019051199, -82.3079325879463 35.535099190395044, -82.30791558796444 35.53496319036574, -82.3079115879706 35.53491919035639, -82.30790158798938 35.534786190328376, -82.30790558799775 35.53473619031858, -82.30791058800678 35.534683190308414, -82.30791458800938 35.53467019030616, -82.30794658802856 35.53458019029122, -82.30799858805146 35.53448719027768, -82.30816458811091 35.53427919025253, -82.30824858814324 35.53415919023686, -82.30830258817029 35.53404119021849, -82.30830358817174 35.534033190216974, -82.30834058820088 35.533883190190274, -82.30834858821689 35.53378819017188, -82.30836558832854 35.53308119003022, -82.30837158833911 35.53301919001817, -82.30844258846943 35.5322491898693, -82.30845658849007 35.532130189846576, -82.30847858852106 35.53195218981279, -82.30853958858818 35.53158218974396, -82.30856158860959 35.53146618972272, -82.30858358863063 35.531353189702, -82.30860158864449 35.5312821896895, -82.30865758868605 35.53107318965288, -82.30867758869955 35.53100618964128, -82.30876058875674 35.53072418959267, -82.30877758876798 35.5306691895832, -82.30883158880035 35.53051718955797, -82.30890558883587 35.53036518953466, -82.30898958886979 35.53023518951697, -82.3091905889448 35.52996318948248, -82.30927458897607 35.52985018946814, -82.30931658899259 35.529788189459936, -82.30933858900619 35.52972318944897, -82.30933958900778 35.52971418944729, -82.30943958902088 35.52973618946201, -82.30959658903909 35.52978618948835, -82.3100985890974 35.52994518957226, -82.31030158912195 35.530003189604855, -82.3103495891288 35.530010189611254, -82.31036758913156 35.53001118961329, -82.31058958916533 35.53003018963999, -82.31063458917346 35.53002518964365, -82.31066458917905 35.53002118964588, -82.3107015891856 35.53001818964908, -82.31075558919623 35.53000718965246, -82.31078658920227 35.53000118965441, -82.31085258921529 35.52998718965841, -82.31105258925461 35.529946189670596, -82.3110655892571 35.529944189671525, -82.3111205892672 35.529937189675785, -82.31115858927429 35.52993218967866, -82.31127258929277 35.52993418969085, -82.31139558931055 35.52995018970677, -82.31159858933667 35.52999818973735, -82.31185858936988 35.530061189776895, -82.31213958940667 35.53012318981838, -82.3128775895053 35.53027318992473, -82.31298758951891 35.53030318994213, -82.31302058952238 35.530315189948, -82.31305858952639 35.530330189954945, -82.31318958953919 35.53038718997999, -82.31346058956329 35.53052119003501, -82.31352558956895 35.530554190048456, -82.31360758957752 35.530586190063374, -82.31372158958924 35.53063219008444, -82.31390558960959 35.53069719011655, -82.31402458962496 35.53072519013452, -82.31406958963143 35.530731190140344, -82.3141475896426 35.53074219015057, -82.31423158965636 35.53074319015938, -82.31426758966226 35.530743190163136, -82.31441758968934 35.53072819017557, -82.31458858972306 35.53069219018581, -82.31468458974358 35.53066219018963, -82.31489858978887 35.53059719019845, -82.3152105898571 35.53048819020847, -82.31532158988001 35.53045819021372, -82.31545958990654 35.53043419022317, -82.31562558993362 35.53043619024063, -82.31603658999646 35.530468190289376, -82.31603758999657 35.53046819028943, -82.3162505900307 35.53047519031279, -82.31650059007285 35.53046919033738, -82.31653159007809 35.530468190340265, -82.3166245900938 35.53046619034946, -82.31665659009906 35.53046619035275, -82.31686859013527 35.53045819037291, -82.31705559016704 35.53045219039092, -82.31730459020864 35.53044919041593, -82.31750359023846 35.530468190440274, -82.31750959023933 35.53046919044116, -82.31771359026764 35.53050419046924, -82.31775059027252 35.53051219047466, -82.31790059029088 35.53055319049841, -82.31803359030381 35.530612190524025, -82.31815559031097 35.53069619055366, -82.31823459031564 35.530750190572746, -82.31832459032285 35.53080019059208, -82.3184505903367 35.530845190614215, -82.31870459037012 35.53090019065159, -82.31891959039761 35.53095219068424, -82.3191045904167 35.531026190718244, -82.31926259042896 35.53111619075277, -82.31941459043958 35.5312101907875, -82.31949759044801 35.531244190802965, -82.3195405904522 35.53126319081117, -82.31973059047786 35.53130019083822, -82.31991259050443 35.53132219086144, -82.31997659051417 35.53132719086901, -82.32027859056028 35.5313521909052, -82.32047059058947 35.531368190928184, -82.32055159060356 35.531363190935515, -82.32063659061977 35.53134919094143, -82.32066359062549 35.53134119094259, -82.32071659063637 35.53132719094522, -82.32078559065191 35.53130019094686, -82.32086759067134 35.5312621909475, -82.32099659069985 35.53121519095128, -82.32113459072814 35.53117919095812, -82.32122059074491 35.53116219096358, -82.32143259078404 35.53113519097993, -82.3216425908236 35.531103190994976, -82.32176359084869 35.5310701910007, -82.3218935908777 35.531021191004136, -82.32221359095303 35.530875191007496, -82.32234459098186 35.53082819101145, -82.32245459100336 35.53080619101829, -82.32253059101731 35.530797191024305, -82.32264759103658 35.530797191036314, -82.3226485910368 35.53079719103642, -82.32284959106742 35.530813191060325, -82.32310759110649 35.530836191091595, -82.32324459112867 35.53083919110631, -82.32333959114494 35.53083519111519, -82.32335859114824 35.53083419111694, -82.32344559116535 35.530816191122256, -82.3234685911698 35.53081219112384, -82.32357559119392 35.53077019112633, -82.32368059121927 35.53071719112635, -82.3237335912347 35.530674191123055, -82.32381859125911 35.530607191118165, -82.32384759126725 35.53058519111669, -82.32394559129652 35.53050019110957, -82.32398659130905 35.530462191106096, -82.32404659132735 35.530408191101294, -82.32411859134938 35.530342191095315, -82.32416959136492 35.5302961910912, -82.32427759139883 35.53019119108104, -82.32436759142816 35.53009719107121, -82.3244165914479 35.530021191060825, -82.3244335914579 35.529975191053275, -82.32444159146237 35.52995419104984, -82.32448959150018 35.529760191015356, -82.32449859150736 35.529723191008785, -82.32454159153085 35.52961719099175, -82.32460259155705 35.52951219097672, -82.32477659162548 35.52925419094226, -82.32493859168854 35.529018190910996, -82.32509859175173 35.52877919087892, -82.32524059171509 35.529169190972745, -82.32527459172677 35.52913019096828, -82.32530459175044 35.52900819094663, -82.32523659176637 35.528832190903884, -82.32523659179114 35.52867119087122, -82.32524359180093 35.5286151908606, -82.32533559183196 35.52851219084912, -82.32538859184771 35.528466190845265, -82.32546559186923 35.52840919084161, -82.32557159189608 35.52834819084018, -82.32577759194244 35.528268190845104, -82.32587759197374 35.52817219083589, -82.3260065920038 35.52811519083761, -82.3261215920309 35.52806219083871, -82.32630459206361 35.528046190854276, -82.32658659211121 35.52803919088187, -82.32674659214176 35.528012190892944, -82.32688059217183 35.52796019089613, -82.3271965922523 35.527776190891295, -82.32732659229507 35.52763819087659, -82.32738059231622 35.52755819086591, -82.32740259237454 35.52720319079612, -82.32754059242257 35.52703919077709, -82.32771559247071 35.52691419076975, -82.3279375925209 35.52682619077466, -82.32814359256135 35.52678419078737, -82.3281735925663 35.526784190790444, -82.32828759258447 35.52678819080299, -82.32842559260553 35.52679919081942, -82.32855559262578 35.526807190834425, -82.32870759265144 35.52680319084922, -82.32884459267642 35.5267881908603, -82.3289975927064 35.5267571908697, -82.32913459273422 35.52672319087692, -82.32968459284967 35.526563190901065, -82.3298525928857 35.52650919090735, -82.32998959291639 35.526456190910714, -82.33013459295036 35.52639119091237, -82.33024159297744 35.52633019091104, -82.33029459299097 35.52629919091016, -82.33043959302948 35.526204190905844, -82.33059959307339 35.526090190899176, -82.33073759311269 35.52598319089161, -82.3308435931449 35.52588719088306, -82.33092059317102 35.5258001908733, -82.33098759319721 35.5257021908603, -82.33103459322217 35.525590190842465, -82.33108059324849 35.52546819082243, -82.33114859329858 35.525216190778295, -82.33117959332247 35.52509419075671, -82.33121759334453 35.52499119073964, -82.33126359336566 35.52490319072657, -82.33133259338878 35.52482719071827, -82.33140859341138 35.524762190712856, -82.33166759348744 35.52454519069545, -82.33166759348805 35.524541190694634, -82.33176659351794 35.524453190687005, -82.331858593549 35.52435019067549, -82.3319505935795 35.52425119066488, -82.33203459361039 35.52414019065098, -82.33211059363816 35.52404119063873, -82.33218659366244 35.5239651906312, -82.33226459368454 35.52390519062694, -82.33234659370714 35.523846190623466, -82.33244559373094 35.523797190623704, -82.33253559375277 35.52375219062383, -82.332751593808 35.523625190620244, -82.33285759383828 35.52354219061424, -82.33295759386718 35.52346119060816, -82.33328559397347 35.52312219057303, -82.33349159404106 35.522904190550044, -82.33356759406884 35.52280519053778, -82.333628594096 35.52269419052152, -82.3336745941217 35.52257619050225, -82.33375859417546 35.522317190458324, -82.3338195942108 35.52215319043134, -82.33398759430023 35.52175219036728, -82.33410959436851 35.52143919031628, -82.334147594394 35.52131419029482, -82.3341625944148 35.52119519027215, -82.33415459442865 35.52109619025131, -82.33412459444084 35.520985190225666, -82.33407159445129 35.52086019019489, -82.33396459446534 35.520654190142, -82.33393359447268 35.520573190122406, -82.33393359447378 35.52056619012103, -82.33390359448052 35.520490190102464, -82.33388759449083 35.52040619008378, -82.33387259451091 35.52025919005245, -82.33385059454098 35.52004019000573, -82.33384959459022 35.519719189940496, -82.33384959459195 35.51970818993821, -82.33384959461895 35.51953218990248, -82.33387259464376 35.51939518987706, -82.33391059466953 35.519269189855414, -82.33396459469782 35.519143189835376, -82.33407859475119 35.518918189801425, -82.3342315948174 35.51865218976322, -82.33436859487485 35.518426189731436, -82.33443759490676 35.51829218971133, -82.33450559493915 35.51815518969057, -82.3345425949651 35.51802618966816, -82.33455959498386 35.517922189648786, -82.33456659500253 35.51780818962638, -82.33455159501717 35.51769718960229, -82.3345055950277 35.517579189573624, -82.33441459503376 35.51744218953652, -82.33430759503806 35.5173001894967, -82.33421659503762 35.517205189468, -82.33413259504121 35.51709118943624, -82.33401059505407 35.516877189380274, -82.333994595056 35.51684718937249, -82.33391059506114 35.516724189338916, -82.33385759506218 35.516660189320476, -82.33380459506108 35.516610189304906, -82.33376559506242 35.51656018929076, -82.33371259506008 35.516518189276766, -82.33366659505836 35.5164801892644, -82.33347859505075 35.51632818921413, -82.33342359505005 35.51627318919732, -82.33340459505055 35.516250189190735, -82.33339259505158 35.516230189185436, -82.33337059505338 35.51619518917602, -82.33333159505996 35.516110189154745, -82.33324759507244 35.51593918911141, -82.3331635950773 35.51581718907805, -82.33310959507492 35.515775189063966, -82.33307159507339 35.5157441890538, -82.33296459506512 35.515683189030455, -82.33278159504597 35.51561118899699, -82.3324535950008 35.51555318895144, -82.33234659498714 35.51552718893516, -82.332117594957 35.515477188901436, -82.33202359494673 35.51544318888492, -82.33197759494128 35.515429188877405, -82.33192659493581 35.51541018886826, -82.33186259492987 35.515380188855595, -82.3318015949251 35.51534618884244, -82.3317675949259 35.51530418883041, -82.33173059492839 35.51524818881521, -82.33171759493658 35.515181188800256, -82.33172059494802 35.515110188786146, -82.3317385949631 35.515031188772014, -82.3317925949863 35.51493818875869, -82.33185059501005 35.514846188745956, -82.3318555950118 35.514840188745254, -82.33211859503645 35.51496218879707, -82.33258959508066 35.515180188889765, -82.33279859510498 35.51524618892464, -82.33293159512463 35.51526118894133, -82.33308059514646 35.515279188960314, -82.33322159516995 35.515277188974416, -82.33355159522506 35.51527318900755, -82.33380759525235 35.515370189053584, -82.33392759526515 35.51541618907525, -82.33406859528326 35.51544918909641, -82.33439859533695 35.51545418913142, -82.33465359538076 35.51544318915536, -82.33494959541531 35.51553618920466, -82.33535959547449 35.515591189258, -82.33558959550972 35.51560918928528, -82.33570859552779 35.51561918929954, -82.33597159556098 35.51568518933998, -82.3361235955627 35.51583718938645)))",6313,37,021,003204,370210032041,2045,2045,37,2022,1990,13,9,5,0,5,23,1616,23,1593,1602,1584,7,5,3,0,3,14,1029,850,179
census_2010_blockgroups_view.fid--2dc29038_13ec899ba8f_-25bf,"MULTIPOLYGON (((-82.56775860828762 35.68210524701732, -82.56783660830739 35.68206124701639, -82.56818060839502 35.681864247011674, -82.56839960844697 35.68176324701373, -82.56871860852266 35.68161724701676, -82.56893760857348 35.68152424702032, -82.56919160863063 35.68142724702673, -82.56923860864107 35.68141024702816, -82.5698856087819 35.68119524705089, -82.57025660886183 35.68107724706507, -82.57056560892883 35.68097624707631, -82.57144160911865 35.680690247108224, -82.57149360912977 35.68067424711031, -82.57164860916313 35.6806252471163, -82.57192360922204 35.68054024712729, -82.57211760926242 35.680487247136526, -82.57228660929295 35.680472247150846, -82.57244960932081 35.68046724716661, -82.57248860932587 35.680476247172436, -82.57252860934426 35.68040024716101, -82.57264960939946 35.6801732471273, -82.57266360940562 35.680148247123626, -82.57269360941807 35.68010024711692, -82.57293960951925 35.67971024706282, -82.57317560961567 35.67934024701174, -82.57339360969858 35.679038246972695, -82.57348160972764 35.67894524696282, -82.57355560975195 35.67886724695455, -82.57365160978203 35.67877624694591, -82.573814609828 35.6786542469378, -82.57386560984196 35.67861824693578, -82.57419060993175 35.678387246922114, -82.57429960996194 35.67830924691743, -82.57451461002103 35.678158246908865, -82.57454461002924 35.678137246907625, -82.57495461014055 35.67785824689298, -82.57548961028841 35.677477246870545, -82.5756866103426 35.67733824686249, -82.57581361037782 35.67724724685693, -82.57586761039293 35.677207246854366, -82.57603061043832 35.6770892468471, -82.57608561045352 35.67705024684488, -82.57640761054151 35.67682724683256, -82.5766226106001 35.67667924682455, -82.5773726108055 35.67615724679538, -82.57769461089354 35.67593424678316, -82.57785061093664 35.6758232467766, -82.5780306109858 35.675698246769656, -82.57832161106586 35.67549324675781, -82.57847961110922 35.67538324675161, -82.57869761116919 35.675229246742745, -82.57935561134975 35.67476924671681, -82.57957461140975 35.67461624670818, -82.57995061151328 35.67435124669291, -82.58018261157699 35.67418824668352, -82.58063861170231 35.673868246665286, -82.58070961172146 35.673820246662814, -82.58096161179232 35.67363324665066, -82.58106561182399 35.673540246642375, -82.58120061186463 35.67342224663226, -82.58139261192828 35.673217246610285, -82.58150961196993 35.67307324659296, -82.58178161206617 35.67274324655377, -82.58186061209524 35.67264024654087, -82.58197561213689 35.672494246522945, -82.58204161216162 35.67240524651163, -82.58204761216416 35.67239524651025, -82.58206761217136 35.67237024650716, -82.58217761221175 35.672227246489356, -82.5822456122362 35.67214224647909, -82.5823166122613 35.67205624646882, -82.58238861226415 35.6721152464883, -82.5824086122648 35.67213224649375, -82.58259761226941 35.67230624654867, -82.58260061226937 35.67230924654964, -82.58266461227018 35.67237324656917, -82.58273361227103 35.672442246590336, -82.58280061227191 35.67250824661066, -82.5829606122741 35.67266624665932, -82.58321261227772 35.67291424673576, -82.58335061227963 35.67305024677766, -82.58347561228139 35.67317324681556, -82.58360861228344 35.67330324685579, -82.58385161228696 35.673542246929415, -82.58392361228793 35.673613246951284, -82.5839766122884 35.67366724696781, -82.58388061222806 35.67395424701634, -82.58362661206709 35.67472224714662, -82.5835936120472 35.67481624716232, -82.58349761198664 35.67510424721112, -82.58335561189786 35.675526247282484, -82.58329561185438 35.675743247320476, -82.58326461183093 35.6758612473413, -82.58266561145406 35.67765524764509, -82.58253961137468 35.678033247709116, -82.58245361132043 35.67829224775304, -82.58211861110907 35.679299247923666, -82.58207761108294 35.67942424794493, -82.5817086108466 35.68055624813752, -82.58149561071498 35.68117824824228, -82.58128861058215 35.68181524835071, -82.58107661044932 35.68244624845742, -82.58095261037055 35.682822248521184, -82.58062461016134 35.683822248691136, -82.58058161013354 35.683956248714004, -82.58071461016031 35.683926248721605, -82.58079761017687 35.68390824872647, -82.58294961153945 35.677408247623994, -82.5830466115844 35.67722224759614, -82.5830746115972 35.677169247588246, -82.58317061164954 35.67693424755022, -82.58329961170557 35.67671024751784, -82.58332861171795 35.67666124751085, -82.5834326117608 35.676496247488, -82.583441611764 35.676485247486646, -82.58356161180492 35.67634924747134, -82.58365561183541 35.6762532474614, -82.58375561186551 35.67616624745399, -82.58382461188548 35.676111247449896, -82.58388061190155 35.67606724744664, -82.58406761195242 35.67593924743986, -82.584347612024 35.6757772474357, -82.58471861211575 35.675583247434304, -82.5849896121833 35.67543724743251, -82.5851926122347 35.675323247430136, -82.585217612241 35.67530924742982, -82.58549561230936 35.67516624742933, -82.5856186123369 35.675120247432616, -82.58570261235705 35.675080247433094, -82.58578861236641 35.67511224744847, -82.58586061237406 35.67514024746162, -82.5860526123971 35.67519824749316, -82.58610361240302 35.67521424750169, -82.58614261240832 35.67522224750733, -82.58626361242466 35.67524624752465, -82.58635161243663 35.67526424753736, -82.58657661246858 35.67529924756765, -82.58663161247695 35.675304247574296, -82.58675561249575 35.675316247589514, -82.58673861246587 35.675491247623384, -82.58670461244662 35.67557924763789, -82.58662161241212 35.67571324765658, -82.58647661237082 35.67582424766431, -82.58644261236311 35.675837247663395, -82.58626661232243 35.67591124766036, -82.58493961202703 35.6763952476225, -82.58476861198668 35.67647224762054, -82.58464261195304 35.67655424762425, -82.58460861194386 35.6765772476255, -82.58446961190067 35.676707247637665, -82.58435261185643 35.67686724765819, -82.58426461181122 35.67706524768947, -82.5841936117697 35.6772572477213, -82.58415761174561 35.67737424774144, -82.58398061162626 35.677956247841735, -82.5839216115828 35.67817424788012, -82.583888611555 35.67831824790595, -82.58381661149356 35.67863824796376, -82.58375261144336 35.678894248009286, -82.58370961140929 35.679068248040316, -82.58365661136308 35.67931024808413, -82.58364561135357 35.67936024809324, -82.58358461130668 35.67959824813542, -82.58358161129561 35.6796662481489, -82.58357661127346 35.67980424817653, -82.58359061126203 35.67989324819612, -82.58361561126203 35.679920248204155, -82.5836306112622 35.679935248208785, -82.58367561126549 35.67996224821891, -82.58376261127576 35.679989248233355, -82.5839606113039 35.68002024826006, -82.58408761132443 35.680024248273895, -82.58433361136251 35.68004224830294, -82.58524661150713 35.680089248406404, -82.58613061164807 35.68012824850534, -82.5865916117203 35.6801572485587, -82.58686861176321 35.680177248591264, -82.5872436118249 35.6801822486308, -82.58779161192113 35.68014924868053, -82.58812561197807 35.68014024871304, -82.58844261203606 35.68010624873871, -82.58860161207156 35.68004724874306, -82.58902861219333 35.67971924872022, -82.5890616122027 35.679694248718555, -82.58939061229475 35.67945224870308, -82.58945561231951 35.679362248691426, -82.58947061233934 35.67925024867017, -82.58934561235515 35.67901324860902, -82.58902761237722 35.67852824847752, -82.58847161242593 35.67761424823411, -82.58834761244233 35.67737524817269, -82.58828061245298 35.67723424813709, -82.58824661245302 35.677197248126035, -82.58854261254137 35.676944248104945, -82.58856361254749 35.67692724810362, -82.58881761262478 35.67670024808352, -82.58942361280658 35.676176248039184, -82.58957561285212 35.676045248028124, -82.58973161289451 35.67593824802235, -82.5897526128957 35.675953248027625, -82.58997461289793 35.67617824809623, -82.5899906128973 35.67619924810212, -82.59012161289174 35.67637624815173, -82.59022161287962 35.676562248199915, -82.5902856128609 35.67675224824519, -82.59034161283665 35.67696924829518, -82.59036861280254 35.67721924834879, -82.59038261278633 35.67733924837475, -82.5903886127489 35.67758824842607, -82.59039561270997 35.6778472484795, -82.5903966126626 35.67815524854234, -82.5903996126142 35.67847124860708, -82.59038061253328 35.67897424870752, -82.59034561246662 35.679368248784165, -82.5902926123902 35.67980524886783, -82.59028361238164 35.67985124887619, -82.59023161233073 35.68012424892649, -82.59022561232626 35.68014724893057, -82.59019461230297 35.68026424895113, -82.59018261229852 35.68028024895323, -82.59013961227332 35.68039724897261, -82.59019161228397 35.680384248975344, -82.5902816123022 35.68036324898028, -82.5903496123151 35.680353248985256, -82.59040361232496 35.68034724898961, -82.59062161236558 35.68031924900631, -82.59076761239665 35.680275249012425, -82.59088261242518 35.68021424901177, -82.59098461245341 35.6801412490074, -82.59106661247783 35.680071249001564, -82.59128261253977 35.679903248989575, -82.59128861254126 35.67990024898955, -82.59138961256717 35.67984124898796, -82.59149661259285 35.67979024898856, -82.59166961262945 35.679739248996015, -82.59180661265464 35.67972424900702, -82.59195661267782 35.67973524902467, -82.59208461269169 35.67978324904766, -82.5922146127004 35.679867249078136, -82.59236861270313 35.68001524912411, -82.59258561269435 35.68030524920554, -82.59267261269247 35.680411249236094, -82.5927416126936 35.680478249256794, -82.5928446127003 35.68054524928101, -82.59293361270885 35.68058624929861, -82.59307161272717 35.68061624931889, -82.59321861274977 35.6806282493365, -82.59337861277727 35.68062224935173, -82.59354561280904 35.68059624936358, -82.59367561283545 35.680565249370595, -82.59380261286452 35.68051424937333, -82.59389061288876 35.68045224936975, -82.59392061289685 35.68043224936876, -82.59404061293287 35.68032824935991, -82.5941266129628 35.680227249348185, -82.59415061297076 35.680201249345366, -82.59422861300177 35.68008424932959, -82.59434161305425 35.67986624929676, -82.59441461308681 35.67973424927739, -82.59447261311091 35.67964124926442, -82.59454961314273 35.67951824924731, -82.59467361319012 35.679345249224774, -82.59480561323738 35.67918124920494, -82.5950356133173 35.67891124917362, -82.59535561342837 35.678537249130365, -82.59547061347023 35.67839024911228, -82.59571561355637 35.678096249077555, -82.59581761359239 35.677973249063, -82.59596161364055 35.67781624904583, -82.59609361368344 35.677681249031934, -82.59620761372312 35.677547249016314, -82.59628861375475 35.677429249000646, -82.59635261378385 35.677310248983, -82.59639661381209 35.677174248959815, -82.5964316138453 35.67699724892729, -82.59646861388656 35.676770248884864, -82.59649561391221 35.67663324885976, -82.59652961394309 35.676470248830036, -82.59655561396148 35.67637924881417, -82.59661361400893 35.67613424877028, -82.59661561403185 35.6759882487407, -82.59660761404811 35.675874248716745, -82.59657761406578 35.67572724868363, -82.59656361407401 35.67565924866838, -82.59652361409891 35.67545524862269, -82.59651061410722 35.67538724860749, -82.59643361414521 35.67505824853256, -82.59641961415224 35.674998248518875, -82.59637261416272 35.674879248489844, -82.59631161417254 35.6747502484573, -82.59607261419382 35.67435524835219, -82.59595561420292 35.67417024830251, -82.59589461420784 35.67407324827646, -82.59578061421838 35.67388224822582, -82.59569961422604 35.67374524818957, -82.59556861423852 35.67352324813093, -82.59546461424546 35.673366248088264, -82.59545061424717 35.673340248081495, -82.59537861425699 35.67319924804535, -82.59533461426712 35.67308624801775, -82.59529361428754 35.67291024797776, -82.59527261430269 35.67278924795093, -82.59526661430787 35.672749247942185, -82.59524861432652 35.67260924791183, -82.59521461434632 35.672444247874694, -82.59516761435857 35.672314247843396, -82.59510161436737 35.67218624781049, -82.59491061438088 35.67189324773116, -82.59478861438639 35.671726247684596, -82.59463861439129 35.67153324762991, -82.59461361439207 35.67150124762075, -82.59443261439698 35.67127424755592, -82.594345614398 35.671174247526636, -82.59440661440722 35.67118024753409, -82.59448661442022 35.671182247542745, -82.59456361443354 35.671179247550086, -82.59466161445238 35.67116224755664, -82.59477261447604 35.6711292475614, -82.59491861451212 35.67105224756072, -82.59517661458352 35.67086824754974, -82.59527261461093 35.67079424754461, -82.59605661483366 35.67019624750337, -82.59688861507166 35.66955124745758, -82.59707961512548 35.66940824744811, -82.59736761520142 35.66922724744079, -82.59760661526042 35.66910224743992, -82.59781261530783 35.66901724744385, -82.59788361532415 35.66898824744521, -82.59879261552307 35.668679247475744, -82.59881261552722 35.66867324747663, -82.59912161559498 35.668568247486995, -82.59942761566177 35.66846524749748, -82.59984161575187 35.668327247511954, -82.60005261579573 35.66827124752225, -82.6002836158395 35.66823624753885, -82.60051361587917 35.668227247560665, -82.60079061592306 35.66824124759198, -82.6010286159578 35.6682722476228, -82.60140061601128 35.66832724767232, -82.60199061609592 35.66841424775065, -82.60206461610655 35.66842524776051, -82.60218061612338 35.66844124777573, -82.60238861615494 35.66846124780115, -82.60253861617922 35.66846524781745, -82.60270561620867 35.668454247832344, -82.60274161621545 35.66844924783497, -82.60293261625095 35.66842524784979, -82.60313061629175 35.6683742478598, -82.60334361633787 35.668305247867664, -82.6041586165213 35.667995247888285, -82.6043176165553 35.66794624789463, -82.60444861658085 35.66792224790321, -82.604576616604 35.66791024791393, -82.60469761662361 35.667913247927004, -82.60471361662617 35.66791424792881, -82.60494961665908 35.667955247961444, -82.60516761668424 35.66802724799854, -82.60533961669815 35.668122248035615, -82.60509961669719 35.66787024795958, -82.60484361670261 35.66755924786999, -82.60480361670324 35.66751224785624, -82.60439761670331 35.66707424772525, -82.60437561670258 35.667055247719105, -82.60419361669652 35.666898247668456, -82.603938616686 35.66669224760019, -82.60358261666642 35.66643524751123, -82.60334361664998 35.66628424745589, -82.60225361656737 35.665645247213604, -82.60205661655385 35.665520247167926, -82.60191661654565 35.66542224713356, -82.60175161653764 35.66529724709111, -82.60148761652815 35.66507424701859, -82.60132361652647 35.66490824696781, -82.60107661653001 35.664619246883596, -82.6009606165343 35.66446624684053, -82.60094461653492 35.664445246834624, -82.60084361654079 35.66429824679424, -82.60019461659478 35.66324924651386, -82.60003561660736 35.6629972464461, -82.59992561661251 35.66284524640385, -82.59983161661292 35.662741246373, -82.59975661661043 35.66267624635206, -82.59956661660017 35.6625382463044, -82.59947061659295 35.6624812462829, -82.59929361658223 35.662360246240056, -82.59918361657907 35.662262246208805, -82.59913361657934 35.66220624619231, -82.5990616165835 35.66210224616364, -82.59902861658705 35.66204324614825, -82.5989906165936 35.6619602461274, -82.59891861661534 35.661741246075415, -82.59873561667445 35.66116224593865, -82.5986786166916 35.66098924589751, -82.59862461670815 35.66082424585842, -82.59853161673274 35.66056424579589, -82.5984836167421 35.66045224576808, -82.59839861675542 35.660274245723095, -82.5982766167691 35.66005424566574, -82.59814561677806 35.65985524561172, -82.59801961678224 35.65969224556561, -82.59788061678447 35.65952824551788, -82.59769661678149 35.65934924546247, -82.59752961677671 35.659200245414965, -82.5969106167524 35.65869124524762, -82.5968026167528 35.6585722452123, -82.59671061675863 35.65843524517494, -82.59665161676749 35.65831424514426, -82.59661161677894 35.658197245116256, -82.59658061679522 35.65805824508477, -82.59657061681409 35.657925245056724, -82.59659561684462 35.65775424502438, -82.59663561687226 35.657618245000805, -82.59670661690599 35.65747624497921, -82.59679661694261 35.65733624495994, -82.59690761697944 35.657217244947134, -82.59706261702536 35.65708624493635, -82.5975346171542 35.65676024491845, -82.59770961720355 35.65662924490983, -82.59780661723417 35.65653524490063, -82.59786961726108 35.65642924488548, -82.59792761729817 35.65625124485516, -82.59804861743238 35.6555122447171, -82.59809361747097 35.65531024468058, -82.59821661756015 35.65486524460262, -82.59829461760921 35.65463124456293, -82.59839261766463 35.65437824452143, -82.59855061774934 35.653999244460586, -82.59856061775487 35.653974244456464, -82.5987556178619 35.653491244378095, -82.59880761789474 35.65333424435153, -82.59884561792464 35.65318124432422, -82.59885061793187 35.65314024431636, -82.59886161794557 35.65306324430184, -82.59885961795543 35.652997244288194, -82.59885761796713 35.65291924427206, -82.59882661798814 35.65274924423431, -82.59877461800083 35.65261124420084, -82.598694618011 35.65245924416168, -82.59857861801714 35.652294244116085, -82.59843761801585 35.652150244072295, -82.59823861800896 35.6519812440174, -82.59785561799166 35.651680243916715, -82.59780961799046 35.651638243903406, -82.59776261798922 35.65159624389009, -82.59775461798938 35.65158624388716, -82.59774861798945 35.65157924388516, -82.59769361799066 35.65151224386581, -82.59765861799956 35.6514172438429, -82.5976616180043 35.65138924383749, -82.5976706180173 35.6513152438233, -82.59782361804375 35.65130824383762, -82.59803961808089 35.65130024385818, -82.59828261812534 35.651274243877936, -82.59830261812894 35.65127224387952, -82.5984346181539 35.65125324388928, -82.59865361819504 35.651222243905494, -82.59911661828208 35.65115724393984, -82.59928561831116 35.651151243955944, -82.5993136183161 35.65114924395846, -82.5994266183353 35.65114624396942, -82.59953461835596 35.651129243977124, -82.59971761838116 35.65116324400281, -82.59975461838616 35.6511702440081, -82.59990061840618 35.65119824402877, -82.60026761845658 35.651267244080515, -82.6004146184767 35.65129524410132, -82.6006356185069 35.65133724413267, -82.60073761848813 35.65156924419036, -82.60084061846925 35.65180224424846, -82.60103861843305 35.65225024436006, -82.6011256184126 35.652476244415, -82.60123161838794 35.65275024448178, -82.60129361837377 35.65290924452053, -82.60131361836936 35.65295924453277, -82.60134261836265 35.65303424455097, -82.60147461833552 35.65335224462939, -82.6016946182903 35.65388224475996, -82.60211061824585 35.65461824495267, -82.6021876182431 35.65471924498114, -82.60223961824117 35.654788245000546, -82.60271861822353 35.65541824517814, -82.60305461819296 35.65597824532668, -82.60342261817271 35.65650624547211, -82.60391861820088 35.65685824559476, -82.60409461821783 35.65693824562923, -82.60420661822658 35.65700224565374, -82.60470261827942 35.657194245743874, -82.60584961844704 35.65734424589236, -82.60675061858981 35.65739024599432, -82.60790961877107 35.65746524612881, -82.60828261882924 35.65749024617223, -82.60979561906568 35.65758924634797, -82.60995161908993 35.6576002463662, -82.61163161935549 35.65769024655726, -82.61212261942926 35.65774124661811, -82.61223161944575 35.65775224663156, -82.61316761958633 35.65785024674774, -82.61457561979341 35.65802624692837, -82.61593061998674 35.65823424711006, -82.61620762002542 35.658282247148236, -82.61763162019811 35.65869824737941, -82.61832562028069 35.658911247494125, -82.61884362034239 35.65907024757985, -82.61995362046918 35.65944524777032, -82.62071762055633 35.659704247901615, -82.62094662057952 35.65980124794492, -82.62204862069096 35.66026724815311, -82.62287662078404 35.66055724829736, -82.62300862079886 35.66060324832031, -82.62377662083522 35.661195248519874, -82.62440062084528 35.66180324870789, -82.62470562082689 35.662251248830565, -82.6247606208217 35.66234424885514, -82.62500962079854 35.662763248966115, -82.62505062071686 35.66333624908711, -82.62501762062956 35.6638662491917, -82.62461762043876 35.66467124931461, -82.62341961998428 35.666323249528084, -82.62279261975658 35.66712224962644, -82.62266361970399 35.66732424965432, -82.62225261953472 35.66797724974518, -82.62158161930789 35.668723249828126, -82.6211986191923 35.66905924985726, -82.62102361915679 35.66910024984761, -82.61923861885373 35.66913924967203, -82.61718561848919 35.669287249491035, -82.61648661834184 35.66948824946013, -82.61579361817884 35.66979724945185, -82.61532061805339 35.67010024946495, -82.61464161784262 35.67073324952406, -82.6143106177093 35.67124024959338, -82.61418661765894 35.67143224961974, -82.61394661752871 35.67201724971424, -82.61372661733509 35.673033249898644, -82.61341861707366 35.6743942501443, -82.61335761702122 35.674668250193776, -82.61325061687765 35.67548225034867, -82.61326361675731 35.67627525051155, -82.6133916166306 35.677233250719915, -82.61342961661038 35.67740525075892, -82.61371261646329 35.67866225104408, -82.61407061635718 35.67973425129926, -82.61437461632772 35.680252251436116, -82.61454861631067 35.680550251514745, -82.61492761628627 35.68111625166908, -82.6153446162908 35.681536251797546, -82.61580561630275 35.68195525193037, -82.61726561639075 35.68295825228485, -82.61777061641023 35.683376252422, -82.61800461640556 35.68365825250349, -82.61803361639684 35.68374625252446, -82.61827761632667 35.68446325269565, -82.61830861629939 35.6846732527416, -82.61844261618498 35.68555725293556, -82.6190046160191 35.68723625333544, -82.61907661597424 35.68760425341788, -82.61916161592175 35.688035253514464, -82.61924561586915 35.688466253610926, -82.61936861577446 35.68921125377537, -82.61936161574596 35.68938825381071, -82.61934461566453 35.689896253912416, -82.61912261554733 35.69041525399537, -82.61830261528281 35.69124425407993, -82.61694361486667 35.69247225419038, -82.61592461455733 35.693376254269744, -82.61532261437429 35.693912254317006, -82.61486261420629 35.69450325439008, -82.61478861417787 35.694607254403685, -82.6147146141495 35.69471125441728, -82.61451061411184 35.69473525440119, -82.61389961399837 35.69481125435379, -82.6137996139798 35.69482425434617, -82.61358961392574 35.69494725434961, -82.61354561393419 35.69484525432435, -82.61309761389894 35.69459125422644, -82.61264761384984 35.69442425414612, -82.61096861371881 35.69346425377775, -82.6104746136623 35.6932982536931, -82.61031161363951 35.69327025367067, -82.61003261358671 35.69331125365026, -82.60925261340311 35.69365925364089, -82.60889461329671 35.693962253665816, -82.60844461308724 35.6948322537968, -82.60829661302485 35.69507625383123, -82.60810661298444 35.69513325382336, -82.60794861296232 35.69510625380154, -82.60793261296003 35.69510425379955, -82.60771861294558 35.694967253749645, -82.60759561298542 35.69457725365751, -82.60748261303466 35.69413725355619, -82.6072226130937 35.69347525339457, -82.60712761312146 35.693193253327316, -82.60700261314503 35.692906253256, -82.60692861318 35.69260025318603, -82.6067696132329 35.692087253065175, -82.60659961325103 35.69178725298655, -82.60652761325478 35.691685252958365, -82.60615161325853 35.69125625283229, -82.60578461325395 35.69089125272018, -82.60573161325097 35.69085325270692, -82.6050816132143 35.69039125254592, -82.60459061316638 35.69017225245079, -82.6042646131405 35.68998925237997, -82.60385761311652 35.6897062522804, -82.60370461311574 35.68954625223211, -82.60357761312774 35.68933225217547, -82.60345961313065 35.68918625213356, -82.60338361314696 35.68899925208761, -82.60333961317734 35.68875525203342, -82.60336761320008 35.68863825201238, -82.6034526132256 35.688564252006074, -82.60380461329144 35.68851725203276, -82.60401461333649 35.68845225204106, -82.60410861336018 35.68840025204018, -82.60423761340067 35.68827725202842, -82.60431861343518 35.688141252009004, -82.60435261348277 35.68786925195712, -82.60430061351725 35.68759025189495, -82.60432561354348 35.68744825186858, -82.60428161355716 35.68731225183628, -82.60409861354812 35.68717325178914, -82.60385861352168 35.687086251746784, -82.60351761347418 35.68702625169944, -82.60285561336588 35.68701425162884, -82.60242661328235 35.68709325160086, -82.60222161323661 35.68716825159501, -82.60206961318505 35.68733825161407, -82.60188661309712 35.68771025167095, -82.60162061298496 35.68814925173304, -82.60145061293366 35.68829825174597, -82.60130961290618 35.68832425173668, -82.60114161288084 35.68830725171595, -82.6009126128695 35.68813425165716, -82.6007886128847 35.68790225159709, -82.6006926129054 35.68766525153897, -82.60060461293048 35.68740825147755, -82.60041861296894 35.68695925136689, -82.60026461297642 35.68674525130752, -82.60004061297536 35.68651125123677, -82.59975861295638 35.68633025117088, -82.59933161291593 35.68613225108662, -82.59919461289911 35.6860932510646, -82.59908561288351 35.68607725105009, -82.59890661284916 35.68610625103764, -82.59878961282449 35.686140251032505, -82.59864561278323 35.68625225104052, -82.59854061274233 35.68640425106061, -82.5984776127043 35.68658225109043, -82.59845361267922 35.68671825111565, -82.59849161263695 35.687033251183735, -82.59861461261809 35.68728725124818, -82.59876361260257 35.68754825131665, -82.5988666125699 35.68787025139286, -82.59892761254063 35.68812525145109, -82.59893361250325 35.688373251502256, -82.5988946124421 35.68872725157032, -82.59888561243496 35.68876325157669, -82.59880361236998 35.68909525163591, -82.59866861230182 35.68939125168234, -82.59845661223777 35.68957725169841, -82.59818261217855 35.68966525168816, -82.59794261213513 35.68968825166807, -82.5977026121006 35.689653251636315, -82.59739861205921 35.68959325159277, -82.59705361200797 35.68955425154935, -82.59668161196225 35.689449251489684, -82.5964066119486 35.689241251419, -82.59627761195749 35.68904525136581, -82.59607161198598 35.68863925126186, -82.59591561203771 35.68813725114356, -82.59584161210391 35.68762925103251, -82.59579661212572 35.6874392509891, -82.59572161212537 35.68736125096557, -82.59561061211576 35.6873042509425, -82.59545361209425 35.68727425092023, -82.59527061206468 35.687268250900196, -82.59470061196318 35.68731125085036, -82.59462761195012 35.68731725084401, -82.59437661190466 35.68734125082306, -82.59419061186739 35.68738225081228, -82.59407261183416 35.68747025081809, -82.59398961180493 35.6875702508299, -82.59395361178139 35.687683250849176, -82.59395361176927 35.687762250865305, -82.5939616117676 35.68778125086997, -82.59402661175588 35.687927250906434, -82.59422561173982 35.688245250991734, -82.5943066117447 35.6883002510112, -82.5944416117453 35.688442251054084, -82.59455361173495 35.68862925110367, -82.59473061171853 35.68892625118237, -82.59473261171844 35.688929251183225, -82.59478961171631 35.68900425120432, -82.59496161171013 35.68922925126793, -82.59501961170804 35.689305251289305, -82.59512861170403 35.689448251329665, -82.59515361169981 35.689502251343285, -82.59521661168901 35.68964025137787, -82.59524361166791 35.68980525141422, -82.59522961163503 35.69000325145315, -82.59520261162206 35.690058251461544, -82.59514961160471 35.69011325146732, -82.59509461158987 35.690150251469134, -82.59506861158273 35.69016825147014, -82.59497461156023 35.6902122514695, -82.59492061154957 35.69022325146619, -82.5948756115388 35.6902442514658, -82.594825611527 35.69026725146528, -82.59469761150145 35.69029425145765, -82.59465061149348 35.69029525145306, -82.59440861145174 35.69030525143015, -82.59426061143215 35.69027225140821, -82.594192611426 35.69023925139446, -82.59400761141598 35.690105251348115, -82.59395061141284 35.69006425133396, -82.5938256114078 35.689962251300265, -82.59381561140742 35.689954251297635, -82.59365361140591 35.68978925124732, -82.59351261141211 35.68959725119372, -82.59340461141122 35.68948725116024, -82.59321561140361 35.6893332511094, -82.59299961138798 35.68920125106022, -82.59286561137255 35.689157251037564, -82.59267661134614 35.68912425101138, -82.59254861132565 35.68911925099719, -82.59169161118453 35.68911025090709, -82.59101961107382 35.68910325083658, -82.59084461103794 35.68914725082753, -82.5907566110079 35.68924625083863, -82.59077761099879 35.6893282508575, -82.59090561097408 35.68962525093114, -82.59102661095508 35.68987825099517, -82.59132361094933 35.69023525109842, -82.59141061093655 35.69041125114323, -82.59138461091794 35.69050425115956, -82.59134361090344 35.69055325116529, -82.5911686108547 35.69068025117318, -82.59072461075293 35.69086125116428, -82.59048861068987 35.69101525117138, -82.59039361067234 35.69102625116386, -82.59025961065004 35.69102625115006, -82.5900906106389 35.690916251110266, -82.58994261062605 35.69084025107955, -82.58971361060249 35.690746251036835, -82.58949161057316 35.69069725100397, -82.58922861053372 35.690669250971226, -82.58913161051755 35.6906692509612, -82.58912061051554 35.69067025096033, -82.58883161046431 35.69069125093484, -82.58867661043416 35.69071925092463, -82.58812461029906 35.690999250924875, -82.58788861023422 35.691164250934136, -82.58761961016647 35.69131325093682, -82.58748461013387 35.69137925093644, -82.58725561008217 35.69146725093076, -82.58691461000038 35.69162925092859, -82.58678360996882 35.69169225092799, -82.58650760988475 35.69193925094988, -82.5863866098416 35.692088250967764, -82.58634660982219 35.69217025098041, -82.58632660980696 35.69224725099402, -82.5863266097866 35.69237925102092, -82.58641360970236 35.69301725115987, -82.58647460969303 35.69314325119174, -82.58652860966798 35.69336325124206, -82.5865426096669 35.69338525124807, -82.58658960963474 35.6936432513054, -82.58660960963223 35.69368125131523, -82.58667660963226 35.69375325133682, -82.58671060957174 35.69418125142744, -82.58678460954228 35.69445125149007, -82.58681160951872 35.694632251529754, -82.58683860947826 35.694923251591796, -82.5868326094559 35.69506125161924, -82.58679860942398 35.69523125165041, -82.58675860940198 35.695330251666476, -82.58667060937204 35.69542925167753, -82.58663060936196 35.695451251677916, -82.58654960934507 35.695473251674095, -82.58646860933162 35.6954732516657, -82.58640160932313 35.69545625165537, -82.58605760929979 35.695237251575335, -82.58601960929826 35.69520625156516, -82.58588260929277 35.695094251528175, -82.58574760929238 35.69495125148518, -82.58566660929768 35.694830251452196, -82.58547160932306 35.69445625135593, -82.58534960934682 35.6941712512853, -82.585282609346 35.69410525126501, -82.58519460936532 35.69388525121111, -82.58515460939613 35.693643251157724, -82.58516160945837 35.693248251077996, -82.58513460950245 35.692934251011266, -82.58504660951584 35.69275325096534, -82.5848576095133 35.692566250907795, -82.58480360951454 35.69250025088875, -82.58448760950604 35.69221525079822, -82.58435860949234 35.69216525077471, -82.58390060941942 35.692144250723274, -82.58369260938235 35.69216025070523, -82.58322060929193 35.69223725067229, -82.58294460924259 35.69225925064838, -82.5824196091553 35.6922592505943, -82.58222360912774 35.69222625056739, -82.58204260910519 35.69217725053881, -82.58195460909911 35.69212225051853, -82.58180560909548 35.69198525047531, -82.58171160909781 35.69186925044193, -82.58161760910602 35.691715250400954, -82.5815496091201 35.69155125036059, -82.58147560918435 35.691056250252096, -82.58146660920049 35.690942250228005, -82.58143560925929 35.69052825014041, -82.58139460930602 35.69018225006581, -82.58139760935501 35.68986825000214, -82.58140160940899 35.68952324993223, -82.58143760946362 35.689209249872036, -82.58144860947891 35.68912224985545, -82.58143460950552 35.68893524981587, -82.58138060950841 35.68885824979463, -82.58134060950778 35.68881924978258, -82.58127360950006 35.68879724977118, -82.58113860947763 35.68879724975734, -82.58103760945932 35.68880724974899, -82.58092260943829 35.68881924973961, -82.58083560941945 35.688847249736284, -82.58077660940783 35.68885924973267, -82.58056260936932 35.688878249714534, -82.58020460930477 35.68891024968421, -82.57982460923996 35.68892124964729, -82.5795356091844 35.688969249627355, -82.57944560916884 35.6889732496189, -82.57943460916687 35.68897424961806, -82.57928160913819 35.68899524960651, -82.57904860909468 35.68902624958885, -82.57901060908748 35.68903124958595, -82.57890860906838 35.689045249578285, -82.5788966090661 35.68904724957749, -82.57885960905865 35.68905524957529, -82.57863760901483 35.6891002495616, -82.57822860893391 35.68918324953643, -82.57797260888557 35.68922124951778, -82.57770960883751 35.689249249496456, -82.57769460883524 35.6892472494945, -82.57710360874444 35.689199249423915, -82.57644360865754 35.68905124932582, -82.57595160859105 35.68895224925502, -82.57572260856321 35.68888624921801, -82.57504960847582 35.68872724911637, -82.57421060834902 35.6886452490133, -82.5734126082283 35.68856824891547, -82.57316960819291 35.688535248883746, -82.57303760817503 35.68850924886483, -82.5729746081664 35.68849724885595, -82.57276560814186 35.688431248820976, -82.57276160814149 35.68842924882011, -82.57263760812994 35.688370248795316, -82.57248960811395 35.68831524876899, -82.57244260811113 35.68828224875743, -82.5719746080641 35.68808324866868, -82.5718226080487 35.68801924864001, -82.57171360803899 35.68796524861777, -82.57144560801498 35.68783224856307, -82.57133760800137 35.68780424854629, -82.57121060798026 35.6878042485332, -82.57118960797665 35.68780524853124, -82.57112260796379 35.68781624852662, -82.57085260789259 35.68798624853341, -82.57075860787019 35.68803024853277, -82.57052960782869 35.688052248513635, -82.57029360779205 35.688035248485924, -82.56997760775292 35.68794824843568, -82.56988260774393 35.68790424841689, -82.56969460772308 35.68783724838386, -82.56968060772158 35.68783224838146, -82.56953260770277 35.68779424835846, -82.56939760768981 35.6877332483322, -82.56920460767425 35.68762624829049, -82.56901360765897 35.68751924824907, -82.56871760764552 35.687288248171505, -82.56864960764692 35.68720624814785, -82.5685016076596 35.68696524808356, -82.56845460766384 35.68688724806283, -82.56831960766183 35.68675524802207, -82.56822560765298 35.68671124800337, -82.56814460764294 35.686689247990536, -82.56790260760782 35.68665624795893, -82.56711460747846 35.68664524787554, -82.56693960745099 35.68663524785551, -82.5668116074348 35.686602247835644, -82.56662960741978 35.68650324779677, -82.56621860736682 35.68640424773426, -82.56613060736244 35.68633824771175, -82.56604960736084 35.6862612476878, -82.56599660737237 35.68612924765541, -82.56596160738884 35.68598524762245, -82.56592860740535 35.685843247590185, -82.56585460742026 35.68566724754671, -82.56576060742147 35.68555824751483, -82.56571960742575 35.68548624749595, -82.56543260742538 35.685180247404105, -82.56541160742549 35.685157247397264, -82.56538360742528 35.68512824738849, -82.56534860742525 35.685091247377336, -82.56532860742531 35.685069247370826, -82.56528160742522 35.68501924735577, -82.56525260742438 35.68499324734753, -82.56513460742062 35.68489124731455, -82.56501060741671 35.68478324727978, -82.56498560741588 35.68476124727274, -82.56492760741293 35.68471824725807, -82.56491060741214 35.68470524725367, -82.56486160740951 35.684669247241274, -82.56484560740871 35.68465724723718, -82.56499560745578 35.68451424722351, -82.56505060747337 35.68445924721793, -82.56520460752255 35.6843072472029, -82.56566160766766 35.683860247158925, -82.56586660773235 35.68366224713968, -82.56632160787676 35.68321724709588, -82.56636460789026 35.68317624709195, -82.56682760803204 35.68275724705428, -82.56706460810018 35.682571247040784, -82.56732460817265 35.682382247029054, -82.56763660825617 35.68217724701947, -82.56775860828762 35.68210524701732)))",6436,37,021,002701,370210027012,2122,2122,52,2105,1885,164,8,26,3,19,17,1841,44,1797,1830,1622,160,8,20,2,18,11,738,688,50
census_2010_blockgroups_view.fid--2dc29038_13ec899ba8f_-25be,"MULTIPOLYGON (((-82.4778396084336 35.58446121789795, -82.4771546084127 35.58386021770532, -82.47673360840227 35.58347521758375, -82.47670660840177 35.58344921757572, -82.4766266084007 35.5833702175514, -82.47650760840226 35.583232217511146, -82.47639660840628 35.58308621747009, -82.47631760841124 35.582969217438105, -82.47623660842001 35.582825217400554, -82.47616860843166 35.582676217363236, -82.47611160844471 35.58253021732772, -82.4760706084581 35.58239921729682, -82.47603760847436 35.582258217264716, -82.47600960849316 35.582106217230994, -82.47599860851516 35.581951217198316, -82.47599860854245 35.5817742171623, -82.47601160856897 35.58161621713149, -82.47603660859701 35.581461217102614, -82.4760826086308 35.58129121707278, -82.47614360866696 35.58112221704464, -82.47623160870798 35.58095021701873, -82.47633760875176 35.58078021699503, -82.4764676088019 35.580594216970546, -82.47663160886144 35.58038421694477, -82.47822560942696 35.57842721671064, -82.47825960943936 35.578383216705255, -82.47840560949194 35.57819921668276, -82.47853760954244 35.578013216658555, -82.4786826096044 35.57776721662342, -82.47878860965847 35.5775302165861, -82.4788416096893 35.57738721656247, -82.4788886097254 35.57720321652997, -82.47891860975666 35.5770322164982, -82.47893860978834 35.57684821646286, -82.47895460983636 35.576553216404534, -82.47902060984953 35.57653921640846, -82.47907460985999 35.57652921641197, -82.47921960989022 35.57648921641878, -82.47928560990371 35.57647221642206, -82.47937260992184 35.576448216426094, -82.47972260999369 35.576358216443786, -82.48020361009219 35.57623621646846, -82.48052461015905 35.5761472164833, -82.4809626102487 35.576036216505834, -82.48103661026302 35.57602321651073, -82.48128061030987 35.57598121652727, -82.48148461034661 35.5759622165444, -82.48175461039546 35.5759352165666, -82.48189961042245 35.57591621657766, -82.48191661042557 35.57591421657898, -82.4821246104661 35.575875216592465, -82.48225161049169 35.57584521659945, -82.48239061052094 35.575805216605545, -82.48258461056344 35.57573821661189, -82.48282461061706 35.575648216618255, -82.48306861066946 35.57557021662748, -82.48309761067593 35.575559216628186, -82.48349061076294 35.57541721663972, -82.48388761084627 35.57530321665731, -82.48398061086542 35.57527921666204, -82.4840606108816 35.57526021666635, -82.48432961093486 35.57520321668245, -82.48446561096131 35.575178216691285, -82.48483161102864 35.57513521672017, -82.48502461106303 35.57511921673677, -82.48543261113387 35.5750982167744, -82.48549461114426 35.57509721678062, -82.48590961121303 35.5750972168232, -82.48600461122864 35.57509821683321, -82.48615661125369 35.5750992168491, -82.48625061126955 35.57509721685836, -82.48630861127936 35.575096216864004, -82.48643561130207 35.5750852168749, -82.48653661132325 35.57505621687932, -82.48662861134241 35.57503121688373, -82.48679061137817 35.574973216888594, -82.48698961142667 35.57487221688849, -82.4872226114856 35.5747402168856, -82.48736061152158 35.57465521688244, -82.48785161165438 35.57432121686505, -82.48793161167649 35.574264216861685, -82.48813861173318 35.574118216853236, -82.48824761176162 35.574051216850776, -82.48833661178249 35.574011216851794, -82.48839161179458 35.57399221685356, -82.48843961180512 35.57397521685512, -82.48854761182572 35.57395721686252, -82.48865761184523 35.57394921687222, -82.48877461186345 35.57395721688585, -82.48921761192913 35.5740072169415, -82.48945261196516 35.57402621696953, -82.48963861199236 35.57404921699334, -82.48975561200669 35.57408221701208, -82.4898306120138 35.5741172170269, -82.48988761201537 35.57416821704311, -82.48992461201212 35.57422921705934, -82.48995261200415 35.57431121707895, -82.4899686119926 35.57440321709922, -82.48995561197503 35.574503217118284, -82.48992861195377 35.57461221713767, -82.48987561192828 35.57472121715439, -82.48976261188213 35.57489921717891, -82.48959461181842 35.575132217209074, -82.48950461177728 35.57530221723438, -82.48950161177552 35.575310217235696, -82.48948361175601 35.57541821725581, -82.48948461174027 35.575521217276886, -82.48951661172566 35.575650217306375, -82.48956161171702 35.575755217332365, -82.48962161171478 35.57583421735456, -82.48967961171442 35.5758982173736, -82.48982661172118 35.57601321741209, -82.49008961173874 35.57618221747346, -82.490170611742 35.57624821749518, -82.490255611741 35.576346217523884, -82.49051661173549 35.576663217615156, -82.49062961173507 35.57678721765199, -82.49105461173929 35.5772172177831, -82.49114061173806 35.57731821781252, -82.4912006117344 35.57740621783655, -82.49125161172779 35.57750421786178, -82.4913346116951 35.57780621793172, -82.49139261167649 35.57798921797491, -82.49143561167016 35.57807621799702, -82.49148161166612 35.57815221801711, -82.49152861166363 35.57821921803564, -82.49163061166125 35.578344218071514, -82.49165861165434 35.57841921808966, -82.49165161164191 35.578492218103754, -82.4916156116218 35.57858421811879, -82.49154261159659 35.57866921812855, -82.49148161157711 35.578730218134744, -82.49140761155948 35.57876521813421, -82.49132561154249 35.5787872181303, -82.49125861153095 35.57879021812399, -82.49086861147062 35.578762218078204, -82.49075861145005 35.57877721806995, -82.49067561143245 35.57880221806649, -82.4905836114086 35.57885821806847, -82.49052261139047 35.578910218072785, -82.49046861137133 35.57897621808064, -82.49044061135628 35.5790442180916, -82.4904276113425 35.57911921810552, -82.4904396113037 35.57938421816064, -82.49046661128111 35.5795602181992, -82.4904946112636 35.57970321823123, -82.4905086112486 35.57981621825563, -82.49051061123016 35.5799382182806, -82.49050161121158 35.58004921830228, -82.49046161116063 35.58033721835669, -82.49038361108823 35.58072321842723, -82.49036161106503 35.58085021845078, -82.49035761104552 35.580972218475154, -82.4903656110327 35.581064218494696, -82.49041361101682 35.5812192185312, -82.49043261100825 35.581295218548675, -82.49044861099024 35.581429218577476, -82.49044761098412 35.58146821858532, -82.49042761096065 35.58159821860967, -82.49044261095072 35.58167921862771, -82.4904926109486 35.58174721864668, -82.49061461095823 35.581815218673064, -82.490682610965 35.58184521868615, -82.49075361097165 35.581878218700105, -82.49084661097936 35.58192821871985, -82.49095861099194 35.58196721873932, -82.49108461100865 35.581994218757735, -82.49123961102835 35.58203321878161, -82.49169561109183 35.58211221884452, -82.49182361110883 35.58213921886315, -82.49191461111805 35.582177218880275, -82.49214761113788 35.58229921892901, -82.49226961115268 35.58233421894871, -82.49249061118412 35.58236821897836, -82.49265961121516 35.58234821899163, -82.49300761128323 35.58228121901375, -82.49339661135627 35.58222521904237, -82.49366161140605 35.58218721906187, -82.49395561146127 35.582145219083564, -82.49413061149538 35.582112219094846, -82.49442361155577 35.5820352191093, -82.49444261155972 35.58203021911023, -82.49444761156086 35.58202821911033, -82.49465861160144 35.5819922191247, -82.49471161161195 35.58198021912769, -82.49473061162553 35.58191321911595, -82.4947586116406 35.58184521910504, -82.49480661166345 35.58174821909025, -82.49488461169663 35.58161721907161, -82.49501061174485 35.58143921904834, -82.49503161175268 35.58141121904482, -82.49522661182057 35.58118021901793, -82.4952686118351 35.581131219012214, -82.4955916119439 35.58077221897244, -82.49623961216503 35.580034218888905, -82.49641861222578 35.5798322188662, -82.49653761226475 35.579707218852995, -82.49665561230508 35.57957221883769, -82.49683461231704 35.57968721887949, -82.49711361233537 35.579868218944995, -82.4972806123493 35.57995821898047, -82.49733161235443 35.57997921898996, -82.49739361236229 35.57999521899956, -82.497496612375 35.58002321901592, -82.49756261238244 35.58004621902736, -82.49759661238582 35.58006121903389, -82.49764861239076 35.580084219043925, -82.49771461239565 35.58012421905883, -82.49775661239659 35.58016321907102, -82.49777161239459 35.58019221907849, -82.49778861239237 35.58022521908694, -82.49778961238945 35.580245219091154, -82.49782061241149 35.58013521907188, -82.49783561242354 35.58007321906084, -82.49785661243506 35.580021219052455, -82.49788661244767 35.57997121904537, -82.49788761244818 35.5799692190451, -82.49793661246369 35.5799212190403, -82.49798761247543 35.57990021904128, -82.49807161249326 35.579874219044626, -82.49826461253396 35.57981821905308, -82.49837461255373 35.57980821906242, -82.49845861257099 35.57978621906647, -82.4986756126179 35.579715219074416, -82.49871861262844 35.579693219074365, -82.49879761264721 35.57965621907489, -82.49898161269267 35.57955921907406, -82.49910561272372 35.57949121907303, -82.49919461274509 35.57944821907339, -82.49931961277132 35.579412219078925, -82.4994016127869 35.57939921908476, -82.49948961280104 35.57940221909437, -82.49951061280407 35.57940521909713, -82.49955361281009 35.57941221910297, -82.49962061281798 35.579433219114094, -82.49968961282434 35.57946621912795, -82.49974961282857 35.57950321914161, -82.49986061282945 35.57961721917619, -82.49993161282325 35.57973421920731, -82.50031561277206 35.580480219398524, -82.50041561276133 35.58065721944481, -82.50046361275744 35.58073421946538, -82.50070161273774 35.581118219567905, -82.5007666127345 35.58120921959313, -82.5007916127339 35.58124021960203, -82.50085061273492 35.58129721961968, -82.50101961274315 35.58142521966305, -82.50111161274909 35.581486219684926, -82.50129961276284 35.5815992197273, -82.50153361277991 35.58174021977994, -82.50164361278628 35.58181721980695, -82.50169261278783 35.581860219820705, -82.50177461278754 35.58195021984746, -82.50232661275079 35.582783220073594, -82.50242061274263 35.58293722011459, -82.50247461273281 35.58305922014495, -82.50249961272452 35.583140220163976, -82.50253461270223 35.583322220204586, -82.50252361268826 35.58340122021959, -82.50250661267444 35.58347222023227, -82.50237561261577 35.583712220267635, -82.50235461260496 35.58376022027519, -82.50240561261393 35.58375722027987, -82.5024716126236 35.58376522028825, -82.50256061263646 35.583777220299844, -82.50269161265162 35.58382022032205, -82.50281361266669 35.58385322034133, -82.50284461267046 35.583862220346305, -82.50291761267749 35.583895220360546, -82.50291961267698 35.58390122036195, -82.50296061266572 35.58401822038996, -82.50308761264688 35.58427722045567, -82.5031806126333 35.584465220503496, -82.50346061260521 35.5849492206308, -82.50357461259668 35.58512722067864, -82.50368761259594 35.58525422071613, -82.50375261259695 35.58531722073561, -82.50398161260057 35.58554022080449, -82.50406461260725 35.585586220822336, -82.50413561261284 35.58562622083784, -82.50417761261609 35.58565022084701, -82.50435661263286 35.58573422088245, -82.50435761263303 35.58573422088256, -82.5044296126385 35.585776220898566, -82.5044266126327 35.58581022090519, -82.50441961261592 35.58591222092519, -82.50441761261021 35.585947220932084, -82.50424661256409 35.58606222093789, -82.50418761254804 35.58610322094023, -82.5037646124372 35.586367220950386, -82.50372161242625 35.58639222095109, -82.50354461238038 35.58649922095467, -82.50334761232816 35.586626220960234, -82.5033456123275 35.58662822096042, -82.50324261230091 35.58669022096249, -82.50314261227399 35.5867572209658, -82.50304961224657 35.58683522097214, -82.50298361222443 35.58690822098018, -82.502919612199 35.58700422099315, -82.50287261217412 35.58711522101089, -82.5028716121736 35.58711722101117, -82.50279161212649 35.58733722104776, -82.50264361209142 35.58740522104634, -82.50255161206958 35.58744822104561, -82.50226161199875 35.58759622104594, -82.50220861198542 35.587625221046416, -82.50206661194977 35.58770422104786, -82.50196461192422 35.587760221048775, -82.50176561187136 35.58788922105453, -82.50101561167183 35.588377221076755, -82.50087861163506 35.58846822108116, -82.50058461155609 35.58866422109084, -82.50046461152394 35.58874422109476, -82.50010561142761 35.58898322110643, -82.49998661139541 35.58906422111075, -82.49989961137213 35.58912122111335, -82.49963861130273 35.58929122112116, -82.49955261127951 35.589349221124074, -82.49935361122677 35.58947722112971, -82.49921261119047 35.589561221132264, -82.49920461118869 35.58956422113203, -82.49897861113492 35.58967022113039, -82.49878761109271 35.58973822112458, -82.49860861105581 35.589785221115754, -82.49843261102045 35.58982522110576, -82.49823561098361 35.589852221091014, -82.49804361094964 35.58986622107412, -82.4980266109469 35.58986622107241, -82.49784361091608 35.589869221054194, -82.49761861088088 35.58985522102822, -82.49742661085328 35.58982822100298, -82.49718861082103 35.589781220968995, -82.49710961081198 35.589755220955546, -82.49688461078604 35.58968122091735, -82.49673661077166 35.58961522088877, -82.49647861074999 35.589478220834366, -82.49636661074223 35.58940822080862, -82.49576861070884 35.58898122066034, -82.49549561069348 35.58878722059277, -82.49539461068751 35.58871722056811, -82.49534461068467 35.58868222055584, -82.49465661064626 35.5881912203853, -82.49465261064604 35.58818822038424, -82.49444861063255 35.58805622033643, -82.4942696106194 35.58794922029634, -82.4940756106024 35.58785022025619, -82.49386261058226 35.587752220214405, -82.49355961055007 35.58763522015945, -82.49340161053179 35.58758322013265, -82.49312661049824 35.587505220088474, -82.49286161046317 35.587448220049666, -82.49251661041309 35.58740122000464, -82.49226761037492 35.58738121997499, -82.49223161036927 35.5873792199709, -82.49203861033821 35.587373219949825, -82.49181561030153 35.587371219926446, -82.49141861023482 35.5873772198869, -82.49140361023242 35.58737721988537, -82.49137861022808 35.58737821988298, -82.49136161022518 35.58737821988127, -82.49134861022297 35.587379219880084, -82.49107661017689 35.587385219853346, -82.49082161013375 35.587391219828405, -82.49026061003957 35.587399219772315, -82.48998960999384 35.58740421974549, -82.4899476099868 35.58740421974119, -82.48945860990455 35.58741221969254, -82.48915760985457 35.587413219661784, -82.48857860975686 35.58742421960452, -82.4881716096892 35.587425219562874, -82.48801860966418 35.58742321954671, -82.48789660964394 35.58742321953419, -82.48756160959061 35.58740921949694, -82.48752160958409 35.5874082194926, -82.4874096095666 35.58740121947964, -82.48725660954285 35.58739121946188, -82.48714060952452 35.587385219448755, -82.48680060947277 35.587355219407684, -82.48664860944956 35.58734221938945, -82.48648460942475 35.58732721936954, -82.48647060942267 35.58732521936772, -82.48610760936985 35.58727821932076, -82.48594060934597 35.587253219298525, -82.48576460932082 35.5872272192752, -82.4857236093149 35.58722121926971, -82.4856016092975 35.5872032192535, -82.48556160929179 35.58719721924824, -82.48536060926372 35.5871632192206, -82.48475860917937 35.58706321913838, -82.48469060916977 35.58705221912918, -82.48455860915165 35.587028219110735, -82.48415360909505 35.586959219055004, -82.48374160903747 35.58689021899867, -82.4830516089403 35.58677821890495, -82.48294060892452 35.58676121889008, -82.48253560886656 35.58670221883646, -82.48241860884978 35.586685218820975, -82.48215860881209 35.58665021878712, -82.48207060879899 35.586640218776054, -82.48195460878176 35.58662721876148, -82.48161460873081 35.586592218719424, -82.4812436086752 35.5865542186735, -82.4808416086141 35.58651821862486, -82.48059460857581 35.586501218596055, -82.48033860853606 35.58648421856624, -82.48025460852274 35.586480218556794, -82.48009160849695 35.586472218538425, -82.47972060843787 35.586456218497034, -82.47960160841862 35.58645321848418, -82.47949460840108 35.58645221847294, -82.47943960839277 35.5864472184663, -82.47937860841238 35.58625421842082, -82.4792906084281 35.586057218371714, -82.47928860842838 35.58605321837066, -82.47919260844169 35.58586421832234, -82.47907360845062 35.58567821827234, -82.47896660845576 35.585529218231024, -82.47884860845795 35.58538821819023, -82.47869260845722 35.58522521814101, -82.47852060845436 35.585059218089576, -82.4784736084536 35.585013218075424, -82.47820660844539 35.58477921800034, -82.47807960844133 35.58466921796497, -82.4778396084336 35.58446121789795)))",5127,37,021,001900,370210019001,1560,1560,93,1523,1423,34,11,21,0,34,37,1302,62,1240,1280,1204,26,10,18,0,22,22,832,739,93
census_2010_blockgroups_view.fid--2dc29038_13ec899ba8f_-25bd,"MULTIPOLYGON (((-82.59328563139253 35.559717224718604, -82.59328263142129 35.55952722467958, -82.59326663142782 35.559467224665745, -82.59337263145895 35.55937922465869, -82.59369363155248 35.55911722463828, -82.59370563155585 35.55910822463767, -82.5938036315837 35.55903322463244, -82.59409863166736 35.55880722461676, -82.59415663168328 35.55876622461437, -82.59429463172081 35.558671224609164, -82.59451063177863 35.55852822460213, -82.59482863186058 35.55833922459635, -82.59514863194026 35.55816622459391, -82.59530063197688 35.558092224594425, -82.59549163202249 35.558001224595465, -82.59570463207211 35.55790922459857, -82.59574363208104 35.55789322459934, -82.59586163210786 35.55784622460192, -82.59590163211675 35.557831224603, -82.59597963213469 35.557799224604416, -82.59601163214187 35.557787224605256, -82.5961486321414 35.55793822465, -82.59611863213439 35.557951224649564, -82.59619463213555 35.558026224672645, -82.59631663213288 35.55817522471553, -82.5965456321334 35.55841922478869, -82.59662163213193 35.558511224815234, -82.59688063212636 35.55882722490614, -82.59705663212502 35.55902622496474, -82.59729263211736 35.559331225051054, -82.59746863209622 35.55965922513592, -82.5975146320852 35.55978122516549, -82.59756763206711 35.559956225206555, -82.59755963199477 35.56041822529974, -82.59748363192654 35.56078022536577, -82.59737663184659 35.561185225437235, -82.59728563181164 35.5613142254542, -82.59717863176803 35.561482225477384, -82.59707163170155 35.561799225530976, -82.59705463168734 35.56187322554428, -82.59703563167004 35.56196522556105, -82.5970256316593 35.56202422557207, -82.59701063164331 35.56211222558841, -82.59701063161586 35.56229122562486, -82.59703363159156 35.562474225664495, -82.59709463157583 35.562642225704984, -82.59712763157259 35.56269922571994, -82.59720863156544 35.562833225755554, -82.5971326315492 35.56285622575249, -82.59700963152251 35.5628972257482, -82.59688663149625 35.56293522574328, -82.59668663145315 35.5629992257358, -82.59651863141664 35.563055225730004, -82.5963966313901 35.56309622572585, -82.59619663134667 35.56316322571893, -82.59589563128218 35.56325722570714, -82.59491263107142 35.56356622566928, -82.59438963095907 35.56373222564941, -82.5938886308511 35.56389322563082, -82.59392763084462 35.56397722565189, -82.59393563084357 35.563993225655985, -82.5940466308252 35.564232225716076, -82.59408663081885 35.56431722573742, -82.59414663080975 35.56444122576883, -82.59416963080645 35.5644872257806, -82.59430963078167 35.56480022585862, -82.59431263077876 35.56482222586348, -82.59432563076794 35.56490622588194, -82.59431363075784 35.56495922589143, -82.59398063070383 35.5649512258557, -82.59389663068983 35.564951225847075, -82.5936186306435 35.564952225818736, -82.59264763048604 35.56492722571406, -82.59233863043579 35.56492022568088, -82.59223263041575 35.56493622567324, -82.59216563040005 35.564966225672485, -82.59213763039332 35.5649792256723, -82.59206863037159 35.565046225678834, -82.5920356303534 35.56512922569236, -82.59203463035308 35.56513022569244, -82.59203363034166 35.56520322570725, -82.59203263033365 35.56525422571754, -82.59206563026396 35.56574322582053, -82.59206963025561 35.56580222583286, -82.59207263021857 35.56604622588292, -82.59206563019264 35.56620722591499, -82.59203763016123 35.56638122594748, -82.59195663010766 35.56664222599237, -82.5918166300282 35.56700822605252, -82.59179063000848 35.56710822607018, -82.59176462998437 35.56723722609379, -82.59175762997027 35.567321226110174, -82.59175162995675 35.56740322612628, -82.59176262988784 35.56786322622106, -82.59174462986489 35.56799322624566, -82.59170962983704 35.56813622627114, -82.59170562983321 35.56815722627504, -82.59162662974879 35.56862122636146, -82.59161962972301 35.56878122639329, -82.59161962969456 35.568966226430945, -82.59161962968467 35.56903022644403, -82.59162362965215 35.56924622648841, -82.59162362965057 35.5692562264904, -82.59162362964585 35.56928722649677, -82.59162462964434 35.56929822649906, -82.59162662962643 35.569417226523505, -82.59163262958049 35.56972222658623, -82.5916316295719 35.56977722659735, -82.59163062955321 35.56989722662165, -82.59162962954233 35.56996722663582, -82.5916396295027 35.570236226691655, -82.5916406294999 35.57025522669559, -82.59166662935051 35.57125522690191, -82.59167462930675 35.57154822696239, -82.5916756292997 35.571595226972036, -82.59167562929638 35.57161722697654, -82.59167762928602 35.57168622699079, -82.59167862928261 35.57170922699558, -82.5916846292499 35.571929227040975, -82.59168562924762 35.57194522704428, -82.59168362916657 35.572470227150994, -82.59168162914776 35.57259022717525, -82.59167862911326 35.57281122721999, -82.59167662907788 35.57303922726616, -82.59167462906444 35.573124227283245, -82.59166762897752 35.57368222739619, -82.59166362891817 35.57406422747354, -82.5916606288694 35.57437822753716, -82.5916606288013 35.57482122762738, -82.59165962879884 35.574836227630286, -82.59164962867706 35.57561722778837, -82.59163862862235 35.575961227857285, -82.59163362858293 35.57621222790787, -82.5916256285109 35.57667122800049, -82.59162262848648 35.576827228031945, -82.5916196284525 35.57704522807606, -82.59159662841004 35.57729622812475, -82.59159262840068 35.577353228136005, -82.59159062838492 35.5774532281561, -82.59156362838061 35.57745222815314, -82.59142362835438 35.57747122814264, -82.59140062834972 35.57747722814154, -82.59127162832283 35.577512228135355, -82.59102362826874 35.577596228127085, -82.59085762823116 35.577661228123254, -82.59083762822665 35.577669228122836, -82.59075762820616 35.57771622812419, -82.59069562818878 35.57776222812719, -82.5905926281587 35.57784622813376, -82.59058862815755 35.57784922813394, -82.59028662806357 35.57813422816094, -82.59018662803236 35.57822922817007, -82.59007962800011 35.578323228178185, -82.58998862797505 35.57838822818213, -82.5898406279388 35.57846422818239, -82.58972562791229 35.57851222818035, -82.58930462782229 35.57864222816363, -82.58908362777699 35.578698228152334, -82.58901562776387 35.57871022814784, -82.58896162775326 35.578721228144545, -82.58874762771187 35.57875922813028, -82.58861462768732 35.57877522811991, -82.58855762767809 35.57877322811369, -82.58837162764816 35.578767228093305, -82.58820362762242 35.57875322807319, -82.58795262758633 35.57871622803997, -82.58786362757405 35.57870022802754, -82.58759962753746 35.57865322799088, -82.58751162752516 35.5786382279788, -82.58748462752145 35.57863322797499, -82.58740662751045 35.578620227964386, -82.58709362746649 35.57856822792165, -82.58698962745184 35.57855122790749, -82.58690062743945 35.578535227895074, -82.5867456274164 35.578518227875755, -82.58668762740751 35.57851322786872, -82.58658362739128 35.57850622785661, -82.58643062736553 35.57850822784139, -82.58618562732333 35.578518227818215, -82.58577662725034 35.578551227782924, -82.58547362719597 35.5785772277572, -82.58539762718247 35.578583227750585, -82.58527962716111 35.578594227740695, -82.58517062714242 35.5785982277303, -82.58509562712935 35.57860222772343, -82.58503462711872 35.5786052277178, -82.58490962709877 35.57860022770394, -82.5848996270971 35.578600227702914, -82.58462262705646 35.57856522766735, -82.58435862702036 35.57851522763015, -82.58417662699524 35.57848122760451, -82.58410062698518 35.5784652275935, -82.58407862698209 35.5784612275904, -82.58389462695985 35.57840722756049, -82.58387962695829 35.57840122755773, -82.58380762695023 35.57837622754521, -82.58374062694294 35.57835122753329, -82.58370562693904 35.57833822752703, -82.5835446269233 35.57826722749602, -82.58348062691688 35.578239227483756, -82.58342462691151 35.57821422747295, -82.58325662689515 35.57813922744041, -82.5832006268895 35.57811522742977, -82.58319162688899 35.57810922742767, -82.58312762688253 35.57808222741563, -82.58304662687453 35.57804622739993, -82.58295762686559 35.578008227383044, -82.58285562685417 35.57797222736527, -82.58284662685313 35.57796922736374, -82.58279962684767 35.57795422735591, -82.58271662683774 35.57792922734225, -82.58273062686098 35.577793227316064, -82.58274662688777 35.57763622728574, -82.58283962703814 35.57675922711671, -82.58284362704326 35.57673022711117, -82.58287262708845 35.57646722706062, -82.58299662728142 35.575346226845056, -82.58302562732585 35.575089226795725, -82.58308462738161 35.574790226740916, -82.58314462743152 35.574530226694115, -82.58323762749231 35.574235226643665, -82.58331362753772 35.5740222266081, -82.58339062757966 35.57383222657721, -82.58351562763733 35.57359222654122, -82.58362762768704 35.57339022651157, -82.58368062771218 35.57328422649545, -82.58373462773555 35.57319022648182, -82.58387562779005 35.57298822645524, -82.583904627801 35.572948226450066, -82.58391562780496 35.57293422644829, -82.58394462781602 35.57289322644293, -82.58403362785052 35.57276522642603, -82.5843016279541 35.57238122637534, -82.58432662796375 35.57234522637059, -82.5843916279886 35.5722542263587, -82.58446062801546 35.57215422634544, -82.58451562803641 35.57207722633543, -82.58465462809477 35.571847226302815, -82.58466962810098 35.57182322629949, -82.58471162812066 35.57174122628713, -82.58472962812928 35.571704226281405, -82.58476362814477 35.5716402262719, -82.58478262815484 35.571595226264634, -82.58479962816334 35.57155822625889, -82.58484862818874 35.57144622624114, -82.58496262825759 35.57112122618662, -82.58501162829448 35.570934226153604, -82.585048628328 35.570756226121155, -82.58507662835298 35.57062422609713, -82.5851526284367 35.57016122601068, -82.58535262866583 35.56888722577182, -82.58539462870587 35.56867222573232, -82.58546062875364 35.568432225690266, -82.58551862878686 35.56827922566502, -82.58557362881781 35.56813722564174, -82.58574862889714 35.56781022559316, -82.58594462896828 35.567559225562185, -82.58599662898702 35.56749322555404, -82.5861216290293 35.567353225538355, -82.58614362903569 35.56733522553694, -82.58653862914852 35.567028225515024, -82.58688662923616 35.56683422551121, -82.58714862930188 35.56668922550857, -82.5871276293052 35.566645225497496, -82.58709162931126 35.56656722547788, -82.58707762931765 35.56651022546485, -82.58706762932306 35.56646422545446, -82.5870356293387 35.56632822542346, -82.5869406293853 35.565922225331065, -82.5869096294009 35.565787225300355, -82.58792462961341 35.5655012253463, -82.5888256298174 35.56514722536662, -82.58910162987986 35.56503922537303, -82.59128763036033 35.56427522544172, -82.59165063045863 35.56402822542861, -82.59234263068852 35.56328022534741, -82.59249763074715 35.56306622531971, -82.59292763094021 35.56227422520253, -82.59302163099719 35.56200522515742, -82.59303463102466 35.56184022512513, -82.5931286310972 35.561470225059466, -82.59314263110767 35.56141722505013, -82.59320963119654 35.56091122495395, -82.59329663126505 35.560559224891165, -82.59328563139253 35.559717224718604)))",5947,37,021,001100,370210011003,1337,1337,119,1302,1107,124,2,4,1,64,35,1129,79,1050,1108,965,95,2,4,1,41,21,588,546,42
census_2010_blockgroups_view.fid--2dc29038_13ec899ba8f_-25bc,"MULTIPOLYGON (((-82.28705257150716 35.61926920532125, -82.28705157150803 35.61926220531976, -82.28704957152976 35.61911920529049, -82.28786957166656 35.61911020537331, -82.2879465716794 35.61910920538105, -82.29063757212823 35.61907920565252, -82.29153557227791 35.61907020574331, -82.29316957255092 35.619049205907615, -82.29408457270357 35.61903820599975, -82.29807257336853 35.61899620640251, -82.29861257345843 35.618991206457196, -82.29970757364163 35.61897520656688, -82.29966857362334 35.61905220657848, -82.29963357360624 35.61912520658969, -82.29958957358518 35.619214206603225, -82.29956657356993 35.6192882066159, -82.29954157355303 35.61937120663015, -82.29970257357972 35.619370206646565, -82.2997175735822 35.61937020664809, -82.30024657366862 35.619376206703855, -82.30042357369753 35.61937820672252, -82.30042357369197 35.61941420672984, -82.30042457368768 35.619443206735795, -82.3004155736776 35.61949820674603, -82.30040057367174 35.619520206749, -82.3003815736637 35.61955220675354, -82.30037557366366 35.619546206751686, -82.30014557359785 35.61972620676449, -82.29995857354578 35.61986320677299, -82.2994465734097 35.620196206787725, -82.29921657334972 35.6203382067929, -82.29914857333186 35.62038120679455, -82.29902757329948 35.620461206798346, -82.29891857326623 35.62056020680716, -82.29878757321957 35.62072220682653, -82.29873257319822 35.6208012068369, -82.29862857315948 35.620940206854364, -82.2985675731421 35.620988206857774, -82.29848057311935 35.6210422068598, -82.2982095730577 35.621151206853945, -82.29806757302619 35.621203206849856, -82.29761757293325 35.621324206828, -82.29754657291669 35.62135520682698, -82.29745957289485 35.62140320682773, -82.29736657286897 35.621471206831956, -82.29717857281385 35.62162720684423, -82.29701257276133 35.62178920685994, -82.29686057270997 35.6219592068788, -82.29674957266933 35.62210320689654, -82.296610572616 35.622299206922015, -82.29649157256536 35.62250020695052, -82.29646357255116 35.622562206960225, -82.2964125725245 35.622680206978856, -82.29628457246824 35.622907207011764, -82.29613457241172 35.62311220703788, -82.29607057238462 35.623219207053026, -82.29603557236322 35.623320207069895, -82.29601857234442 35.623423207089, -82.29601957233075 35.62351320710739, -82.29603357231848 35.62360720712792, -82.29604357231595 35.62363420713445, -82.29607057230952 35.623704207151405, -82.29609157230851 35.62373320715947, -82.29612657230672 35.623782207173065, -82.29624157230714 35.623902207209184, -82.29630557230409 35.62399020723367, -82.29634557230229 35.62404420724874, -82.29637757230267 35.624076207258575, -82.29627957228404 35.624092207251685, -82.29621857227212 35.624104207247846, -82.2960375722365 35.62414120723669, -82.29589257220664 35.62417920722946, -82.29581057218573 35.62422720723073, -82.2957685721734 35.624262207233436, -82.29572857216137 35.62429720723649, -82.29566157213716 35.624382207246775, -82.29560657211464 35.624469207258755, -82.29557057209576 35.62455220727195, -82.29551257206936 35.624661207288, -82.29546457204917 35.624740207299084, -82.29534857199991 35.62493520732672, -82.29528157197613 35.62501720733642, -82.29518857194681 35.62510720734512, -82.29512457192571 35.62517520735236, -82.29495457186415 35.62539220737885, -82.29480857180319 35.62563020741204, -82.29476057177808 35.625741207429655, -82.29472357175815 35.62583020744385, -82.29466957171907 35.62602520747784, -82.29466557170122 35.62613620749999, -82.29472557172303 35.626059207490556, -82.29477157174817 35.625946207472325, -82.2948145717709 35.625845207456315, -82.29489157180639 35.625698207434404, -82.29507657186562 35.625512207415774, -82.2951725718931 35.62543720741043, -82.29522557190812 35.625397207407815, -82.29535457193975 35.62533020740753, -82.29536257194152 35.62532720740773, -82.29549457197156 35.625274207410534, -82.29552157197679 35.62526920741238, -82.29568557200741 35.6252462074246, -82.29584857203301 35.62525420744307, -82.29602657205642 35.62529320746933, -82.29605457205997 35.62530020747364, -82.2961895720751 35.62534620749686, -82.29629057208656 35.625380207514155, -82.29636457209469 35.62540620752709, -82.29645357210647 35.625425207540104, -82.29656757212716 35.625413207549464, -82.29660257213514 35.62539920755023, -82.2967035721577 35.62536120755294, -82.29680557218059 35.62532220755557, -82.29681157218188 35.625320207555724, -82.29693257220508 35.62529920756395, -82.29704357222184 35.6253092075775, -82.29713057223401 35.62532320758928, -82.29715657223751 35.625328207592965, -82.29723657225475 35.6253022075959, -82.29748657229035 35.62533920762924, -82.29823957239714 35.62545220772985, -82.29849057243275 35.62549020776349, -82.29855757244894 35.625457207763695, -82.2987705724939 35.62539420777286, -82.29902057253621 35.62538720779721, -82.29913357255522 35.62538520780847, -82.29924657256915 35.62541520782623, -82.29934957257817 35.62546720784742, -82.29942357258061 35.62553020786784, -82.29951757257899 35.62564120790003, -82.29956957256914 35.62576020792957, -82.2995655725544 35.62585120794764, -82.29958157253898 35.625968207972974, -82.2996375725141 35.62618820802337, -82.29965957249516 35.626334208055276, -82.29965557247178 35.62648120808475, -82.29962157243646 35.626673208120195, -82.29960557241908 35.626768208137854, -82.29955657239003 35.626903208160144, -82.2995285723696 35.62700620817814, -82.29949957235698 35.62705620818529, -82.29941257232488 35.6271712081997, -82.29938757231545 35.627205208204046, -82.2992345722707 35.62733120821378, -82.29888457217177 35.62759720823168, -82.29883057215801 35.627628208232416, -82.29869357212323 35.62770720823432, -82.29854457209412 35.62773620822483, -82.29840457206562 35.62777120821753, -82.29830157204003 35.627826208217996, -82.29819857200984 35.62791120822466, -82.29817057199493 35.62797820823532, -82.29817657198363 35.62805720825197, -82.29825057194431 35.628390208327176, -82.29826657192633 35.62852320835587, -82.2982615719072 35.62864220837947, -82.29819957187568 35.628779208400836, -82.29811457183739 35.62893620842392, -82.2979935717913 35.629105208445836, -82.29792057176032 35.62922720846305, -82.29785857173849 35.629302208471806, -82.29772057168951 35.629471208491935, -82.29765857166595 35.62955720850294, -82.29763957165403 35.62961420851253, -82.29756557160606 35.6298452085518, -82.29755657158678 35.62996020857419, -82.29755457158211 35.629988208579675, -82.29755357157981 35.630002208582376, -82.29755157156279 35.630109208603926, -82.29754757155925 35.630128208607374, -82.29754057155161 35.63017020861513, -82.29753257154354 35.63021420862329, -82.29746357150111 35.63041420865672, -82.29746257149105 35.63047820866968, -82.2974625714905 35.630482208670486, -82.29749457148641 35.63054220868593, -82.29753057147909 35.630628208707144, -82.29754557146825 35.630714208726104, -82.29754657145506 35.63080020874363, -82.29752857144119 35.630870208755994, -82.29749857142625 35.63093520876605, -82.29743457140242 35.631021208776914, -82.29734657137283 35.63111820878754, -82.29725857133914 35.63124220880365, -82.29720857131898 35.631319208814034, -82.29703657124867 35.63159020885135, -82.29696157121005 35.631759208877924, -82.29695257119944 35.631818208888944, -82.29691257114565 35.63212320894676, -82.29691257112663 35.63224620897165, -82.29690657110594 35.632373208996825, -82.29689557108735 35.632481209017584, -82.2968935710764 35.63255020903135, -82.2968935710728 35.63257320903604, -82.29689057106138 35.63264420905019, -82.29689257105281 35.63270120906194, -82.2969085710504 35.63273420907024, -82.2969475710503 35.632776209082834, -82.29690857103735 35.63281820908733, -82.29689457103237 35.63283520908937, -82.29685957101937 35.63288220909523, -82.29682757100665 35.63293020910176, -82.29680657099928 35.63295520910457, -82.29677057098644 35.63300020911004, -82.29671057096769 35.6330572091154, -82.29660157093089 35.633178209128715, -82.29646057088704 35.6333112091412, -82.29631557084176 35.633449209154215, -82.29623357081141 35.633558209167866, -82.29611957074908 35.633839209213185, -82.29598257068774 35.634089209249694, -82.29591257065248 35.634242209273545, -82.29587357062648 35.63436820929509, -82.29587057061491 35.634440209309396, -82.29588057061395 35.634457209313844, -82.2959095706114 35.63450420932637, -82.29595657061432 35.63453520933756, -82.29604757062707 35.634550209349996, -82.29615157064423 35.63455020936075, -82.2962255706556 35.634556209369535, -82.29628357066547 35.63455420937517, -82.29630357066885 35.634553209376996, -82.29654457069739 35.63462620941668, -82.29659157070218 35.63464520942534, -82.29670157071342 35.63469020944587, -82.29682757077651 35.63441720940348, -82.29686657079269 35.63435420939468, -82.29690457080679 35.63430320938828, -82.29709257085729 35.63417820938228, -82.29717657088298 35.63410120937532, -82.29723457090003 35.634053209371594, -82.29726057090735 35.63403320937018, -82.29734657092689 35.633999209372206, -82.29754357096269 35.63397820938823, -82.29766857098602 35.6339602093975, -82.2977985710102 35.6339432094075, -82.2978845710304 35.63390420940837, -82.29799957105472 35.63387020941338, -82.29803457106155 35.633863209415566, -82.2981595710856 35.633841209424006, -82.2981935710921 35.633835209426344, -82.29828057110558 35.63384120943649, -82.29838157112098 35.63384920944849, -82.29853157114172 35.6338752094693, -82.29862057115209 35.633903209484174, -82.29863757115368 35.63391120948749, -82.29870157115943 35.63394220950045, -82.29874557116271 35.633968209510236, -82.29897357122728 35.63379420949845, -82.29904857125746 35.63367920948287, -82.29906457126819 35.63362720947392, -82.29907757127611 35.63358920946766, -82.29912057131085 35.633411209435884, -82.29917957135382 35.63319620939836, -82.29926257139391 35.63302620937243, -82.2993825714333 35.632899209359024, -82.29972857153723 35.632597209333404, -82.29985857157493 35.63249220932558, -82.30017357166705 35.63223320930547, -82.30022557168306 35.63218520930108, -82.30026157169426 35.632151209297945, -82.30031857171141 35.63210120929362, -82.3003795717277 35.63206120929184, -82.30042157173888 35.63203420929064, -82.30053057176798 35.631962209287316, -82.30066957180578 35.63186620928219, -82.30076657183545 35.63177820927428, -82.30078757184289 35.63175220927119, -82.30084957186446 35.63167920926274, -82.30096657191041 35.63150720923994, -82.3012355720081 35.6311632091979, -82.30152257211071 35.63080620915503, -82.30164557215357 35.630660209138114, -82.30183957222113 35.63043120911165, -82.30193757225737 35.63030120909539, -82.30192157224765 35.63034720910309, -82.30191657223892 35.63039820911292, -82.30191557223468 35.63042420911803, -82.30190757221497 35.63054320914137, -82.30190457219032 35.630699209172775, -82.30190457218623 35.630726209178185, -82.30191157217601 35.63079920919378, -82.30191357217214 35.63082620919941, -82.3019205721645 35.63088320921176, -82.3019245721613 35.63090820921719, -82.30193057215786 35.6309362092235, -82.30193757215262 35.630978209232744, -82.30199357214558 35.63108320925984, -82.30208157214648 35.63117120928684, -82.30217757215188 35.63123920931048, -82.30229157216156 35.631298209334254, -82.30240657217294 35.631347209356015, -82.3025615721893 35.63140720938421, -82.302727572209 35.63145720941145, -82.3030705722554 35.631523209460234, -82.30335757229423 35.631578209501036, -82.3035475723187 35.63162320952977, -82.30367757233518 35.63165520954964, -82.30370857233908 35.63166320955447, -82.30386157236151 35.6316812095739, -82.3039585723775 35.63168120958391, -82.3040455723933 35.631672209591024, -82.30412457240956 35.63165120959495, -82.30430057244715 35.63159620960196, -82.30444957247836 35.631554209608765, -82.30452357249084 35.63155220961604, -82.3046185725053 35.63156020962741, -82.30471557251755 35.6315842096423, -82.30477957252404 35.631611209654416, -82.30491457253656 35.63167420968116, -82.30500657254593 35.63171120969807, -82.30510457255934 35.63172920971185, -82.30518157257491 35.63171120971614, -82.30523657258848 35.63168220971599, -82.30528957260515 35.631631209711095, -82.30533157262195 35.63156720970249, -82.3053635726395 35.631488209689685, -82.30538657265781 35.63139420967299, -82.30539457266379 35.63136420966768, -82.30539557266698 35.63134420966378, -82.3054085726893 35.63121420963874, -82.30538057279578 35.63049620949016, -82.30538157281293 35.63038620946788, -82.30542057285592 35.63015020942403, -82.30546357288534 35.63000620939925, -82.30562057297507 35.62959420933185, -82.30580357307072 35.629171209264875, -82.3059895731681 35.62874020919655, -82.30609757321463 35.62855520917013, -82.30623857326685 35.62836820914671, -82.30645957334465 35.62810120911533, -82.30653757337193 35.628008209104536, -82.30671157343188 35.627806209081456, -82.30701657353723 35.62745120904086, -82.30761357373719 35.62679620896949, -82.30800457387511 35.62632220891365, -82.30805357389227 35.626263208906764, -82.30829157397402 35.62598920887568, -82.30845457402702 35.625820208858144, -82.30847057403214 35.625804208856664, -82.3085875740667 35.62570620884872, -82.30862357407618 35.62568320884776, -82.30869957409595 35.62563620884607, -82.3088115741221 35.6255872088477, -82.30897957415459 35.62555620885875, -82.30922657419545 35.6255562088842, -82.3093115742087 35.62556120889396, -82.31006157432589 35.62560420898006, -82.31039857437956 35.6256172090175, -82.31087557445537 35.625636209070535, -82.31097157446962 35.6256462090825, -82.31101757447558 35.62565720908942, -82.31106457447936 35.625683209099556, -82.31103757447136 35.62570620910144, -82.31100357445567 35.62577120911114, -82.31098657444431 35.62582620912056, -82.31098157444038 35.62584620912405, -82.31097657442328 35.62595120914488, -82.31098457439063 35.62617120919033, -82.3109945743683 35.62632620922286, -82.3110065743444 35.62649320925793, -82.3110525742857 35.62692220934981, -82.3110755742575 35.62712820939395, -82.3110695742365 35.627258209419736, -82.31106057422132 35.62734620943665, -82.31103957420413 35.627435209452635, -82.31092157411867 35.6278612095268, -82.31084057405486 35.62818720958473, -82.31078357400986 35.62841720962543, -82.31076257398617 35.62854820964987, -82.31076657397725 35.62861020966296, -82.31079557396157 35.62874220969271, -82.31080257396117 35.62875220969539, -82.31076657395255 35.62876920969518, -82.31075157394777 35.628784209696676, -82.3107385739422 35.62880620969976, -82.31073057393445 35.628848209707506, -82.31074157390064 35.62907820975529, -82.31077757388184 35.62923820979148, -82.31082057384111 35.62954720985866, -82.31082957381588 35.62972020989468, -82.31081257380427 35.62977720990452, -82.31078357378996 35.62983820991388, -82.31069757375195 35.62999220993627, -82.31066057372959 35.63009720995377, -82.31043657363793 35.63045021000235, -82.31021357349994 35.63110421011204, -82.31006857347148 35.631133210102945, -82.30955457338071 35.6311712100577, -82.30921057331692 35.63121621003134, -82.30899457327796 35.63123721001333, -82.30891157326137 35.63125621000859, -82.30888457325594 35.63126221000708, -82.30879457323175 35.63132221000991, -82.30874857321916 35.63135421001171, -82.3086345731806 35.63148221002591, -82.30857657315616 35.63157821003938, -82.30857257314528 35.63164421005238, -82.30857257314233 35.631663210056246, -82.30858757313476 35.63172821007095, -82.30861257313212 35.63177221008251, -82.30861557313162 35.63177821008404, -82.30865457313365 35.63180721009393, -82.3086995731395 35.63181721010055, -82.30874257314616 35.63182021010559, -82.30893157317468 35.63183721012859, -82.30917457320945 35.63187221016073, -82.30919657321247 35.631876210163824, -82.30931957323065 35.63189021017936, -82.30933157323238 35.631891210180775, -82.30943857324611 35.631917210197095, -82.30953257325342 35.63197021021753, -82.30960057325369 35.63204121023898, -82.30968457324605 35.63218021027586, -82.30971657324929 35.63219321028183, -82.30978557326107 35.63219121028849, -82.30987657327879 35.63217321029425, -82.30996057329607 35.63215121029846, -82.31004657331276 35.632135210304085, -82.31005457331422 35.632134210304706, -82.31013757332825 35.632132210312825, -82.31021857334275 35.63212521031976, -82.31054157341337 35.63201321033041, -82.31074757345033 35.631994210347784, -82.31095457347946 35.63202721037577, -82.31113057349633 35.632106210410036, -82.31123757351155 35.63212221042426, -82.31134957352911 35.63212821043705, -82.31143257354326 35.63212521044497, -82.31157757357107 35.632100210454944, -82.31171257359543 35.632087210466175, -82.31182857361235 35.63210121048101, -82.31198757363379 35.63213221050374, -82.31209757364684 35.63216521052176, -82.31218957365604 35.632204210539115, -82.31226757366036 35.63225921055839, -82.31234457366072 35.632339210582515, -82.31237857365383 35.63242021060246, -82.31238357364215 35.63250121061942, -82.31238257364093 35.63250821062076, -82.31238057363 35.63257621063433, -82.31236957361753 35.632645210647226, -82.31238457360143 35.63276521067312, -82.31239857359758 35.63280521068268, -82.3124255735652 35.633043210733746, -82.31241057353634 35.633213210766755, -82.31237657350802 35.633360210793086, -82.31236457349785 35.633413210802566, -82.31229657345287 35.633631210839845, -82.31227357343883 35.63369721085088, -82.31224657340928 35.6338592108809, -82.31220957338051 35.63400621090697, -82.31217757335989 35.63410521092376, -82.31212657333117 35.63423621094512, -82.31209957330226 35.63439421097433, -82.31206257328112 35.63449121099024, -82.31201957325989 35.63458221100428, -82.31199757324892 35.63463021101177, -82.31192057321805 35.63474721102754, -82.31182257318636 35.634847211037695, -82.31173257315929 35.6349262110445, -82.31169357314032 35.63500721105693, -82.31162457311693 35.63508421106539, -82.31149657308173 35.63517521107067, -82.31129857303088 35.63529221107404, -82.31127557302143 35.6353292110791, -82.31127757300739 35.63542221109828, -82.31129757300616 35.63545121110617, -82.31135657300696 35.63550921112406, -82.31140057301137 35.63552721113225, -82.31145357301996 35.63552821113789, -82.31152457303362 35.635516211142765, -82.31175257308527 35.63542521114783, -82.31190757311789 35.63538021115469, -82.3120605731481 35.63534821116404, -82.3121765731693 35.635335211173235, -82.31225257318204 35.63533421118091, -82.31231857319212 35.63533921118878, -82.31237657319645 35.63537321120168, -82.31243257319545 35.635439211220834, -82.31245757318625 35.63552521124084, -82.31244857317027 35.63561921125901, -82.31241357314502 35.63574521128097, -82.31236357312216 35.63583921129492, -82.31232557310689 35.63589721130274, -82.31223357307769 35.63598821131171, -82.31195157300614 35.636149211315285, -82.31189257298628 35.63621421132242, -82.31188257297043 35.63630621134006, -82.31189357295756 35.636401211360464, -82.31194157294361 35.63654221139405, -82.31194257293902 35.636573211400425, -82.31194657293167 35.6366252114114, -82.31193057291037 35.63674521143408, -82.31180957286266 35.636924211457966, -82.31174957283235 35.63705621147853, -82.31168657280632 35.637157211492536, -82.31162757277566 35.63729221151388, -82.31161757276719 35.63733621152176, -82.31165057276388 35.637393211536754, -82.31178257276756 35.63751021157415, -82.31189257277649 35.6375692115974, -82.31194157277783 35.63761321161144, -82.31200657277944 35.63767221163008, -82.3122035727841 35.63785221168693, -82.31221857278442 35.63786621169134, -82.31222957278379 35.637882211695704, -82.31226857278554 35.63791221170582, -82.31224057277682 35.63793921170845, -82.31215857275082 35.6380192117162, -82.31213157274198 35.63804721171911, -82.31212857274124 35.63804921171922, -82.31212157273869 35.638058211720306, -82.31211957273787 35.63806121172072, -82.31207957272429 35.638106211725734, -82.31202757270489 35.63817621173461, -82.31193457266941 35.63830621175141, -82.31180457260912 35.6385572117889, -82.31177857259671 35.638609211796755, -82.31173757257773 35.638688211808606, -82.31172957257408 35.63870321181081, -82.31170557256267 35.63875121181804, -82.31169857255905 35.63876721182055, -82.31165357253762 35.63885721183417, -82.31141557243393 35.63927321189412, -82.31129657238453 35.6394652119208, -82.31124457236285 35.63955021193267, -82.31106857229649 35.6397912119634, -82.31085457222306 35.64003721199123, -82.3106675721602 35.64024321201381, -82.31056957212877 35.64034221202382, -82.31032057205279 35.6405672120438, -82.31011757199431 35.6407282120555, -82.30998557195852 35.64081821206009, -82.30981957191533 35.64092021206368, -82.30955657184951 35.641064212065785, -82.30952957184327 35.64107621206548, -82.30922457176976 35.641225212064214, -82.30899457171861 35.64131021205774, -82.30878357167363 35.641376212049366, -82.30839757159153 35.64149421203352, -82.30825757156194 35.64153621202759, -82.30783657147224 35.64166621201054, -82.30767957143628 35.64173121200753, -82.30751257139379 35.64182721200979, -82.30739857136322 35.64190321201347, -82.3072995713343 35.641984212019686, -82.30697857122522 35.64234621206003, -82.30691157120361 35.64241421206693, -82.30672057114191 35.64260921208679, -82.30650057107971 35.642776212098006, -82.30648957107681 35.642783212098294, -82.30645957106823 35.642806212099806, -82.30645057106558 35.64281421210056, -82.30627357101537 35.642949212109656, -82.30605857095587 35.64310421211897, -82.30600557094112 35.643143212121394, -82.30583357089594 35.64325121212555, -82.30560957084272 35.643356212123756, -82.3053645707881 35.643447212116946, -82.30511357073352 35.64353221210831, -82.30485357068034 35.64359821209487, -82.30470657065138 35.643628212085815, -82.30422957055742 35.64372621205646, -82.30400557051168 35.643783212044895, -82.30392357049432 35.64380721204129, -82.30373457045405 35.64386621203374, -82.30343657038672 35.64398321202677, -82.30316457032303 35.64410421202326, -82.30304757029437 35.64416421202334, -82.30276757022536 35.644311212024306, -82.30272457021488 35.644333212024264, -82.30267557020264 35.64436021202473, -82.30260457018314 35.64441021202759, -82.30256557017236 35.64443821202928, -82.30245357014161 35.6445172120337, -82.30242957013485 35.64453521203492, -82.30221457007113 35.64471721204967, -82.30214257004877 35.64478521205598, -82.30204457001787 35.64488021206516, -82.30194456998657 35.64497521207416, -82.30182156994428 35.6451172120903, -82.30180956994046 35.6451292120915, -82.30166756989304 35.64528421210831, -82.30155356985699 35.64539521211903, -82.30143456982323 35.64548621212521, -82.30100556971193 35.64574721213395, -82.30099956971044 35.6457502121339, -82.30077456964978 35.6459022121415, -82.30071756963387 35.64594421214413, -82.30062356960765 35.646013212148425, -82.30058756959738 35.64604121215043, -82.30041256954709 35.64617921216041, -82.30035556952905 35.64623521216588, -82.3002745695027 35.64631821217431, -82.30019756947807 35.646395212182036, -82.30014956946246 35.64644521218727, -82.29998056940413 35.646641212209616, -82.29995856939637 35.64666821221274, -82.2999035693794 35.6467192122174, -82.29977056933787 35.64684521222932, -82.29975556933312 35.64686021223074, -82.29933956921361 35.64718821225444, -82.2991955691721 35.64730221226266, -82.29913456915433 35.64735221226655, -82.29901756911605 35.64747421227922, -82.29896856909541 35.6475552122906, -82.29867956897293 35.648038212358784, -82.29857456893062 35.648199212380675, -82.29842256887741 35.64838021240167, -82.29839556886913 35.64840521240404, -82.29815056879168 35.64864421242722, -82.298101568776 35.64869321243205, -82.29802456873283 35.648889212463935, -82.29799156869225 35.64911621250657, -82.29799556867931 35.64920421252485, -82.29800956864192 35.649460212578234, -82.29799156861186 35.64963521261191, -82.29793156857858 35.64978621263635, -82.29783656853377 35.64997421266467, -82.29770356847831 35.65019021269484, -82.29750956840289 35.65047021273161, -82.29738756835715 35.65063521275248, -82.29726756831477 35.65078121276976, -82.29722456829924 35.65083521277626, -82.29705756823792 35.6510532128033, -82.29697756819542 35.651242212833374, -82.29696956818661 35.65129021284225, -82.29696356818098 35.65132021284779, -82.29694756816411 35.65141221286473, -82.29694256815846 35.651443212870596, -82.29693756815301 35.6514732128761, -82.29693256812305 35.65166121291375, -82.29695256811289 35.65174821293354, -82.2969705681039 35.65182521295099, -82.297107568089 35.65206721301428, -82.29734256807097 35.65243421311293, -82.29740256806262 35.652552213143125, -82.29744256805684 35.65263221316344, -82.29753356804089 35.65283221321347, -82.29761556802356 35.65303121326228, -82.29765856801471 35.65313421328765, -82.2976595679828 35.65334121332974, -82.297634567928 35.65366821339352, -82.297619567892 35.65388421343585, -82.29761856788522 35.653927213444454, -82.29761556786472 35.65405621347036, -82.2976155678579 35.654100213479246, -82.29761456784858 35.65415921349111, -82.29763756782556 35.65433221352856, -82.29764356782071 35.65437021353697, -82.29773056780357 35.65457321358711, -82.29796656778429 35.65494921368782, -82.29804456777799 35.65507321372098, -82.29810956777932 35.65513421374012, -82.29821856778163 35.65523521377185, -82.29823556778226 35.6552492137765, -82.29842156778847 35.65540721382772, -82.2985765677906 35.65555921387456, -82.29861156778999 35.65560021388652, -82.29869756778852 35.655701213915926, -82.2987155677861 35.65573621392478, -82.29874756778135 35.6558012139413, -82.29875856776984 35.655887213959915, -82.29876656776256 35.655942213971855, -82.29872956772333 35.65615621401148, -82.29864256768009 35.6563422140403, -82.29863956767838 35.6563502140416, -82.29859656764883 35.65649521406655, -82.29852956760409 35.65671221410368, -82.29846056756698 35.656878214130266, -82.29832656752023 35.657037214148744, -82.298140567465 35.65719521416157, -82.2979775674164 35.657335214173166, -82.29783556737077 35.65747821418757, -82.29752356727832 35.65774221420888, -82.2974385672461 35.6578592142239, -82.2974325671892 35.65822021429644, -82.2973975671605 35.658368214322955, -82.29726556710845 35.65856321434887, -82.29709256705198 35.65874321436757, -82.29661556691491 35.65911921439459, -82.29655156689653 35.65916921439812, -82.29648256687652 35.65922521440243, -82.29635956684245 35.65931321440751, -82.29629556682487 35.659359214410266, -82.2960915667721 35.659482214414176, -82.29590356672335 35.65959621441796, -82.29558256666041 35.659660214397746, -82.2955795666667 35.65961621438849, -82.29551256665111 35.65964521438745, -82.29550556664945 35.659649214387635, -82.29529656661097 35.65967421437102, -82.29522456659755 35.65968421436565, -82.29519456659214 35.659687214363224, -82.29510556657574 35.65969821435622, -82.29507656657034 35.65970221435406, -82.29501456655889 35.65971021434929, -82.2944685664534 35.659808214312804, -82.2942865664132 35.65987421430741, -82.29411856636668 35.65999521431456, -82.29390556628671 35.66028421435126, -82.2937875662421 35.66044621437191, -82.29356156617052 35.66066721439347, -82.29342456612672 35.66080321440698, -82.29285856598729 35.66110021440875, -82.2924215658912 35.66125421439486, -82.29178856574076 35.661550214389635, -82.29150556566674 35.66172621439611, -82.29131656562188 35.66181421439441, -82.29054256544802 35.662111214374754, -82.29031556539455 35.66221421437224, -82.29002356532567 35.662347214369056, -82.28987556529538 35.662385214361535, -82.28918156514061 35.66264421434241, -82.28903956510487 35.66272321434379, -82.28897456508852 35.66275921434438, -82.28879056504209 35.6628632143465, -82.2887825650397 35.66287021434706, -82.28873256502284 35.66292521435313, -82.288636564991 35.6630282143641, -82.2884745649279 35.66326321439508, -82.2884745649277 35.66326421439526, -82.28795556476258 35.66377621444558, -82.28757456463872 35.66416921448599, -82.28742956459155 35.66431921450138, -82.28729556454293 35.66449021452234, -82.28720156450856 35.66461121453715, -82.28707256445335 35.66483021456823, -82.28706456443867 35.66491621458486, -82.28705656442402 35.665002214601515, -82.28698356440314 35.66505921460551, -82.28691156438244 35.66511621460967, -82.28672956432672 35.665281214624386, -82.28650056427021 35.66540221462528, -82.2860155641423 35.66571021463765, -82.28588956411113 35.66577721463825, -82.28563856404857 35.665913214639865, -82.2852815639564 35.66612721464649, -82.28505256388527 35.66634221466646, -82.28459456372966 35.66685821472394, -82.28442556366076 35.66712221476002, -82.28429056359063 35.667430214808604, -82.28408156352562 35.6676272148269, -82.28319956317708 35.66893521500132, -82.28307156312087 35.66916121503388, -82.2827885629881 35.66971621511731, -82.28267356291876 35.67004021517119, -82.28258756282646 35.67054421526456, -82.2825855628243 35.67055621526675, -82.28245156270317 35.671194215382414, -82.2824775626504 35.6715622154598, -82.2825525626286 35.67178221551218, -82.282814562608 35.672194215622895, -82.2829785626095 35.67235921567331, -82.28336656261307 35.67274921579255, -82.28368256262765 35.67299121587423, -82.28387156263325 35.67315621592729, -82.28392756262622 35.673261215954334, -82.28395956262227 35.673321215969835, -82.2842085626037 35.67370621607363, -82.28434256258824 35.673948216136594, -82.28456556254922 35.67443721625889, -82.28491556252088 35.67499221640766, -82.28531856252431 35.67539921653185, -82.28567556252953 35.675745216639015, -82.28594556251875 35.6761022167393, -82.28631656254329 35.67633921682577, -82.28644356255153 35.676421216855466, -82.2869755625797 35.67680621698857, -82.28710356259059 35.676872217015195, -82.28721856259591 35.676960217044865, -82.28742156261536 35.67705121708433, -82.28742756259433 35.677193217113825, -82.28714256253106 35.677297217105505, -82.28704756250978 35.677333217102984, -82.28581456230259 35.6773562169803, -82.28566056227649 35.67736021696515, -82.28537456222169 35.67740921694553, -82.28495756219115 35.67716221685238, -82.28424956215194 35.676661216677566, -82.28414656219498 35.67627421658836, -82.28399756219096 35.67614121654597, -82.28344056219755 35.67550621635962, -82.28328556219613 35.67535021631191, -82.28285056219242 35.674911216177954, -82.2824955622093 35.67442421604245, -82.28228456223285 35.674048215944346, -82.2822175622557 35.673829215893015, -82.28221756229641 35.67356721583982, -82.28210556231686 35.67331621577731, -82.28210556242699 35.67260621563325, -82.28204956250661 35.67203321551122, -82.2813205626278 35.670476215119955, -82.28090056267921 35.669697214918486, -82.28084456270192 35.66949121487091, -82.28067656270261 35.66930821481636, -82.28064856272275 35.66914821478107, -82.28031156271695 35.66882721468113, -82.28020156271086 35.66874921465384, -82.28011356284883 35.667766214445386, -82.28009856290555 35.66738421436632, -82.28019256295552 35.667162214330965, -82.28032056301866 35.66689121428914, -82.28050156310864 35.66650421422931, -82.28067756316796 35.666309214208, -82.2809505632735 35.66591921415703, -82.28118456334265 35.665722214141226, -82.28156656345595 35.66539821411493, -82.28205256356897 35.66518721412231, -82.28236156368402 35.66477421407037, -82.28252956376848 35.664408214013484, -82.28281056387527 35.664019213963584, -82.2836525641244 35.66330921390641, -82.28370856417631 35.66303421385639, -82.2837355641882 35.662986213849486, -82.2838775642503 35.662737213813635, -82.28427056438265 35.66230221376587, -82.28483456453719 35.66190621374381, -82.2850945646612 35.66138321366455, -82.2852285647441 35.660991213598784, -82.28531156476843 35.660922213593416, -82.28536656478617 35.66086621358774, -82.28544956481264 35.660784213579625, -82.28539256484122 35.66053921352407, -82.28526656495438 35.659675213335674, -82.28649156544688 35.6578032130823, -82.28584956548372 35.65688121282895, -82.28582156548536 35.65684121281796, -82.28614056592724 35.65433021234134, -82.28655456612361 35.65350421221645, -82.28657056626044 35.65263821204233, -82.28642756639123 35.65164221182552, -82.28625656648849 35.650832211643525, -82.28557956681288 35.648017211002404, -82.28506156679754 35.64756421085707, -82.28403756667082 35.64729121069589, -82.28318256656466 35.647065210561784, -82.28284256660119 35.64646721040534, -82.28277156667485 35.64591621028622, -82.28290656680734 35.64520421015572, -82.28301156701173 35.64399720992162, -82.28309656717242 35.64305020973821, -82.28244656727198 35.64171520940026, -82.28191256751084 35.639603208916654, -82.28154256753878 35.63902920876202, -82.28064656748845 35.638399208541635, -82.28014956745156 35.638107208431165, -82.27995956743742 35.637996208389026, -82.27708856703305 35.63754720800159, -82.27615456688619 35.63750020789562, -82.27578656684916 35.63734720782666, -82.2750895668617 35.6365232075875, -82.27491256686493 35.63631420752684, -82.27486956686582 35.63626220751185, -82.27314756679846 35.634862207050155, -82.27274556683454 35.63420120687454, -82.27186456678525 35.63358020665763, -82.27085156686026 35.632016206235825, -82.27079456685286 35.632003206227246, -82.27038056688369 35.63136320605467, -82.27087756705106 35.630811205994, -82.27146756725402 35.63013020591685, -82.27290656749675 35.63009620605838, -82.27383756775055 35.629449206023196, -82.27423956787518 35.62907220598821, -82.27390156790875 35.62849520583621, -82.27373256792563 35.628206205760115, -82.27207456811243 35.625232204985736, -82.271979568132 35.62500420492969, -82.27182556810601 35.62500820491463, -82.27144856808543 35.624739204821125, -82.27160156819069 35.62422220473209, -82.27179856832117 35.62358920462393, -82.2718835683942 35.623208204555425, -82.27197756846881 35.62282620448768, -82.27207756851674 35.622623204456865, -82.27215756855506 35.622461204432206, -82.27230056862383 35.62216920438772, -82.27234956864554 35.622081204374965, -82.27243756868421 35.62192520435231, -82.27256456871285 35.62187520435528, -82.27267456873695 35.621837204358975, -82.27276756875723 35.621805204362026, -82.27287056877881 35.62177520436656, -82.27298056880097 35.62174920437267, -82.27300956880686 35.62174220437425, -82.27312456882923 35.621720204381624, -82.27299056875106 35.622083204441445, -82.27285656868172 35.622388204489525, -82.2728115686544 35.622516204510816, -82.27268056857434 35.622894204573996, -82.27266256855265 35.6230152045967, -82.27265656853767 35.62310520461426, -82.27267156851464 35.623270204649366, -82.27274756848696 35.62353020470996, -82.27287156847164 35.6237612047696, -82.27293256847027 35.62383520479092, -82.27295156846984 35.623858204797514, -82.27301756847292 35.62390820481451, -82.27316056848157 35.62400520484889, -82.27332056849359 35.62409820488428, -82.27335456851075 35.62402320487254, -82.2734015685379 35.62389820485204, -82.27351456860171 35.62360620480448, -82.27364456867076 35.62329920475562, -82.27372956871538 35.62310120472421, -82.27394456874059 35.62316720475979, -82.2740225687532 35.62316920476828, -82.27437156880866 35.6231832048071, -82.27453356884638 35.62311220480943, -82.27479456892542 35.622879204789044, -82.27480956893292 35.62284720478414, -82.27494656899736 35.62257620474328, -82.27501856900734 35.622589204753346, -82.27523756903715 35.62263020478432, -82.27531056904704 35.622644204794675, -82.2752695689963 35.62292820484806, -82.27525456897743 35.623034204868, -82.27587456901348 35.623462205018804, -82.27598456901987 35.62353820504553, -82.27613656904921 35.62351020505553, -82.27623656906859 35.62349220506222, -82.27625356907937 35.6234402050534, -82.27625456908034 35.62343520505254, -82.27632056912142 35.623240205019776, -82.2762895691593 35.62296220496016, -82.27627256918126 35.62280220492594, -82.27626756918713 35.62275920491673, -82.27626556919034 35.62273620491181, -82.27618456918705 35.62267120489024, -82.2761525691858 35.62264520488169, -82.27611956919797 35.62253120485519, -82.2760225692347 35.622190204776004, -82.27599056924691 35.6220772047498, -82.2759955692778 35.62188320471093, -82.27608956929178 35.62189320472265, -82.27619056930672 35.62190420473526, -82.27619856930805 35.6219042047361, -82.27637956933624 35.62191520475702, -82.27652956935952 35.621924204774366, -82.276571569366 35.62192720477934, -82.27663856937924 35.621913204783404, -82.27672756939675 35.62189520478887, -82.27674156939979 35.621890204789366, -82.27697456944911 35.621820204799164, -82.27703656946606 35.621776204796625, -82.27712456949008 35.62171520479332, -82.27714256951593 35.62156720476516, -82.27714656952045 35.62154220476052, -82.2770865695473 35.62130520470622, -82.27704356956647 35.621135204667326, -82.27700756958285 35.62099120463436, -82.27702956958805 35.62098120463463, -82.27709656960344 35.620953204635846, -82.2771195696086 35.620944204636366, -82.27719456960924 35.62102020465959, -82.27722156961015 35.621043204667, -82.27724156961169 35.621054204671246, -82.27727856961319 35.62108420468118, -82.27728456961356 35.6210882046826, -82.27731156961586 35.62110220468826, -82.27733856961768 35.62111920469445, -82.27736456961962 35.62113420470019, -82.27737956962369 35.62112420469977, -82.27743756963845 35.621090204698774, -82.27749556965469 35.6210472046961, -82.27762456968723 35.620974204694605, -82.27768756970391 35.62093420469296, -82.27776956972282 35.620899204694354, -82.27782356973636 35.62086920469381, -82.27788456974785 35.62086020469827, -82.27795656975984 35.62085920470557, -82.27802756976877 35.62087720471644, -82.27810356977078 35.620945204738106, -82.2781505697679 35.62101420475698, -82.27817456976007 35.621090204774845, -82.27817656975998 35.62109320477568, -82.27823956975523 35.62119120480206, -82.2782985697535 35.621265204823146, -82.27838456975498 35.62134720484865, -82.27841756975592 35.621376204857995, -82.27850556975868 35.62145220488242, -82.27851856975929 35.62146220488581, -82.27855556976141 35.62148820489489, -82.2787685697725 35.621643204948334, -82.2788025697743 35.621668204956904, -82.27896156977825 35.62181220500255, -82.27906756977826 35.62192520503637, -82.27916956977204 35.622074205077126, -82.2792345697611 35.6222142051123, -82.27925156975721 35.62225720512273, -82.27930356974582 35.622386205154285, -82.27932656973057 35.622509205181615, -82.27933656970876 35.62266120521347, -82.2793255696993 35.62271020522229, -82.27929956967658 35.6228292052437, -82.27924856963789 35.623025205278275, -82.27917556959551 35.623221205310436, -82.2791405695795 35.62328720532021, -82.27909556955863 35.62337420533325, -82.27902056953498 35.62344720534032, -82.27903856953158 35.62348820535056, -82.2790615695245 35.62355820536711, -82.27906256951961 35.62359120537387, -82.2790705695003 35.62372420540167, -82.27911156947664 35.623921205445875, -82.27917056947024 35.6240252054731, -82.27919856946711 35.6240752054861, -82.27926356946713 35.624144205506795, -82.27928056946855 35.62415320551037, -82.27933456947336 35.62418020552141, -82.27934456947415 35.62418520552351, -82.27935356947602 35.62418320552395, -82.27937656947192 35.624234205536695, -82.27950556947754 35.624335205570496, -82.27951456947798 35.62434220557288, -82.27975556949022 35.62452020563384, -82.28008356950993 35.62474220571268, -82.28027656952153 35.62487320575926, -82.28028056957423 35.624537205691475, -82.28029456973252 35.62352920548841, -82.28029956978521 35.623194205420965, -82.28033556980397 35.62311120540786, -82.28035856981431 35.623069205401684, -82.28050756987987 35.622804205363295, -82.2805695699037 35.62271620535185, -82.28064956993421 35.62260420533736, -82.28071256995719 35.62252320532743, -82.28088057001126 35.62235320531026, -82.28107957007501 35.62215320529021, -82.28119657011554 35.62201620527453, -82.28132257016128 35.62185520525486, -82.28142257019972 35.621713205236354, -82.28151957023977 35.62155820521494, -82.28167557030403 35.62130920518048, -82.28169757031414 35.62126720517418, -82.28177157034798 35.621127205153506, -82.28177857035101 35.62111520515173, -82.28186957038912 35.62096620513095, -82.28196157042609 35.620825205111835, -82.28198357043622 35.62078320510552, -82.28202457045178 35.620726205098194, -82.28205057046141 35.62069220509394, -82.28212557048737 35.62060420508387, -82.28214057048454 35.620638205092284, -82.28215057048452 35.620649205095575, -82.282205570484 35.62071120511385, -82.28226257048551 35.62076220513008, -82.28229357048625 35.62079020513891, -82.28230357048706 35.62079620514119, -82.28239957053368 35.62059720511068, -82.28243057055515 35.62049120509239, -82.28250757060752 35.62023520504844, -82.28252757065162 35.61997120499688, -82.2825955706791 35.61986620498267, -82.28270257071206 35.61976720497359, -82.28287157075268 35.61968520497435, -82.28312057080818 35.61959220498119, -82.28314057081413 35.61957520497982, -82.2831475708211 35.619537204972815, -82.28336457085635 35.61954120499602, -82.28401857096209 35.619555205066305, -82.28408357097253 35.61955720507339, -82.28423657099623 35.619567205091236, -82.28444057102789 35.61958020511496, -82.28474757106991 35.619636205157974, -82.28481857107863 35.619655205169124, -82.28500657110165 35.619707205199084, -82.28543957114756 35.61987220527728, -82.2858045711818 35.62004020534897, -82.28605157120727 35.62013920539455, -82.28628357123563 35.62020320543147, -82.28647757126086 35.620247205460444, -82.28648157126155 35.6202472054608, -82.28666957128976 35.62026520548382, -82.28687257132052 35.620283205508464, -82.28707057135368 35.62028020552829, -82.28707557136434 35.62021620551577, -82.287073571368 35.620191205510494, -82.28706257140708 35.61992620545565, -82.28706257140823 35.61991920545419, -82.28706257141499 35.61987520544527, -82.28706257142068 35.61983820543772, -82.28705957144254 35.619694205408194, -82.28705257150716 35.61926920532125)))",6387,37,021,003102,370210031022,1239,1239,27,1213,1142,53,1,5,1,11,26,1087,25,1062,1064,1000,47,1,5,1,10,23,606,345,261
census_2010_blockgroups_view.fid--2dc29038_13ec899ba8f_-25bb,"MULTIPOLYGON (((-82.65920563147401 35.63044324589235, -82.65945163149851 35.63055024593946, -82.6597026315221 35.63066824598921, -82.65989763153122 35.630820246040265, -82.66010663152858 35.63106324611121, -82.6604916315098 35.631601246260416, -82.66054263150887 35.63166224627809, -82.66065163150697 35.63179224631577, -82.6608256315107 35.631956246367096, -82.66102663152243 35.63209724641646, -82.66124263154025 35.63221524646267, -82.66145563155955 35.632320246505955, -82.6617236315866 35.63243424655674, -82.66195063161253 35.63251124659569, -82.66214863163917 35.63255224662439, -82.6622866316612 35.63255824663979, -82.66243163168708 35.632547246652415, -82.66255963171328 35.63251524665909, -82.66269663174471 35.63245924666166, -82.66283263178 35.632377246659, -82.6630056318277 35.63225424665164, -82.66338363193691 35.631954246629284, -82.6645176322682 35.63102924655716, -82.66489863237784 35.630729246535104, -82.66516563245067 35.630545246524974, -82.665170632452 35.63054224652496, -82.66532563248849 35.63047224652661, -82.66543663251176 35.63044124653168, -82.66554563253145 35.63043124654081, -82.66566763255028 35.63044124655538, -82.66581863257016 35.63047524657782, -82.66601163259291 35.63053624661005, -82.66666363266802 35.63075324672125, -82.6668316326896 35.630795246747006, -82.66694463270412 35.63082324676438, -82.66694963270508 35.63082224676465, -82.66695963270436 35.63083724676871, -82.66720663266433 35.63136424690149, -82.66721763266294 35.631385246906945, -82.66758563261777 35.63207624708559, -82.66814463256652 35.63301324733399, -82.6684656325373 35.63355024747641, -82.6685246325319 35.63364924750263, -82.6689866324891 35.63442624770842, -82.66900863248722 35.634462247718076, -82.66943163245287 35.63514224790006, -82.66987363245056 35.63563524804601, -82.67020163245407 35.63596724814729, -82.67035663245568 35.63612424819523, -82.67053963245786 35.636308248251574, -82.67089763246163 35.63667024836213, -82.67096663246222 35.6367412483837, -82.67163463246729 35.63743024859276, -82.67167763246785 35.637473248605936, -82.67214163247492 35.6379292487465, -82.6721786324755 35.63796524875767, -82.67278363248148 35.63858024894512, -82.67295363248321 35.63875324899783, -82.67349663248407 35.63933424917208, -82.67377963248451 35.63963724926283, -82.67391063247591 35.639835249316704, -82.67396263247248 35.63991324933795, -82.67411863246222 35.6401482494019, -82.67417163245896 35.640227249423376, -82.67433063244856 35.64046624948847, -82.67436663244607 35.64052124950335, -82.67448963243363 35.64073524955963, -82.6744896324325 35.64074224956108, -82.67473763240115 35.64121424968281, -82.67501963235961 35.64178824982874, -82.67521263232834 35.64220024993258, -82.6755166322634 35.64295025011667, -82.6756376322342 35.64327025019433, -82.67561363221746 35.643353250208804, -82.67555263218857 35.64347425022723, -82.67546563214707 35.64365025025414, -82.67541863210288 35.64388625029748, -82.67540663206567 35.64411425034273, -82.67540563205995 35.644150250349924, -82.67537863203088 35.64430925037954, -82.67536863202578 35.64433225038325, -82.67532463200334 35.64443025039871, -82.67516963194024 35.64467225043217, -82.67497363186799 35.64492925046443, -82.67496063186303 35.644947250466736, -82.67482563180337 35.64518825050199, -82.67463063173693 35.64540825052678, -82.67439563166563 35.645617250545335, -82.67419363161159 35.6457492505515, -82.67381663148784 35.64614525059352, -82.67350263138327 35.64648425063037, -82.67348663137786 35.646502250632444, -82.67324363128573 35.646837250675745, -82.67316963124888 35.64699625070061, -82.67316263123149 35.64710125072126, -82.67280663117563 35.64707925068018, -82.67244263111165 35.64710125064729, -82.67228763108575 35.64710125063142, -82.67187063102816 35.647024250572876, -82.67172263100187 35.64703525055987, -82.67162863098036 35.64707325055806, -82.671587630959 35.647167250572934, -82.67149863089196 35.64750625063299, -82.67139963081587 35.6478922507015, -82.67142663079497 35.648057250737885, -82.67149963078528 35.64819925077433, -82.67170263079032 35.64838625083328, -82.67181663077271 35.64862325089332, -82.67187063075289 35.64881025093701, -82.67190363072034 35.64905725099076, -82.67195063069589 35.649266251038235, -82.67199863068201 35.64940825107207, -82.67209863068345 35.64950725110256, -82.67245563073007 35.649590251156056, -82.67270463074952 35.64973325121082, -82.67284663075039 35.64988125125556, -82.67292763073674 35.65005725129972, -82.67297463071495 35.650249251343716, -82.672960630694 35.65037025136696, -82.67293363067162 35.65048625138791, -82.67283263064301 35.65056225139304, -82.67269163061522 35.65059025138421, -82.67250963058244 35.65060625136881, -82.67230763054036 35.650661251359224, -82.67213963049542 35.650771251364475, -82.67206563046106 35.65091425138599, -82.6720586304269 35.65112825142888, -82.67209163039847 35.65134825147712, -82.67225363033819 35.651914251609135, -82.67230063030696 35.6521672516656, -82.67232063029425 35.65227125168885, -82.67234063026959 35.65245325172799, -82.67232763024361 35.65260725175805, -82.67227363022292 35.65268325176801, -82.67219263019928 35.65274925177313, -82.67210563018388 35.65275525176547, -82.67199763017699 35.65268325173966, -82.67192363016878 35.65265625172658, -82.67182963014803 35.65268925172366, -82.6717556301197 35.65279325173724, -82.6716676300949 35.65285925174167, -82.67147963005503 35.65291425173359, -82.670953629953 35.65300825169873, -82.67085262993533 35.653013251689366, -82.6706176298885 35.653063251675405, -82.6704756298641 35.65306825166183, -82.6703686298497 35.653046251646366, -82.67018662983702 35.65293125160417, -82.66995062983086 35.652716251536134, -82.66965462981116 35.65252425146665, -82.66938562978676 35.652392251412046, -82.66931262978369 35.65233325139257, -82.66910962977542 35.65216725133784, -82.66892162976279 35.65204625129385, -82.66859762973428 35.651881251226946, -82.66834262972566 35.6516612511559, -82.66803962969642 35.651524251096845, -82.66791862967965 35.651502251079904, -82.66753462960224 35.65158925105824, -82.66722462954631 35.651617251032164, -82.66698862950965 35.65160025100438, -82.66671962947841 35.651512250958795, -82.66651062945793 35.65141925091837, -82.66577762935869 35.651271250812954, -82.66534662930644 35.65114425074274, -82.66489562926017 35.650957250658344, -82.66446462921284 35.650798250581666, -82.66409162916105 35.65073125052968, -82.66397262914451 35.650710250513136, -82.66379762912818 35.650627250478294, -82.66365662913343 35.65044025042571, -82.66354262912961 35.65034225039396, -82.66317862910044 35.65013825031504, -82.66275462910278 35.64966525017507, -82.6626676291011 35.6495822501492, -82.66251262909796 35.64943525010335, -82.6623506290879 35.649325250064265, -82.66218262906678 35.64928125003798, -82.66196062903067 35.649275250013964, -82.66171762898168 35.64933025000029, -82.66161662895136 35.6494182500078, -82.66151562891174 35.64956625002764, -82.6613606288578 35.64974825004879, -82.66119262881115 35.64986925005621, -82.66109862877687 35.649990250071205, -82.66106462875608 35.65008825008769, -82.66106962875527 35.65009925009047, -82.66110562874852 35.65018225011105, -82.66134762874634 35.65045725019202, -82.66142162873926 35.65058325022525, -82.66144862871326 35.650781250268395, -82.66140162868165 35.65093525029498, -82.66127962861816 35.65121525033954, -82.66125262858411 35.65140725037589, -82.66128662856164 35.651589250416514, -82.66137362854656 35.65178125046458, -82.66154262854165 35.65199525052554, -82.66186562855553 35.652254250611534, -82.66195262855473 35.65235325064061, -82.66199362854557 35.65245725066606, -82.66200662853414 35.652545250685286, -82.6619796285221 35.65259425069248, -82.66191262850415 35.652638250694665, -82.66158262843324 35.652742250681875, -82.66117162835786 35.65278625064868, -82.66089562830258 35.65284725063275, -82.66074762826776 35.65291325063095, -82.66059962822702 35.65301725063702, -82.66045762817889 35.65317625065485, -82.66022262808966 35.653501250696955, -82.66009462803699 35.65370425072518, -82.66002662800115 35.653863250750575, -82.65990562796821 35.65394625075512, -82.6598386279495 35.65399525075823, -82.65970362792021 35.65403925075334, -82.65947462787867 35.65406125073429, -82.65925062784078 35.65406525071204, -82.65919862783198 35.6540662507069, -82.65876762775082 35.65412725067507, -82.65813462763687 35.65418225062129, -82.65740762751429 35.65419225054864, -82.65717562747955 35.65416725051971, -82.6570986274679 35.654159250510176, -82.65676162742203 35.65409325046206, -82.65653962738504 35.6540932504393, -82.65637062735517 35.65410425042418, -82.65622962731639 35.65420325042987, -82.65593962720365 35.654621250485285, -82.65585862717828 35.654698250492665, -82.65555662712212 35.65473625046935, -82.65548062711105 35.654726250459476, -82.6549566270333 35.654664250393026, -82.65431062693166 35.654626250318884, -82.65354262680204 35.654637250242246, -82.65345962678819 35.65463725023373, -82.65293062669934 35.65464225018039, -82.6527216266561 35.65469725017012, -82.65252662661096 35.65477925016687, -82.65235762656832 35.65487325016862, -82.65213562651628 35.65497125016579, -82.65171862642045 35.65514225015778, -82.6514356263522 35.65527925015669, -82.65117262629482 35.655367250147606, -82.65076162622391 35.65538325010861, -82.65057362618326 35.6554442501017, -82.65041862614734 35.65550925009906, -82.65033762612204 35.65558625010643, -82.6503446261019 35.65572425013525, -82.65044562609835 35.65585625017252, -82.65068762611071 35.65603725023431, -82.65084262611857 35.65615325027392, -82.65101062611873 35.65633425032806, -82.65118562611389 35.65655425039085, -82.65127962609999 35.656746250439596, -82.65130662607484 35.65693825048161, -82.651273626043 35.657109250512974, -82.65120562600958 35.65725225053524, -82.65107762596716 35.65738925054997, -82.65080862589099 35.657592250563695, -82.6505996258434 35.657675250559144, -82.65032362579673 35.65768025053177, -82.64996662574669 35.65761925048274, -82.64972762571979 35.65753525044095, -82.64957662570286 35.6574822504147, -82.6487886256395 35.657042250244075, -82.6484186256075 35.65685025016687, -82.6478326255618 35.6565142500382, -82.64757762553033 35.6564432499975, -82.64737462549233 35.6564702499822, -82.64720662545328 35.65654224997958, -82.64708562541537 35.65665724999058, -82.64701762537183 35.65686625002619, -82.6470046253465 35.657016250055435, -82.64700462534509 35.65702525005722, -82.64708562532813 35.65722325010593, -82.64706462530594 35.65734425012845, -82.64688962524788 35.657531250148516, -82.64679562519419 35.65777825018923, -82.64672962514597 35.658019250231604, -82.6467146251348 35.658075250241545, -82.64656662506876 35.65834425028109, -82.64636862501506 35.65847825028807, -82.64636462501393 35.65848125028828, -82.64624962498968 35.65851425028317, -82.64606162495421 35.65854125026938, -82.64593262492674 35.65858025026401, -82.64557662483355 35.6588002502723, -82.64544862480975 35.65881625026241, -82.64523262477475 35.65881025023906, -82.64506462475265 35.65877225021394, -82.64496362473336 35.65878825020692, -82.64467962466148 35.65894725021009, -82.64466062465651 35.65895925021055, -82.64447862462278 35.65898125019637, -82.64408162456107 35.65895325014982, -82.64407462454297 35.65906325017161, -82.64401362450823 35.659222250197686, -82.64396062448753 35.659299250208, -82.64383262445507 35.65937125020944, -82.64360962440868 35.659431250198786, -82.6434616243739 35.659497250197056, -82.64333362433314 35.65962325020953, -82.64332062432253 35.659678250219386, -82.64325262429513 35.65978225023361, -82.64284862418111 35.66008525025387, -82.64272062412844 35.660288250282065, -82.64252562404263 35.66063425033256, -82.64241562400439 35.66076325034753, -82.64234362397931 35.66084825035745, -82.64171662379017 35.66139725040493, -82.64158262375167 35.66150225041252, -82.64131962368415 35.66165625041692, -82.64094862359788 35.66181525041122, -82.64076062355804 35.6618702504031, -82.64055862349313 35.66207325042371, -82.64040962343604 35.66228225045094, -82.64008662333224 35.662606250483805, -82.63978362321654 35.66302925053887, -82.63951462312684 35.66332025057056, -82.63935862306528 35.66355125060158, -82.63919762299102 35.66385825064757, -82.63888662286627 35.66433125071205, -82.63878562281815 35.66453425074305, -82.63864462276754 35.66471025076444, -82.63852362272699 35.66484225077889, -82.6383546226836 35.66494125078169, -82.63818662264636 35.66500125077666, -82.63801162260368 35.665089250776575, -82.63777562255335 35.66516025076678, -82.63763462252894 35.66516625075356, -82.637506622512 35.665138250734685, -82.63699462245226 35.66497325064848, -82.63677262241528 35.66497325062562, -82.63662962238408 35.66502125062072, -82.63659762237685 35.665033250619835, -82.63638162233242 35.665088250608896, -82.63581662223999 35.66507725054852, -82.63547962215938 35.66523625054629, -82.6350556220456 35.66551625055976, -82.63480562197516 35.66570325057222, -82.63452262188987 35.665950250593504, -82.63439862185722 35.66602825059656, -82.63435862184643 35.666055250597985, -82.63435562184969 35.666030250592534, -82.63435162188229 35.665815250548334, -82.63436162190293 35.66569225052428, -82.63439862193592 35.66551825049264, -82.63450662199625 35.66524425044792, -82.63455362201961 35.66514325043213, -82.63471562209092 35.66485625039033, -82.63478062211792 35.66475125037563, -82.63496162219083 35.66447425033778, -82.63500462221046 35.664393250325716, -82.63506162224067 35.66425925030423, -82.63511462227508 35.66409325027585, -82.63514362230167 35.663952250250105, -82.63515462231089 35.66390425024142, -82.63518062234601 35.66370525020358, -82.63519562238206 35.66348725016068, -82.6351496224231 35.66317225009172, -82.63512162244551 35.66299625005299, -82.63508162246465 35.66282925001489, -82.63506662247704 35.662733249993714, -82.6349856225086 35.66244124992591, -82.63490962253175 35.66220924987077, -82.63488662254505 35.66209824984589, -82.63487062255895 35.661991249822385, -82.63486762257448 35.66188724980088, -82.63487262258624 35.66181624978692, -82.63491662261947 35.66164824975719, -82.635334622835 35.66070224960737, -82.63553462293173 35.66029124954419, -82.63561262297533 35.6600932495118, -82.63565062299891 35.65998124949297, -82.63567162303774 35.65975224944844, -82.63568362309589 35.65938824937547, -82.6356766231149 35.65925724934809, -82.63562662314627 35.65900024929059, -82.63559562315251 35.6589262492723, -82.6355356231603 35.65881124924272, -82.63543062316423 35.6586722492036, -82.63527662316166 35.658523249157376, -82.63502462315023 35.65832524909117, -82.63477562314026 35.658121249023935, -82.63457962313637 35.65793524896591, -82.63448362314476 35.6577772489239, -82.63440662315705 35.657614248882716, -82.63436462317351 35.65746224884746, -82.63432762319377 35.65729124880879, -82.63421662329701 35.65650224863657, -82.63419162332713 35.65628024858877, -82.6341796233558 35.656081248546975, -82.63419262338422 35.65591124851367, -82.63421062340308 35.655808248494544, -82.63420862342745 35.65564824846171, -82.63418962344252 35.655530248435724, -82.63415262345052 35.655438248413176, -82.63410862345627 35.6553532483913, -82.63405662346337 35.6552512483652, -82.63388162348181 35.65494324828439, -82.63381962348642 35.654846248258316, -82.63371562349435 35.65468224821414, -82.633665623506 35.6545532481828, -82.6336616235183 35.65446924816524, -82.63366062352213 35.654443248159865, -82.63368662354515 35.65432224813788, -82.63376662358387 35.65415724811252, -82.6338886236367 35.65394624808196, -82.63393762365601 35.65387424807241, -82.63406562370523 35.653693248048654, -82.6340746237087 35.65368024804696, -82.63413562373283 35.65359024803486, -82.63425662377657 35.65343724801609, -82.63437962382304 35.65326824799427, -82.6344586238552 35.65314524797737, -82.63458962391907 35.65287224793516, -82.63461362393387 35.65280224792336, -82.63464262395077 35.652724247910434, -82.63469062398515 35.6525532478806, -82.63481262405205 35.652251247831536, -82.63485562407287 35.65216224781782, -82.63492762409781 35.65207824780806, -82.63503162412859 35.65199124780109, -82.63504062413115 35.65198424780055, -82.63515862416277 35.65190624779677, -82.63530662420116 35.65181724779388, -82.63549262424759 35.651717247792604, -82.63561262427912 35.65164224778962, -82.63605562440604 35.65129724776485, -82.63630362448299 35.65106624774329, -82.63648962454492 35.650865247721356, -82.63658062458853 35.65068024769304, -82.63661262462254 35.65049424765839, -82.63662262465637 35.650286247617046, -82.6365826247607 35.64956624746628, -82.63658162480469 35.649280247407866, -82.63660162487585 35.64884024732024, -82.63669862498271 35.6482522472104, -82.63681162505165 35.647927247155756, -82.63700962513009 35.647632247115965, -82.63718062518736 35.64744524709543, -82.63730962524153 35.64723324706549, -82.63743162530317 35.64696524702338, -82.63749162533321 35.64683524700311, -82.63770962544027 35.646376246931936, -82.63777762547831 35.646202246903506, -82.63795962556708 35.64582324684494, -82.63809862564409 35.64547424678813, -82.63817862569775 35.645212246742915, -82.63819562571358 35.64512824672747, -82.63820562573527 35.644998246702144, -82.63819062575202 35.644873246675026, -82.6381756257599 35.64480624665988, -82.6381516257736 35.64469124663395, -82.63809962578951 35.644532246596185, -82.63805562579526 35.64444724657439, -82.63787962580915 35.64416724649923, -82.63771762581425 35.64395924644023, -82.6375826258188 35.643784246390716, -82.6375176258203 35.643704246367655, -82.63750962582061 35.64369324636465, -82.6374246258261 35.64356624633003, -82.63737362582914 35.643491246309566, -82.63735562583095 35.64346024630135, -82.63731662583434 35.64339624628428, -82.63718462585304 35.64313224621693, -82.63717762585418 35.64311724621312, -82.637134625869 35.64297524617976, -82.63702662586654 35.642874246148075, -82.63695462586769 35.642789246123414, -82.63692862586844 35.64275624611397, -82.63690762586916 35.642729246106306, -82.63689662586972 35.642713246101984, -82.63685262587546 35.64262824608011, -82.63682362589469 35.642472246045386, -82.63683062595098 35.64211524597333, -82.63683462598817 35.641878245925405, -82.6368386260124 35.64172524589468, -82.63683562603454 35.641578245864395, -82.6368286260753 35.641306245808224, -82.63681762608564 35.64122724579105, -82.63680262609384 35.64115824577538, -82.63676862610065 35.641077245755426, -82.63672562610412 35.64100824573694, -82.63665862610593 35.64092424571293, -82.63646562610604 35.640715245650526, -82.63638162610651 35.64062124562277, -82.63622562611167 35.64041924556556, -82.63594262612764 35.64001024545318, -82.63588662613037 35.63993224543148, -82.63559162614494 35.639519245317004, -82.63543362615279 35.639298245255695, -82.63493362617868 35.63859024506014, -82.63449462619768 35.63799324489336, -82.63417162619754 35.63764524478931, -82.63387662619535 35.63734124469704, -82.63353362618635 35.63702924459825, -82.63338362618427 35.636880244552515, -82.63328462618404 35.63677524452091, -82.63324062618592 35.63671524450412, -82.63312562619383 35.636540244456675, -82.63307862619709 35.63646824443718, -82.63298062621172 35.63626724438613, -82.63285262623472 35.6359802443145, -82.63281462624164 35.63589424429308, -82.6327556262467 35.63579724426723, -82.63325362631747 35.63587624433448, -82.633332626331 35.635873244342015, -82.63340862634601 35.63585824434677, -82.63342562634995 35.63585124434708, -82.63348462636299 35.635830244348845, -82.63354662638083 35.63578124434522, -82.63359362639672 35.63572924433945, -82.63370862645198 35.63549424430337, -82.63376262647537 35.63540124428997, -82.63385762650952 35.6352822442755, -82.63399862655704 35.6351262442582, -82.63426162664771 35.634821244223076, -82.63437362668519 35.63469924420972, -82.63444162670609 35.63463724420406, -82.63450762672389 35.63459324420187, -82.63459862674611 35.63454724420182, -82.63475562677831 35.63450724420982, -82.63484762679496 35.634499244217615, -82.63497662681662 35.63449724423049, -82.63512962683953 35.6345142442497, -82.63536462687141 35.6345612442834, -82.63547162688442 35.634592244300684, -82.63551462688892 35.63460924430854, -82.63560962689893 35.634647244326075, -82.63595862692316 35.63486624440652, -82.63603862692818 35.63492024442579, -82.63612362693345 35.63497824444631, -82.63642462695198 35.635183244519034, -82.63673362697193 35.635387244592366, -82.63696162698842 35.635526244644005, -82.63714862700428 35.6356252446834, -82.6373076270197 35.635697244714414, -82.63756862705017 35.63578124475837, -82.63763662705918 35.63579624476842, -82.63775262707414 35.635824244785994, -82.63804162711422 35.63587624482633, -82.63823462713873 35.635925244856146, -82.63848362717137 35.63598224489333, -82.63866662719361 35.6360362449231, -82.6388126272112 35.63607924494686, -82.63895862722168 35.63616924498022, -82.63924362722598 35.63644924506651, -82.63940162723223 35.63657924510927, -82.6395296272393 35.63667124514112, -82.6396566272489 35.6367462451695, -82.63975862726139 35.63677524518585, -82.63977262726308 35.63677924518811, -82.63989262728029 35.63679724520411, -82.6400506273046 35.63681024522299, -82.64020162732649 35.6368312452428, -82.64021162732762 35.636834245244394, -82.64024162733129 35.63684324524937, -82.64025162733247 35.63684624525095, -82.64034262734333 35.636874245266064, -82.64040562734915 35.636904245278664, -82.64049262735716 35.63694624529612, -82.64062862736488 35.63704324532988, -82.64067362736729 35.63707624534116, -82.6410066273705 35.637415245444515, -82.64112662737281 35.637529245480096, -82.64125562738289 35.63760324550837, -82.64140262740084 35.63764524553207, -82.641562627426 35.63765524555053, -82.64169162744787 35.637652245563096, -82.64206962751165 35.637647245600924, -82.64212162752042 35.63764624560612, -82.64241462756979 35.63764224563532, -82.64265262760782 35.6376522456618, -82.64287662763626 35.63771024569665, -82.6430746276533 35.63781324573801, -82.64312162765722 35.637838245747886, -82.64348062768049 35.63807524583307, -82.64398462770887 35.63843524595823, -82.64423262771675 35.63865224602791, -82.64445862771703 35.63889424610044, -82.64463562771569 35.639094246159395, -82.64477262771969 35.639216246198266, -82.64492162772991 35.63931024623277, -82.64528362776697 35.6394612463007, -82.64543962777954 35.63954824633452, -82.64544562777985 35.63955224633592, -82.64567262779555 35.639696246388624, -82.64591462781786 35.639812246437096, -82.64614762784493 35.63988824647648, -82.64633962786962 35.63993524650584, -82.64641362787921 35.639953246517024, -82.64642662788103 35.6399552465188, -82.64657262790077 35.639985246539915, -82.64669162791917 35.63999424655399, -82.6467816279331 35.64000124656467, -82.64748162804742 35.640015246639365, -82.6478896281166 35.64000724667962, -82.64802462813941 35.64000524669318, -82.64845962821421 35.63998924673456, -82.64872262826252 35.63996024675567, -82.64884862828832 35.639928246762004, -82.64894162831145 35.639879246761616, -82.64904462834427 35.63977724675141, -82.64922762841755 35.63949924671357, -82.64929062845106 35.63935024668967, -82.64929462846725 35.63924924666953, -82.64922162849864 35.638967246604494, -82.64921862851494 35.638858246581975, -82.64923862853438 35.6387532465627, -82.64930162856255 35.63863824654568, -82.64936462858128 35.63858524654135, -82.64941862859706 35.6385412465379, -82.64962162864624 35.638441246538406, -82.64986562869734 35.63837324654957, -82.65009462874183 35.63833224656475, -82.65010562874379 35.63833124656567, -82.65031262877996 35.6383202465847, -82.65059662882595 35.63832824661548, -82.6509566288791 35.63837224666144, -82.65118362891364 35.63839324668902, -82.6512106289182 35.63839324669179, -82.65123762892266 35.6383932466946, -82.65131862893621 35.63839324670295, -82.65134562894063 35.6383932467057, -82.65135862895173 35.63833524669518, -82.65148862903196 35.63795524663115, -82.65158362908981 35.637682246585165, -82.65162562911961 35.637534246559376, -82.65165962915087 35.63736824652897, -82.6516686291744 35.63722524650074, -82.65165762919524 35.63707824646967, -82.65163262921139 35.636946246440225, -82.65164162924015 35.63676924640503, -82.65168162926824 35.63663024638083, -82.65169062927282 35.63661024637775, -82.65175362930293 35.636483246358296, -82.6518266293328 35.63636824634231, -82.65190062935669 35.63629324633465, -82.6519636293739 35.6362492463322, -82.65201362938765 35.636214246330105, -82.65216762942116 35.63616324633556, -82.65234962945848 35.63611724634492, -82.65250462948495 35.63611324636003, -82.65254562949136 35.63611624636482, -82.65278662952824 35.63613724639382, -82.65298562955128 35.63620224642761, -82.65313562956565 35.63627124645697, -82.65348962959622 35.63645524653086, -82.65373362961991 35.63656524657829, -82.65385062963392 35.63660024659745, -82.65395162964722 35.63662324661252, -82.65410862967124 35.63663724663153, -82.65420262968776 35.63663124663991, -82.65426262970028 35.63661524664284, -82.65427562970285 35.6366122466436, -82.65434862971955 35.63658324664512, -82.65440262973402 35.63654724664342, -82.65446462975552 35.636474246634826, -82.65455362979242 35.636331246614844, -82.65461262982157 35.63620624659541, -82.65463662983215 35.636163246589085, -82.65465462984132 35.63612324658277, -82.6547596298888 35.63592824655387, -82.655035630018 35.63538824647209, -82.65516863007788 35.63514324643582, -82.65527063012367 35.634956246408194, -82.65545163020222 35.63464224636277, -82.65559263026174 35.63440824632959, -82.65592863041023 35.633807246241574, -82.65610763049278 35.63346524619027, -82.65625363056407 35.63316024614305, -82.65647563068245 35.632631246058054, -82.65666763077206 35.632257246001515, -82.65677263081517 35.63209124597848, -82.65706863093558 35.631629245914745, -82.65720963099291 35.63140924588428, -82.65737663106644 35.63111224584092, -82.65750763112831 35.63085224580139, -82.65758663116263 35.630715245781616, -82.65760763117132 35.630681245776856, -82.6577116312053 35.63057324576541, -82.65782163123515 35.630498245761494, -82.65798763127685 35.630407245759905, -82.65819863132569 35.63031824576352, -82.65842063137322 35.63024924577223, -82.65857763140257 35.630228245784075, -82.65875163142663 35.630260245808465, -82.65878863143064 35.63027424581508, -82.65900663145433 35.63035624585422, -82.65920563147401 35.63044324589235)))",5981,37,021,002606,370210026061,1325,1325,112,1296,1208,24,8,2,0,54,29,1004,68,936,994,928,17,8,2,0,39,10,529,490,39
